Geo_FIPS,Geo_NAME,Geo_QName,Geo_NATION,Geo_STATE,Geo_COUNTY,Geo_CT,SE_T157_001,SE_T157_002,SE_T157_003
"01001","Autauga County","Autauga County, Alabama","00","01","001",,17662,16003,1659
"01003","Baldwin County","Baldwin County, Alabama","00","01","003",,74285,55336,18949
"01005","Barbour County","Barbour County, Alabama","00","01","005",,12461,10409,2052
"01007","Bibb County","Bibb County, Alabama","00","01","007",,8345,7421,924
"01009","Blount County","Blount County, Alabama","00","01","009",,21158,19265,1893
"01011","Bullock County","Bullock County, Alabama","00","01","011",,4727,3986,741
"01013","Butler County","Butler County, Alabama","00","01","013",,9957,8398,1559
"01015","Calhoun County","Calhoun County, Alabama","00","01","015",,51322,45307,6015
"01017","Chambers County","Chambers County, Alabama","00","01","017",,16256,14522,1734
"01019","Cherokee County","Cherokee County, Alabama","00","01","019",,14025,9719,4306
"01021","Chilton County","Chilton County, Alabama","00","01","021",,17651,15287,2364
"01023","Choctaw County","Choctaw County, Alabama","00","01","023",,7839,6363,1476
"01025","Clarke County","Clarke County, Alabama","00","01","025",,12631,10578,2053
"01027","Clay County","Clay County, Alabama","00","01","027",,6612,5765,847
"01029","Cleburne County","Cleburne County, Alabama","00","01","029",,6189,5590,599
"01031","Coffee County","Coffee County, Alabama","00","01","031",,19837,17421,2416
"01033","Colbert County","Colbert County, Alabama","00","01","033",,24980,22461,2519
"01035","Conecuh County","Conecuh County, Alabama","00","01","035",,7265,5792,1473
"01037","Coosa County","Coosa County, Alabama","00","01","037",,6142,4682,1460
"01039","Covington County","Covington County, Alabama","00","01","039",,18578,15640,2938
"01041","Crenshaw County","Crenshaw County, Alabama","00","01","041",,6644,5577,1067
"01043","Cullman County","Cullman County, Alabama","00","01","043",,35233,30706,4527
"01045","Dale County","Dale County, Alabama","00","01","045",,21779,18878,2901
"01047","Dallas County","Dallas County, Alabama","00","01","047",,20450,17841,2609
"01049","DeKalb County","DeKalb County, Alabama","00","01","049",,28051,25113,2938
"01051","Elmore County","Elmore County, Alabama","00","01","051",,25733,22737,2996
"01053","Escambia County","Escambia County, Alabama","00","01","053",,16544,14297,2247
"01055","Etowah County","Etowah County, Alabama","00","01","055",,45959,41615,4344
"01057","Fayette County","Fayette County, Alabama","00","01","057",,8472,7493,979
"01059","Franklin County","Franklin County, Alabama","00","01","059",,13749,12259,1490
"01061","Geneva County","Geneva County, Alabama","00","01","061",,12115,10477,1638
"01063","Greene County","Greene County, Alabama","00","01","063",,5117,3931,1186
"01065","Hale County","Hale County, Alabama","00","01","065",,7756,6415,1341
"01067","Henry County","Henry County, Alabama","00","01","067",,8037,6525,1512
"01069","Houston County","Houston County, Alabama","00","01","069",,39571,35834,3737
"01071","Jackson County","Jackson County, Alabama","00","01","071",,24168,21615,2553
"01073","Jefferson County","Jefferson County, Alabama","00","01","073",,288162,263265,24897
"01075","Lamar County","Lamar County, Alabama","00","01","075",,7517,6468,1049
"01077","Lauderdale County","Lauderdale County, Alabama","00","01","077",,40424,36088,4336
"01079","Lawrence County","Lawrence County, Alabama","00","01","079",,15009,13538,1471
"01081","Lee County","Lee County, Alabama","00","01","081",,50329,45702,4627
"01083","Limestone County","Limestone County, Alabama","00","01","083",,26897,24688,2209
"01085","Lowndes County","Lowndes County, Alabama","00","01","085",,5801,4909,892
"01087","Macon County","Macon County, Alabama","00","01","087",,10627,8950,1677
"01089","Madison County","Madison County, Alabama","00","01","089",,120288,109955,10333
"01091","Marengo County","Marengo County, Alabama","00","01","091",,10127,8767,1360
"01093","Marion County","Marion County, Alabama","00","01","093",,14416,12697,1719
"01095","Marshall County","Marshall County, Alabama","00","01","095",,36331,32547,3784
"01097","Mobile County","Mobile County, Alabama","00","01","097",,165101,150179,14922
"01099","Monroe County","Monroe County, Alabama","00","01","099",,11343,9383,1960
"01101","Montgomery County","Montgomery County, Alabama","00","01","101",,95437,86068,9369
"01103","Morgan County","Morgan County, Alabama","00","01","103",,47388,43602,3786
"01105","Perry County","Perry County, Alabama","00","01","105",,5406,4333,1073
"01107","Pickens County","Pickens County, Alabama","00","01","107",,9520,8086,1434
"01109","Pike County","Pike County, Alabama","00","01","109",,13981,11933,2048
"01111","Randolph County","Randolph County, Alabama","00","01","111",,10285,8642,1643
"01113","Russell County","Russell County, Alabama","00","01","113",,22831,19741,3090
"01115","St. Clair County","St. Clair County, Alabama","00","01","115",,27303,24143,3160
"01117","Shelby County","Shelby County, Alabama","00","01","117",,59302,54631,4671
"01119","Sumter County","Sumter County, Alabama","00","01","119",,6953,5708,1245
"01121","Talladega County","Talladega County, Alabama","00","01","121",,34469,30674,3795
"01123","Tallapoosa County","Tallapoosa County, Alabama","00","01","123",,20510,16656,3854
"01125","Tuscaloosa County","Tuscaloosa County, Alabama","00","01","125",,71429,64517,6912
"01127","Walker County","Walker County, Alabama","00","01","127",,32417,28364,4053
"01129","Washington County","Washington County, Alabama","00","01","129",,8123,6705,1418
"01131","Wilcox County","Wilcox County, Alabama","00","01","131",,6183,4776,1407
"01133","Winston County","Winston County, Alabama","00","01","133",,12502,10107,2395
"02013","Aleutians East Borough","Aleutians East Borough, Alaska","00","02","013",,724,526,198
"02016","Aleutians West Census Area","Aleutians West Census Area, Alaska","00","02","016",,2234,1270,964
"02020","Anchorage Municipality","Anchorage Municipality, Alaska","00","02","020",,100368,94822,5546
"02050","Bethel Census Area","Bethel Census Area, Alaska","00","02","050",,5188,4226,962
"02060","Bristol Bay Borough","Bristol Bay Borough, Alaska","00","02","060",,979,490,489
"02068","Denali Borough","Denali Borough, Alaska","00","02","068",,1351,785,566
"02070","Dillingham Census Area","Dillingham Census Area, Alaska","00","02","070",,2332,1529,803
"02090","Fairbanks North Star Borough","Fairbanks North Star Borough, Alaska","00","02","090",,33291,29777,3514
"02100","Haines Borough","Haines Borough, Alaska","00","02","100",,1419,991,428
"02105","Hoonah-Angoon Census Area","Hoonah-Angoon Census Area, Alaska","00","02","105",,1579.1595052,1025.5547261,553.6047791
"02110","Juneau City and Borough","Juneau City and Borough, Alaska","00","02","110",,12282,11543,739
"02122","Kenai Peninsula Borough","Kenai Peninsula Borough, Alaska","00","02","122",,24871,18438,6433
"02130","Ketchikan Gateway Borough","Ketchikan Gateway Borough, Alaska","00","02","130",,6221.47949836,5401.576309424,819.903188936
"02150","Kodiak Island Borough","Kodiak Island Borough, Alaska","00","02","150",,5159,4424,735
"02164","Lake and Peninsula Borough","Lake and Peninsula Borough, Alaska","00","02","164",,1557,588,969
"02170","Matanuska-Susitna Borough","Matanuska-Susitna Borough, Alaska","00","02","170",,27329,20556,6773
"02180","Nome Census Area","Nome Census Area, Alaska","00","02","180",,3649,2693,956
"02185","North Slope Borough","North Slope Borough, Alaska","00","02","185",,2538,2109,429
"02188","Northwest Arctic Borough","Northwest Arctic Borough, Alaska","00","02","188",,2540,1780,760
"02195","Petersburg Census Area","Petersburg Census Area, Alaska","00","02","195",,2085.5455784,1642.9069462,442.6386322
"02198","Prince of Wales-Hyder Census Area","Prince of Wales-Hyder Census Area, Alaska","00","02","198",,3036.111292435,2248.014318654,788.096973781
"02220","Sitka City and Borough","Sitka City and Borough, Alaska","00","02","220",,3650,3278,372
"02230","Skagway Municipality","Skagway Municipality, Alaska","00","02","230",,528.8404948,343.4452739,185.3952209
"02240","Southeast Fairbanks Census Area","Southeast Fairbanks Census Area, Alaska","00","02","240",,3225,2098,1127
"02261","Valdez-Cordova Census Area","Valdez-Cordova Census Area, Alaska","00","02","261",,5148,3884,1264
"02270","Wade Hampton Census Area","Wade Hampton Census Area, Alaska","00","02","270",,2063,1602,461
"02275","Wrangell City and Borough","Wrangell City and Borough, Alaska","00","02","275",,1213.863630805,955.502425722,258.361205083
"02282","Yakutat City and Borough","Yakutat City and Borough, Alaska","00","02","282",,499,265,234
"02290","Yukon-Koyukuk Census Area","Yukon-Koyukuk Census Area, Alaska","00","02","290",,3917,2309,1608
"04001","Apache County","Apache County, Arizona","00","04","001",,31621,19971,11650
"04003","Cochise County","Cochise County, Arizona","00","04","003",,51126,43893,7233
"04005","Coconino County","Coconino County, Arizona","00","04","005",,53443,40448,12995
"04007","Gila County","Gila County, Arizona","00","04","007",,28189,20140,8049
"04009","Graham County","Graham County, Arizona","00","04","009",,11430,10116,1314
"04011","Greenlee County","Greenlee County, Arizona","00","04","011",,3744,3117,627
"04012","La Paz County","La Paz County, Arizona","00","04","012",,15133,8362,6771
"04013","Maricopa County","Maricopa County, Arizona","00","04","013",,1250231,1132886,117345
"04015","Mohave County","Mohave County, Arizona","00","04","015",,80062,62809,17253
"04017","Navajo County","Navajo County, Arizona","00","04","017",,47413,30043,17370
"04019","Pima County","Pima County, Arizona","00","04","019",,366737,332350,34387
"04021","Pinal County","Pinal County, Arizona","00","04","021",,81154,61364,19790
"04023","Santa Cruz County","Santa Cruz County, Arizona","00","04","023",,13036,11809,1227
"04025","Yavapai County","Yavapai County, Arizona","00","04","025",,81730,70171,11559
"04027","Yuma County","Yuma County, Arizona","00","04","027",,74140,53848,20292
"05001","Arkansas County","Arkansas County, Arkansas","00","05","001",,9672,8457,1215
"05003","Ashley County","Ashley County, Arkansas","00","05","003",,10615,9384,1231
"05005","Baxter County","Baxter County, Arkansas","00","05","005",,19891,17052,2839
"05007","Benton County","Benton County, Arkansas","00","05","007",,64281,58212,6069
"05009","Boone County","Boone County, Arkansas","00","05","009",,15426,13851,1575
"05011","Bradley County","Bradley County, Arkansas","00","05","011",,5930,4834,1096
"05013","Calhoun County","Calhoun County, Arkansas","00","05","013",,3012,2317,695
"05015","Carroll County","Carroll County, Arkansas","00","05","015",,11828,10189,1639
"05017","Chicot County","Chicot County, Arkansas","00","05","017",,5974,5205,769
"05019","Clark County","Clark County, Arkansas","00","05","019",,10166,8912,1254
"05021","Clay County","Clay County, Arkansas","00","05","021",,8498,7417,1081
"05023","Cleburne County","Cleburne County, Arkansas","00","05","023",,13732,10190,3542
"05025","Cleveland County","Cleveland County, Arkansas","00","05","025",,3834,3273,561
"05027","Columbia County","Columbia County, Arkansas","00","05","027",,11566,9981,1585
"05029","Conway County","Conway County, Arkansas","00","05","029",,9028,7967,1061
"05031","Craighead County","Craighead County, Arkansas","00","05","031",,35133,32301,2832
"05033","Crawford County","Crawford County, Arkansas","00","05","033",,21315,19702,1613
"05035","Crittenden County","Crittenden County, Arkansas","00","05","035",,20507,18471,2036
"05037","Cross County","Cross County, Arkansas","00","05","037",,8030,7391,639
"05039","Dallas County","Dallas County, Arkansas","00","05","039",,4401,3519,882
"05041","Desha County","Desha County, Arkansas","00","05","041",,6663,5922,741
"05043","Drew County","Drew County, Arkansas","00","05","043",,8287,7337,950
"05045","Faulkner County","Faulkner County, Arkansas","00","05","045",,34546,31882,2664
"05047","Franklin County","Franklin County, Arkansas","00","05","047",,7673,6882,791
"05049","Fulton County","Fulton County, Arkansas","00","05","049",,5973,4810,1163
"05051","Garland County","Garland County, Arkansas","00","05","051",,44953,37813,7140
"05053","Grant County","Grant County, Arkansas","00","05","053",,6960,6241,719
"05055","Greene County","Greene County, Arkansas","00","05","055",,16161,14750,1411
"05057","Hempstead County","Hempstead County, Arkansas","00","05","057",,10166,8959,1207
"05059","Hot Spring County","Hot Spring County, Arkansas","00","05","059",,13384,12004,1380
"05061","Howard County","Howard County, Arkansas","00","05","061",,6297,5471,826
"05063","Independence County","Independence County, Arkansas","00","05","063",,14841,13467,1374
"05065","Izard County","Izard County, Arkansas","00","05","065",,6591,5440,1151
"05067","Jackson County","Jackson County, Arkansas","00","05","067",,7956,6971,985
"05069","Jefferson County","Jefferson County, Arkansas","00","05","069",,34350,30555,3795
"05071","Johnson County","Johnson County, Arkansas","00","05","071",,9926,8738,1188
"05073","Lafayette County","Lafayette County, Arkansas","00","05","073",,4560,3434,1126
"05075","Lawrence County","Lawrence County, Arkansas","00","05","075",,8085,7108,977
"05077","Lee County","Lee County, Arkansas","00","05","077",,4768,4182,586
"05079","Lincoln County","Lincoln County, Arkansas","00","05","079",,4955,4265,690
"05081","Little River County","Little River County, Arkansas","00","05","081",,6435,5465,970
"05083","Logan County","Logan County, Arkansas","00","05","083",,9942,8693,1249
"05085","Lonoke County","Lonoke County, Arkansas","00","05","085",,20749,19262,1487
"05087","Madison County","Madison County, Arkansas","00","05","087",,6537,5463,1074
"05089","Marion County","Marion County, Arkansas","00","05","089",,8235,6776,1459
"05091","Miller County","Miller County, Arkansas","00","05","091",,17727,15637,2090
"05093","Mississippi County","Mississippi County, Arkansas","00","05","093",,22310,19349,2961
"05095","Monroe County","Monroe County, Arkansas","00","05","095",,5067,4105,962
"05097","Montgomery County","Montgomery County, Arkansas","00","05","097",,5048,3785,1263
"05099","Nevada County","Nevada County, Arkansas","00","05","099",,4751,3893,858
"05101","Newton County","Newton County, Arkansas","00","05","101",,4316,3500,816
"05103","Ouachita County","Ouachita County, Arkansas","00","05","103",,13450,11613,1837
"05105","Perry County","Perry County, Arkansas","00","05","105",,4702,3989,713
"05107","Phillips County","Phillips County, Arkansas","00","05","107",,10859,9711,1148
"05109","Pike County","Pike County, Arkansas","00","05","109",,5536,4504,1032
"05111","Poinsett County","Poinsett County, Arkansas","00","05","111",,11051,10026,1025
"05113","Polk County","Polk County, Arkansas","00","05","113",,9236,8047,1189
"05115","Pope County","Pope County, Arkansas","00","05","115",,22851,20701,2150
"05117","Prairie County","Prairie County, Arkansas","00","05","117",,4790,3894,896
"05119","Pulaski County","Pulaski County, Arkansas","00","05","119",,161135,147942,13193
"05121","Randolph County","Randolph County, Arkansas","00","05","121",,8268,7265,1003
"05123","St. Francis County","St. Francis County, Arkansas","00","05","123",,11242,10043,1199
"05125","Saline County","Saline County, Arkansas","00","05","125",,33825,31778,2047
"05127","Scott County","Scott County, Arkansas","00","05","127",,4924,4323,601
"05129","Searcy County","Searcy County, Arkansas","00","05","129",,4292,3523,769
"05131","Sebastian County","Sebastian County, Arkansas","00","05","131",,49311,45300,4011
"05133","Sevier County","Sevier County, Arkansas","00","05","133",,6434,5708,726
"05135","Sharp County","Sharp County, Arkansas","00","05","135",,9342,7211,2131
"05137","Stone County","Stone County, Arkansas","00","05","137",,5715,4768,947
"05139","Union County","Union County, Arkansas","00","05","139",,20676,17989,2687
"05141","Van Buren County","Van Buren County, Arkansas","00","05","141",,9164,6825,2339
"05143","Washington County","Washington County, Arkansas","00","05","143",,64330,60151,4179
"05145","White County","White County, Arkansas","00","05","145",,27613,25148,2465
"05147","Woodruff County","Woodruff County, Arkansas","00","05","147",,4089,3531,558
"05149","Yell County","Yell County, Arkansas","00","05","149",,9157,7922,1235
"06001","Alameda County","Alameda County, California","00","06","001",,540183,523366,16817
"06003","Alpine County","Alpine County, California","00","06","003",,1514,483,1031
"06005","Amador County","Amador County, California","00","06","005",,15035,12759,2276
"06007","Butte County","Butte County, California","00","06","007",,85523,79566,5957
"06009","Calaveras County","Calaveras County, California","00","06","009",,22946,16469,6477
"06011","Colusa County","Colusa County, California","00","06","011",,6774,6097,677
"06013","Contra Costa County","Contra Costa County, California","00","06","013",,354577,344129,10448
"06015","Del Norte County","Del Norte County, California","00","06","015",,10434,9170,1264
"06017","El Dorado County","El Dorado County, California","00","06","017",,71278,58939,12339
"06019","Fresno County","Fresno County, California","00","06","019",,270767,252940,17827
"06021","Glenn County","Glenn County, California","00","06","021",,9982,9172,810
"06023","Humboldt County","Humboldt County, California","00","06","023",,55912,51238,4674
"06025","Imperial County","Imperial County, California","00","06","025",,43891,39384,4507
"06027","Inyo County","Inyo County, California","00","06","027",,9042,7703,1339
"06029","Kern County","Kern County, California","00","06","029",,231564,208652,22912
"06031","Kings County","Kings County, California","00","06","031",,36563,34418,2145
"06033","Lake County","Lake County, California","00","06","033",,32528,23974,8554
"06035","Lassen County","Lassen County, California","00","06","035",,12000,9625,2375
"06037","Los Angeles County","Los Angeles County, California","00","06","037",,3270909,3133774,137135
"06039","Madera County","Madera County, California","00","06","039",,40387,36155,4232
"06041","Marin County","Marin County, California","00","06","041",,104990,100650,4340
"06043","Mariposa County","Mariposa County, California","00","06","043",,8826,6613,2213
"06045","Mendocino County","Mendocino County, California","00","06","045",,36937,33266,3671
"06047","Merced County","Merced County, California","00","06","047",,68373,63815,4558
"06049","Modoc County","Modoc County, California","00","06","049",,4807,3784,1023
"06051","Mono County","Mono County, California","00","06","051",,11757,5137,6620
"06053","Monterey County","Monterey County, California","00","06","053",,131708,121236,10472
"06055","Napa County","Napa County, California","00","06","055",,48554,45402,3152
"06057","Nevada County","Nevada County, California","00","06","057",,44282,36894,7388
"06059","Orange County","Orange County, California","00","06","059",,969484,935287,34197
"06061","Placer County","Placer County, California","00","06","061",,107302,93382,13920
"06063","Plumas County","Plumas County, California","00","06","063",,13386,9000,4386
"06065","Riverside County","Riverside County, California","00","06","065",,584674,506218,78456
"06067","Sacramento County","Sacramento County, California","00","06","067",,474814,453602,21212
"06069","San Benito County","San Benito County, California","00","06","069",,16499,15885,614
"06071","San Bernardino County","San Bernardino County, California","00","06","071",,601369,528594,72775
"06073","San Diego County","San Diego County, California","00","06","073",,1040149,994677,45472
"06075","San Francisco County","San Francisco County, California","00","06","075",,346527,329700,16827
"06077","San Joaquin County","San Joaquin County, California","00","06","077",,189160,181629,7531
"06079","San Luis Obispo County","San Luis Obispo County, California","00","06","079",,102275,92739,9536
"06081","San Mateo County","San Mateo County, California","00","06","081",,260576,254103,6473
"06083","Santa Barbara County","Santa Barbara County, California","00","06","083",,142901,136622,6279
"06085","Santa Clara County","Santa Clara County, California","00","06","085",,579329,565863,13466
"06087","Santa Cruz County","Santa Cruz County, California","00","06","087",,98873,91139,7734
"06089","Shasta County","Shasta County, California","00","06","089",,68810,63426,5384
"06091","Sierra County","Sierra County, California","00","06","091",,2202,1520,682
"06093","Siskiyou County","Siskiyou County, California","00","06","093",,21947,18556,3391
"06095","Solano County","Solano County, California","00","06","095",,134513,130403,4110
"06097","Sonoma County","Sonoma County, California","00","06","097",,183153,172403,10750
"06099","Stanislaus County","Stanislaus County, California","00","06","099",,150807,145146,5661
"06101","Sutter County","Sutter County, California","00","06","101",,28319,27033,1286
"06103","Tehama County","Tehama County, California","00","06","103",,23547,21013,2534
"06105","Trinity County","Trinity County, California","00","06","105",,7980,5587,2393
"06107","Tulare County","Tulare County, California","00","06","107",,119639,110385,9254
"06109","Tuolumne County","Tuolumne County, California","00","06","109",,28336,21004,7332
"06111","Ventura County","Ventura County, California","00","06","111",,251712,243234,8478
"06113","Yolo County","Yolo County, California","00","06","113",,61587,59375,2212
"06115","Yuba County","Yuba County, California","00","06","115",,22636,20535,2101
"08001","Adams County","Adams County, Colorado","00","08","001",,126810.775326571,122566.343294206,4244.43203236436
"08003","Alamosa County","Alamosa County, Colorado","00","08","003",,6088,5467,621
"08005","Arapahoe County","Arapahoe County, Colorado","00","08","005",,196835,190909,5926
"08007","Archuleta County","Archuleta County, Colorado","00","08","007",,6212,3980,2232
"08009","Baca County","Baca County, Colorado","00","08","009",,2364,1905,459
"08011","Bent County","Bent County, Colorado","00","08","011",,2366,2003,363
"08013","Boulder County","Boulder County, Colorado","00","08","013",,111045.228090412,106210.731921672,4834.49616874021
"08014","Broomfield County","Broomfield County, Colorado","00","08","014",,15359.0941829855,14757.8710903333,601.223092652186
"08015","Chaffee County","Chaffee County, Colorado","00","08","015",,8392,6584,1808
"08017","Cheyenne County","Cheyenne County, Colorado","00","08","017",,1105,880,225
"08019","Clear Creek County","Clear Creek County, Colorado","00","08","019",,5128,4019,1109
"08021","Conejos County","Conejos County, Colorado","00","08","021",,3886,2980,906
"08023","Costilla County","Costilla County, Colorado","00","08","023",,2202,1503,699
"08025","Crowley County","Crowley County, Colorado","00","08","025",,1542,1358,184
"08027","Custer County","Custer County, Colorado","00","08","027",,2989,1480,1509
"08029","Delta County","Delta County, Colorado","00","08","029",,12374,11058,1316
"08031","Denver County","Denver County, Colorado","00","08","031",,251435,239235,12200
"08033","Dolores County","Dolores County, Colorado","00","08","033",,1193,785,408
"08035","Douglas County","Douglas County, Colorado","00","08","035",,63333,60924,2409
"08037","Eagle County","Eagle County, Colorado","00","08","037",,22111,15148,6963
"08039","Elbert County","Elbert County, Colorado","00","08","039",,7113,6770,343
"08041","El Paso County","El Paso County, Colorado","00","08","041",,202428,192409,10019
"08043","Fremont County","Fremont County, Colorado","00","08","043",,17145,15232,1913
"08045","Garfield County","Garfield County, Colorado","00","08","045",,17336,16229,1107
"08047","Gilpin County","Gilpin County, Colorado","00","08","047",,2929,2043,886
"08049","Grand County","Grand County, Colorado","00","08","049",,10894,5075,5819
"08051","Gunnison County","Gunnison County, Colorado","00","08","051",,9135,5649,3486
"08053","Hinsdale County","Hinsdale County, Colorado","00","08","053",,1304,359,945
"08055","Huerfano County","Huerfano County, Colorado","00","08","055",,4599,3082,1517
"08057","Jackson County","Jackson County, Colorado","00","08","057",,1145,661,484
"08059","Jefferson County","Jefferson County, Colorado","00","08","059",,211792.145502565,205392.172956953,6399.97254561185
"08061","Kiowa County","Kiowa County, Colorado","00","08","061",,817,665,152
"08063","Kit Carson County","Kit Carson County, Colorado","00","08","063",,3430,2990,440
"08065","Lake County","Lake County, Colorado","00","08","065",,3913,2977,936
"08067","La Plata County","La Plata County, Colorado","00","08","067",,20765,17342,3423
"08069","Larimer County","Larimer County, Colorado","00","08","069",,105392,97164,8228
"08071","Las Animas County","Las Animas County, Colorado","00","08","071",,7629,6173,1456
"08073","Lincoln County","Lincoln County, Colorado","00","08","073",,2406,2058,348
"08075","Logan County","Logan County, Colorado","00","08","075",,8424,7551,873
"08077","Mesa County","Mesa County, Colorado","00","08","077",,48427,45823,2604
"08079","Mineral County","Mineral County, Colorado","00","08","079",,1119,377,742
"08081","Moffat County","Moffat County, Colorado","00","08","081",,5635,4983,652
"08083","Montezuma County","Montezuma County, Colorado","00","08","083",,10497,9201,1296
"08085","Montrose County","Montrose County, Colorado","00","08","085",,14202,13043,1159
"08087","Morgan County","Morgan County, Colorado","00","08","087",,10410,9539,871
"08089","Otero County","Otero County, Colorado","00","08","089",,8813,7920,893
"08091","Ouray County","Ouray County, Colorado","00","08","091",,2146,1576,570
"08093","Park County","Park County, Colorado","00","08","093",,10697,5894,4803
"08095","Phillips County","Phillips County, Colorado","00","08","095",,2014,1781,233
"08097","Pitkin County","Pitkin County, Colorado","00","08","097",,10096,6807,3289
"08099","Prowers County","Prowers County, Colorado","00","08","099",,5977,5307,670
"08101","Pueblo County","Pueblo County, Colorado","00","08","101",,58926,54579,4347
"08103","Rio Blanco County","Rio Blanco County, Colorado","00","08","103",,2855,2306,549
"08105","Rio Grande County","Rio Grande County, Colorado","00","08","105",,6003,4701,1302
"08107","Routt County","Routt County, Colorado","00","08","107",,11217,7953,3264
"08109","Saguache County","Saguache County, Colorado","00","08","109",,3087,2300,787
"08111","San Juan County","San Juan County, Colorado","00","08","111",,632,269,363
"08113","San Miguel County","San Miguel County, Colorado","00","08","113",,5197,3015,2182
"08115","Sedgwick County","Sedgwick County, Colorado","00","08","115",,1387,1165,222
"08117","Summit County","Summit County, Colorado","00","08","117",,24201,9120,15081
"08119","Teller County","Teller County, Colorado","00","08","119",,10362,7993,2369
"08121","Washington County","Washington County, Colorado","00","08","121",,2307,1989,318
"08123","Weld County","Weld County, Colorado","00","08","123",,66168.7568974665,63222.8807368351,2945.87616063138
"08125","Yuma County","Yuma County, Colorado","00","08","125",,4295,3800,495
"09001","Fairfield County","Fairfield County, Connecticut","00","09","001",,339466,324232,15234
"09003","Hartford County","Hartford County, Connecticut","00","09","003",,353022,335098,17924
"09005","Litchfield County","Litchfield County, Connecticut","00","09","005",,79267,71551,7716
"09007","Middlesex County","Middlesex County, Connecticut","00","09","007",,67285,61341,5944
"09009","New Haven County","New Haven County, Connecticut","00","09","009",,340732,319040,21692
"09011","New London County","New London County, Connecticut","00","09","011",,110674,99835,10839
"09013","Tolland County","Tolland County, Connecticut","00","09","013",,51570,49431,2139
"09015","Windham County","Windham County, Connecticut","00","09","015",,43959,41142,2817
"10001","Kent County","Kent County, Delaware","00","10","001",,50481,47224,3257
"10003","New Castle County","New Castle County, Delaware","00","10","003",,199521,188935,10586
"10005","Sussex County","Sussex County, Delaware","00","10","005",,93070,62577,30493
"11001","District of Columbia","District of Columbia, District of Columbia","00","11","001",,274845,248338,26507
"12001","Alachua County","Alachua County, Florida","00","12","001",,95113,87509,7604
"12003","Baker County","Baker County, Florida","00","12","003",,7592,7043,549
"12005","Bay County","Bay County, Florida","00","12","005",,78435,59597,18838
"12007","Bradford County","Bradford County, Florida","00","12","007",,9605,8497,1108
"12009","Brevard County","Brevard County, Florida","00","12","009",,222072,198195,23877
"12011","Broward County","Broward County, Florida","00","12","011",,741043,654445,86598
"12013","Calhoun County","Calhoun County, Florida","00","12","013",,5250,4468,782
"12015","Charlotte County","Charlotte County, Florida","00","12","015",,79758,63864,15894
"12017","Citrus County","Citrus County, Florida","00","12","017",,62204,52634,9570
"12019","Clay County","Clay County, Florida","00","12","019",,53748,50243,3505
"12021","Collier County","Collier County, Florida","00","12","021",,144536,102973,41563
"12023","Columbia County","Columbia County, Florida","00","12","023",,23579,20925,2654
"12027","DeSoto County","DeSoto County, Florida","00","12","027",,13608,10746,2862
"12029","Dixie County","Dixie County, Florida","00","12","029",,7362,5205,2157
"12031","Duval County","Duval County, Florida","00","12","031",,329778,303747,26031
"12033","Escambia County","Escambia County, Florida","00","12","033",,124647,111049,13598
"12035","Flagler County","Flagler County, Florida","00","12","035",,24452,21294,3158
"12037","Franklin County","Franklin County, Florida","00","12","037",,7180,4096,3084
"12039","Gadsden County","Gadsden County, Florida","00","12","039",,17703,15867,1836
"12041","Gilchrist County","Gilchrist County, Florida","00","12","041",,5906,5021,885
"12043","Glades County","Glades County, Florida","00","12","043",,5790,3852,1938
"12045","Gulf County","Gulf County, Florida","00","12","045",,7587,4931,2656
"12047","Hamilton County","Hamilton County, Florida","00","12","047",,4966,4161,805
"12049","Hardee County","Hardee County, Florida","00","12","049",,9820,8166,1654
"12051","Hendry County","Hendry County, Florida","00","12","051",,12294,10850,1444
"12053","Hernando County","Hernando County, Florida","00","12","053",,62727,55425,7302
"12055","Highlands County","Highlands County, Florida","00","12","055",,48846,37471,11375
"12057","Hillsborough County","Hillsborough County, Florida","00","12","057",,425962,391357,34605
"12059","Holmes County","Holmes County, Florida","00","12","059",,7998,6921,1077
"12061","Indian River County","Indian River County, Florida","00","12","061",,57902,49137,8765
"12063","Jackson County","Jackson County, Florida","00","12","063",,19490,16620,2870
"12065","Jefferson County","Jefferson County, Florida","00","12","065",,5251,4695,556
"12067","Lafayette County","Lafayette County, Florida","00","12","067",,2660,2142,518
"12069","Lake County","Lake County, Florida","00","12","069",,102830,88413,14417
"12071","Lee County","Lee County, Florida","00","12","071",,245405,188599,56806
"12073","Leon County","Leon County, Florida","00","12","073",,103974,96521,7453
"12075","Levy County","Levy County, Florida","00","12","075",,16570,13867,2703
"12077","Liberty County","Liberty County, Florida","00","12","077",,3156,2222,934
"12079","Madison County","Madison County, Florida","00","12","079",,7836,6629,1207
"12081","Manatee County","Manatee County, Florida","00","12","081",,138128,112460,25668
"12083","Marion County","Marion County, Florida","00","12","083",,122663,106755,15908
"12085","Martin County","Martin County, Florida","00","12","085",,65471,55288,10183
"12086","Miami-Dade County","Miami-Dade County, Florida","00","12","086",,852278,776774,75504
"12087","Monroe County","Monroe County, Florida","00","12","087",,51617,35086,16531
"12089","Nassau County","Nassau County, Florida","00","12","089",,25917,21980,3937
"12091","Okaloosa County","Okaloosa County, Florida","00","12","091",,78593,66269,12324
"12093","Okeechobee County","Okeechobee County, Florida","00","12","093",,15504,12593,2911
"12095","Orange County","Orange County, Florida","00","12","095",,361349,336286,25063
"12097","Osceola County","Osceola County, Florida","00","12","097",,72293,60977,11316
"12099","Palm Beach County","Palm Beach County, Florida","00","12","099",,556428,474175,82253
"12101","Pasco County","Pasco County, Florida","00","12","101",,173717,147566,26151
"12103","Pinellas County","Pinellas County, Florida","00","12","103",,481573,414968,66605
"12105","Polk County","Polk County, Florida","00","12","105",,226376,187233,39143
"12107","Putnam County","Putnam County, Florida","00","12","107",,33870,27839,6031
"12109","St. Johns County","St. Johns County, Florida","00","12","109",,58008,49614,8394
"12111","St. Lucie County","St. Lucie County, Florida","00","12","111",,91262,76933,14329
"12113","Santa Rosa County","Santa Rosa County, Florida","00","12","113",,49119,43793,5326
"12115","Sarasota County","Sarasota County, Florida","00","12","115",,182467,149937,32530
"12117","Seminole County","Seminole County, Florida","00","12","117",,147079,139572,7507
"12119","Sumter County","Sumter County, Florida","00","12","119",,25195,20779,4416
"12121","Suwannee County","Suwannee County, Florida","00","12","121",,15679,13460,2219
"12123","Taylor County","Taylor County, Florida","00","12","123",,9646,7176,2470
"12125","Union County","Union County, Florida","00","12","125",,3736,3367,369
"12127","Volusia County","Volusia County, Florida","00","12","127",,211938,184723,27215
"12129","Wakulla County","Wakulla County, Florida","00","12","129",,9820,8450,1370
"12131","Walton County","Walton County, Florida","00","12","131",,29083,16548,12535
"12133","Washington County","Washington County, Florida","00","12","133",,9503,7931,1572
"13001","Appling County","Appling County, Georgia","00","13","001",,7854,6606,1248
"13003","Atkinson County","Atkinson County, Georgia","00","13","003",,3171,2717,454
"13005","Bacon County","Bacon County, Georgia","00","13","005",,4464,3833,631
"13007","Baker County","Baker County, Georgia","00","13","007",,1740,1514,226
"13009","Baldwin County","Baldwin County, Georgia","00","13","009",,17173,14758,2415
"13011","Banks County","Banks County, Georgia","00","13","011",,5808,5364,444
"13013","Barrow County","Barrow County, Georgia","00","13","013",,17304,16354,950
"13015","Bartow County","Bartow County, Georgia","00","13","015",,28751,27176,1575
"13017","Ben Hill County","Ben Hill County, Georgia","00","13","017",,7623,6673,950
"13019","Berrien County","Berrien County, Georgia","00","13","019",,7100,6261,839
"13021","Bibb County","Bibb County, Georgia","00","13","021",,67194,59667,7527
"13023","Bleckley County","Bleckley County, Georgia","00","13","023",,4866,4372,494
"13025","Brantley County","Brantley County, Georgia","00","13","025",,6490,5436,1054
"13027","Brooks County","Brooks County, Georgia","00","13","027",,7118,6155,963
"13029","Bryan County","Bryan County, Georgia","00","13","029",,8675,8089,586
"13031","Bulloch County","Bulloch County, Georgia","00","13","031",,22742,20743,1999
"13033","Burke County","Burke County, Georgia","00","13","033",,8842,7934,908
"13035","Butts County","Butts County, Georgia","00","13","035",,7380,6455,925
"13037","Calhoun County","Calhoun County, Georgia","00","13","037",,2305,1962,343
"13039","Camden County","Camden County, Georgia","00","13","039",,16958,14705,2253
"13043","Candler County","Candler County, Georgia","00","13","043",,3893,3375,518
"13045","Carroll County","Carroll County, Georgia","00","13","045",,34067,31568,2499
"13047","Catoosa County","Catoosa County, Georgia","00","13","047",,21794,20425,1369
"13049","Charlton County","Charlton County, Georgia","00","13","049",,3859,3342,517
"13051","Chatham County","Chatham County, Georgia","00","13","051",,99683,89865,9818
"13053","Chattahoochee County","Chattahoochee County, Georgia","00","13","053",,3316,2932,384
"13055","Chattooga County","Chattooga County, Georgia","00","13","055",,10677,9577,1100
"13057","Cherokee County","Cherokee County, Georgia","00","13","057",,51937,49495,2442
"13059","Clarke County","Clarke County, Georgia","00","13","059",,42126,39706,2420
"13061","Clay County","Clay County, Georgia","00","13","061",,1925,1347,578
"13063","Clayton County","Clayton County, Georgia","00","13","063",,86461,82243,4218
"13065","Clinch County","Clinch County, Georgia","00","13","065",,2837,2512,325
"13067","Cobb County","Cobb County, Georgia","00","13","067",,237522,227487,10035
"13069","Coffee County","Coffee County, Georgia","00","13","069",,15610,13354,2256
"13071","Colquitt County","Colquitt County, Georgia","00","13","071",,17554,15495,2059
"13073","Columbia County","Columbia County, Georgia","00","13","073",,33321,31120,2201
"13075","Cook County","Cook County, Georgia","00","13","075",,6558,5882,676
"13077","Coweta County","Coweta County, Georgia","00","13","077",,33182,31442,1740
"13079","Crawford County","Crawford County, Georgia","00","13","079",,4872,4461,411
"13081","Crisp County","Crisp County, Georgia","00","13","081",,9559,8337,1222
"13083","Dade County","Dade County, Georgia","00","13","083",,6224,5633,591
"13085","Dawson County","Dawson County, Georgia","00","13","085",,7163,6069,1094
"13087","Decatur County","Decatur County, Georgia","00","13","087",,11968,10380,1588
"13089","DeKalb County","DeKalb County, Georgia","00","13","089",,261231,249339,11892
"13091","Dodge County","Dodge County, Georgia","00","13","091",,8186,7062,1124
"13093","Dooly County","Dooly County, Georgia","00","13","093",,4499,3909,590
"13095","Dougherty County","Dougherty County, Georgia","00","13","095",,39656,35552,4104
"13097","Douglas County","Douglas County, Georgia","00","13","097",,34825,32822,2003
"13099","Early County","Early County, Georgia","00","13","099",,5338,4695,643
"13101","Echols County","Echols County, Georgia","00","13","101",,1482,1264,218
"13103","Effingham County","Effingham County, Georgia","00","13","103",,14169,13151,1018
"13105","Elbert County","Elbert County, Georgia","00","13","105",,9136,8004,1132
"13107","Emanuel County","Emanuel County, Georgia","00","13","107",,9419,8045,1374
"13109","Evans County","Evans County, Georgia","00","13","109",,4381,3778,603
"13111","Fannin County","Fannin County, Georgia","00","13","111",,11134,8369,2765
"13113","Fayette County","Fayette County, Georgia","00","13","113",,32726,31524,1202
"13115","Floyd County","Floyd County, Georgia","00","13","115",,36615,34028,2587
"13117","Forsyth County","Forsyth County, Georgia","00","13","117",,36505,34565,1940
"13119","Franklin County","Franklin County, Georgia","00","13","119",,9303,7888,1415
"13121","Fulton County","Fulton County, Georgia","00","13","121",,348632,321242,27390
"13123","Gilmer County","Gilmer County, Georgia","00","13","123",,11924,9071,2853
"13125","Glascock County","Glascock County, Georgia","00","13","125",,1192,1004,188
"13127","Glynn County","Glynn County, Georgia","00","13","127",,32636,27208,5428
"13129","Gordon County","Gordon County, Georgia","00","13","129",,17145,16173,972
"13131","Grady County","Grady County, Georgia","00","13","131",,9991,8797,1194
"13133","Greene County","Greene County, Georgia","00","13","133",,6653,5477,1176
"13135","Gwinnett County","Gwinnett County, Georgia","00","13","135",,209682,202317,7365
"13137","Habersham County","Habersham County, Georgia","00","13","137",,14634,13259,1375
"13139","Hall County","Hall County, Georgia","00","13","139",,51046,47381,3665
"13141","Hancock County","Hancock County, Georgia","00","13","141",,4287,3237,1050
"13143","Haralson County","Haralson County, Georgia","00","13","143",,10719,9826,893
"13145","Harris County","Harris County, Georgia","00","13","145",,10288,8822,1466
"13147","Hart County","Hart County, Georgia","00","13","147",,11111,9106,2005
"13149","Heard County","Heard County, Georgia","00","13","149",,4512,4043,469
"13151","Henry County","Henry County, Georgia","00","13","151",,43166,41373,1793
"13153","Houston County","Houston County, Georgia","00","13","153",,44509,40911,3598
"13155","Irwin County","Irwin County, Georgia","00","13","155",,4149,3644,505
"13157","Jackson County","Jackson County, Georgia","00","13","157",,16226,15057,1169
"13159","Jasper County","Jasper County, Georgia","00","13","159",,4806,4175,631
"13161","Jeff Davis County","Jeff Davis County, Georgia","00","13","161",,5581,4828,753
"13163","Jefferson County","Jefferson County, Georgia","00","13","163",,7221,6339,882
"13165","Jenkins County","Jenkins County, Georgia","00","13","165",,3907,3214,693
"13167","Johnson County","Johnson County, Georgia","00","13","167",,3634,3130,504
"13169","Jones County","Jones County, Georgia","00","13","169",,9272,8659,613
"13171","Lamar County","Lamar County, Georgia","00","13","171",,6145,5712,433
"13173","Lanier County","Lanier County, Georgia","00","13","173",,3011,2593,418
"13175","Laurens County","Laurens County, Georgia","00","13","175",,19687,17083,2604
"13177","Lee County","Lee County, Georgia","00","13","177",,8813,8229,584
"13179","Liberty County","Liberty County, Georgia","00","13","179",,21977,19383,2594
"13181","Lincoln County","Lincoln County, Georgia","00","13","181",,4514,3251,1263
"13183","Long County","Long County, Georgia","00","13","183",,4232,3574,658
"13185","Lowndes County","Lowndes County, Georgia","00","13","185",,36551,32654,3897
"13187","Lumpkin County","Lumpkin County, Georgia","00","13","187",,8263,7537,726
"13189","McDuffie County","McDuffie County, Georgia","00","13","189",,8916,7970,946
"13191","McIntosh County","McIntosh County, Georgia","00","13","191",,5735,4202,1533
"13193","Macon County","Macon County, Georgia","00","13","193",,5495,4834,661
"13195","Madison County","Madison County, Georgia","00","13","195",,10520,9800,720
"13197","Marion County","Marion County, Georgia","00","13","197",,3130,2668,462
"13199","Meriwether County","Meriwether County, Georgia","00","13","199",,9211,8248,963
"13201","Miller County","Miller County, Georgia","00","13","201",,2770,2487,283
"13205","Mitchell County","Mitchell County, Georgia","00","13","205",,8880,8063,817
"13207","Monroe County","Monroe County, Georgia","00","13","207",,8425,7719,706
"13209","Montgomery County","Montgomery County, Georgia","00","13","209",,3492,2919,573
"13211","Morgan County","Morgan County, Georgia","00","13","211",,6128,5558,570
"13213","Murray County","Murray County, Georgia","00","13","213",,14320,13286,1034
"13215","Muscogee County","Muscogee County, Georgia","00","13","215",,76182,69819,6363
"13217","Newton County","Newton County, Georgia","00","13","217",,23033,21997,1036
"13219","Oconee County","Oconee County, Georgia","00","13","219",,9528,9051,477
"13221","Oglethorpe County","Oglethorpe County, Georgia","00","13","221",,5368,4849,519
"13223","Paulding County","Paulding County, Georgia","00","13","223",,29274,28089,1185
"13225","Peach County","Peach County, Georgia","00","13","225",,9093,8436,657
"13227","Pickens County","Pickens County, Georgia","00","13","227",,10687,8960,1727
"13229","Pierce County","Pierce County, Georgia","00","13","229",,6719,5958,761
"13231","Pike County","Pike County, Georgia","00","13","231",,5068,4755,313
"13233","Polk County","Polk County, Georgia","00","13","233",,15059,14012,1047
"13235","Pulaski County","Pulaski County, Georgia","00","13","235",,3944,3407,537
"13237","Putnam County","Putnam County, Georgia","00","13","237",,10319,7402,2917
"13239","Quitman County","Quitman County, Georgia","00","13","239",,1773,1047,726
"13241","Rabun County","Rabun County, Georgia","00","13","241",,10210,6279,3931
"13243","Randolph County","Randolph County, Georgia","00","13","243",,3402,2909,493
"13245","Richmond County","Richmond County, Georgia","00","13","245",,82312,73920,8392
"13247","Rockdale County","Rockdale County, Georgia","00","13","247",,25082,24052,1030
"13249","Schley County","Schley County, Georgia","00","13","249",,1612,1435,177
"13251","Screven County","Screven County, Georgia","00","13","251",,6853,5797,1056
"13253","Seminole County","Seminole County, Georgia","00","13","253",,4742,3573,1169
"13255","Spalding County","Spalding County, Georgia","00","13","255",,23001,21519,1482
"13257","Stephens County","Stephens County, Georgia","00","13","257",,11652,9951,1701
"13259","Stewart County","Stewart County, Georgia","00","13","259",,2354,2007,347
"13261","Sumter County","Sumter County, Georgia","00","13","261",,13700,12025,1675
"13263","Talbot County","Talbot County, Georgia","00","13","263",,2871,2538,333
"13265","Taliaferro County","Taliaferro County, Georgia","00","13","265",,1085,870,215
"13267","Tattnall County","Tattnall County, Georgia","00","13","267",,8578,7057,1521
"13269","Taylor County","Taylor County, Georgia","00","13","269",,3978,3281,697
"13271","Telfair County","Telfair County, Georgia","00","13","271",,5083,4140,943
"13273","Terrell County","Terrell County, Georgia","00","13","273",,4460,4002,458
"13275","Thomas County","Thomas County, Georgia","00","13","275",,18285,16309,1976
"13277","Tift County","Tift County, Georgia","00","13","277",,15411,13919,1492
"13279","Toombs County","Toombs County, Georgia","00","13","279",,11371,9877,1494
"13281","Towns County","Towns County, Georgia","00","13","281",,6282,3998,2284
"13283","Treutlen County","Treutlen County, Georgia","00","13","283",,2865,2531,334
"13285","Troup County","Troup County, Georgia","00","13","285",,23824,21920,1904
"13287","Turner County","Turner County, Georgia","00","13","287",,3916,3435,481
"13289","Twiggs County","Twiggs County, Georgia","00","13","289",,4291,3832,459
"13291","Union County","Union County, Georgia","00","13","291",,10001,7159,2842
"13293","Upson County","Upson County, Georgia","00","13","293",,11616,10722,894
"13295","Walker County","Walker County, Georgia","00","13","295",,25577,23605,1972
"13297","Walton County","Walton County, Georgia","00","13","297",,22500,21307,1193
"13299","Ware County","Ware County, Georgia","00","13","299",,15831,13475,2356
"13301","Warren County","Warren County, Georgia","00","13","301",,2767,2435,332
"13303","Washington County","Washington County, Georgia","00","13","303",,8327,7435,892
"13305","Wayne County","Wayne County, Georgia","00","13","305",,10827,9324,1503
"13307","Webster County","Webster County, Georgia","00","13","307",,1115,911,204
"13309","Wheeler County","Wheeler County, Georgia","00","13","309",,2447,2011,436
"13311","White County","White County, Georgia","00","13","311",,9454,7731,1723
"13313","Whitfield County","Whitfield County, Georgia","00","13","313",,30722,29385,1337
"13315","Wilcox County","Wilcox County, Georgia","00","13","315",,3320,2785,535
"13317","Wilkes County","Wilkes County, Georgia","00","13","317",,5022,4314,708
"13319","Wilkinson County","Wilkinson County, Georgia","00","13","319",,4449,3827,622
"13321","Worth County","Worth County, Georgia","00","13","321",,9086,8106,980
"15001","Hawaii County","Hawaii County, Hawaii","00","15","001",,62674,52985,9689
"15003","Honolulu County","Honolulu County, Hawaii","00","15","003",,315988,286450,29538
"15005","Kalawao County","Kalawao County, Hawaii","00","15","005",,172,115,57
"15007","Kauai County","Kauai County, Hawaii","00","15","007",,25331,20183,5148
"15009","Maui County","Maui County, Hawaii","00","15","009",,56377,43507,12870
"16001","Ada County","Ada County, Idaho","00","16","001",,118516,113408,5108
"16003","Adams County","Adams County, Idaho","00","16","003",,1982,1421,561
"16005","Bannock County","Bannock County, Idaho","00","16","005",,29102,27192,1910
"16007","Bear Lake County","Bear Lake County, Idaho","00","16","007",,3268,2259,1009
"16009","Benewah County","Benewah County, Idaho","00","16","009",,4238,3580,658
"16011","Bingham County","Bingham County, Idaho","00","16","011",,14303,13317,986
"16013","Blaine County","Blaine County, Idaho","00","16","013",,12186,7780,4406
"16015","Boise County","Boise County, Idaho","00","16","015",,4349,2616,1733
"16017","Bonner County","Bonner County, Idaho","00","16","017",,19646,14693,4953
"16019","Bonneville County","Bonneville County, Idaho","00","16","019",,30484,28753,1731
"16021","Boundary County","Boundary County, Idaho","00","16","021",,4095,3707,388
"16023","Butte County","Butte County, Idaho","00","16","023",,1290,1089,201
"16025","Camas County","Camas County, Idaho","00","16","025",,601,396,205
"16027","Canyon County","Canyon County, Idaho","00","16","027",,47965,45018,2947
"16029","Caribou County","Caribou County, Idaho","00","16","029",,3188,2560,628
"16031","Cassia County","Cassia County, Idaho","00","16","031",,7862,7060,802
"16033","Clark County","Clark County, Idaho","00","16","033",,521,340,181
"16035","Clearwater County","Clearwater County, Idaho","00","16","035",,4144,3456,688
"16037","Custer County","Custer County, Idaho","00","16","037",,2983,1770,1213
"16039","Elmore County","Elmore County, Idaho","00","16","039",,10527,9092,1435
"16041","Franklin County","Franklin County, Idaho","00","16","041",,3872,3476,396
"16043","Fremont County","Fremont County, Idaho","00","16","043",,6890,3885,3005
"16045","Gem County","Gem County, Idaho","00","16","045",,5888,5539,349
"16047","Gooding County","Gooding County, Idaho","00","16","047",,5505,5046,459
"16049","Idaho County","Idaho County, Idaho","00","16","049",,7537,6084,1453
"16051","Jefferson County","Jefferson County, Idaho","00","16","051",,6287,5901,386
"16053","Jerome County","Jerome County, Idaho","00","16","053",,6713,6298,415
"16055","Kootenai County","Kootenai County, Idaho","00","16","055",,46607,41308,5299
"16057","Latah County","Latah County, Idaho","00","16","057",,13838,13059,779
"16059","Lemhi County","Lemhi County, Idaho","00","16","059",,4154,3275,879
"16061","Lewis County","Lewis County, Idaho","00","16","061",,1795,1554,241
"16063","Lincoln County","Lincoln County, Idaho","00","16","063",,1651,1447,204
"16065","Madison County","Madison County, Idaho","00","16","065",,7630,7129,501
"16067","Minidoka County","Minidoka County, Idaho","00","16","067",,7498,6973,525
"16069","Nez Perce County","Nez Perce County, Idaho","00","16","069",,16203,15286,917
"16071","Oneida County","Oneida County, Idaho","00","16","071",,1755,1430,325
"16073","Owyhee County","Owyhee County, Idaho","00","16","073",,4452,3710,742
"16075","Payette County","Payette County, Idaho","00","16","075",,7949,7371,578
"16077","Power County","Power County, Idaho","00","16","077",,2844,2560,284
"16079","Shoshone County","Shoshone County, Idaho","00","16","079",,7057,5906,1151
"16081","Teton County","Teton County, Idaho","00","16","081",,2632,2078,554
"16083","Twin Falls County","Twin Falls County, Idaho","00","16","083",,25595,23853,1742
"16085","Valley County","Valley County, Idaho","00","16","085",,8084,3208,4876
"16087","Washington County","Washington County, Idaho","00","16","087",,4138,3762,376
"17001","Adams County","Adams County, Illinois","00","17","001",,29386,26860,2526
"17003","Alexander County","Alexander County, Illinois","00","17","003",,4591,3808,783
"17005","Bond County","Bond County, Illinois","00","17","005",,6690,6155,535
"17007","Boone County","Boone County, Illinois","00","17","007",,15414,14597,817
"17009","Brown County","Brown County, Illinois","00","17","009",,2456,2108,348
"17011","Bureau County","Bureau County, Illinois","00","17","011",,15331,14182,1149
"17013","Calhoun County","Calhoun County, Illinois","00","17","013",,2681,2046,635
"17015","Carroll County","Carroll County, Illinois","00","17","015",,7945,6794,1151
"17017","Cass County","Cass County, Illinois","00","17","017",,5784,5347,437
"17019","Champaign County","Champaign County, Illinois","00","17","019",,75280,70597,4683
"17021","Christian County","Christian County, Illinois","00","17","021",,14992,13921,1071
"17023","Clark County","Clark County, Illinois","00","17","023",,7816,6971,845
"17025","Clay County","Clay County, Illinois","00","17","025",,6394,5839,555
"17027","Clinton County","Clinton County, Illinois","00","17","027",,13805,12754,1051
"17029","Coles County","Coles County, Illinois","00","17","029",,22768,21043,1725
"17031","Cook County","Cook County, Illinois","00","17","031",,2096121,1974181,121940
"17033","Crawford County","Crawford County, Illinois","00","17","033",,8785,7842,943
"17035","Cumberland County","Cumberland County, Illinois","00","17","035",,4876,4368,508
"17037","DeKalb County","DeKalb County, Illinois","00","17","037",,32988,31674,1314
"17039","De Witt County","De Witt County, Illinois","00","17","039",,7282,6770,512
"17041","Douglas County","Douglas County, Illinois","00","17","041",,8005,7574,431
"17043","DuPage County","DuPage County, Illinois","00","17","043",,335621,325601,10020
"17045","Edgar County","Edgar County, Illinois","00","17","045",,8611,7874,737
"17047","Edwards County","Edwards County, Illinois","00","17","047",,3199,2905,294
"17049","Effingham County","Effingham County, Illinois","00","17","049",,13959,13001,958
"17051","Fayette County","Fayette County, Illinois","00","17","051",,9053,8146,907
"17053","Ford County","Ford County, Illinois","00","17","053",,6060,5639,421
"17055","Franklin County","Franklin County, Illinois","00","17","055",,18105,16408,1697
"17057","Fulton County","Fulton County, Illinois","00","17","057",,16240,14877,1363
"17059","Gallatin County","Gallatin County, Illinois","00","17","059",,3071,2726,345
"17061","Greene County","Greene County, Illinois","00","17","061",,6332,5757,575
"17063","Grundy County","Grundy County, Illinois","00","17","063",,15040,14293,747
"17065","Hamilton County","Hamilton County, Illinois","00","17","065",,3983,3462,521
"17067","Hancock County","Hancock County, Illinois","00","17","067",,8909,8069,840
"17069","Hardin County","Hardin County, Illinois","00","17","069",,2494,1987,507
"17071","Henderson County","Henderson County, Illinois","00","17","071",,4126,3365,761
"17073","Henry County","Henry County, Illinois","00","17","073",,21270,20056,1214
"17075","Iroquois County","Iroquois County, Illinois","00","17","075",,13362,12220,1142
"17077","Jackson County","Jackson County, Illinois","00","17","077",,26844,24215,2629
"17079","Jasper County","Jasper County, Illinois","00","17","079",,4294,3930,364
"17081","Jefferson County","Jefferson County, Illinois","00","17","081",,16990,15374,1616
"17083","Jersey County","Jersey County, Illinois","00","17","083",,8918,8096,822
"17085","Jo Daviess County","Jo Daviess County, Illinois","00","17","085",,12003,9218,2785
"17087","Johnson County","Johnson County, Illinois","00","17","087",,5046,4183,863
"17089","Kane County","Kane County, Illinois","00","17","089",,138998,133901,5097
"17091","Kankakee County","Kankakee County, Illinois","00","17","091",,40610,38182,2428
"17093","Kendall County","Kendall County, Illinois","00","17","093",,19519,18798,721
"17095","Knox County","Knox County, Illinois","00","17","095",,23717,22056,1661
"17097","Lake County","Lake County, Illinois","00","17","097",,225919,216297,9622
"17099","LaSalle County","LaSalle County, Illinois","00","17","099",,46438,43417,3021
"17101","Lawrence County","Lawrence County, Illinois","00","17","101",,7014,6309,705
"17103","Lee County","Lee County, Illinois","00","17","103",,14310,13253,1057
"17105","Livingston County","Livingston County, Illinois","00","17","105",,15297,14374,923
"17107","Logan County","Logan County, Illinois","00","17","107",,11872,11113,759
"17109","McDonough County","McDonough County, Illinois","00","17","109",,13289,12360,929
"17111","McHenry County","McHenry County, Illinois","00","17","111",,92908,89403,3505
"17113","McLean County","McLean County, Illinois","00","17","113",,59972,56746,3226
"17115","Macon County","Macon County, Illinois","00","17","115",,50241,46561,3680
"17117","Macoupin County","Macoupin County, Illinois","00","17","117",,21097,19253,1844
"17119","Madison County","Madison County, Illinois","00","17","119",,108942,101953,6989
"17121","Marion County","Marion County, Illinois","00","17","121",,18022,16619,1403
"17123","Marshall County","Marshall County, Illinois","00","17","123",,5914,5225,689
"17125","Mason County","Mason County, Illinois","00","17","125",,7033,6389,644
"17127","Massac County","Massac County, Illinois","00","17","127",,6951,6261,690
"17129","Menard County","Menard County, Illinois","00","17","129",,5285,4873,412
"17131","Mercer County","Mercer County, Illinois","00","17","131",,7109,6624,485
"17133","Monroe County","Monroe County, Illinois","00","17","133",,10749,10275,474
"17135","Montgomery County","Montgomery County, Illinois","00","17","135",,12525,11507,1018
"17137","Morgan County","Morgan County, Illinois","00","17","137",,15291,14039,1252
"17139","Moultrie County","Moultrie County, Illinois","00","17","139",,5743,5405,338
"17141","Ogle County","Ogle County, Illinois","00","17","141",,20420,19278,1142
"17143","Peoria County","Peoria County, Illinois","00","17","143",,78204,72733,5471
"17145","Perry County","Perry County, Illinois","00","17","145",,9457,8504,953
"17147","Piatt County","Piatt County, Illinois","00","17","147",,6798,6475,323
"17149","Pike County","Pike County, Illinois","00","17","149",,8011,6876,1135
"17151","Pope County","Pope County, Illinois","00","17","151",,2351,1769,582
"17153","Pulaski County","Pulaski County, Illinois","00","17","153",,3353,2893,460
"17155","Putnam County","Putnam County, Illinois","00","17","155",,2888,2415,473
"17157","Randolph County","Randolph County, Illinois","00","17","157",,13328,12084,1244
"17159","Richland County","Richland County, Illinois","00","17","159",,7468,6660,808
"17161","Rock Island County","Rock Island County, Illinois","00","17","161",,64489,60712,3777
"17163","St. Clair County","St. Clair County, Illinois","00","17","163",,104446,96810,7636
"17165","Saline County","Saline County, Illinois","00","17","165",,12360,10992,1368
"17167","Sangamon County","Sangamon County, Illinois","00","17","167",,85459,78722,6737
"17169","Schuyler County","Schuyler County, Illinois","00","17","169",,3304,2975,329
"17171","Scott County","Scott County, Illinois","00","17","171",,2464,2222,242
"17173","Shelby County","Shelby County, Illinois","00","17","173",,10060,9056,1004
"17175","Stark County","Stark County, Illinois","00","17","175",,2725,2525,200
"17177","Stephenson County","Stephenson County, Illinois","00","17","177",,21713,19785,1928
"17179","Tazewell County","Tazewell County, Illinois","00","17","179",,52973,50327,2646
"17181","Union County","Union County, Illinois","00","17","181",,7894,7290,604
"17183","Vermilion County","Vermilion County, Illinois","00","17","183",,36349,33406,2943
"17185","Wabash County","Wabash County, Illinois","00","17","185",,5758,5192,566
"17187","Warren County","Warren County, Illinois","00","17","187",,7787,7166,621
"17189","Washington County","Washington County, Illinois","00","17","189",,6385,5848,537
"17191","Wayne County","Wayne County, Illinois","00","17","191",,7950,7143,807
"17193","White County","White County, Illinois","00","17","193",,7393,6534,859
"17195","Whiteside County","Whiteside County, Illinois","00","17","195",,25025,23684,1341
"17197","Will County","Will County, Illinois","00","17","197",,175524,167542,7982
"17199","Williamson County","Williamson County, Illinois","00","17","199",,27703,25358,2345
"17201","Winnebago County","Winnebago County, Illinois","00","17","201",,114404,107980,6424
"17203","Woodford County","Woodford County, Illinois","00","17","203",,13487,12797,690
"18001","Adams County","Adams County, Indiana","00","18","001",,12404,11818,586
"18003","Allen County","Allen County, Indiana","00","18","003",,138905,128745,10160
"18005","Bartholomew County","Bartholomew County, Indiana","00","18","005",,29853,27936,1917
"18007","Benton County","Benton County, Indiana","00","18","007",,3818,3558,260
"18009","Blackford County","Blackford County, Indiana","00","18","009",,6155,5690,465
"18011","Boone County","Boone County, Indiana","00","18","011",,17929,17081,848
"18013","Brown County","Brown County, Indiana","00","18","013",,7163,5897,1266
"18015","Carroll County","Carroll County, Indiana","00","18","015",,8675,7718,957
"18017","Cass County","Cass County, Indiana","00","18","017",,16620,15715,905
"18019","Clark County","Clark County, Indiana","00","18","019",,41176,38751,2425
"18021","Clay County","Clay County, Indiana","00","18","021",,11097,10216,881
"18023","Clinton County","Clinton County, Indiana","00","18","023",,13267,12545,722
"18025","Crawford County","Crawford County, Indiana","00","18","025",,5138,4181,957
"18027","Daviess County","Daviess County, Indiana","00","18","027",,11898,10894,1004
"18029","Dearborn County","Dearborn County, Indiana","00","18","029",,17791,16832,959
"18031","Decatur County","Decatur County, Indiana","00","18","031",,9992,9389,603
"18033","DeKalb County","DeKalb County, Indiana","00","18","033",,16144,15134,1010
"18035","Delaware County","Delaware County, Indiana","00","18","035",,51032,47131,3901
"18037","Dubois County","Dubois County, Indiana","00","18","037",,15511,14813,698
"18039","Elkhart County","Elkhart County, Indiana","00","18","039",,69791,66154,3637
"18041","Fayette County","Fayette County, Indiana","00","18","041",,10981,10199,782
"18043","Floyd County","Floyd County, Indiana","00","18","043",,29087,27511,1576
"18045","Fountain County","Fountain County, Indiana","00","18","045",,7692,7041,651
"18047","Franklin County","Franklin County, Indiana","00","18","047",,8596,7868,728
"18049","Fulton County","Fulton County, Indiana","00","18","049",,9123,8082,1041
"18051","Gibson County","Gibson County, Indiana","00","18","051",,14125,12847,1278
"18053","Grant County","Grant County, Indiana","00","18","053",,30560,28319,2241
"18055","Greene County","Greene County, Indiana","00","18","055",,15053,13372,1681
"18057","Hamilton County","Hamilton County, Indiana","00","18","057",,69478,65933,3545
"18059","Hancock County","Hancock County, Indiana","00","18","059",,21750,20718,1032
"18061","Harrison County","Harrison County, Indiana","00","18","061",,13699,12917,782
"18063","Hendricks County","Hendricks County, Indiana","00","18","063",,39229,37275,1954
"18065","Henry County","Henry County, Indiana","00","18","065",,20592,19486,1106
"18067","Howard County","Howard County, Indiana","00","18","067",,37604,34800,2804
"18069","Huntington County","Huntington County, Indiana","00","18","069",,15269,14242,1027
"18071","Jackson County","Jackson County, Indiana","00","18","071",,17137,16052,1085
"18073","Jasper County","Jasper County, Indiana","00","18","073",,11236,10686,550
"18075","Jay County","Jay County, Indiana","00","18","075",,9074,8405,669
"18077","Jefferson County","Jefferson County, Indiana","00","18","077",,13386,12148,1238
"18079","Jennings County","Jennings County, Indiana","00","18","079",,11469,10134,1335
"18081","Johnson County","Johnson County, Indiana","00","18","081",,45095,42434,2661
"18083","Knox County","Knox County, Indiana","00","18","083",,17305,15552,1753
"18085","Kosciusko County","Kosciusko County, Indiana","00","18","085",,32188,27283,4905
"18087","LaGrange County","LaGrange County, Indiana","00","18","087",,12938,11225,1713
"18089","Lake County","Lake County, Indiana","00","18","089",,194992,181633,13359
"18091","LaPorte County","LaPorte County, Indiana","00","18","091",,45621,41050,4571
"18093","Lawrence County","Lawrence County, Indiana","00","18","093",,20560,18535,2025
"18095","Madison County","Madison County, Indiana","00","18","095",,56939,53052,3887
"18097","Marion County","Marion County, Indiana","00","18","097",,387183,352164,35019
"18099","Marshall County","Marshall County, Indiana","00","18","099",,18099,16519,1580
"18101","Martin County","Martin County, Indiana","00","18","101",,4729,4183,546
"18103","Miami County","Miami County, Indiana","00","18","103",,15299,13716,1583
"18105","Monroe County","Monroe County, Indiana","00","18","105",,50846,46898,3948
"18107","Montgomery County","Montgomery County, Indiana","00","18","107",,15678,14595,1083
"18109","Morgan County","Morgan County, Indiana","00","18","109",,25908,24437,1471
"18111","Newton County","Newton County, Indiana","00","18","111",,5726,5340,386
"18113","Noble County","Noble County, Indiana","00","18","113",,18233,16696,1537
"18115","Ohio County","Ohio County, Indiana","00","18","115",,2424,2201,223
"18117","Orange County","Orange County, Indiana","00","18","117",,8348,7621,727
"18119","Owen County","Owen County, Indiana","00","18","119",,9853,8282,1571
"18121","Parke County","Parke County, Indiana","00","18","121",,7539,6415,1124
"18123","Perry County","Perry County, Indiana","00","18","123",,8223,7270,953
"18125","Pike County","Pike County, Indiana","00","18","125",,5611,5119,492
"18127","Porter County","Porter County, Indiana","00","18","127",,57616,54649,2967
"18129","Posey County","Posey County, Indiana","00","18","129",,11076,10205,871
"18131","Pulaski County","Pulaski County, Indiana","00","18","131",,5918,5170,748
"18133","Putnam County","Putnam County, Indiana","00","18","133",,13505,12374,1131
"18135","Randolph County","Randolph County, Indiana","00","18","135",,11775,10937,838
"18137","Ripley County","Ripley County, Indiana","00","18","137",,10482,9842,640
"18139","Rush County","Rush County, Indiana","00","18","139",,7337,6923,414
"18141","St. Joseph County","St. Joseph County, Indiana","00","18","141",,107013,100743,6270
"18143","Scott County","Scott County, Indiana","00","18","143",,9737,8832,905
"18145","Shelby County","Shelby County, Indiana","00","18","145",,17633,16561,1072
"18147","Spencer County","Spencer County, Indiana","00","18","147",,8333,7569,764
"18149","Starke County","Starke County, Indiana","00","18","149",,10201,8740,1461
"18151","Steuben County","Steuben County, Indiana","00","18","151",,17337,12738,4599
"18153","Sullivan County","Sullivan County, Indiana","00","18","153",,8804,7819,985
"18155","Switzerland County","Switzerland County, Indiana","00","18","155",,4226,3435,791
"18157","Tippecanoe County","Tippecanoe County, Indiana","00","18","157",,58343,55226,3117
"18159","Tipton County","Tipton County, Indiana","00","18","159",,6848,6469,379
"18161","Union County","Union County, Indiana","00","18","161",,3077,2793,284
"18163","Vanderburgh County","Vanderburgh County, Indiana","00","18","163",,76300,70623,5677
"18165","Vermillion County","Vermillion County, Indiana","00","18","165",,7405,6762,643
"18167","Vigo County","Vigo County, Indiana","00","18","167",,45203,40998,4205
"18169","Wabash County","Wabash County, Indiana","00","18","169",,14034,13215,819
"18171","Warren County","Warren County, Indiana","00","18","171",,3477,3219,258
"18173","Warrick County","Warrick County, Indiana","00","18","173",,20546,19438,1108
"18175","Washington County","Washington County, Indiana","00","18","175",,11191,10264,927
"18177","Wayne County","Wayne County, Indiana","00","18","177",,30468,28469,1999
"18179","Wells County","Wells County, Indiana","00","18","179",,10970,10402,568
"18181","White County","White County, Indiana","00","18","181",,12083,9727,2356
"18183","Whitley County","Whitley County, Indiana","00","18","183",,12545,11711,834
"19001","Adair County","Adair County, Iowa","00","19","001",,3690,3398,292
"19003","Adams County","Adams County, Iowa","00","19","003",,2109,1867,242
"19005","Allamakee County","Allamakee County, Iowa","00","19","005",,7142,5722,1420
"19007","Appanoose County","Appanoose County, Iowa","00","19","007",,6697,5779,918
"19009","Audubon County","Audubon County, Iowa","00","19","009",,2995,2773,222
"19011","Benton County","Benton County, Iowa","00","19","011",,10377,9746,631
"19013","Black Hawk County","Black Hawk County, Iowa","00","19","013",,51759,49683,2076
"19015","Boone County","Boone County, Iowa","00","19","015",,10968,10374,594
"19017","Bremer County","Bremer County, Iowa","00","19","017",,9337,8860,477
"19019","Buchanan County","Buchanan County, Iowa","00","19","019",,8697,7933,764
"19021","Buena Vista County","Buena Vista County, Iowa","00","19","021",,8145,7499,646
"19023","Butler County","Butler County, Iowa","00","19","023",,6578,6175,403
"19025","Calhoun County","Calhoun County, Iowa","00","19","025",,5219,4513,706
"19027","Carroll County","Carroll County, Iowa","00","19","027",,9019,8486,533
"19029","Cass County","Cass County, Iowa","00","19","029",,6590,6120,470
"19031","Cedar County","Cedar County, Iowa","00","19","031",,7570,7147,423
"19033","Cerro Gordo County","Cerro Gordo County, Iowa","00","19","033",,21488,19374,2114
"19035","Cherokee County","Cherokee County, Iowa","00","19","035",,5850,5378,472
"19037","Chickasaw County","Chickasaw County, Iowa","00","19","037",,5593,5192,401
"19039","Clarke County","Clarke County, Iowa","00","19","039",,3934,3584,350
"19041","Clay County","Clay County, Iowa","00","19","041",,7828,7259,569
"19043","Clayton County","Clayton County, Iowa","00","19","043",,8619,7375,1244
"19045","Clinton County","Clinton County, Iowa","00","19","045",,21585,20105,1480
"19047","Crawford County","Crawford County, Iowa","00","19","047",,6958,6441,517
"19049","Dallas County","Dallas County, Iowa","00","19","049",,16529,15584,945
"19051","Davis County","Davis County, Iowa","00","19","051",,3530,3207,323
"19053","Decatur County","Decatur County, Iowa","00","19","053",,3833,3337,496
"19055","Delaware County","Delaware County, Iowa","00","19","055",,7682,6834,848
"19057","Des Moines County","Des Moines County, Iowa","00","19","057",,18643,17270,1373
"19059","Dickinson County","Dickinson County, Iowa","00","19","059",,11375,7103,4272
"19061","Dubuque County","Dubuque County, Iowa","00","19","061",,35505,33690,1815
"19063","Emmet County","Emmet County, Iowa","00","19","063",,4889,4450,439
"19065","Fayette County","Fayette County, Iowa","00","19","065",,9505,8778,727
"19067","Floyd County","Floyd County, Iowa","00","19","067",,7317,6828,489
"19069","Franklin County","Franklin County, Iowa","00","19","069",,4763,4356,407
"19071","Fremont County","Fremont County, Iowa","00","19","071",,3514,3199,315
"19073","Greene County","Greene County, Iowa","00","19","073",,4623,4205,418
"19075","Grundy County","Grundy County, Iowa","00","19","075",,5304,4984,320
"19077","Guthrie County","Guthrie County, Iowa","00","19","077",,5467,4641,826
"19079","Hamilton County","Hamilton County, Iowa","00","19","079",,7082,6692,390
"19081","Hancock County","Hancock County, Iowa","00","19","081",,5164,4795,369
"19083","Hardin County","Hardin County, Iowa","00","19","083",,8318,7628,690
"19085","Harrison County","Harrison County, Iowa","00","19","085",,6602,6115,487
"19087","Henry County","Henry County, Iowa","00","19","087",,8246,7626,620
"19089","Howard County","Howard County, Iowa","00","19","089",,4327,3974,353
"19091","Humboldt County","Humboldt County, Iowa","00","19","091",,4645,4295,350
"19093","Ida County","Ida County, Iowa","00","19","093",,3506,3213,293
"19095","Iowa County","Iowa County, Iowa","00","19","095",,6545,6163,382
"19097","Jackson County","Jackson County, Iowa","00","19","097",,8949,8078,871
"19099","Jasper County","Jasper County, Iowa","00","19","099",,15659,14689,970
"19101","Jefferson County","Jefferson County, Iowa","00","19","101",,7241,6649,592
"19103","Johnson County","Johnson County, Iowa","00","19","103",,45831,44080,1751
"19105","Jones County","Jones County, Iowa","00","19","105",,8126,7560,566
"19107","Keokuk County","Keokuk County, Iowa","00","19","107",,5013,4586,427
"19109","Kossuth County","Kossuth County, Iowa","00","19","109",,7605,6974,631
"19111","Lee County","Lee County, Iowa","00","19","111",,16612,15161,1451
"19113","Linn County","Linn County, Iowa","00","19","113",,80551,76753,3798
"19115","Louisa County","Louisa County, Iowa","00","19","115",,5133,4519,614
"19117","Lucas County","Lucas County, Iowa","00","19","117",,4239,3811,428
"19119","Lyon County","Lyon County, Iowa","00","19","119",,4758,4428,330
"19121","Madison County","Madison County, Iowa","00","19","121",,5661,5326,335
"19123","Mahaska County","Mahaska County, Iowa","00","19","123",,9551,8880,671
"19125","Marion County","Marion County, Iowa","00","19","125",,12755,12017,738
"19127","Marshall County","Marshall County, Iowa","00","19","127",,16324,15338,986
"19129","Mills County","Mills County, Iowa","00","19","129",,5671,5324,347
"19131","Mitchell County","Mitchell County, Iowa","00","19","131",,4594,4294,300
"19133","Monona County","Monona County, Iowa","00","19","133",,4660,4211,449
"19135","Monroe County","Monroe County, Iowa","00","19","135",,3588,3228,360
"19137","Montgomery County","Montgomery County, Iowa","00","19","137",,5399,4886,513
"19139","Muscatine County","Muscatine County, Iowa","00","19","139",,16786,15847,939
"19141","O'Brien County","O'Brien County, Iowa","00","19","141",,6509,6001,508
"19143","Osceola County","Osceola County, Iowa","00","19","143",,3012,2778,234
"19145","Page County","Page County, Iowa","00","19","145",,7302,6708,594
"19147","Palo Alto County","Palo Alto County, Iowa","00","19","147",,4631,4119,512
"19149","Plymouth County","Plymouth County, Iowa","00","19","149",,9880,9372,508
"19151","Pocahontas County","Pocahontas County, Iowa","00","19","151",,3988,3617,371
"19153","Polk County","Polk County, Iowa","00","19","153",,156447,149112,7335
"19155","Pottawattamie County","Pottawattamie County, Iowa","00","19","155",,35761,33844,1917
"19157","Poweshiek County","Poweshiek County, Iowa","00","19","157",,8556,7398,1158
"19159","Ringgold County","Ringgold County, Iowa","00","19","159",,2789,2245,544
"19161","Sac County","Sac County, Iowa","00","19","161",,5460,4746,714
"19163","Scott County","Scott County, Iowa","00","19","163",,65649,62334,3315
"19165","Shelby County","Shelby County, Iowa","00","19","165",,5459,5173,286
"19167","Sioux County","Sioux County, Iowa","00","19","167",,11260,10693,567
"19169","Story County","Story County, Iowa","00","19","169",,30630,29383,1247
"19171","Tama County","Tama County, Iowa","00","19","171",,7583,7018,565
"19173","Taylor County","Taylor County, Iowa","00","19","173",,3199,2824,375
"19175","Union County","Union County, Iowa","00","19","175",,5657,5242,415
"19177","Van Buren County","Van Buren County, Iowa","00","19","177",,3581,3181,400
"19179","Wapello County","Wapello County, Iowa","00","19","179",,15873,14784,1089
"19181","Warren County","Warren County, Iowa","00","19","181",,15289,14708,581
"19183","Washington County","Washington County, Iowa","00","19","183",,8543,8056,487
"19185","Wayne County","Wayne County, Iowa","00","19","185",,3357,2821,536
"19187","Webster County","Webster County, Iowa","00","19","187",,16969,15878,1091
"19189","Winnebago County","Winnebago County, Iowa","00","19","189",,5065,4749,316
"19191","Winneshiek County","Winneshiek County, Iowa","00","19","191",,8208,7734,474
"19193","Woodbury County","Woodbury County, Iowa","00","19","193",,41394,39151,2243
"19195","Worth County","Worth County, Iowa","00","19","195",,3534,3278,256
"19197","Wright County","Wright County, Iowa","00","19","197",,6559,5940,619
"20001","Allen County","Allen County, Kansas","00","20","001",,6449,5775,674
"20003","Anderson County","Anderson County, Kansas","00","20","003",,3596,3221,375
"20005","Atchison County","Atchison County, Kansas","00","20","005",,6818,6275,543
"20007","Barber County","Barber County, Kansas","00","20","007",,2740,2235,505
"20009","Barton County","Barton County, Kansas","00","20","009",,12888,11393,1495
"20011","Bourbon County","Bourbon County, Kansas","00","20","011",,7135,6161,974
"20013","Brown County","Brown County, Kansas","00","20","013",,4815,4318,497
"20015","Butler County","Butler County, Kansas","00","20","015",,23176,21527,1649
"20017","Chase County","Chase County, Kansas","00","20","017",,1529,1246,283
"20019","Chautauqua County","Chautauqua County, Kansas","00","20","019",,2169,1796,373
"20021","Cherokee County","Cherokee County, Kansas","00","20","021",,10031,8875,1156
"20023","Cheyenne County","Cheyenne County, Kansas","00","20","023",,1636,1360,276
"20025","Clark County","Clark County, Kansas","00","20","025",,1111,979,132
"20027","Clay County","Clay County, Kansas","00","20","027",,4084,3617,467
"20029","Cloud County","Cloud County, Kansas","00","20","029",,4838,4163,675
"20031","Coffey County","Coffey County, Kansas","00","20","031",,3876,3489,387
"20033","Comanche County","Comanche County, Kansas","00","20","033",,1088,872,216
"20035","Cowley County","Cowley County, Kansas","00","20","035",,15673,14039,1634
"20037","Crawford County","Crawford County, Kansas","00","20","037",,17221,15504,1717
"20039","Decatur County","Decatur County, Kansas","00","20","039",,1821,1494,327
"20041","Dickinson County","Dickinson County, Kansas","00","20","041",,8686,7903,783
"20043","Doniphan County","Doniphan County, Kansas","00","20","043",,3489,3173,316
"20045","Douglas County","Douglas County, Kansas","00","20","045",,40250,38486,1764
"20047","Edwards County","Edwards County, Kansas","00","20","047",,1754,1455,299
"20049","Elk County","Elk County, Kansas","00","20","049",,1860,1412,448
"20051","Ellis County","Ellis County, Kansas","00","20","051",,12078,11193,885
"20053","Ellsworth County","Ellsworth County, Kansas","00","20","053",,3228,2481,747
"20055","Finney County","Finney County, Kansas","00","20","055",,13763,12948,815
"20057","Ford County","Ford County, Kansas","00","20","057",,11650,10852,798
"20059","Franklin County","Franklin County, Kansas","00","20","059",,10229,9452,777
"20061","Geary County","Geary County, Kansas","00","20","061",,11959,10458,1501
"20063","Gove County","Gove County, Kansas","00","20","063",,1423,1245,178
"20065","Graham County","Graham County, Kansas","00","20","065",,1553,1263,290
"20067","Grant County","Grant County, Kansas","00","20","067",,3027,2742,285
"20069","Gray County","Gray County, Kansas","00","20","069",,2181,2045,136
"20071","Greeley County","Greeley County, Kansas","00","20","071",,712,602,110
"20073","Greenwood County","Greenwood County, Kansas","00","20","073",,4273,3234,1039
"20075","Hamilton County","Hamilton County, Kansas","00","20","075",,1211,1054,157
"20077","Harper County","Harper County, Kansas","00","20","077",,3270,2773,497
"20079","Harvey County","Harvey County, Kansas","00","20","079",,13378,12581,797
"20081","Haskell County","Haskell County, Kansas","00","20","081",,1639,1481,158
"20083","Hodgeman County","Hodgeman County, Kansas","00","20","083",,945,796,149
"20085","Jackson County","Jackson County, Kansas","00","20","085",,5094,4727,367
"20087","Jefferson County","Jefferson County, Kansas","00","20","087",,7491,6830,661
"20089","Jewell County","Jewell County, Kansas","00","20","089",,2103,1695,408
"20091","Johnson County","Johnson County, Kansas","00","20","091",,181612,174570,7042
"20093","Kearny County","Kearny County, Kansas","00","20","093",,1657,1542,115
"20095","Kingman County","Kingman County, Kansas","00","20","095",,3852,3371,481
"20097","Kiowa County","Kiowa County, Kansas","00","20","097",,1643,1365,278
"20099","Labette County","Labette County, Kansas","00","20","099",,10306,9194,1112
"20101","Lane County","Lane County, Kansas","00","20","101",,1065,910,155
"20103","Leavenworth County","Leavenworth County, Kansas","00","20","103",,24401,23071,1330
"20105","Lincoln County","Lincoln County, Kansas","00","20","105",,1853,1529,324
"20107","Linn County","Linn County, Kansas","00","20","107",,4720,3807,913
"20109","Logan County","Logan County, Kansas","00","20","109",,1423,1243,180
"20111","Lyon County","Lyon County, Kansas","00","20","111",,14757,13691,1066
"20113","McPherson County","McPherson County, Kansas","00","20","113",,11830,11205,625
"20115","Marion County","Marion County, Kansas","00","20","115",,5882,5114,768
"20117","Marshall County","Marshall County, Kansas","00","20","117",,4999,4458,541
"20119","Meade County","Meade County, Kansas","00","20","119",,1968,1728,240
"20121","Miami County","Miami County, Kansas","00","20","121",,10984,10365,619
"20123","Mitchell County","Mitchell County, Kansas","00","20","123",,3340,2850,490
"20125","Montgomery County","Montgomery County, Kansas","00","20","125",,17207,14903,2304
"20127","Morris County","Morris County, Kansas","00","20","127",,3160,2539,621
"20129","Morton County","Morton County, Kansas","00","20","129",,1519,1306,213
"20131","Nemaha County","Nemaha County, Kansas","00","20","131",,4340,3959,381
"20133","Neosho County","Neosho County, Kansas","00","20","133",,7461,6739,722
"20135","Ness County","Ness County, Kansas","00","20","135",,1835,1516,319
"20137","Norton County","Norton County, Kansas","00","20","137",,2673,2266,407
"20139","Osage County","Osage County, Kansas","00","20","139",,7018,6490,528
"20141","Osborne County","Osborne County, Kansas","00","20","141",,2419,1940,479
"20143","Ottawa County","Ottawa County, Kansas","00","20","143",,2755,2430,325
"20145","Pawnee County","Pawnee County, Kansas","00","20","145",,3114,2739,375
"20147","Phillips County","Phillips County, Kansas","00","20","147",,3088,2496,592
"20149","Pottawatomie County","Pottawatomie County, Kansas","00","20","149",,7311,6771,540
"20151","Pratt County","Pratt County, Kansas","00","20","151",,4633,3963,670
"20153","Rawlins County","Rawlins County, Kansas","00","20","153",,1565,1269,296
"20155","Reno County","Reno County, Kansas","00","20","155",,27625,25498,2127
"20157","Republic County","Republic County, Kansas","00","20","157",,3113,2557,556
"20159","Rice County","Rice County, Kansas","00","20","159",,4609,4050,559
"20161","Riley County","Riley County, Kansas","00","20","161",,23397,22137,1260
"20163","Rooks County","Rooks County, Kansas","00","20","163",,2758,2362,396
"20165","Rush County","Rush County, Kansas","00","20","165",,1928,1548,380
"20167","Russell County","Russell County, Kansas","00","20","167",,3871,3207,664
"20169","Saline County","Saline County, Kansas","00","20","169",,22695,21436,1259
"20171","Scott County","Scott County, Kansas","00","20","171",,2291,2045,246
"20173","Sedgwick County","Sedgwick County, Kansas","00","20","173",,191133,176444,14689
"20175","Seward County","Seward County, Kansas","00","20","175",,8027,7419,608
"20177","Shawnee County","Shawnee County, Kansas","00","20","177",,73768,68920,4848
"20179","Sheridan County","Sheridan County, Kansas","00","20","179",,1263,1124,139
"20181","Sherman County","Sherman County, Kansas","00","20","181",,3184,2758,426
"20183","Smith County","Smith County, Kansas","00","20","183",,2326,1953,373
"20185","Stafford County","Stafford County, Kansas","00","20","185",,2458,2010,448
"20187","Stanton County","Stanton County, Kansas","00","20","187",,1007,858,149
"20189","Stevens County","Stevens County, Kansas","00","20","189",,2265,1988,277
"20191","Sumner County","Sumner County, Kansas","00","20","191",,10877,9888,989
"20193","Thomas County","Thomas County, Kansas","00","20","193",,3562,3226,336
"20195","Trego County","Trego County, Kansas","00","20","195",,1723,1412,311
"20197","Wabaunsee County","Wabaunsee County, Kansas","00","20","197",,3033,2633,400
"20199","Wallace County","Wallace County, Kansas","00","20","199",,791,674,117
"20201","Washington County","Washington County, Kansas","00","20","201",,3142,2673,469
"20203","Wichita County","Wichita County, Kansas","00","20","203",,1119,967,152
"20205","Wilson County","Wilson County, Kansas","00","20","205",,4937,4203,734
"20207","Woodson County","Woodson County, Kansas","00","20","207",,2076,1642,434
"20209","Wyandotte County","Wyandotte County, Kansas","00","20","209",,65892,59700,6192
"21001","Adair County","Adair County, Kentucky","00","21","001",,7792,6747,1045
"21003","Allen County","Allen County, Kentucky","00","21","003",,8057,6910,1147
"21005","Anderson County","Anderson County, Kentucky","00","21","005",,7752,7320,432
"21007","Ballard County","Ballard County, Kentucky","00","21","007",,3837,3395,442
"21009","Barren County","Barren County, Kentucky","00","21","009",,17095,15346,1749
"21011","Bath County","Bath County, Kentucky","00","21","011",,4994,4445,549
"21013","Bell County","Bell County, Kentucky","00","21","013",,13341,12004,1337
"21015","Boone County","Boone County, Kentucky","00","21","015",,33351,31258,2093
"21017","Bourbon County","Bourbon County, Kentucky","00","21","017",,8349,7681,668
"21019","Boyd County","Boyd County, Kentucky","00","21","019",,21976,20010,1966
"21021","Boyle County","Boyle County, Kentucky","00","21","021",,11418,10574,844
"21023","Bracken County","Bracken County, Kentucky","00","21","023",,3715,3228,487
"21025","Breathitt County","Breathitt County, Kentucky","00","21","025",,6812,6170,642
"21027","Breckinridge County","Breckinridge County, Kentucky","00","21","027",,9890,7324,2566
"21029","Bullitt County","Bullitt County, Kentucky","00","21","029",,23160,22171,989
"21031","Butler County","Butler County, Kentucky","00","21","031",,5815,5059,756
"21033","Caldwell County","Caldwell County, Kentucky","00","21","033",,6126,5431,695
"21035","Calloway County","Calloway County, Kentucky","00","21","035",,16069,13862,2207
"21037","Campbell County","Campbell County, Kentucky","00","21","037",,36898,34742,2156
"21039","Carlisle County","Carlisle County, Kentucky","00","21","039",,2490,2208,282
"21041","Carroll County","Carroll County, Kentucky","00","21","041",,4439,3940,499
"21043","Carter County","Carter County, Kentucky","00","21","043",,11534,10342,1192
"21045","Casey County","Casey County, Kentucky","00","21","045",,7242,6260,982
"21047","Christian County","Christian County, Kentucky","00","21","047",,27182,24857,2325
"21049","Clark County","Clark County, Kentucky","00","21","049",,13749,13015,734
"21051","Clay County","Clay County, Kentucky","00","21","051",,9439,8556,883
"21053","Clinton County","Clinton County, Kentucky","00","21","053",,4888,4086,802
"21055","Crittenden County","Crittenden County, Kentucky","00","21","055",,4410,3829,581
"21057","Cumberland County","Cumberland County, Kentucky","00","21","057",,3567,2976,591
"21059","Daviess County","Daviess County, Kentucky","00","21","059",,38432,36033,2399
"21061","Edmonson County","Edmonson County, Kentucky","00","21","061",,6104,4648,1456
"21063","Elliott County","Elliott County, Kentucky","00","21","063",,3107,2638,469
"21065","Estill County","Estill County, Kentucky","00","21","065",,6824,6108,716
"21067","Fayette County","Fayette County, Kentucky","00","21","067",,116167,108288,7879
"21069","Fleming County","Fleming County, Kentucky","00","21","069",,6120,5367,753
"21071","Floyd County","Floyd County, Kentucky","00","21","071",,18551,16881,1670
"21073","Franklin County","Franklin County, Kentucky","00","21","073",,21409,19907,1502
"21075","Fulton County","Fulton County, Kentucky","00","21","075",,3697,3237,460
"21077","Gallatin County","Gallatin County, Kentucky","00","21","077",,3362,2902,460
"21079","Garrard County","Garrard County, Kentucky","00","21","079",,6414,5741,673
"21081","Grant County","Grant County, Kentucky","00","21","081",,9306,8175,1131
"21083","Graves County","Graves County, Kentucky","00","21","083",,16340,14841,1499
"21085","Grayson County","Grayson County, Kentucky","00","21","085",,12802,9596,3206
"21087","Green County","Green County, Kentucky","00","21","087",,5420,4706,714
"21089","Greenup County","Greenup County, Kentucky","00","21","089",,15977,14536,1441
"21091","Hancock County","Hancock County, Kentucky","00","21","091",,3600,3215,385
"21093","Hardin County","Hardin County, Kentucky","00","21","093",,37673,34497,3176
"21095","Harlan County","Harlan County, Kentucky","00","21","095",,15017,13291,1726
"21097","Harrison County","Harrison County, Kentucky","00","21","097",,7660,7012,648
"21099","Hart County","Hart County, Kentucky","00","21","099",,8045,6769,1276
"21101","Henderson County","Henderson County, Kentucky","00","21","101",,19466,18095,1371
"21103","Henry County","Henry County, Kentucky","00","21","103",,6381,5844,537
"21105","Hickman County","Hickman County, Kentucky","00","21","105",,2436,2188,248
"21107","Hopkins County","Hopkins County, Kentucky","00","21","107",,20668,18820,1848
"21109","Jackson County","Jackson County, Kentucky","00","21","109",,6065,5307,758
"21111","Jefferson County","Jefferson County, Kentucky","00","21","111",,305835,287012,18823
"21113","Jessamine County","Jessamine County, Kentucky","00","21","113",,14646,13867,779
"21115","Johnson County","Johnson County, Kentucky","00","21","115",,10236,9103,1133
"21117","Kenton County","Kenton County, Kentucky","00","21","117",,63571,59444,4127
"21119","Knott County","Knott County, Kentucky","00","21","119",,7579,6717,862
"21121","Knox County","Knox County, Kentucky","00","21","121",,13999,12416,1583
"21123","Larue County","Larue County, Kentucky","00","21","123",,5860,5275,585
"21125","Laurel County","Laurel County, Kentucky","00","21","125",,22317,20353,1964
"21127","Lawrence County","Lawrence County, Kentucky","00","21","127",,7040,5954,1086
"21129","Lee County","Lee County, Kentucky","00","21","129",,3321,2985,336
"21131","Leslie County","Leslie County, Kentucky","00","21","131",,5502,4885,617
"21133","Letcher County","Letcher County, Kentucky","00","21","133",,11405,10085,1320
"21135","Lewis County","Lewis County, Kentucky","00","21","135",,6173,5422,751
"21137","Lincoln County","Lincoln County, Kentucky","00","21","137",,10127,9206,921
"21139","Livingston County","Livingston County, Kentucky","00","21","139",,4772,3996,776
"21141","Logan County","Logan County, Kentucky","00","21","141",,11875,10506,1369
"21143","Lyon County","Lyon County, Kentucky","00","21","143",,4189,2898,1291
"21145","McCracken County","McCracken County, Kentucky","00","21","145",,30361,27736,2625
"21147","McCreary County","McCreary County, Kentucky","00","21","147",,7405,6520,885
"21149","McLean County","McLean County, Kentucky","00","21","149",,4392,3984,408
"21151","Madison County","Madison County, Kentucky","00","21","151",,29595,27152,2443
"21153","Magoffin County","Magoffin County, Kentucky","00","21","153",,5447,5024,423
"21155","Marion County","Marion County, Kentucky","00","21","155",,7277,6613,664
"21157","Marshall County","Marshall County, Kentucky","00","21","157",,14730,12412,2318
"21159","Martin County","Martin County, Kentucky","00","21","159",,5551,4776,775
"21161","Mason County","Mason County, Kentucky","00","21","161",,7754,6847,907
"21163","Meade County","Meade County, Kentucky","00","21","163",,10293,9470,823
"21165","Menifee County","Menifee County, Kentucky","00","21","165",,3710,2537,1173
"21167","Mercer County","Mercer County, Kentucky","00","21","167",,9289,8423,866
"21169","Metcalfe County","Metcalfe County, Kentucky","00","21","169",,4592,4016,576
"21171","Monroe County","Monroe County, Kentucky","00","21","171",,5288,4741,547
"21173","Montgomery County","Montgomery County, Kentucky","00","21","173",,9682,8902,780
"21175","Morgan County","Morgan County, Kentucky","00","21","175",,5487,4752,735
"21177","Muhlenberg County","Muhlenberg County, Kentucky","00","21","177",,13675,12357,1318
"21179","Nelson County","Nelson County, Kentucky","00","21","179",,14934,13953,981
"21181","Nicholas County","Nicholas County, Kentucky","00","21","181",,3051,2710,341
"21183","Ohio County","Ohio County, Kentucky","00","21","183",,9909,8899,1010
"21185","Oldham County","Oldham County, Kentucky","00","21","185",,15541,14856,685
"21187","Owen County","Owen County, Kentucky","00","21","187",,5345,4086,1259
"21189","Owsley County","Owsley County, Kentucky","00","21","189",,2247,1894,353
"21191","Pendleton County","Pendleton County, Kentucky","00","21","191",,5756,5170,586
"21193","Perry County","Perry County, Kentucky","00","21","193",,12741,11460,1281
"21195","Pike County","Pike County, Kentucky","00","21","195",,30923,27612,3311
"21197","Powell County","Powell County, Kentucky","00","21","197",,5526,5044,482
"21199","Pulaski County","Pulaski County, Kentucky","00","21","199",,27181,22719,4462
"21201","Robertson County","Robertson County, Kentucky","00","21","201",,1034,866,168
"21203","Rockcastle County","Rockcastle County, Kentucky","00","21","203",,7353,6544,809
"21205","Rowan County","Rowan County, Kentucky","00","21","205",,8985,7927,1058
"21207","Russell County","Russell County, Kentucky","00","21","207",,9064,6941,2123
"21209","Scott County","Scott County, Kentucky","00","21","209",,12977,12110,867
"21211","Shelby County","Shelby County, Kentucky","00","21","211",,12857,12104,753
"21213","Simpson County","Simpson County, Kentucky","00","21","213",,7016,6415,601
"21215","Spencer County","Spencer County, Kentucky","00","21","215",,4555,4251,304
"21217","Taylor County","Taylor County, Kentucky","00","21","217",,10180,9233,947
"21219","Todd County","Todd County, Kentucky","00","21","219",,5121,4569,552
"21221","Trigg County","Trigg County, Kentucky","00","21","221",,6698,5215,1483
"21223","Trimble County","Trimble County, Kentucky","00","21","223",,3437,3137,300
"21225","Union County","Union County, Kentucky","00","21","225",,6234,5710,524
"21227","Warren County","Warren County, Kentucky","00","21","227",,38350,35365,2985
"21229","Washington County","Washington County, Kentucky","00","21","229",,4542,4121,421
"21231","Wayne County","Wayne County, Kentucky","00","21","231",,9789,7913,1876
"21233","Webster County","Webster County, Kentucky","00","21","233",,6250,5560,690
"21235","Whitley County","Whitley County, Kentucky","00","21","235",,15288,13780,1508
"21237","Wolfe County","Wolfe County, Kentucky","00","21","237",,3264,2816,448
"21239","Woodford County","Woodford County, Kentucky","00","21","239",,9374,8893,481
"22001","Acadia Parish","Acadia Parish, Louisiana","00","22","001",,23209,21142,2067
"22003","Allen Parish","Allen Parish, Louisiana","00","22","003",,9157,8102,1055
"22005","Ascension Parish","Ascension Parish, Louisiana","00","22","005",,29172,26691,2481
"22007","Assumption Parish","Assumption Parish, Louisiana","00","22","007",,9635,8239,1396
"22009","Avoyelles Parish","Avoyelles Parish, Louisiana","00","22","009",,16576,14736,1840
"22011","Beauregard Parish","Beauregard Parish, Louisiana","00","22","011",,14501,12104,2397
"22013","Bienville Parish","Bienville Parish, Louisiana","00","22","013",,7830,6108,1722
"22015","Bossier Parish","Bossier Parish, Louisiana","00","22","015",,40286,36628,3658
"22017","Caddo Parish","Caddo Parish, Louisiana","00","22","017",,108296,97974,10322
"22019","Calcasieu Parish","Calcasieu Parish, Louisiana","00","22","019",,75995,68613,7382
"22021","Caldwell Parish","Caldwell Parish, Louisiana","00","22","021",,5035,3941,1094
"22023","Cameron Parish","Cameron Parish, Louisiana","00","22","023",,5336,3592,1744
"22025","Catahoula Parish","Catahoula Parish, Louisiana","00","22","025",,5351,4082,1269
"22027","Claiborne Parish","Claiborne Parish, Louisiana","00","22","027",,7815,6270,1545
"22029","Concordia Parish","Concordia Parish, Louisiana","00","22","029",,9148,7521,1627
"22031","De Soto Parish","De Soto Parish, Louisiana","00","22","031",,11204,9691,1513
"22033","East Baton Rouge Parish","East Baton Rouge Parish, Louisiana","00","22","033",,169073,156365,12708
"22035","East Carroll Parish","East Carroll Parish, Louisiana","00","22","035",,3303,2969,334
"22037","East Feliciana Parish","East Feliciana Parish, Louisiana","00","22","037",,7915,6699,1216
"22039","Evangeline Parish","Evangeline Parish, Louisiana","00","22","039",,14258,12736,1522
"22041","Franklin Parish","Franklin Parish, Louisiana","00","22","041",,8623,7754,869
"22043","Grant Parish","Grant Parish, Louisiana","00","22","043",,8531,7073,1458
"22045","Iberia Parish","Iberia Parish, Louisiana","00","22","045",,27844,25381,2463
"22047","Iberville Parish","Iberville Parish, Louisiana","00","22","047",,11953,10674,1279
"22049","Jackson Parish","Jackson Parish, Louisiana","00","22","049",,7338,6086,1252
"22051","Jefferson Parish","Jefferson Parish, Louisiana","00","22","051",,187907,176234,11673
"22053","Jefferson Davis Parish","Jefferson Davis Parish, Louisiana","00","22","053",,12824,11480,1344
"22055","Lafayette Parish","Lafayette Parish, Louisiana","00","22","055",,78122,72372,5750
"22057","Lafourche Parish","Lafourche Parish, Louisiana","00","22","057",,35045,32057,2988
"22059","La Salle Parish","La Salle Parish, Louisiana","00","22","059",,6273,5291,982
"22061","Lincoln Parish","Lincoln Parish, Louisiana","00","22","061",,17000,15235,1765
"22063","Livingston Parish","Livingston Parish, Louisiana","00","22","063",,36212,32630,3582
"22065","Madison Parish","Madison Parish, Louisiana","00","22","065",,4979,4469,510
"22067","Morehouse Parish","Morehouse Parish, Louisiana","00","22","067",,12711,11382,1329
"22069","Natchitoches Parish","Natchitoches Parish, Louisiana","00","22","069",,16890,14263,2627
"22071","Orleans Parish","Orleans Parish, Louisiana","00","22","071",,215091,188251,26840
"22073","Ouachita Parish","Ouachita Parish, Louisiana","00","22","073",,60154,55216,4938
"22075","Plaquemines Parish","Plaquemines Parish, Louisiana","00","22","075",,10481,9021,1460
"22077","Pointe Coupee Parish","Pointe Coupee Parish, Louisiana","00","22","077",,10297,8397,1900
"22079","Rapides Parish","Rapides Parish, Louisiana","00","22","079",,52038,47120,4918
"22081","Red River Parish","Red River Parish, Louisiana","00","22","081",,3988,3414,574
"22083","Richland Parish","Richland Parish, Louisiana","00","22","083",,8335,7490,845
"22085","Sabine Parish","Sabine Parish, Louisiana","00","22","085",,13671,9221,4450
"22087","St. Bernard Parish","St. Bernard Parish, Louisiana","00","22","087",,26790,25123,1667
"22089","St. Charles Parish","St. Charles Parish, Louisiana","00","22","089",,17430,16422,1008
"22091","St. Helena Parish","St. Helena Parish, Louisiana","00","22","091",,5034,3873,1161
"22093","St. James Parish","St. James Parish, Louisiana","00","22","093",,7605,6992,613
"22095","St. John the Baptist Parish","St. John the Baptist Parish, Louisiana","00","22","095",,15532,14283,1249
"22097","St. Landry Parish","St. Landry Parish, Louisiana","00","22","097",,36216,32328,3888
"22099","St. Martin Parish","St. Martin Parish, Louisiana","00","22","099",,20245,17164,3081
"22101","St. Mary Parish","St. Mary Parish, Louisiana","00","22","101",,21650,19317,2333
"22103","St. Tammany Parish","St. Tammany Parish, Louisiana","00","22","103",,75398,69253,6145
"22105","Tangipahoa Parish","Tangipahoa Parish, Louisiana","00","22","105",,40794,36558,4236
"22107","Tensas Parish","Tensas Parish, Louisiana","00","22","107",,3359,2416,943
"22109","Terrebonne Parish","Terrebonne Parish, Louisiana","00","22","109",,39928,35997,3931
"22111","Union Parish","Union Parish, Louisiana","00","22","111",,10873,8857,2016
"22113","Vermilion Parish","Vermilion Parish, Louisiana","00","22","113",,22461,19832,2629
"22115","Vernon Parish","Vernon Parish, Louisiana","00","22","115",,21030,18260,2770
"22117","Washington Parish","Washington Parish, Louisiana","00","22","117",,19106,16467,2639
"22119","Webster Parish","Webster Parish, Louisiana","00","22","119",,18991,16501,2490
"22121","West Baton Rouge Parish","West Baton Rouge Parish, Louisiana","00","22","121",,8370,7663,707
"22123","West Carroll Parish","West Carroll Parish, Louisiana","00","22","123",,4980,4458,522
"22125","West Feliciana Parish","West Feliciana Parish, Louisiana","00","22","125",,4485,3645,840
"22127","Winn Parish","Winn Parish, Louisiana","00","22","127",,7502,5930,1572
"23001","Androscoggin County","Androscoggin County, Maine","00","23","001",,45960,42028,3932
"23003","Aroostook County","Aroostook County, Maine","00","23","003",,38719,30356,8363
"23005","Cumberland County","Cumberland County, Maine","00","23","005",,122600,107989,14611
"23007","Franklin County","Franklin County, Maine","00","23","007",,19159,11806,7353
"23009","Hancock County","Hancock County, Maine","00","23","009",,33945,21864,12081
"23011","Kennebec County","Kennebec County, Maine","00","23","011",,56364,47683,8681
"23013","Knox County","Knox County, Maine","00","23","013",,21612,16608,5004
"23015","Lincoln County","Lincoln County, Maine","00","23","015",,20849,14158,6691
"23017","Oxford County","Oxford County, Maine","00","23","017",,32295,22314,9981
"23019","Penobscot County","Penobscot County, Maine","00","23","019",,66847,58096,8751
"23021","Piscataquis County","Piscataquis County, Maine","00","23","021",,13783,7278,6505
"23023","Sagadahoc County","Sagadahoc County, Maine","00","23","023",,16489,14117,2372
"23025","Somerset County","Somerset County, Maine","00","23","025",,28222,20496,7726
"23027","Waldo County","Waldo County, Maine","00","23","027",,18904,14726,4178
"23029","Washington County","Washington County, Maine","00","23","029",,21919,14118,7801
"23031","York County","York County, Maine","00","23","031",,94234,74563,19671
"24001","Allegany County","Allegany County, Maryland","00","24","001",,32984,29322,3662
"24003","Anne Arundel County","Anne Arundel County, Maryland","00","24","003",,186937,178670,8267
"24005","Baltimore County","Baltimore County, Maryland","00","24","005",,313734,299877,13857
"24009","Calvert County","Calvert County, Maryland","00","24","009",,27576,25447,2129
"24011","Caroline County","Caroline County, Maryland","00","24","011",,12028,11097,931
"24013","Carroll County","Carroll County, Maryland","00","24","013",,54260,52503,1757
"24015","Cecil County","Cecil County, Maryland","00","24","015",,34461,31223,3238
"24017","Charles County","Charles County, Maryland","00","24","017",,43903,41668,2235
"24019","Dorchester County","Dorchester County, Maryland","00","24","019",,14681,12706,1975
"24021","Frederick County","Frederick County, Maryland","00","24","021",,73017,70060,2957
"24023","Garrett County","Garrett County, Maryland","00","24","023",,16761,11476,5285
"24025","Harford County","Harford County, Maryland","00","24","025",,83146,79667,3479
"24027","Howard County","Howard County, Maryland","00","24","027",,92818,90043,2775
"24029","Kent County","Kent County, Maryland","00","24","029",,9410,7666,1744
"24031","Montgomery County","Montgomery County, Maryland","00","24","031",,334632,324565,10067
"24033","Prince George's County","Prince George's County, Maryland","00","24","033",,302378,286610,15768
"24035","Queen Anne's County","Queen Anne's County, Maryland","00","24","035",,16674,15315,1359
"24037","St. Mary's County","St. Mary's County, Maryland","00","24","037",,34081,30642,3439
"24039","Somerset County","Somerset County, Maryland","00","24","039",,10092,8361,1731
"24041","Talbot County","Talbot County, Maryland","00","24","041",,16500,14307,2193
"24043","Washington County","Washington County, Maryland","00","24","043",,52972,49726,3246
"24045","Wicomico County","Wicomico County, Maryland","00","24","045",,34401,32218,2183
"24047","Worcester County","Worcester County, Maryland","00","24","047",,47360,19694,27666
"24510","Baltimore city","Baltimore city, Maryland","00","24","510",,300477,257996,42481
"25001","Barnstable County","Barnstable County, Massachusetts","00","25","001",,147083,94822,52261
"25003","Berkshire County","Berkshire County, Massachusetts","00","25","003",,66301,56006,10295
"25005","Bristol County","Bristol County, Massachusetts","00","25","005",,216918,205411,11507
"25007","Dukes County","Dukes County, Massachusetts","00","25","007",,14836,6421,8415
"25009","Essex County","Essex County, Massachusetts","00","25","009",,287144,275419,11725
"25011","Franklin County","Franklin County, Massachusetts","00","25","011",,31939,29466,2473
"25013","Hampden County","Hampden County, Massachusetts","00","25","013",,185876,175288,10588
"25015","Hampshire County","Hampshire County, Massachusetts","00","25","015",,58644,55991,2653
"25017","Middlesex County","Middlesex County, Massachusetts","00","25","017",,576681,561220,15461
"25019","Nantucket County","Nantucket County, Massachusetts","00","25","019",,9210,3699,5511
"25021","Norfolk County","Norfolk County, Massachusetts","00","25","021",,255154,248827,6327
"25023","Plymouth County","Plymouth County, Massachusetts","00","25","023",,181524,168361,13163
"25025","Suffolk County","Suffolk County, Massachusetts","00","25","025",,292520,278722,13798
"25027","Worcester County","Worcester County, Massachusetts","00","25","027",,298159,283927,14232
"26001","Alcona County","Alcona County, Michigan","00","26","001",,10584,5132,5452
"26003","Alger County","Alger County, Michigan","00","26","003",,5964,3785,2179
"26005","Allegan County","Allegan County, Michigan","00","26","005",,43292,38165,5127
"26007","Alpena County","Alpena County, Michigan","00","26","007",,15289,12818,2471
"26009","Antrim County","Antrim County, Michigan","00","26","009",,15090,9222,5868
"26011","Arenac County","Arenac County, Michigan","00","26","011",,9563,6710,2853
"26013","Baraga County","Baraga County, Michigan","00","26","013",,4631,3353,1278
"26015","Barry County","Barry County, Michigan","00","26","015",,23876,21035,2841
"26017","Bay County","Bay County, Michigan","00","26","017",,46423,43930,2493
"26019","Benzie County","Benzie County, Michigan","00","26","019",,10312,6500,3812
"26021","Berrien County","Berrien County, Michigan","00","26","021",,73445,63569,9876
"26023","Branch County","Branch County, Michigan","00","26","023",,19822,16349,3473
"26025","Calhoun County","Calhoun County, Michigan","00","26","025",,58691,54100,4591
"26027","Cass County","Cass County, Michigan","00","26","027",,23884,19676,4208
"26029","Charlevoix County","Charlevoix County, Michigan","00","26","029",,15370,10400,4970
"26031","Cheboygan County","Cheboygan County, Michigan","00","26","031",,16583,10835,5748
"26033","Chippewa County","Chippewa County, Michigan","00","26","033",,19430,13474,5956
"26035","Clare County","Clare County, Michigan","00","26","035",,22229,12686,9543
"26037","Clinton County","Clinton County, Michigan","00","26","037",,24630,23653,977
"26039","Crawford County","Crawford County, Michigan","00","26","039",,10042,5625,4417
"26041","Delta County","Delta County, Michigan","00","26","041",,19223,15836,3387
"26043","Dickinson County","Dickinson County, Michigan","00","26","043",,13702,11386,2316
"26045","Eaton County","Eaton County, Michigan","00","26","045",,42118,40167,1951
"26047","Emmet County","Emmet County, Michigan","00","26","047",,18554,12577,5977
"26049","Genesee County","Genesee County, Michigan","00","26","049",,183630,169825,13805
"26051","Gladwin County","Gladwin County, Michigan","00","26","051",,16828,10561,6267
"26053","Gogebic County","Gogebic County, Michigan","00","26","053",,10839,7425,3414
"26055","Grand Traverse County","Grand Traverse County, Michigan","00","26","055",,34842,30396,4446
"26057","Gratiot County","Gratiot County, Michigan","00","26","057",,15516,14501,1015
"26059","Hillsdale County","Hillsdale County, Michigan","00","26","059",,20189,17335,2854
"26061","Houghton County","Houghton County, Michigan","00","26","061",,17748,13793,3955
"26063","Huron County","Huron County, Michigan","00","26","063",,20430,14597,5833
"26065","Ingham County","Ingham County, Michigan","00","26","065",,115056,108593,6463
"26067","Ionia County","Ionia County, Michigan","00","26","067",,22006,20606,1400
"26069","Iosco County","Iosco County, Michigan","00","26","069",,20432,11727,8705
"26071","Iron County","Iron County, Michigan","00","26","071",,8772,5748,3024
"26073","Isabella County","Isabella County, Michigan","00","26","073",,24528,22425,2103
"26075","Jackson County","Jackson County, Michigan","00","26","075",,62906,58168,4738
"26077","Kalamazoo County","Kalamazoo County, Michigan","00","26","077",,99250,93479,5771
"26079","Kalkaska County","Kalkaska County, Michigan","00","26","079",,10822,6428,4394
"26081","Kent County","Kent County, Michigan","00","26","081",,224000,212890,11110
"26083","Keweenaw County","Keweenaw County, Michigan","00","26","083",,2327,998,1329
"26085","Lake County","Lake County, Michigan","00","26","085",,13498,4704,8794
"26087","Lapeer County","Lapeer County, Michigan","00","26","087",,32732,30729,2003
"26089","Leelanau County","Leelanau County, Michigan","00","26","089",,13297,8436,4861
"26091","Lenawee County","Lenawee County, Michigan","00","26","091",,39769,35930,3839
"26093","Livingston County","Livingston County, Michigan","00","26","093",,58919,55384,3535
"26095","Luce County","Luce County, Michigan","00","26","095",,4008,2481,1527
"26097","Mackinac County","Mackinac County, Michigan","00","26","097",,9413,5067,4346
"26099","Macomb County","Macomb County, Michigan","00","26","099",,320276,309203,11073
"26101","Manistee County","Manistee County, Michigan","00","26","101",,14272,9860,4412
"26103","Marquette County","Marquette County, Michigan","00","26","103",,32877,25767,7110
"26105","Mason County","Mason County, Michigan","00","26","105",,16063,11406,4657
"26107","Mecosta County","Mecosta County, Michigan","00","26","107",,19593,14915,4678
"26109","Menominee County","Menominee County, Michigan","00","26","109",,13639,10529,3110
"26111","Midland County","Midland County, Michigan","00","26","111",,33796,31769,2027
"26113","Missaukee County","Missaukee County, Michigan","00","26","113",,8621,5450,3171
"26115","Monroe County","Monroe County, Michigan","00","26","115",,56471,53772,2699
"26117","Montcalm County","Montcalm County, Michigan","00","26","117",,25900,22079,3821
"26119","Montmorency County","Montmorency County, Michigan","00","26","119",,9238,4455,4783
"26121","Muskegon County","Muskegon County, Michigan","00","26","121",,68556,63330,5226
"26123","Newaygo County","Newaygo County, Michigan","00","26","123",,23202,17599,5603
"26125","Oakland County","Oakland County, Michigan","00","26","125",,492006,471115,20891
"26127","Oceana County","Oceana County, Michigan","00","26","127",,15009,9778,5231
"26129","Ogemaw County","Ogemaw County, Michigan","00","26","129",,15404,8842,6562
"26131","Ontonagon County","Ontonagon County, Michigan","00","26","131",,5404,3456,1948
"26133","Osceola County","Osceola County, Michigan","00","26","133",,12853,8861,3992
"26135","Oscoda County","Oscoda County, Michigan","00","26","135",,8690,3921,4769
"26137","Otsego County","Otsego County, Michigan","00","26","137",,13375,8995,4380
"26139","Ottawa County","Ottawa County, Michigan","00","26","139",,86856,81662,5194
"26141","Presque Isle County","Presque Isle County, Michigan","00","26","141",,9910,6155,3755
"26143","Roscommon County","Roscommon County, Michigan","00","26","143",,23109,11250,11859
"26145","Saginaw County","Saginaw County, Michigan","00","26","145",,85505,80430,5075
"26147","St. Clair County","St. Clair County, Michigan","00","26","147",,67107,62072,5035
"26149","St. Joseph County","St. Joseph County, Michigan","00","26","149",,26503,23381,3122
"26151","Sanilac County","Sanilac County, Michigan","00","26","151",,21314,16871,4443
"26153","Schoolcraft County","Schoolcraft County, Michigan","00","26","153",,5700,3606,2094
"26155","Shiawassee County","Shiawassee County, Michigan","00","26","155",,29087,26896,2191
"26157","Tuscola County","Tuscola County, Michigan","00","26","157",,23378,21454,1924
"26159","Van Buren County","Van Buren County, Michigan","00","26","159",,33975,27982,5993
"26161","Washtenaw County","Washtenaw County, Michigan","00","26","161",,131069,125327,5742
"26163","Wayne County","Wayne County, Michigan","00","26","163",,826145,768440,57705
"26165","Wexford County","Wexford County, Michigan","00","26","165",,14872,11824,3048
"27001","Aitkin County","Aitkin County, Minnesota","00","27","001",,14168,6644,7524
"27003","Anoka County","Anoka County, Minnesota","00","27","003",,108091,106428,1663
"27005","Becker County","Becker County, Minnesota","00","27","005",,16612,11844,4768
"27007","Beltrami County","Beltrami County, Minnesota","00","27","007",,16989,14337,2652
"27009","Benton County","Benton County, Minnesota","00","27","009",,13460,13065,395
"27011","Big Stone County","Big Stone County, Minnesota","00","27","011",,3171,2377,794
"27013","Blue Earth County","Blue Earth County, Minnesota","00","27","013",,21971,21062,909
"27015","Brown County","Brown County, Minnesota","00","27","015",,11163,10598,565
"27017","Carlton County","Carlton County, Minnesota","00","27","017",,13721,12064,1657
"27019","Carver County","Carver County, Minnesota","00","27","019",,24883,24356,527
"27021","Cass County","Cass County, Minnesota","00","27","021",,21286,10893,10393
"27023","Chippewa County","Chippewa County, Minnesota","00","27","023",,5855,5361,494
"27025","Chisago County","Chisago County, Minnesota","00","27","025",,15533,14454,1079
"27027","Clay County","Clay County, Minnesota","00","27","027",,19746,18670,1076
"27029","Clearwater County","Clearwater County, Minnesota","00","27","029",,4114,3330,784
"27031","Cook County","Cook County, Minnesota","00","27","031",,4708,2350,2358
"27033","Cottonwood County","Cottonwood County, Minnesota","00","27","033",,5376,4917,459
"27035","Crow Wing County","Crow Wing County, Minnesota","00","27","035",,33483,22250,11233
"27037","Dakota County","Dakota County, Minnesota","00","27","037",,133750,131151,2599
"27039","Dodge County","Dodge County, Minnesota","00","27","039",,6642,6420,222
"27041","Douglas County","Douglas County, Minnesota","00","27","041",,16694,13276,3418
"27043","Faribault County","Faribault County, Minnesota","00","27","043",,7247,6652,595
"27045","Fillmore County","Fillmore County, Minnesota","00","27","045",,8908,8228,680
"27047","Freeborn County","Freeborn County, Minnesota","00","27","047",,13996,13356,640
"27049","Goodhue County","Goodhue County, Minnesota","00","27","049",,17879,16983,896
"27051","Grant County","Grant County, Minnesota","00","27","051",,3098,2534,564
"27053","Hennepin County","Hennepin County, Minnesota","00","27","053",,468824,456129,12695
"27055","Houston County","Houston County, Minnesota","00","27","055",,8168,7633,535
"27057","Hubbard County","Hubbard County, Minnesota","00","27","057",,12229,7435,4794
"27059","Isanti County","Isanti County, Minnesota","00","27","059",,12062,11236,826
"27061","Itasca County","Itasca County, Minnesota","00","27","061",,24528,17789,6739
"27063","Jackson County","Jackson County, Minnesota","00","27","063",,5092,4556,536
"27065","Kanabec County","Kanabec County, Minnesota","00","27","065",,6846,5759,1087
"27067","Kandiyohi County","Kandiyohi County, Minnesota","00","27","067",,18415,15936,2479
"27069","Kittson County","Kittson County, Minnesota","00","27","069",,2719,2167,552
"27071","Koochiching County","Koochiching County, Minnesota","00","27","071",,7719,6040,1679
"27073","Lac qui Parle County","Lac qui Parle County, Minnesota","00","27","073",,3774,3316,458
"27075","Lake County","Lake County, Minnesota","00","27","075",,6840,4646,2194
"27077","Lake of the Woods County","Lake of the Woods County, Minnesota","00","27","077",,3238,1903,1335
"27079","Le Sueur County","Le Sueur County, Minnesota","00","27","079",,10858,9630,1228
"27081","Lincoln County","Lincoln County, Minnesota","00","27","081",,3043,2653,390
"27083","Lyon County","Lyon County, Minnesota","00","27","083",,10298,9715,583
"27085","McLeod County","McLeod County, Minnesota","00","27","085",,14087,13449,638
"27087","Mahnomen County","Mahnomen County, Minnesota","00","27","087",,2700,1969,731
"27089","Marshall County","Marshall County, Minnesota","00","27","089",,4791,4101,690
"27091","Martin County","Martin County, Minnesota","00","27","091",,9800,9067,733
"27093","Meeker County","Meeker County, Minnesota","00","27","093",,9821,8590,1231
"27095","Mille Lacs County","Mille Lacs County, Minnesota","00","27","095",,10467,8638,1829
"27097","Morrison County","Morrison County, Minnesota","00","27","097",,13870,11816,2054
"27099","Mower County","Mower County, Minnesota","00","27","099",,16251,15582,669
"27101","Murray County","Murray County, Minnesota","00","27","101",,4357,3722,635
"27103","Nicollet County","Nicollet County, Minnesota","00","27","103",,11240,10642,598
"27105","Nobles County","Nobles County, Minnesota","00","27","105",,8465,7939,526
"27107","Norman County","Norman County, Minnesota","00","27","107",,3455,3010,445
"27109","Olmsted County","Olmsted County, Minnesota","00","27","109",,49422,47807,1615
"27111","Otter Tail County","Otter Tail County, Minnesota","00","27","111",,33862,22671,11191
"27113","Pennington County","Pennington County, Minnesota","00","27","113",,6033,5525,508
"27115","Pine County","Pine County, Minnesota","00","27","115",,15353,9939,5414
"27117","Pipestone County","Pipestone County, Minnesota","00","27","117",,4434,4069,365
"27119","Polk County","Polk County, Minnesota","00","27","119",,14008,12070,1938
"27121","Pope County","Pope County, Minnesota","00","27","121",,5827,4513,1314
"27123","Ramsey County","Ramsey County, Minnesota","00","27","123",,206448,201236,5212
"27125","Red Lake County","Red Lake County, Minnesota","00","27","125",,1883,1727,156
"27127","Redwood County","Redwood County, Minnesota","00","27","127",,7230,6674,556
"27129","Renville County","Renville County, Minnesota","00","27","129",,7413,6779,634
"27131","Rice County","Rice County, Minnesota","00","27","131",,20061,18888,1173
"27133","Rock County","Rock County, Minnesota","00","27","133",,4137,3843,294
"27135","Roseau County","Roseau County, Minnesota","00","27","135",,7101,6190,911
"27137","St. Louis County","St. Louis County, Minnesota","00","27","137",,95800,82619,13181
"27139","Scott County","Scott County, Minnesota","00","27","139",,31609,30692,917
"27141","Sherburne County","Sherburne County, Minnesota","00","27","141",,22827,21581,1246
"27143","Sibley County","Sibley County, Minnesota","00","27","143",,6024,5772,252
"27145","Stearns County","Stearns County, Minnesota","00","27","145",,50291,47604,2687
"27147","Steele County","Steele County, Minnesota","00","27","147",,13306,12846,460
"27149","Stevens County","Stevens County, Minnesota","00","27","149",,4074,3751,323
"27151","Swift County","Swift County, Minnesota","00","27","151",,4821,4353,468
"27153","Todd County","Todd County, Minnesota","00","27","153",,11900,9342,2558
"27155","Traverse County","Traverse County, Minnesota","00","27","155",,2199,1717,482
"27157","Wabasha County","Wabasha County, Minnesota","00","27","157",,9066,8277,789
"27159","Wadena County","Wadena County, Minnesota","00","27","159",,6334,5426,908
"27161","Waseca County","Waseca County, Minnesota","00","27","161",,7427,7059,368
"27163","Washington County","Washington County, Minnesota","00","27","163",,73635,71462,2173
"27165","Watonwan County","Watonwan County, Minnesota","00","27","165",,5036,4627,409
"27167","Wilkin County","Wilkin County, Minnesota","00","27","167",,3105,2752,353
"27169","Winona County","Winona County, Minnesota","00","27","169",,19551,18744,807
"27171","Wright County","Wright County, Minnesota","00","27","171",,34355,31465,2890
"27173","Yellow Medicine County","Yellow Medicine County, Minnesota","00","27","173",,4873,4439,434
"28001","Adams County","Adams County, Mississippi","00","28","001",,15175,13677,1498
"28003","Alcorn County","Alcorn County, Mississippi","00","28","003",,15818,14224,1594
"28005","Amite County","Amite County, Mississippi","00","28","005",,6446,5271,1175
"28007","Attala County","Attala County, Mississippi","00","28","007",,8639,7567,1072
"28009","Benton County","Benton County, Mississippi","00","28","009",,3456,2999,457
"28011","Bolivar County","Bolivar County, Mississippi","00","28","011",,14939,13776,1163
"28013","Calhoun County","Calhoun County, Mississippi","00","28","013",,6902,6019,883
"28015","Carroll County","Carroll County, Mississippi","00","28","015",,4888,4071,817
"28017","Chickasaw County","Chickasaw County, Mississippi","00","28","017",,7981,7253,728
"28019","Choctaw County","Choctaw County, Mississippi","00","28","019",,4249,3686,563
"28021","Claiborne County","Claiborne County, Mississippi","00","28","021",,4252,3685,567
"28023","Clarke County","Clarke County, Mississippi","00","28","023",,8100,6978,1122
"28025","Clay County","Clay County, Mississippi","00","28","025",,8810,8152,658
"28027","Coahoma County","Coahoma County, Mississippi","00","28","027",,11490,10553,937
"28029","Copiah County","Copiah County, Mississippi","00","28","029",,11101,10142,959
"28031","Covington County","Covington County, Mississippi","00","28","031",,8083,7126,957
"28033","DeSoto County","DeSoto County, Mississippi","00","28","033",,40795,38792,2003
"28035","Forrest County","Forrest County, Mississippi","00","28","035",,29913,27183,2730
"28037","Franklin County","Franklin County, Mississippi","00","28","037",,4119,3211,908
"28039","George County","George County, Mississippi","00","28","039",,7513,6742,771
"28041","Greene County","Greene County, Mississippi","00","28","041",,4947,4148,799
"28043","Grenada County","Grenada County, Mississippi","00","28","043",,9973,8820,1153
"28045","Hancock County","Hancock County, Mississippi","00","28","045",,21072,16897,4175
"28047","Harrison County","Harrison County, Mississippi","00","28","047",,79636,71538,8098
"28049","Hinds County","Hinds County, Mississippi","00","28","049",,100287,91030,9257
"28051","Holmes County","Holmes County, Mississippi","00","28","051",,8439,7314,1125
"28053","Humphreys County","Humphreys County, Mississippi","00","28","053",,4138,3765,373
"28055","Issaquena County","Issaquena County, Mississippi","00","28","055",,877,726,151
"28057","Itawamba County","Itawamba County, Mississippi","00","28","057",,9804,8773,1031
"28059","Jackson County","Jackson County, Mississippi","00","28","059",,51678,47676,4002
"28061","Jasper County","Jasper County, Mississippi","00","28","061",,7671,6708,963
"28063","Jefferson County","Jefferson County, Mississippi","00","28","063",,3819,3308,511
"28065","Jefferson Davis County","Jefferson Davis County, Mississippi","00","28","065",,5891,5177,714
"28067","Jones County","Jones County, Mississippi","00","28","067",,26921,24275,2646
"28069","Kemper County","Kemper County, Mississippi","00","28","069",,4533,3909,624
"28071","Lafayette County","Lafayette County, Mississippi","00","28","071",,16587,14373,2214
"28073","Lamar County","Lamar County, Mississippi","00","28","073",,15433,14396,1037
"28075","Lauderdale County","Lauderdale County, Mississippi","00","28","075",,33418,29990,3428
"28077","Lawrence County","Lawrence County, Mississippi","00","28","077",,5688,5040,648
"28079","Leake County","Leake County, Mississippi","00","28","079",,8585,7611,974
"28081","Lee County","Lee County, Mississippi","00","28","081",,31887,29200,2687
"28083","Leflore County","Leflore County, Mississippi","00","28","083",,14097,12956,1141
"28085","Lincoln County","Lincoln County, Mississippi","00","28","085",,14052,12538,1514
"28087","Lowndes County","Lowndes County, Mississippi","00","28","087",,25104,22849,2255
"28089","Madison County","Madison County, Mississippi","00","28","089",,28781,27219,1562
"28091","Marion County","Marion County, Mississippi","00","28","091",,10395,9336,1059
"28093","Marshall County","Marshall County, Mississippi","00","28","093",,13252,12163,1089
"28095","Monroe County","Monroe County, Mississippi","00","28","095",,16236,14603,1633
"28097","Montgomery County","Montgomery County, Mississippi","00","28","097",,5402,4690,712
"28099","Neshoba County","Neshoba County, Mississippi","00","28","099",,11980,10694,1286
"28101","Newton County","Newton County, Mississippi","00","28","101",,9259,8221,1038
"28103","Noxubee County","Noxubee County, Mississippi","00","28","103",,5228,4470,758
"28105","Oktibbeha County","Oktibbeha County, Mississippi","00","28","105",,17344,15945,1399
"28107","Panola County","Panola County, Mississippi","00","28","107",,13736,12232,1504
"28109","Pearl River County","Pearl River County, Mississippi","00","28","109",,20610,18078,2532
"28111","Perry County","Perry County, Mississippi","00","28","111",,5107,4420,687
"28113","Pike County","Pike County, Mississippi","00","28","113",,16720,14792,1928
"28115","Pontotoc County","Pontotoc County, Mississippi","00","28","115",,10816,10097,719
"28117","Prentiss County","Prentiss County, Mississippi","00","28","117",,10681,9821,860
"28119","Quitman County","Quitman County, Mississippi","00","28","119",,3923,3565,358
"28121","Rankin County","Rankin County, Mississippi","00","28","121",,45070,42089,2981
"28123","Scott County","Scott County, Mississippi","00","28","123",,11116,10183,933
"28125","Sharkey County","Sharkey County, Mississippi","00","28","125",,2416,2163,253
"28127","Simpson County","Simpson County, Mississippi","00","28","127",,11307,10076,1231
"28129","Smith County","Smith County, Mississippi","00","28","129",,7005,6046,959
"28131","Stone County","Stone County, Mississippi","00","28","131",,5343,4747,596
"28133","Sunflower County","Sunflower County, Mississippi","00","28","133",,10338,9637,701
"28135","Tallahatchie County","Tallahatchie County, Mississippi","00","28","135",,5711,5263,448
"28137","Tate County","Tate County, Mississippi","00","28","137",,9354,8850,504
"28139","Tippah County","Tippah County, Mississippi","00","28","139",,8868,8108,760
"28141","Tishomingo County","Tishomingo County, Mississippi","00","28","141",,9553,7917,1636
"28143","Tunica County","Tunica County, Mississippi","00","28","143",,3705,3258,447
"28145","Union County","Union County, Mississippi","00","28","145",,10693,9786,907
"28147","Walthall County","Walthall County, Mississippi","00","28","147",,6418,5571,847
"28149","Warren County","Warren County, Mississippi","00","28","149",,20789,18756,2033
"28151","Washington County","Washington County, Mississippi","00","28","151",,24381,22158,2223
"28153","Wayne County","Wayne County, Mississippi","00","28","153",,9049,7857,1192
"28155","Webster County","Webster County, Mississippi","00","28","155",,4344,3905,439
"28157","Wilkinson County","Wilkinson County, Mississippi","00","28","157",,5106,3578,1528
"28159","Winston County","Winston County, Mississippi","00","28","159",,8472,7578,894
"28161","Yalobusha County","Yalobusha County, Mississippi","00","28","161",,6224,5260,964
"28163","Yazoo County","Yazoo County, Mississippi","00","28","163",,10015,9178,837
"29001","Adair County","Adair County, Missouri","00","29","001",,10826,9669,1157
"29003","Andrew County","Andrew County, Missouri","00","29","003",,6662,6273,389
"29005","Atchison County","Atchison County, Missouri","00","29","005",,3103,2722,381
"29007","Audrain County","Audrain County, Missouri","00","29","007",,10881,9844,1037
"29009","Barry County","Barry County, Missouri","00","29","009",,15964,13398,2566
"29011","Barton County","Barton County, Missouri","00","29","011",,5409,4895,514
"29013","Bates County","Bates County, Missouri","00","29","013",,7247,6511,736
"29015","Benton County","Benton County, Missouri","00","29","015",,12691,7420,5271
"29017","Bollinger County","Bollinger County, Missouri","00","29","017",,5522,4576,946
"29019","Boone County","Boone County, Missouri","00","29","019",,56678,53094,3584
"29021","Buchanan County","Buchanan County, Missouri","00","29","021",,36574,33557,3017
"29023","Butler County","Butler County, Missouri","00","29","023",,18707,16718,1989
"29025","Caldwell County","Caldwell County, Missouri","00","29","025",,4493,3523,970
"29027","Callaway County","Callaway County, Missouri","00","29","027",,16167,14416,1751
"29029","Camden County","Camden County, Missouri","00","29","029",,33470,15779,17691
"29031","Cape Girardeau County","Cape Girardeau County, Missouri","00","29","031",,29434,26980,2454
"29033","Carroll County","Carroll County, Missouri","00","29","033",,4897,4169,728
"29035","Carter County","Carter County, Missouri","00","29","035",,3028,2378,650
"29037","Cass County","Cass County, Missouri","00","29","037",,31677,30168,1509
"29039","Cedar County","Cedar County, Missouri","00","29","039",,6813,5685,1128
"29041","Chariton County","Chariton County, Missouri","00","29","041",,4250,3469,781
"29043","Christian County","Christian County, Missouri","00","29","043",,21827,20425,1402
"29045","Clark County","Clark County, Missouri","00","29","045",,3483,2966,517
"29047","Clay County","Clay County, Missouri","00","29","047",,76230,72558,3672
"29049","Clinton County","Clinton County, Missouri","00","29","049",,7877,7152,725
"29051","Cole County","Cole County, Missouri","00","29","051",,28915,27040,1875
"29053","Cooper County","Cooper County, Missouri","00","29","053",,6676,5932,744
"29055","Crawford County","Crawford County, Missouri","00","29","055",,10850,8858,1992
"29057","Dade County","Dade County, Missouri","00","29","057",,3758,3202,556
"29059","Dallas County","Dallas County, Missouri","00","29","059",,6914,6030,884
"29061","Daviess County","Daviess County, Missouri","00","29","061",,3853,3178,675
"29063","DeKalb County","DeKalb County, Missouri","00","29","063",,3839,3528,311
"29065","Dent County","Dent County, Missouri","00","29","065",,6994,5982,1012
"29067","Douglas County","Douglas County, Missouri","00","29","067",,5919,5201,718
"29069","Dunklin County","Dunklin County, Missouri","00","29","069",,14682,13411,1271
"29071","Franklin County","Franklin County, Missouri","00","29","071",,38295,34945,3350
"29073","Gasconade County","Gasconade County, Missouri","00","29","073",,7813,6171,1642
"29075","Gentry County","Gentry County, Missouri","00","29","075",,3214,2747,467
"29077","Greene County","Greene County, Missouri","00","29","077",,104517,97859,6658
"29079","Grundy County","Grundy County, Missouri","00","29","079",,5102,4382,720
"29081","Harrison County","Harrison County, Missouri","00","29","081",,4316,3658,658
"29083","Henry County","Henry County, Missouri","00","29","083",,10261,9133,1128
"29085","Hickory County","Hickory County, Missouri","00","29","085",,6184,3911,2273
"29087","Holt County","Holt County, Missouri","00","29","087",,2931,2237,694
"29089","Howard County","Howard County, Missouri","00","29","089",,4346,3836,510
"29091","Howell County","Howell County, Missouri","00","29","091",,16340,14762,1578
"29093","Iron County","Iron County, Missouri","00","29","093",,4907,4197,710
"29095","Jackson County","Jackson County, Missouri","00","29","095",,288231,266294,21937
"29097","Jasper County","Jasper County, Missouri","00","29","097",,45571,41412,4159
"29099","Jefferson County","Jefferson County, Missouri","00","29","099",,75586,71499,4087
"29101","Johnson County","Johnson County, Missouri","00","29","101",,18886,17410,1476
"29103","Knox County","Knox County, Missouri","00","29","103",,2317,1791,526
"29105","Laclede County","Laclede County, Missouri","00","29","105",,14320,12760,1560
"29107","Lafayette County","Lafayette County, Missouri","00","29","107",,13707,12569,1138
"29109","Lawrence County","Lawrence County, Missouri","00","29","109",,14789,13568,1221
"29111","Lewis County","Lewis County, Missouri","00","29","111",,4602,3956,646
"29113","Lincoln County","Lincoln County, Missouri","00","29","113",,15511,13851,1660
"29115","Linn County","Linn County, Missouri","00","29","115",,6554,5697,857
"29117","Livingston County","Livingston County, Missouri","00","29","117",,6467,5736,731
"29119","McDonald County","McDonald County, Missouri","00","29","119",,9287,8113,1174
"29121","Macon County","Macon County, Missouri","00","29","121",,7502,6501,1001
"29123","Madison County","Madison County, Missouri","00","29","123",,5656,4711,945
"29125","Maries County","Maries County, Missouri","00","29","125",,4149,3519,630
"29127","Marion County","Marion County, Missouri","00","29","127",,12443,11066,1377
"29129","Mercer County","Mercer County, Missouri","00","29","129",,2125,1600,525
"29131","Miller County","Miller County, Missouri","00","29","131",,11263,9284,1979
"29133","Mississippi County","Mississippi County, Missouri","00","29","133",,5840,5383,457
"29135","Moniteau County","Moniteau County, Missouri","00","29","135",,5742,5259,483
"29137","Monroe County","Monroe County, Missouri","00","29","137",,4565,3656,909
"29139","Montgomery County","Montgomery County, Missouri","00","29","139",,5726,4775,951
"29141","Morgan County","Morgan County, Missouri","00","29","141",,13898,7850,6048
"29143","New Madrid County","New Madrid County, Missouri","00","29","143",,8600,7824,776
"29145","Newton County","Newton County, Missouri","00","29","145",,21897,20140,1757
"29147","Nodaway County","Nodaway County, Missouri","00","29","147",,8909,8138,771
"29149","Oregon County","Oregon County, Missouri","00","29","149",,4997,4263,734
"29151","Osage County","Osage County, Missouri","00","29","151",,5904,4922,982
"29153","Ozark County","Ozark County, Missouri","00","29","153",,5114,3950,1164
"29155","Pemiscot County","Pemiscot County, Missouri","00","29","155",,8793,7855,938
"29157","Perry County","Perry County, Missouri","00","29","157",,7815,6904,911
"29159","Pettis County","Pettis County, Missouri","00","29","159",,16963,15568,1395
"29161","Phelps County","Phelps County, Missouri","00","29","161",,17501,15683,1818
"29163","Pike County","Pike County, Missouri","00","29","163",,7493,6451,1042
"29165","Platte County","Platte County, Missouri","00","29","165",,30902,29278,1624
"29167","Polk County","Polk County, Missouri","00","29","167",,11183,9917,1266
"29169","Pulaski County","Pulaski County, Missouri","00","29","169",,15408,13433,1975
"29171","Putnam County","Putnam County, Missouri","00","29","171",,2914,2228,686
"29173","Ralls County","Ralls County, Missouri","00","29","173",,4564,3736,828
"29175","Randolph County","Randolph County, Missouri","00","29","175",,10740,9199,1541
"29177","Ray County","Ray County, Missouri","00","29","177",,9371,8743,628
"29179","Reynolds County","Reynolds County, Missouri","00","29","179",,3759,2721,1038
"29181","Ripley County","Ripley County, Missouri","00","29","181",,6392,5416,976
"29183","St. Charles County","St. Charles County, Missouri","00","29","183",,105514,101663,3851
"29185","St. Clair County","St. Clair County, Missouri","00","29","185",,5205,4040,1165
"29186","Ste. Genevieve County","Ste. Genevieve County, Missouri","00","29","186",,8018,6586,1432
"29187","St. Francois County","St. Francois County, Missouri","00","29","187",,24449,20793,3656
"29189","St. Louis County","St. Louis County, Missouri","00","29","189",,423749,404312,19437
"29195","Saline County","Saline County, Missouri","00","29","195",,10019,9015,1004
"29197","Schuyler County","Schuyler County, Missouri","00","29","197",,2027,1725,302
"29199","Scotland County","Scotland County, Missouri","00","29","199",,2292,1902,390
"29201","Scott County","Scott County, Missouri","00","29","201",,16951,15626,1325
"29203","Shannon County","Shannon County, Missouri","00","29","203",,3862,3319,543
"29205","Shelby County","Shelby County, Missouri","00","29","205",,3245,2745,500
"29207","Stoddard County","Stoddard County, Missouri","00","29","207",,13221,12064,1157
"29209","Stone County","Stone County, Missouri","00","29","209",,16241,11822,4419
"29211","Sullivan County","Sullivan County, Missouri","00","29","211",,3364,2925,439
"29213","Taney County","Taney County, Missouri","00","29","213",,19688,16158,3530
"29215","Texas County","Texas County, Missouri","00","29","215",,10764,9378,1386
"29217","Vernon County","Vernon County, Missouri","00","29","217",,8872,7966,906
"29219","Warren County","Warren County, Missouri","00","29","219",,11046,9185,1861
"29221","Washington County","Washington County, Missouri","00","29","221",,9894,8406,1488
"29223","Wayne County","Wayne County, Missouri","00","29","223",,7496,5551,1945
"29225","Webster County","Webster County, Missouri","00","29","225",,12052,11073,979
"29227","Worth County","Worth County, Missouri","00","29","227",,1245,1009,236
"29229","Wright County","Wright County, Missouri","00","29","229",,7957,7081,876
"29510","St. Louis city","St. Louis city, Missouri","00","29","510",,176354,147076,29278
"30001","Beaverhead County","Beaverhead County, Montana","00","30","001",,4571,3684,887
"30003","Big Horn County","Big Horn County, Montana","00","30","003",,4655,3924,731
"30005","Blaine County","Blaine County, Montana","00","30","005",,2947,2501,446
"30007","Broadwater County","Broadwater County, Montana","00","30","007",,2002,1752,250
"30009","Carbon County","Carbon County, Montana","00","30","009",,5494,4065,1429
"30011","Carter County","Carter County, Montana","00","30","011",,811,543,268
"30013","Cascade County","Cascade County, Montana","00","30","013",,35225,32547,2678
"30015","Chouteau County","Chouteau County, Montana","00","30","015",,2776,2226,550
"30017","Custer County","Custer County, Montana","00","30","017",,5360,4768,592
"30019","Daniels County","Daniels County, Montana","00","30","019",,1154,892,262
"30021","Dawson County","Dawson County, Montana","00","30","021",,4168,3625,543
"30023","Deer Lodge County","Deer Lodge County, Montana","00","30","023",,4958,3995,963
"30025","Fallon County","Fallon County, Montana","00","30","025",,1410,1140,270
"30027","Fergus County","Fergus County, Montana","00","30","027",,5558,4860,698
"30029","Flathead County","Flathead County, Montana","00","30","029",,34773,29588,5185
"30031","Gallatin County","Gallatin County, Montana","00","30","031",,29489,26323,3166
"30033","Garfield County","Garfield County, Montana","00","30","033",,961,532,429
"30035","Glacier County","Glacier County, Montana","00","30","035",,5243,4304,939
"30037","Golden Valley County","Golden Valley County, Montana","00","30","037",,450,365,85
"30039","Granite County","Granite County, Montana","00","30","039",,2074,1200,874
"30041","Hill County","Hill County, Montana","00","30","041",,7453,6457,996
"30043","Jefferson County","Jefferson County, Montana","00","30","043",,4199,3747,452
"30045","Judith Basin County","Judith Basin County, Montana","00","30","045",,1325,951,374
"30047","Lake County","Lake County, Montana","00","30","047",,13605,10192,3413
"30049","Lewis and Clark County","Lewis and Clark County, Montana","00","30","049",,25672,22850,2822
"30051","Liberty County","Liberty County, Montana","00","30","051",,1070,833,237
"30053","Lincoln County","Lincoln County, Montana","00","30","053",,9319,7764,1555
"30055","McCone County","McCone County, Montana","00","30","055",,1087,810,277
"30057","Madison County","Madison County, Montana","00","30","057",,4671,2956,1715
"30059","Meagher County","Meagher County, Montana","00","30","059",,1363,803,560
"30061","Mineral County","Mineral County, Montana","00","30","061",,1961,1584,377
"30063","Missoula County","Missoula County, Montana","00","30","063",,41319,38439,2880
"30065","Musselshell County","Musselshell County, Montana","00","30","065",,2317,1878,439
"30067","Park County","Park County, Montana","00","30","067",,8247,6828,1419
"30069","Petroleum County","Petroleum County, Montana","00","30","069",,292,211,81
"30071","Phillips County","Phillips County, Montana","00","30","071",,2502,1848,654
"30073","Pondera County","Pondera County, Montana","00","30","073",,2834,2410,424
"30075","Powder River County","Powder River County, Montana","00","30","075",,1007,737,270
"30077","Powell County","Powell County, Montana","00","30","077",,2930,2422,508
"30079","Prairie County","Prairie County, Montana","00","30","079",,718,537,181
"30081","Ravalli County","Ravalli County, Montana","00","30","081",,15946,14289,1657
"30083","Richland County","Richland County, Montana","00","30","083",,4557,3878,679
"30085","Roosevelt County","Roosevelt County, Montana","00","30","085",,4044,3581,463
"30087","Rosebud County","Rosebud County, Montana","00","30","087",,3912,3307,605
"30089","Sanders County","Sanders County, Montana","00","30","089",,5271,4273,998
"30091","Sheridan County","Sheridan County, Montana","00","30","091",,2167,1741,426
"30093","Silver Bow County","Silver Bow County, Montana","00","30","093",,16176,14432,1744
"30095","Stillwater County","Stillwater County, Montana","00","30","095",,3947,3234,713
"30097","Sweet Grass County","Sweet Grass County, Montana","00","30","097",,1860,1476,384
"30099","Teton County","Teton County, Montana","00","30","099",,2910,2538,372
"30101","Toole County","Toole County, Montana","00","30","101",,2300,1962,338
"30103","Treasure County","Treasure County, Montana","00","30","103",,422,357,65
"30105","Valley County","Valley County, Montana","00","30","105",,4847,3150,1697
"30107","Wheatland County","Wheatland County, Montana","00","30","107",,1154,853,301
"30109","Wibaux County","Wibaux County, Montana","00","30","109",,587,421,166
"30111","Yellowstone County","Yellowstone County, Montana","00","30","111",,54563,52084,2479
"31001","Adams County","Adams County, Nebraska","00","31","001",,13014,12141,873
"31003","Antelope County","Antelope County, Nebraska","00","31","003",,3346,2953,393
"31005","Arthur County","Arthur County, Nebraska","00","31","005",,273,185,88
"31007","Banner County","Banner County, Nebraska","00","31","007",,375,311,64
"31009","Blaine County","Blaine County, Nebraska","00","31","009",,333,238,95
"31011","Boone County","Boone County, Nebraska","00","31","011",,2733,2454,279
"31013","Box Butte County","Box Butte County, Nebraska","00","31","013",,5488,4780,708
"31015","Boyd County","Boyd County, Nebraska","00","31","015",,1406,1014,392
"31017","Brown County","Brown County, Nebraska","00","31","017",,1916,1530,386
"31019","Buffalo County","Buffalo County, Nebraska","00","31","019",,16830,15930,900
"31021","Burt County","Burt County, Nebraska","00","31","021",,3723,3155,568
"31023","Butler County","Butler County, Nebraska","00","31","023",,3901,3426,475
"31025","Cass County","Cass County, Nebraska","00","31","025",,10179,9161,1018
"31027","Cedar County","Cedar County, Nebraska","00","31","027",,4200,3623,577
"31029","Chase County","Chase County, Nebraska","00","31","029",,1927,1662,265
"31031","Cherry County","Cherry County, Nebraska","00","31","031",,3220,2508,712
"31033","Cheyenne County","Cheyenne County, Nebraska","00","31","033",,4569,4071,498
"31035","Clay County","Clay County, Nebraska","00","31","035",,3066,2756,310
"31037","Colfax County","Colfax County, Nebraska","00","31","037",,4088,3682,406
"31039","Cuming County","Cuming County, Nebraska","00","31","039",,4283,3945,338
"31041","Custer County","Custer County, Nebraska","00","31","041",,5585,4826,759
"31043","Dakota County","Dakota County, Nebraska","00","31","043",,7528,7095,433
"31045","Dawes County","Dawes County, Nebraska","00","31","045",,4004,3512,492
"31047","Dawson County","Dawson County, Nebraska","00","31","047",,9805,8824,981
"31049","Deuel County","Deuel County, Nebraska","00","31","049",,1032,908,124
"31051","Dixon County","Dixon County, Nebraska","00","31","051",,2673,2413,260
"31053","Dodge County","Dodge County, Nebraska","00","31","053",,15468,14433,1035
"31055","Douglas County","Douglas County, Nebraska","00","31","055",,192672,182194,10478
"31057","Dundy County","Dundy County, Nebraska","00","31","057",,1196,961,235
"31059","Fillmore County","Fillmore County, Nebraska","00","31","059",,2990,2689,301
"31061","Franklin County","Franklin County, Nebraska","00","31","061",,1746,1485,261
"31063","Frontier County","Frontier County, Nebraska","00","31","063",,1543,1192,351
"31065","Furnas County","Furnas County, Nebraska","00","31","065",,2730,2278,452
"31067","Gage County","Gage County, Nebraska","00","31","067",,10030,9316,714
"31069","Garden County","Garden County, Nebraska","00","31","069",,1298,1020,278
"31071","Garfield County","Garfield County, Nebraska","00","31","071",,1021,813,208
"31073","Gosper County","Gosper County, Nebraska","00","31","073",,1281,863,418
"31075","Grant County","Grant County, Nebraska","00","31","075",,449,292,157
"31077","Greeley County","Greeley County, Nebraska","00","31","077",,1199,1077,122
"31079","Hall County","Hall County, Nebraska","00","31","079",,21574,20356,1218
"31081","Hamilton County","Hamilton County, Nebraska","00","31","081",,3850,3503,347
"31083","Harlan County","Harlan County, Nebraska","00","31","083",,2327,1597,730
"31085","Hayes County","Hayes County, Nebraska","00","31","085",,526,430,96
"31087","Hitchcock County","Hitchcock County, Nebraska","00","31","087",,1675,1287,388
"31089","Holt County","Holt County, Nebraska","00","31","089",,5281,4608,673
"31091","Hooker County","Hooker County, Nebraska","00","31","091",,440,335,105
"31093","Howard County","Howard County, Nebraska","00","31","093",,2782,2546,236
"31095","Jefferson County","Jefferson County, Nebraska","00","31","095",,3942,3527,415
"31097","Johnson County","Johnson County, Nebraska","00","31","097",,2116,1887,229
"31099","Kearney County","Kearney County, Nebraska","00","31","099",,2846,2643,203
"31101","Keith County","Keith County, Nebraska","00","31","101",,5178,3707,1471
"31103","Keya Paha County","Keya Paha County, Nebraska","00","31","103",,548,409,139
"31105","Kimball County","Kimball County, Nebraska","00","31","105",,1972,1727,245
"31107","Knox County","Knox County, Nebraska","00","31","107",,4773,3811,962
"31109","Lancaster County","Lancaster County, Nebraska","00","31","109",,104217,99187,5030
"31111","Lincoln County","Lincoln County, Nebraska","00","31","111",,15438,14076,1362
"31113","Logan County","Logan County, Nebraska","00","31","113",,386,316,70
"31115","Loup County","Loup County, Nebraska","00","31","115",,377,289,88
"31117","McPherson County","McPherson County, Nebraska","00","31","117",,283,202,81
"31119","Madison County","Madison County, Nebraska","00","31","119",,14432,13436,996
"31121","Merrick County","Merrick County, Nebraska","00","31","121",,3649,3209,440
"31123","Morrill County","Morrill County, Nebraska","00","31","123",,2460,2138,322
"31125","Nance County","Nance County, Nebraska","00","31","125",,1787,1577,210
"31127","Nemaha County","Nemaha County, Nebraska","00","31","127",,3439,3047,392
"31129","Nuckolls County","Nuckolls County, Nebraska","00","31","129",,2530,2218,312
"31131","Otoe County","Otoe County, Nebraska","00","31","131",,6567,6060,507
"31133","Pawnee County","Pawnee County, Nebraska","00","31","133",,1587,1339,248
"31135","Perkins County","Perkins County, Nebraska","00","31","135",,1444,1275,169
"31137","Phelps County","Phelps County, Nebraska","00","31","137",,4191,3844,347
"31139","Pierce County","Pierce County, Nebraska","00","31","139",,3247,2979,268
"31141","Platte County","Platte County, Nebraska","00","31","141",,12916,12076,840
"31143","Polk County","Polk County, Nebraska","00","31","143",,2717,2259,458
"31145","Red Willow County","Red Willow County, Nebraska","00","31","145",,5278,4710,568
"31147","Richardson County","Richardson County, Nebraska","00","31","147",,4560,3993,567
"31149","Rock County","Rock County, Nebraska","00","31","149",,935,763,172
"31151","Saline County","Saline County, Nebraska","00","31","151",,5611,5188,423
"31153","Sarpy County","Sarpy County, Nebraska","00","31","153",,44981,43426,1555
"31155","Saunders County","Saunders County, Nebraska","00","31","155",,8266,7498,768
"31157","Scotts Bluff County","Scotts Bluff County, Nebraska","00","31","157",,16119,14887,1232
"31159","Seward County","Seward County, Nebraska","00","31","159",,6428,6013,415
"31161","Sheridan County","Sheridan County, Nebraska","00","31","161",,3013,2549,464
"31163","Sherman County","Sherman County, Nebraska","00","31","163",,1839,1394,445
"31165","Sioux County","Sioux County, Nebraska","00","31","165",,780,605,175
"31167","Stanton County","Stanton County, Nebraska","00","31","167",,2452,2297,155
"31169","Thayer County","Thayer County, Nebraska","00","31","169",,2828,2541,287
"31171","Thomas County","Thomas County, Nebraska","00","31","171",,446,325,121
"31173","Thurston County","Thurston County, Nebraska","00","31","173",,2467,2255,212
"31175","Valley County","Valley County, Nebraska","00","31","175",,2273,1965,308
"31177","Washington County","Washington County, Nebraska","00","31","177",,7408,6940,468
"31179","Wayne County","Wayne County, Nebraska","00","31","179",,3662,3437,225
"31181","Webster County","Webster County, Nebraska","00","31","181",,1972,1708,264
"31183","Wheeler County","Wheeler County, Nebraska","00","31","183",,561,352,209
"31185","York County","York County, Nebraska","00","31","185",,6172,5722,450
"32001","Churchill County","Churchill County, Nevada","00","32","001",,9732,8912,820
"32003","Clark County","Clark County, Nevada","00","32","003",,559799,512253,47546
"32005","Douglas County","Douglas County, Nevada","00","32","005",,19006,16401,2605
"32007","Elko County","Elko County, Nevada","00","32","007",,18456,15638,2818
"32009","Esmeralda County","Esmeralda County, Nevada","00","32","009",,833,455,378
"32011","Eureka County","Eureka County, Nevada","00","32","011",,1025,666,359
"32013","Humboldt County","Humboldt County, Nevada","00","32","013",,6954,5733,1221
"32015","Lander County","Lander County, Nevada","00","32","015",,2780,2093,687
"32017","Lincoln County","Lincoln County, Nevada","00","32","017",,2178,1540,638
"32019","Lyon County","Lyon County, Nevada","00","32","019",,14279,13007,1272
"32021","Mineral County","Mineral County, Nevada","00","32","021",,2866,2197,669
"32023","Nye County","Nye County, Nevada","00","32","023",,15934,13309,2625
"32027","Pershing County","Pershing County, Nevada","00","32","027",,2389,1962,427
"32029","Storey County","Storey County, Nevada","00","32","029",,1596,1462,134
"32031","Washoe County","Washoe County, Nevada","00","32","031",,143908,132084,11824
"32033","White Pine County","White Pine County, Nevada","00","32","033",,4439,3282,1157
"32510","Carson City","Carson City, Nevada","00","32","510",,21283,20171,1112
"33001","Belknap County","Belknap County, New Hampshire","00","33","001",,32121,22459,9662
"33003","Carroll County","Carroll County, New Hampshire","00","33","003",,34750,18351,16399
"33005","Cheshire County","Cheshire County, New Hampshire","00","33","005",,31876,28299,3577
"33007","Coos County","Coos County, New Hampshire","00","33","007",,19623,13961,5662
"33009","Grafton County","Grafton County, New Hampshire","00","33","009",,43729,31598,12131
"33011","Hillsborough County","Hillsborough County, New Hampshire","00","33","011",,149961,144455,5506
"33013","Merrimack County","Merrimack County, New Hampshire","00","33","013",,56244,51843,4401
"33015","Rockingham County","Rockingham County, New Hampshire","00","33","015",,113023,104529,8494
"33017","Strafford County","Strafford County, New Hampshire","00","33","017",,45539,42581,2958
"33019","Sullivan County","Sullivan County, New Hampshire","00","33","019",,20158,16530,3628
"34001","Atlantic County","Atlantic County, New Jersey","00","34","001",,114090,95024,19066
"34003","Bergen County","Bergen County, New Jersey","00","34","003",,339820,330817,9003
"34005","Burlington County","Burlington County, New Jersey","00","34","005",,161311,154371,6940
"34007","Camden County","Camden County, New Jersey","00","34","007",,199679,185744,13935
"34009","Cape May County","Cape May County, New Jersey","00","34","009",,91047,42148,48899
"34011","Cumberland County","Cumberland County, New Jersey","00","34","011",,52863,49143,3720
"34013","Essex County","Essex County, New Jersey","00","34","013",,301011,283736,17275
"34015","Gloucester County","Gloucester County, New Jersey","00","34","015",,95054,90717,4337
"34017","Hudson County","Hudson County, New Jersey","00","34","017",,240618,230546,10072
"34019","Hunterdon County","Hunterdon County, New Jersey","00","34","019",,45032,43678,1354
"34021","Mercer County","Mercer County, New Jersey","00","34","021",,133280,125807,7473
"34023","Middlesex County","Middlesex County, New Jersey","00","34","023",,273637,265815,7822
"34025","Monmouth County","Monmouth County, New Jersey","00","34","025",,240884,224236,16648
"34027","Morris County","Morris County, New Jersey","00","34","027",,174379,169711,4668
"34029","Ocean County","Ocean County, New Jersey","00","34","029",,248711,200402,48309
"34031","Passaic County","Passaic County, New Jersey","00","34","031",,170048,163856,6192
"34033","Salem County","Salem County, New Jersey","00","34","033",,26158,24295,1863
"34035","Somerset County","Somerset County, New Jersey","00","34","035",,112023,108984,3039
"34037","Sussex County","Sussex County, New Jersey","00","34","037",,56528,50831,5697
"34039","Union County","Union County, New Jersey","00","34","039",,192945,186124,6821
"34041","Warren County","Warren County, New Jersey","00","34","041",,41157,38660,2497
"35001","Bernalillo County","Bernalillo County, New Mexico","00","35","001",,239074,220936,18138
"35003","Catron County","Catron County, New Mexico","00","35","003",,2548,1584,964
"35005","Chaves County","Chaves County, New Mexico","00","35","005",,25647,22561,3086
"35006","Cibola County","Cibola County, New Mexico","00","35","006",,10328,8327,2001
"35007","Colfax County","Colfax County, New Mexico","00","35","007",,8959,5821,3138
"35009","Curry County","Curry County, New Mexico","00","35","009",,19212,16766,2446
"35011","De Baca County","De Baca County, New Mexico","00","35","011",,1307,922,385
"35013","Doña Ana County","Doña Ana County, New Mexico","00","35","013",,65210,59556,5654
"35015","Eddy County","Eddy County, New Mexico","00","35","015",,22249,19379,2870
"35017","Grant County","Grant County, New Mexico","00","35","017",,14066,12146,1920
"35019","Guadalupe County","Guadalupe County, New Mexico","00","35","019",,2160,1655,505
"35021","Harding County","Harding County, New Mexico","00","35","021",,545,371,174
"35023","Hidalgo County","Hidalgo County, New Mexico","00","35","023",,2848,2152,696
"35025","Lea County","Lea County, New Mexico","00","35","025",,23405,19699,3706
"35027","Lincoln County","Lincoln County, New Mexico","00","35","027",,15298,8202,7096
"35028","Los Alamos County","Los Alamos County, New Mexico","00","35","028",,7937,7497,440
"35029","Luna County","Luna County, New Mexico","00","35","029",,11291,9397,1894
"35031","McKinley County","McKinley County, New Mexico","00","35","031",,26718,21476,5242
"35033","Mora County","Mora County, New Mexico","00","35","033",,2973,2017,956
"35035","Otero County","Otero County, New Mexico","00","35","035",,29272,22984,6288
"35037","Quay County","Quay County, New Mexico","00","35","037",,5664,4201,1463
"35039","Rio Arriba County","Rio Arriba County, New Mexico","00","35","039",,18016,15044,2972
"35041","Roosevelt County","Roosevelt County, New Mexico","00","35","041",,7746,6639,1107
"35043","Sandoval County","Sandoval County, New Mexico","00","35","043",,34866,31411,3455
"35045","San Juan County","San Juan County, New Mexico","00","35","045",,43221,37711,5510
"35047","San Miguel County","San Miguel County, New Mexico","00","35","047",,14254,11134,3120
"35049","Santa Fe County","Santa Fe County, New Mexico","00","35","049",,57701,52482,5219
"35051","Sierra County","Sierra County, New Mexico","00","35","051",,8727,6113,2614
"35053","Socorro County","Socorro County, New Mexico","00","35","053",,7808,6675,1133
"35055","Taos County","Taos County, New Mexico","00","35","055",,17404,12675,4729
"35057","Torrance County","Torrance County, New Mexico","00","35","057",,7257,6024,1233
"35059","Union County","Union County, New Mexico","00","35","059",,2225,1733,492
"35061","Valencia County","Valencia County, New Mexico","00","35","061",,24643,22681,1962
"36001","Albany County","Albany County, New York","00","36","001",,129972,120512,9460
"36003","Allegany County","Allegany County, New York","00","36","003",,24505,18009,6496
"36005","Bronx County","Bronx County, New York","00","36","005",,490659,463212,27447
"36007","Broome County","Broome County, New York","00","36","007",,88817,80749,8068
"36009","Cattaraugus County","Cattaraugus County, New York","00","36","009",,39839,32023,7816
"36011","Cayuga County","Cayuga County, New York","00","36","011",,35477,30558,4919
"36013","Chautauqua County","Chautauqua County, New York","00","36","013",,64900,54515,10385
"36015","Chemung County","Chemung County, New York","00","36","015",,37745,35049,2696
"36017","Chenango County","Chenango County, New York","00","36","017",,23890,19926,3964
"36019","Clinton County","Clinton County, New York","00","36","019",,33091,29423,3668
"36021","Columbia County","Columbia County, New York","00","36","021",,30207,24796,5411
"36023","Cortland County","Cortland County, New York","00","36","023",,20116,18210,1906
"36025","Delaware County","Delaware County, New York","00","36","025",,28952,19270,9682
"36027","Dutchess County","Dutchess County, New York","00","36","027",,106103,99536,6567
"36029","Erie County","Erie County, New York","00","36","029",,415868,380873,34995
"36031","Essex County","Essex County, New York","00","36","031",,23115,15028,8087
"36033","Franklin County","Franklin County, New York","00","36","033",,23936,17931,6005
"36035","Fulton County","Fulton County, New York","00","36","035",,27787,21884,5903
"36037","Genesee County","Genesee County, New York","00","36","037",,24190,22770,1420
"36039","Greene County","Greene County, New York","00","36","039",,26544,18256,8288
"36041","Hamilton County","Hamilton County, New York","00","36","041",,7965,2362,5603
"36043","Herkimer County","Herkimer County, New York","00","36","043",,32026,25734,6292
"36045","Jefferson County","Jefferson County, New York","00","36","045",,54070,40068,14002
"36047","Kings County","Kings County, New York","00","36","047",,930866,880727,50139
"36049","Lewis County","Lewis County, New York","00","36","049",,15134,10040,5094
"36051","Livingston County","Livingston County, New York","00","36","051",,24023,22150,1873
"36053","Madison County","Madison County, New York","00","36","053",,28646,25368,3278
"36055","Monroe County","Monroe County, New York","00","36","055",,304388,286512,17876
"36057","Montgomery County","Montgomery County, New York","00","36","057",,22522,20038,2484
"36059","Nassau County","Nassau County, New York","00","36","059",,458151,447387,10764
"36061","New York County","New York County, New York","00","36","061",,798144,738644,59500
"36063","Niagara County","Niagara County, New York","00","36","063",,95715,87846,7869
"36065","Oneida County","Oneida County, New York","00","36","065",,102803,90496,12307
"36067","Onondaga County","Onondaga County, New York","00","36","067",,196633,181153,15480
"36069","Ontario County","Ontario County, New York","00","36","069",,42647,38370,4277
"36071","Orange County","Orange County, New York","00","36","071",,122754,114788,7966
"36073","Orleans County","Orleans County, New York","00","36","073",,17347,15363,1984
"36075","Oswego County","Oswego County, New York","00","36","075",,52831,45522,7309
"36077","Otsego County","Otsego County, New York","00","36","077",,28481,23291,5190
"36079","Putnam County","Putnam County, New York","00","36","079",,35030,32703,2327
"36081","Queens County","Queens County, New York","00","36","081",,817250,782664,34586
"36083","Rensselaer County","Rensselaer County, New York","00","36","083",,66120,59894,6226
"36085","Richmond County","Richmond County, New York","00","36","085",,163993,156341,7652
"36087","Rockland County","Rockland County, New York","00","36","087",,94973,92675,2298
"36089","St. Lawrence County","St. Lawrence County, New York","00","36","089",,49721,40506,9215
"36091","Saratoga County","Saratoga County, New York","00","36","091",,86701,78165,8536
"36093","Schenectady County","Schenectady County, New York","00","36","093",,65032,59684,5348
"36095","Schoharie County","Schoharie County, New York","00","36","095",,15915,11991,3924
"36097","Schuyler County","Schuyler County, New York","00","36","097",,9181,7374,1807
"36099","Seneca County","Seneca County, New York","00","36","099",,14794,12630,2164
"36101","Steuben County","Steuben County, New York","00","36","101",,46132,39071,7061
"36103","Suffolk County","Suffolk County, New York","00","36","103",,522323,469299,53024
"36105","Sullivan County","Sullivan County, New York","00","36","105",,44730,27661,17069
"36107","Tioga County","Tioga County, New York","00","36","107",,21410,19725,1685
"36109","Tompkins County","Tompkins County, New York","00","36","109",,38625,36420,2205
"36111","Ulster County","Ulster County, New York","00","36","111",,77656,67499,10157
"36113","Warren County","Warren County, New York","00","36","113",,34852,25726,9126
"36115","Washington County","Washington County, New York","00","36","115",,26794,22458,4336
"36117","Wayne County","Wayne County, New York","00","36","117",,38767,34908,3859
"36119","Westchester County","Westchester County, New York","00","36","119",,349445,337142,12303
"36121","Wyoming County","Wyoming County, New York","00","36","121",,16940,14906,2034
"36123","Yates County","Yates County, New York","00","36","123",,12064,9029,3035
"37001","Alamance County","Alamance County, North Carolina","00","37","001",,55463,51584,3879
"37003","Alexander County","Alexander County, North Carolina","00","37","003",,14098,13137,961
"37005","Alleghany County","Alleghany County, North Carolina","00","37","005",,6412,4593,1819
"37007","Anson County","Anson County, North Carolina","00","37","007",,10221,9204,1017
"37009","Ashe County","Ashe County, North Carolina","00","37","009",,13268,10411,2857
"37011","Avery County","Avery County, North Carolina","00","37","011",,11911,6532,5379
"37013","Beaufort County","Beaufort County, North Carolina","00","37","013",,22139,18319,3820
"37015","Bertie County","Bertie County, North Carolina","00","37","015",,9050,7743,1307
"37017","Bladen County","Bladen County, North Carolina","00","37","017",,15316,12897,2419
"37019","Brunswick County","Brunswick County, North Carolina","00","37","019",,51431,30438,20993
"37021","Buncombe County","Buncombe County, North Carolina","00","37","021",,93973,85776,8197
"37023","Burke County","Burke County, North Carolina","00","37","023",,37427,34528,2899
"37025","Cabarrus County","Cabarrus County, North Carolina","00","37","025",,52848,49519,3329
"37027","Caldwell County","Caldwell County, North Carolina","00","37","027",,33430,30768,2662
"37029","Camden County","Camden County, North Carolina","00","37","029",,2973,2662,311
"37031","Carteret County","Carteret County, North Carolina","00","37","031",,40947,25204,15743
"37033","Caswell County","Caswell County, North Carolina","00","37","033",,9601,8670,931
"37035","Catawba County","Catawba County, North Carolina","00","37","035",,59919,55533,4386
"37037","Chatham County","Chatham County, North Carolina","00","37","037",,21358,19741,1617
"37039","Cherokee County","Cherokee County, North Carolina","00","37","039",,13499,10336,3163
"37041","Chowan County","Chowan County, North Carolina","00","37","041",,6443,5580,863
"37043","Clay County","Clay County, North Carolina","00","37","043",,5425,3847,1578
"37045","Cleveland County","Cleveland County, North Carolina","00","37","045",,40317,37046,3271
"37047","Columbus County","Columbus County, North Carolina","00","37","047",,24060,21308,2752
"37049","Craven County","Craven County, North Carolina","00","37","049",,38150,34582,3568
"37051","Cumberland County","Cumberland County, North Carolina","00","37","051",,118425,107358,11067
"37053","Currituck County","Currituck County, North Carolina","00","37","053",,10687,6902,3785
"37055","Dare County","Dare County, North Carolina","00","37","055",,26671,12690,13981
"37057","Davidson County","Davidson County, North Carolina","00","37","057",,62432,58156,4276
"37059","Davie County","Davie County, North Carolina","00","37","059",,14953,13750,1203
"37061","Duplin County","Duplin County, North Carolina","00","37","061",,20520,18267,2253
"37063","Durham County","Durham County, North Carolina","00","37","063",,95452,89015,6437
"37065","Edgecombe County","Edgecombe County, North Carolina","00","37","065",,24002,20392,3610
"37067","Forsyth County","Forsyth County, North Carolina","00","37","067",,133093,123851,9242
"37069","Franklin County","Franklin County, North Carolina","00","37","069",,20364,17843,2521
"37071","Gaston County","Gaston County, North Carolina","00","37","071",,78842,73936,4906
"37073","Gates County","Gates County, North Carolina","00","37","073",,4389,3901,488
"37075","Graham County","Graham County, North Carolina","00","37","075",,5084,3354,1730
"37077","Granville County","Granville County, North Carolina","00","37","077",,17896,16654,1242
"37079","Greene County","Greene County, North Carolina","00","37","079",,7368,6696,672
"37081","Guilford County","Guilford County, North Carolina","00","37","081",,180391,168667,11724
"37083","Halifax County","Halifax County, North Carolina","00","37","083",,25309,22122,3187
"37085","Harnett County","Harnett County, North Carolina","00","37","085",,38605,33800,4805
"37087","Haywood County","Haywood County, North Carolina","00","37","087",,28640,23100,5540
"37089","Henderson County","Henderson County, North Carolina","00","37","089",,42996,37414,5582
"37091","Hertford County","Hertford County, North Carolina","00","37","091",,9724,8953,771
"37093","Hoke County","Hoke County, North Carolina","00","37","093",,12518,11373,1145
"37095","Hyde County","Hyde County, North Carolina","00","37","095",,3302,2185,1117
"37097","Iredell County","Iredell County, North Carolina","00","37","097",,51918,47360,4558
"37099","Jackson County","Jackson County, North Carolina","00","37","099",,19291,13191,6100
"37101","Johnston County","Johnston County, North Carolina","00","37","101",,50196,46595,3601
"37103","Jones County","Jones County, North Carolina","00","37","103",,4679,4061,618
"37105","Lee County","Lee County, North Carolina","00","37","105",,19909,18466,1443
"37107","Lenoir County","Lenoir County, North Carolina","00","37","107",,27184,23862,3322
"37109","Lincoln County","Lincoln County, North Carolina","00","37","109",,25717,24041,1676
"37111","McDowell County","McDowell County, North Carolina","00","37","111",,18377,16604,1773
"37113","Macon County","Macon County, North Carolina","00","37","113",,20746,12828,7918
"37115","Madison County","Madison County, North Carolina","00","37","115",,9722,8000,1722
"37117","Martin County","Martin County, North Carolina","00","37","117",,10930,10020,910
"37119","Mecklenburg County","Mecklenburg County, North Carolina","00","37","119",,292780,273416,19364
"37121","Mitchell County","Mitchell County, North Carolina","00","37","121",,7919,6551,1368
"37123","Montgomery County","Montgomery County, North Carolina","00","37","123",,14145,9848,4297
"37125","Moore County","Moore County, North Carolina","00","37","125",,35151,30713,4438
"37127","Nash County","Nash County, North Carolina","00","37","127",,37051,33644,3407
"37129","New Hanover County","New Hanover County, North Carolina","00","37","129",,79616,68183,11433
"37131","Northampton County","Northampton County, North Carolina","00","37","131",,10455,8691,1764
"37133","Onslow County","Onslow County, North Carolina","00","37","133",,55726,48122,7604
"37135","Orange County","Orange County, North Carolina","00","37","135",,49289,45863,3426
"37137","Pamlico County","Pamlico County, North Carolina","00","37","137",,6781,5178,1603
"37139","Pasquotank County","Pasquotank County, North Carolina","00","37","139",,14289,12907,1382
"37141","Pender County","Pender County, North Carolina","00","37","141",,20798,16054,4744
"37143","Perquimans County","Perquimans County, North Carolina","00","37","143",,6043,4645,1398
"37145","Person County","Person County, North Carolina","00","37","145",,15504,14085,1419
"37147","Pitt County","Pitt County, North Carolina","00","37","147",,58408,52539,5869
"37149","Polk County","Polk County, North Carolina","00","37","149",,9192,7908,1284
"37151","Randolph County","Randolph County, North Carolina","00","37","151",,54422,50659,3763
"37153","Richmond County","Richmond County, North Carolina","00","37","153",,19886,17873,2013
"37155","Robeson County","Robeson County, North Carolina","00","37","155",,47779,43677,4102
"37157","Rockingham County","Rockingham County, North Carolina","00","37","157",,40208,36989,3219
"37159","Rowan County","Rowan County, North Carolina","00","37","159",,53980,49940,4040
"37161","Rutherford County","Rutherford County, North Carolina","00","37","161",,29535,25191,4344
"37163","Sampson County","Sampson County, North Carolina","00","37","163",,25142,22273,2869
"37165","Scotland County","Scotland County, North Carolina","00","37","165",,14693,13399,1294
"37167","Stanly County","Stanly County, North Carolina","00","37","167",,24582,22223,2359
"37169","Stokes County","Stokes County, North Carolina","00","37","169",,19262,17579,1683
"37171","Surry County","Surry County, North Carolina","00","37","171",,31033,28408,2625
"37173","Swain County","Swain County, North Carolina","00","37","173",,7105,5137,1968
"37175","Transylvania County","Transylvania County, North Carolina","00","37","175",,15553,12320,3233
"37177","Tyrrell County","Tyrrell County, North Carolina","00","37","177",,2032,1537,495
"37179","Union County","Union County, North Carolina","00","37","179",,45695,43390,2305
"37181","Vance County","Vance County, North Carolina","00","37","181",,18196,16199,1997
"37183","Wake County","Wake County, North Carolina","00","37","183",,258953,242040,16913
"37185","Warren County","Warren County, North Carolina","00","37","185",,10548,7708,2840
"37187","Washington County","Washington County, North Carolina","00","37","187",,6174,5367,807
"37189","Watauga County","Watauga County, North Carolina","00","37","189",,23155,16540,6615
"37191","Wayne County","Wayne County, North Carolina","00","37","191",,47313,42612,4701
"37193","Wilkes County","Wilkes County, North Carolina","00","37","193",,29261,26650,2611
"37195","Wilson County","Wilson County, North Carolina","00","37","195",,30729,28613,2116
"37197","Yadkin County","Yadkin County, North Carolina","00","37","197",,15821,14505,1316
"37199","Yancey County","Yancey County, North Carolina","00","37","199",,9729,7472,2257
"38001","Adams County","Adams County, North Dakota","00","38","001",,1416,1121,295
"38003","Barnes County","Barnes County, North Dakota","00","38","003",,5599,4884,715
"38005","Benson County","Benson County, North Dakota","00","38","005",,2932,2328,604
"38007","Billings County","Billings County, North Dakota","00","38","007",,529,366,163
"38009","Bottineau County","Bottineau County, North Dakota","00","38","009",,4409,2962,1447
"38011","Bowman County","Bowman County, North Dakota","00","38","011",,1596,1358,238
"38013","Burke County","Burke County, North Dakota","00","38","013",,1412,1013,399
"38015","Burleigh County","Burleigh County, North Dakota","00","38","015",,29003,27670,1333
"38017","Cass County","Cass County, North Dakota","00","38","017",,53790,51315,2475
"38019","Cavalier County","Cavalier County, North Dakota","00","38","019",,2725,2017,708
"38021","Dickey County","Dickey County, North Dakota","00","38","021",,2656,2283,373
"38023","Divide County","Divide County, North Dakota","00","38","023",,1469,1005,464
"38025","Dunn County","Dunn County, North Dakota","00","38","025",,1965,1378,587
"38027","Eddy County","Eddy County, North Dakota","00","38","027",,1418,1164,254
"38029","Emmons County","Emmons County, North Dakota","00","38","029",,2168,1786,382
"38031","Foster County","Foster County, North Dakota","00","38","031",,1793,1540,253
"38033","Golden Valley County","Golden Valley County, North Dakota","00","38","033",,973,761,212
"38035","Grand Forks County","Grand Forks County, North Dakota","00","38","035",,27373,25435,1938
"38037","Grant County","Grant County, North Dakota","00","38","037",,1722,1195,527
"38039","Griggs County","Griggs County, North Dakota","00","38","039",,1521,1178,343
"38041","Hettinger County","Hettinger County, North Dakota","00","38","041",,1419,1152,267
"38043","Kidder County","Kidder County, North Dakota","00","38","043",,1610,1158,452
"38045","LaMoure County","LaMoure County, North Dakota","00","38","045",,2271,1942,329
"38047","Logan County","Logan County, North Dakota","00","38","047",,1193,963,230
"38049","McHenry County","McHenry County, North Dakota","00","38","049",,2983,2526,457
"38051","McIntosh County","McIntosh County, North Dakota","00","38","051",,1853,1467,386
"38053","McKenzie County","McKenzie County, North Dakota","00","38","053",,2719,2151,568
"38055","McLean County","McLean County, North Dakota","00","38","055",,5264,3815,1449
"38057","Mercer County","Mercer County, North Dakota","00","38","057",,4402,3346,1056
"38059","Morton County","Morton County, North Dakota","00","38","059",,10587,9889,698
"38061","Mountrail County","Mountrail County, North Dakota","00","38","061",,3438,2560,878
"38063","Nelson County","Nelson County, North Dakota","00","38","063",,2014,1628,386
"38065","Oliver County","Oliver County, North Dakota","00","38","065",,903,791,112
"38067","Pembina County","Pembina County, North Dakota","00","38","067",,4115,3535,580
"38069","Pierce County","Pierce County, North Dakota","00","38","069",,2269,1964,305
"38071","Ramsey County","Ramsey County, North Dakota","00","38","071",,5729,4957,772
"38073","Ransom County","Ransom County, North Dakota","00","38","073",,2604,2350,254
"38075","Renville County","Renville County, North Dakota","00","38","075",,1413,1085,328
"38077","Richland County","Richland County, North Dakota","00","38","077",,7575,6885,690
"38079","Rolette County","Rolette County, North Dakota","00","38","079",,5027,4556,471
"38081","Sargent County","Sargent County, North Dakota","00","38","081",,2016,1786,230
"38083","Sheridan County","Sheridan County, North Dakota","00","38","083",,924,731,193
"38085","Sioux County","Sioux County, North Dakota","00","38","085",,1216,1095,121
"38087","Slope County","Slope County, North Dakota","00","38","087",,451,313,138
"38089","Stark County","Stark County, North Dakota","00","38","089",,9722,8932,790
"38091","Steele County","Steele County, North Dakota","00","38","091",,1231,923,308
"38093","Stutsman County","Stutsman County, North Dakota","00","38","093",,9817,8954,863
"38095","Towner County","Towner County, North Dakota","00","38","095",,1558,1218,340
"38097","Traill County","Traill County, North Dakota","00","38","097",,3708,3341,367
"38099","Walsh County","Walsh County, North Dakota","00","38","099",,5757,5029,728
"38101","Ward County","Ward County, North Dakota","00","38","101",,25097,23041,2056
"38103","Wells County","Wells County, North Dakota","00","38","103",,2643,2215,428
"38105","Williams County","Williams County, North Dakota","00","38","105",,9680,8095,1585
"39001","Adams County","Adams County, Ohio","00","39","001",,11822,10501,1321
"39003","Allen County","Allen County, Ohio","00","39","003",,44245,40646,3599
"39005","Ashland County","Ashland County, Ohio","00","39","005",,20832,19524,1308
"39007","Ashtabula County","Ashtabula County, Ohio","00","39","007",,43792,39397,4395
"39009","Athens County","Athens County, Ohio","00","39","009",,24901,22501,2400
"39011","Auglaize County","Auglaize County, Ohio","00","39","011",,18470,17376,1094
"39013","Belmont County","Belmont County, Ohio","00","39","013",,31236,28309,2927
"39015","Brown County","Brown County, Ohio","00","39","015",,17193,15555,1638
"39017","Butler County","Butler County, Ohio","00","39","017",,129793,123082,6711
"39019","Carroll County","Carroll County, Ohio","00","39","019",,13016,11126,1890
"39021","Champaign County","Champaign County, Ohio","00","39","021",,15890,14952,938
"39023","Clark County","Clark County, Ohio","00","39","023",,61056,56648,4408
"39025","Clermont County","Clermont County, Ohio","00","39","025",,69226,66013,3213
"39027","Clinton County","Clinton County, Ohio","00","39","027",,16577,15416,1161
"39029","Columbiana County","Columbiana County, Ohio","00","39","029",,46083,42973,3110
"39031","Coshocton County","Coshocton County, Ohio","00","39","031",,16107,14356,1751
"39033","Crawford County","Crawford County, Ohio","00","39","033",,20178,18957,1221
"39035","Cuyahoga County","Cuyahoga County, Ohio","00","39","035",,616903,571457,45446
"39037","Darke County","Darke County, Ohio","00","39","037",,21583,20419,1164
"39039","Defiance County","Defiance County, Ohio","00","39","039",,16040,15138,902
"39041","Delaware County","Delaware County, Ohio","00","39","041",,42374,39674,2700
"39043","Erie County","Erie County, Ohio","00","39","043",,35909,31727,4182
"39045","Fairfield County","Fairfield County, Ohio","00","39","045",,47922,45425,2497
"39047","Fayette County","Fayette County, Ohio","00","39","047",,11904,11054,850
"39049","Franklin County","Franklin County, Ohio","00","39","049",,471016,438778,32238
"39051","Fulton County","Fulton County, Ohio","00","39","051",,16232,15480,752
"39053","Gallia County","Gallia County, Ohio","00","39","053",,13498,12060,1438
"39055","Geauga County","Geauga County, Ohio","00","39","055",,32805,31630,1175
"39057","Greene County","Greene County, Ohio","00","39","057",,58224,55312,2912
"39059","Guernsey County","Guernsey County, Ohio","00","39","059",,18771,16094,2677
"39061","Hamilton County","Hamilton County, Ohio","00","39","061",,373393,346790,26603
"39063","Hancock County","Hancock County, Ohio","00","39","063",,29785,27898,1887
"39065","Hardin County","Hardin County, Ohio","00","39","065",,12907,11963,944
"39067","Harrison County","Harrison County, Ohio","00","39","067",,7680,6398,1282
"39069","Henry County","Henry County, Ohio","00","39","069",,11622,10935,687
"39071","Highland County","Highland County, Ohio","00","39","071",,17583,15587,1996
"39073","Hocking County","Hocking County, Ohio","00","39","073",,12141,10843,1298
"39075","Holmes County","Holmes County, Ohio","00","39","075",,12280,11337,943
"39077","Huron County","Huron County, Ohio","00","39","077",,23594,22307,1287
"39079","Jackson County","Jackson County, Ohio","00","39","079",,13909,12619,1290
"39081","Jefferson County","Jefferson County, Ohio","00","39","081",,33291,30417,2874
"39083","Knox County","Knox County, Ohio","00","39","083",,21793,19975,1818
"39085","Lake County","Lake County, Ohio","00","39","085",,93487,89700,3787
"39087","Lawrence County","Lawrence County, Ohio","00","39","087",,27189,24732,2457
"39089","Licking County","Licking County, Ohio","00","39","089",,58760,55609,3151
"39091","Logan County","Logan County, Ohio","00","39","091",,21571,17956,3615
"39093","Lorain County","Lorain County, Ohio","00","39","093",,111368,105836,5532
"39095","Lucas County","Lucas County, Ohio","00","39","095",,196259,182847,13412
"39097","Madison County","Madison County, Ohio","00","39","097",,14399,13672,727
"39099","Mahoning County","Mahoning County, Ohio","00","39","099",,111762,102587,9175
"39101","Marion County","Marion County, Ohio","00","39","101",,26298,24578,1720
"39103","Medina County","Medina County, Ohio","00","39","103",,56793,54542,2251
"39105","Meigs County","Meigs County, Ohio","00","39","105",,10782,9234,1548
"39107","Mercer County","Mercer County, Ohio","00","39","107",,15875,14756,1119
"39109","Miami County","Miami County, Ohio","00","39","109",,40554,38437,2117
"39111","Monroe County","Monroe County, Ohio","00","39","111",,7212,6021,1191
"39113","Montgomery County","Montgomery County, Ohio","00","39","113",,248443,229229,19214
"39115","Morgan County","Morgan County, Ohio","00","39","115",,7771,5890,1881
"39117","Morrow County","Morrow County, Ohio","00","39","117",,12132,11499,633
"39119","Muskingum County","Muskingum County, Ohio","00","39","119",,35163,32518,2645
"39121","Noble County","Noble County, Ohio","00","39","121",,5480,4546,934
"39123","Ottawa County","Ottawa County, Ohio","00","39","123",,25532,16474,9058
"39125","Paulding County","Paulding County, Ohio","00","39","125",,8478,7773,705
"39127","Perry County","Perry County, Ohio","00","39","127",,13655,12500,1155
"39129","Pickaway County","Pickaway County, Ohio","00","39","129",,18596,17599,997
"39131","Pike County","Pike County, Ohio","00","39","131",,11602,10444,1158
"39133","Portage County","Portage County, Ohio","00","39","133",,60096,56449,3647
"39135","Preble County","Preble County, Ohio","00","39","135",,17186,16001,1185
"39137","Putnam County","Putnam County, Ohio","00","39","137",,12753,12200,553
"39139","Richland County","Richland County, Ohio","00","39","139",,53062,49534,3528
"39141","Ross County","Ross County, Ohio","00","39","141",,29461,27136,2325
"39143","Sandusky County","Sandusky County, Ohio","00","39","143",,25253,23717,1536
"39145","Scioto County","Scioto County, Ohio","00","39","145",,34054,30871,3183
"39147","Seneca County","Seneca County, Ohio","00","39","147",,23692,22292,1400
"39149","Shelby County","Shelby County, Ohio","00","39","149",,18682,17636,1046
"39151","Stark County","Stark County, Ohio","00","39","151",,157024,148316,8708
"39153","Summit County","Summit County, Ohio","00","39","153",,230880,217788,13092
"39155","Trumbull County","Trumbull County, Ohio","00","39","155",,95117,89020,6097
"39157","Tuscarawas County","Tuscarawas County, Ohio","00","39","157",,38113,35653,2460
"39159","Union County","Union County, Ohio","00","39","159",,15217,14346,871
"39161","Van Wert County","Van Wert County, Ohio","00","39","161",,12363,11587,776
"39163","Vinton County","Vinton County, Ohio","00","39","163",,5653,4892,761
"39165","Warren County","Warren County, Ohio","00","39","165",,58692,55966,2726
"39167","Washington County","Washington County, Ohio","00","39","167",,27760,25137,2623
"39169","Wayne County","Wayne County, Ohio","00","39","169",,42324,40445,1879
"39171","Williams County","Williams County, Ohio","00","39","171",,16140,15105,1035
"39173","Wood County","Wood County, Ohio","00","39","173",,47468,45172,2296
"39175","Wyandot County","Wyandot County, Ohio","00","39","175",,9324,8882,442
"40001","Adair County","Adair County, Oklahoma","00","40","001",,8348,7471,877
"40003","Alfalfa County","Alfalfa County, Oklahoma","00","40","003",,2832,2199,633
"40005","Atoka County","Atoka County, Oklahoma","00","40","005",,5673,4964,709
"40007","Beaver County","Beaver County, Oklahoma","00","40","007",,2719,2245,474
"40009","Beckham County","Beckham County, Oklahoma","00","40","009",,8796,7356,1440
"40011","Blaine County","Blaine County, Oklahoma","00","40","011",,5208,4159,1049
"40013","Bryan County","Bryan County, Oklahoma","00","40","013",,16715,14422,2293
"40015","Caddo County","Caddo County, Oklahoma","00","40","015",,13096,10957,2139
"40017","Canadian County","Canadian County, Oklahoma","00","40","017",,33969,31484,2485
"40019","Carter County","Carter County, Oklahoma","00","40","019",,20577,17992,2585
"40021","Cherokee County","Cherokee County, Oklahoma","00","40","021",,19499,16175,3324
"40023","Choctaw County","Choctaw County, Oklahoma","00","40","023",,7539,6220,1319
"40025","Cimarron County","Cimarron County, Oklahoma","00","40","025",,1583,1257,326
"40027","Cleveland County","Cleveland County, Oklahoma","00","40","027",,84844,79186,5658
"40029","Coal County","Coal County, Oklahoma","00","40","029",,2744,2373,371
"40031","Comanche County","Comanche County, Oklahoma","00","40","031",,45416,39808,5608
"40033","Cotton County","Cotton County, Oklahoma","00","40","033",,3085,2614,471
"40035","Craig County","Craig County, Oklahoma","00","40","035",,6459,5620,839
"40037","Creek County","Creek County, Oklahoma","00","40","037",,27986,25289,2697
"40039","Custer County","Custer County, Oklahoma","00","40","039",,11675,10136,1539
"40041","Delaware County","Delaware County, Oklahoma","00","40","041",,22290,14838,7452
"40043","Dewey County","Dewey County, Oklahoma","00","40","043",,2425,1962,463
"40045","Ellis County","Ellis County, Oklahoma","00","40","045",,2146,1769,377
"40047","Garfield County","Garfield County, Oklahoma","00","40","047",,26047,23175,2872
"40049","Garvin County","Garvin County, Oklahoma","00","40","049",,12641,10865,1776
"40051","Grady County","Grady County, Oklahoma","00","40","051",,19444,17341,2103
"40053","Grant County","Grant County, Oklahoma","00","40","053",,2622,2089,533
"40055","Greer County","Greer County, Oklahoma","00","40","055",,2788,2237,551
"40057","Harmon County","Harmon County, Oklahoma","00","40","057",,1647,1266,381
"40059","Harper County","Harper County, Oklahoma","00","40","059",,1863,1509,354
"40061","Haskell County","Haskell County, Oklahoma","00","40","061",,5573,4624,949
"40063","Hughes County","Hughes County, Oklahoma","00","40","063",,6237,5319,918
"40065","Jackson County","Jackson County, Oklahoma","00","40","065",,12377,10590,1787
"40067","Jefferson County","Jefferson County, Oklahoma","00","40","067",,3373,2716,657
"40069","Johnston County","Johnston County, Oklahoma","00","40","069",,4782,4057,725
"40071","Kay County","Kay County, Oklahoma","00","40","071",,21804,19157,2647
"40073","Kingfisher County","Kingfisher County, Oklahoma","00","40","073",,5879,5247,632
"40075","Kiowa County","Kiowa County, Oklahoma","00","40","075",,5304,4208,1096
"40077","Latimer County","Latimer County, Oklahoma","00","40","077",,4709,3951,758
"40079","Le Flore County","Le Flore County, Oklahoma","00","40","079",,20142,17861,2281
"40081","Lincoln County","Lincoln County, Oklahoma","00","40","081",,13712,12178,1534
"40083","Logan County","Logan County, Oklahoma","00","40","083",,13906,12389,1517
"40085","Love County","Love County, Oklahoma","00","40","085",,4066,3442,624
"40087","McClain County","McClain County, Oklahoma","00","40","087",,11189,10331,858
"40089","McCurtain County","McCurtain County, Oklahoma","00","40","089",,15427,13216,2211
"40091","McIntosh County","McIntosh County, Oklahoma","00","40","091",,12640,8085,4555
"40093","Major County","Major County, Oklahoma","00","40","093",,3540,3046,494
"40095","Marshall County","Marshall County, Oklahoma","00","40","095",,8517,5371,3146
"40097","Mayes County","Mayes County, Oklahoma","00","40","097",,17423,14823,2600
"40099","Murray County","Murray County, Oklahoma","00","40","099",,6479,5003,1476
"40101","Muskogee County","Muskogee County, Oklahoma","00","40","101",,29575,26458,3117
"40103","Noble County","Noble County, Oklahoma","00","40","103",,5082,4504,578
"40105","Nowata County","Nowata County, Oklahoma","00","40","105",,4705,4147,558
"40107","Okfuskee County","Okfuskee County, Oklahoma","00","40","107",,5114,4270,844
"40109","Oklahoma County","Oklahoma County, Oklahoma","00","40","109",,295020,266834,28186
"40111","Okmulgee County","Okmulgee County, Oklahoma","00","40","111",,17316,15300,2016
"40113","Osage County","Osage County, Oklahoma","00","40","113",,18826,16617,2209
"40115","Ottawa County","Ottawa County, Oklahoma","00","40","115",,14842,12984,1858
"40117","Pawnee County","Pawnee County, Oklahoma","00","40","117",,7464,6383,1081
"40119","Payne County","Payne County, Oklahoma","00","40","119",,29326,26680,2646
"40121","Pittsburg County","Pittsburg County, Oklahoma","00","40","121",,21520,17157,4363
"40123","Pontotoc County","Pontotoc County, Oklahoma","00","40","123",,15575,13978,1597
"40125","Pottawatomie County","Pottawatomie County, Oklahoma","00","40","125",,27302,24540,2762
"40127","Pushmataha County","Pushmataha County, Oklahoma","00","40","127",,5795,4739,1056
"40129","Roger Mills County","Roger Mills County, Oklahoma","00","40","129",,1749,1428,321
"40131","Rogers County","Rogers County, Oklahoma","00","40","131",,27476,25724,1752
"40133","Seminole County","Seminole County, Oklahoma","00","40","133",,11146,9575,1571
"40135","Sequoyah County","Sequoyah County, Oklahoma","00","40","135",,16940,14761,2179
"40137","Stephens County","Stephens County, Oklahoma","00","40","137",,19854,17463,2391
"40139","Texas County","Texas County, Oklahoma","00","40","139",,8014,7153,861
"40141","Tillman County","Tillman County, Oklahoma","00","40","141",,4342,3594,748
"40143","Tulsa County","Tulsa County, Oklahoma","00","40","143",,243953,226892,17061
"40145","Wagoner County","Wagoner County, Oklahoma","00","40","145",,23174,21010,2164
"40147","Washington County","Washington County, Oklahoma","00","40","147",,22250,20179,2071
"40149","Washita County","Washita County, Oklahoma","00","40","149",,5452,4506,946
"40151","Woods County","Woods County, Oklahoma","00","40","151",,4492,3684,808
"40153","Woodward County","Woodward County, Oklahoma","00","40","153",,8341,7141,1200
"41001","Baker County","Baker County, Oregon","00","41","001",,8402,6883,1519
"41003","Benton County","Benton County, Oregon","00","41","003",,31980,30145,1835
"41005","Clackamas County","Clackamas County, Oregon","00","41","005",,136954,128201,8753
"41007","Clatsop County","Clatsop County, Oregon","00","41","007",,19685,14703,4982
"41009","Columbia County","Columbia County, Oregon","00","41","009",,17572,16375,1197
"41011","Coos County","Coos County, Oregon","00","41","011",,29247,26213,3034
"41013","Crook County","Crook County, Oregon","00","41","013",,8264,7354,910
"41015","Curry County","Curry County, Oregon","00","41","015",,11406,9543,1863
"41017","Deschutes County","Deschutes County, Oregon","00","41","017",,54583,45595,8988
"41019","Douglas County","Douglas County, Oregon","00","41","019",,43284,39821,3463
"41021","Gilliam County","Gilliam County, Oregon","00","41","021",,1043,819,224
"41023","Grant County","Grant County, Oregon","00","41","023",,4004,3246,758
"41025","Harney County","Harney County, Oregon","00","41","025",,3533,3036,497
"41027","Hood River County","Hood River County, Oregon","00","41","027",,7818,7248,570
"41029","Jackson County","Jackson County, Oregon","00","41","029",,75737,71532,4205
"41031","Jefferson County","Jefferson County, Oregon","00","41","031",,8319,6727,1592
"41033","Josephine County","Josephine County, Oregon","00","41","033",,33239,31000,2239
"41035","Klamath County","Klamath County, Oregon","00","41","035",,28883,25205,3678
"41037","Lake County","Lake County, Oregon","00","41","037",,3999,3084,915
"41039","Lane County","Lane County, Oregon","00","41","039",,138946,130453,8493
"41041","Lincoln County","Lincoln County, Oregon","00","41","041",,26889,19296,7593
"41043","Linn County","Linn County, Oregon","00","41","043",,42521,39541,2980
"41045","Malheur County","Malheur County, Oregon","00","41","045",,11233,10221,1012
"41047","Marion County","Marion County, Oregon","00","41","047",,108174,101641,6533
"41049","Morrow County","Morrow County, Oregon","00","41","049",,4276,3776,500
"41051","Multnomah County","Multnomah County, Oregon","00","41","051",,288561,272098,16463
"41053","Polk County","Polk County, Oregon","00","41","053",,24461,23058,1403
"41055","Sherman County","Sherman County, Oregon","00","41","055",,935,797,138
"41057","Tillamook County","Tillamook County, Oregon","00","41","057",,15906,10200,5706
"41059","Umatilla County","Umatilla County, Oregon","00","41","059",,27676,25195,2481
"41061","Union County","Union County, Oregon","00","41","061",,10603,9740,863
"41063","Wallowa County","Wallowa County, Oregon","00","41","063",,3900,3029,871
"41065","Wasco County","Wasco County, Oregon","00","41","065",,10651,9401,1250
"41067","Washington County","Washington County, Oregon","00","41","067",,178913,169162,9751
"41069","Wheeler County","Wheeler County, Oregon","00","41","069",,842,653,189
"41071","Yamhill County","Yamhill County, Oregon","00","41","071",,30270,28732,1538
"42001","Adams County","Adams County, Pennsylvania","00","42","001",,35831,33652,2179
"42003","Allegheny County","Allegheny County, Pennsylvania","00","42","003",,583646,537150,46496
"42005","Armstrong County","Armstrong County, Pennsylvania","00","42","005",,32387,29005,3382
"42007","Beaver County","Beaver County, Pennsylvania","00","42","007",,77765,72576,5189
"42009","Bedford County","Bedford County, Pennsylvania","00","42","009",,23529,19768,3761
"42011","Berks County","Berks County, Pennsylvania","00","42","011",,150222,141570,8652
"42013","Blair County","Blair County, Pennsylvania","00","42","013",,55061,51518,3543
"42015","Bradford County","Bradford County, Pennsylvania","00","42","015",,28664,24453,4211
"42017","Bucks County","Bucks County, Pennsylvania","00","42","017",,225498,218725,6773
"42019","Butler County","Butler County, Pennsylvania","00","42","019",,69868,65862,4006
"42021","Cambria County","Cambria County, Pennsylvania","00","42","021",,65796,60531,5265
"42023","Cameron County","Cameron County, Pennsylvania","00","42","023",,4592,2465,2127
"42025","Carbon County","Carbon County, Pennsylvania","00","42","025",,30492,23701,6791
"42027","Centre County","Centre County, Pennsylvania","00","42","027",,53161,49323,3838
"42029","Chester County","Chester County, Pennsylvania","00","42","029",,163773,157905,5868
"42031","Clarion County","Clarion County, Pennsylvania","00","42","031",,19426,16052,3374
"42033","Clearfield County","Clearfield County, Pennsylvania","00","42","033",,37855,32785,5070
"42035","Clinton County","Clinton County, Pennsylvania","00","42","035",,18166,14773,3393
"42037","Columbia County","Columbia County, Pennsylvania","00","42","037",,27733,24915,2818
"42039","Crawford County","Crawford County, Pennsylvania","00","42","039",,42416,34678,7738
"42041","Cumberland County","Cumberland County, Pennsylvania","00","42","041",,86951,83015,3936
"42043","Dauphin County","Dauphin County, Pennsylvania","00","42","043",,111133,102670,8463
"42045","Delaware County","Delaware County, Pennsylvania","00","42","045",,216978,206320,10658
"42047","Elk County","Elk County, Pennsylvania","00","42","047",,18115,14124,3991
"42049","Erie County","Erie County, Pennsylvania","00","42","049",,114322,106507,7815
"42051","Fayette County","Fayette County, Pennsylvania","00","42","051",,66490,59969,6521
"42053","Forest County","Forest County, Pennsylvania","00","42","053",,8701,2000,6701
"42055","Franklin County","Franklin County, Pennsylvania","00","42","055",,53803,50633,3170
"42057","Fulton County","Fulton County, Pennsylvania","00","42","057",,6790,5660,1130
"42059","Greene County","Greene County, Pennsylvania","00","42","059",,16678,15060,1618
"42061","Huntingdon County","Huntingdon County, Pennsylvania","00","42","061",,21058,16759,4299
"42063","Indiana County","Indiana County, Pennsylvania","00","42","063",,37250,34123,3127
"42065","Jefferson County","Jefferson County, Pennsylvania","00","42","065",,22104,18375,3729
"42067","Juniata County","Juniata County, Pennsylvania","00","42","067",,10031,8584,1447
"42069","Lackawanna County","Lackawanna County, Pennsylvania","00","42","069",,95362,86218,9144
"42071","Lancaster County","Lancaster County, Pennsylvania","00","42","071",,179990,172560,7430
"42073","Lawrence County","Lawrence County, Pennsylvania","00","42","073",,39635,37091,2544
"42075","Lebanon County","Lebanon County, Pennsylvania","00","42","075",,49320,46551,2769
"42077","Lehigh County","Lehigh County, Pennsylvania","00","42","077",,128910,121906,7004
"42079","Luzerne County","Luzerne County, Pennsylvania","00","42","079",,144686,130687,13999
"42081","Lycoming County","Lycoming County, Pennsylvania","00","42","081",,52464,47003,5461
"42083","McKean County","McKean County, Pennsylvania","00","42","083",,21644,18024,3620
"42085","Mercer County","Mercer County, Pennsylvania","00","42","085",,49859,46712,3147
"42087","Mifflin County","Mifflin County, Pennsylvania","00","42","087",,20745,18413,2332
"42089","Monroe County","Monroe County, Pennsylvania","00","42","089",,67581,49454,18127
"42091","Montgomery County","Montgomery County, Pennsylvania","00","42","091",,297434,286098,11336
"42093","Montour County","Montour County, Pennsylvania","00","42","093",,7627,7085,542
"42095","Northampton County","Northampton County, Pennsylvania","00","42","095",,106710,101541,5169
"42097","Northumberland County","Northumberland County, Pennsylvania","00","42","097",,43164,38835,4329
"42099","Perry County","Perry County, Pennsylvania","00","42","099",,18941,16695,2246
"42101","Philadelphia County","Philadelphia County, Pennsylvania","00","42","101",,661958,590071,71887
"42103","Pike County","Pike County, Pennsylvania","00","42","103",,34681,17433,17248
"42105","Potter County","Potter County, Pennsylvania","00","42","105",,12159,7005,5154
"42107","Schuylkill County","Schuylkill County, Pennsylvania","00","42","107",,67806,60530,7276
"42109","Snyder County","Snyder County, Pennsylvania","00","42","109",,14890,13654,1236
"42111","Somerset County","Somerset County, Pennsylvania","00","42","111",,37163,31222,5941
"42113","Sullivan County","Sullivan County, Pennsylvania","00","42","113",,6017,2660,3357
"42115","Susquehanna County","Susquehanna County, Pennsylvania","00","42","115",,21829,16529,5300
"42117","Tioga County","Tioga County, Pennsylvania","00","42","117",,19893,15925,3968
"42119","Union County","Union County, Pennsylvania","00","42","119",,14684,13178,1506
"42121","Venango County","Venango County, Pennsylvania","00","42","121",,26904,22747,4157
"42123","Warren County","Warren County, Pennsylvania","00","42","123",,23058,17696,5362
"42125","Washington County","Washington County, Pennsylvania","00","42","125",,87267,81130,6137
"42127","Wayne County","Wayne County, Pennsylvania","00","42","127",,30593,18350,12243
"42129","Westmoreland County","Westmoreland County, Pennsylvania","00","42","129",,161058,149813,11245
"42131","Wyoming County","Wyoming County, Pennsylvania","00","42","131",,12713,10762,1951
"42133","York County","York County, Pennsylvania","00","42","133",,156720,148219,8501
"44001","Bristol County","Bristol County, Rhode Island","00","44","001",,19881,19033,848
"44003","Kent County","Kent County, Rhode Island","00","44","003",,70365,67320,3045
"44005","Newport County","Newport County, Rhode Island","00","44","005",,39561,35228,4333
"44007","Providence County","Providence County, Rhode Island","00","44","007",,253214,239936,13278
"44009","Washington County","Washington County, Rhode Island","00","44","009",,56816,46907,9909
"45001","Abbeville County","Abbeville County, South Carolina","00","45","001",,11656,10131,1525
"45003","Aiken County","Aiken County, South Carolina","00","45","003",,61987,55587,6400
"45005","Allendale County","Allendale County, South Carolina","00","45","005",,4568,3915,653
"45007","Anderson County","Anderson County, South Carolina","00","45","007",,73213,65649,7564
"45009","Bamberg County","Bamberg County, South Carolina","00","45","009",,7130,6123,1007
"45011","Barnwell County","Barnwell County, South Carolina","00","45","011",,10191,9021,1170
"45013","Beaufort County","Beaufort County, South Carolina","00","45","013",,60509,45532,14977
"45015","Berkeley County","Berkeley County, South Carolina","00","45","015",,54717,49922,4795
"45017","Calhoun County","Calhoun County, South Carolina","00","45","017",,6864,5917,947
"45019","Charleston County","Charleston County, South Carolina","00","45","019",,141031,123326,17705
"45021","Cherokee County","Cherokee County, South Carolina","00","45","021",,22400,20495,1905
"45023","Chester County","Chester County, South Carolina","00","45","023",,14374,12880,1494
"45025","Chesterfield County","Chesterfield County, South Carolina","00","45","025",,18818,16557,2261
"45027","Clarendon County","Clarendon County, South Carolina","00","45","027",,15303,11812,3491
"45029","Colleton County","Colleton County, South Carolina","00","45","029",,18129,14470,3659
"45031","Darlington County","Darlington County, South Carolina","00","45","031",,28942,25793,3149
"45033","Dillon County","Dillon County, South Carolina","00","45","033",,12679,11199,1480
"45035","Dorchester County","Dorchester County, South Carolina","00","45","035",,37237,34709,2528
"45037","Edgefield County","Edgefield County, South Carolina","00","45","037",,9223,8270,953
"45039","Fairfield County","Fairfield County, South Carolina","00","45","039",,10383,8774,1609
"45041","Florence County","Florence County, South Carolina","00","45","041",,51836,47147,4689
"45043","Georgetown County","Georgetown County, South Carolina","00","45","043",,28282,21659,6623
"45045","Greenville County","Greenville County, South Carolina","00","45","045",,162803,149556,13247
"45047","Greenwood County","Greenwood County, South Carolina","00","45","047",,28243,25729,2514
"45049","Hampton County","Hampton County, South Carolina","00","45","049",,8582,7444,1138
"45051","Horry County","Horry County, South Carolina","00","45","051",,122085,81800,40285
"45053","Jasper County","Jasper County, South Carolina","00","45","053",,7928,7042,886
"45055","Kershaw County","Kershaw County, South Carolina","00","45","055",,22683,20188,2495
"45057","Lancaster County","Lancaster County, South Carolina","00","45","057",,24962,23178,1784
"45059","Laurens County","Laurens County, South Carolina","00","45","059",,30239,26290,3949
"45061","Lee County","Lee County, South Carolina","00","45","061",,7670,6886,784
"45063","Lexington County","Lexington County, South Carolina","00","45","063",,90978,83240,7738
"45065","McCormick County","McCormick County, South Carolina","00","45","065",,4459,3558,901
"45067","Marion County","Marion County, South Carolina","00","45","067",,15143,13301,1842
"45069","Marlboro County","Marlboro County, South Carolina","00","45","069",,11894,10478,1416
"45071","Newberry County","Newberry County, South Carolina","00","45","071",,16805,14026,2779
"45073","Oconee County","Oconee County, South Carolina","00","45","073",,32383,27283,5100
"45075","Orangeburg County","Orangeburg County, South Carolina","00","45","075",,39304,34118,5186
"45077","Pickens County","Pickens County, South Carolina","00","45","077",,46000,41306,4694
"45079","Richland County","Richland County, South Carolina","00","45","079",,129793,120101,9692
"45081","Saluda County","Saluda County, South Carolina","00","45","081",,8543,7127,1416
"45083","Spartanburg County","Spartanburg County, South Carolina","00","45","083",,106986,97735,9251
"45085","Sumter County","Sumter County, South Carolina","00","45","085",,41751,37728,4023
"45087","Union County","Union County, South Carolina","00","45","087",,13351,12087,1264
"45089","Williamsburg County","Williamsburg County, South Carolina","00","45","089",,15552,13714,1838
"45091","York County","York County, South Carolina","00","45","091",,66061,61051,5010
"46003","Aurora County","Aurora County, South Dakota","00","46","003",,1298,1165,133
"46005","Beadle County","Beadle County, South Dakota","00","46","005",,8206,7210,996
"46007","Bennett County","Bennett County, South Dakota","00","46","007",,1278,1123,155
"46009","Bon Homme County","Bon Homme County, South Dakota","00","46","009",,3007,2635,372
"46011","Brookings County","Brookings County, South Dakota","00","46","011",,11576,10665,911
"46013","Brown County","Brown County, South Dakota","00","46","013",,15861,14638,1223
"46015","Brule County","Brule County, South Dakota","00","46","015",,2272,1998,274
"46017","Buffalo County","Buffalo County, South Dakota","00","46","017",,602,526,76
"46019","Butte County","Butte County, South Dakota","00","46","019",,4059,3516,543
"46021","Campbell County","Campbell County, South Dakota","00","46","021",,962,725,237
"46023","Charles Mix County","Charles Mix County, South Dakota","00","46","023",,3853,3343,510
"46025","Clark County","Clark County, South Dakota","00","46","025",,1880,1598,282
"46027","Clay County","Clay County, South Dakota","00","46","027",,5438,4878,560
"46029","Codington County","Codington County, South Dakota","00","46","029",,11324,10357,967
"46031","Corson County","Corson County, South Dakota","00","46","031",,1536,1271,265
"46033","Custer County","Custer County, South Dakota","00","46","033",,3624,2970,654
"46035","Davison County","Davison County, South Dakota","00","46","035",,8093,7585,508
"46037","Day County","Day County, South Dakota","00","46","037",,3618,2586,1032
"46039","Deuel County","Deuel County, South Dakota","00","46","039",,2172,1843,329
"46041","Dewey County","Dewey County, South Dakota","00","46","041",,2133,1863,270
"46043","Douglas County","Douglas County, South Dakota","00","46","043",,1453,1321,132
"46045","Edmunds County","Edmunds County, South Dakota","00","46","045",,2022,1681,341
"46047","Fall River County","Fall River County, South Dakota","00","46","047",,3812,3127,685
"46049","Faulk County","Faulk County, South Dakota","00","46","049",,1235,1014,221
"46051","Grant County","Grant County, South Dakota","00","46","051",,3456,3116,340
"46053","Gregory County","Gregory County, South Dakota","00","46","053",,2405,2022,383
"46055","Haakon County","Haakon County, South Dakota","00","46","055",,1002,870,132
"46057","Hamlin County","Hamlin County, South Dakota","00","46","057",,2626,2048,578
"46059","Hand County","Hand County, South Dakota","00","46","059",,1840,1543,297
"46061","Hanson County","Hanson County, South Dakota","00","46","061",,1218,1115,103
"46063","Harding County","Harding County, South Dakota","00","46","063",,804,525,279
"46065","Hughes County","Hughes County, South Dakota","00","46","065",,7055,6512,543
"46067","Hutchinson County","Hutchinson County, South Dakota","00","46","067",,3517,3190,327
"46069","Hyde County","Hyde County, South Dakota","00","46","069",,769,679,90
"46071","Jackson County","Jackson County, South Dakota","00","46","071",,1173,945,228
"46073","Jerauld County","Jerauld County, South Dakota","00","46","073",,1167,987,180
"46075","Jones County","Jones County, South Dakota","00","46","075",,614,509,105
"46077","Kingsbury County","Kingsbury County, South Dakota","00","46","077",,2724,2406,318
"46079","Lake County","Lake County, South Dakota","00","46","079",,5282,4372,910
"46081","Lawrence County","Lawrence County, South Dakota","00","46","081",,10427,8881,1546
"46083","Lincoln County","Lincoln County, South Dakota","00","46","083",,9131,8782,349
"46085","Lyman County","Lyman County, South Dakota","00","46","085",,1636,1400,236
"46087","McCook County","McCook County, South Dakota","00","46","087",,2383,2204,179
"46089","McPherson County","McPherson County, South Dakota","00","46","089",,1465,1227,238
"46091","Marshall County","Marshall County, South Dakota","00","46","091",,2562,1844,718
"46093","Meade County","Meade County, South Dakota","00","46","093",,10149,8805,1344
"46095","Mellette County","Mellette County, South Dakota","00","46","095",,824,694,130
"46097","Miner County","Miner County, South Dakota","00","46","097",,1408,1212,196
"46099","Minnehaha County","Minnehaha County, South Dakota","00","46","099",,60237,57996,2241
"46101","Moody County","Moody County, South Dakota","00","46","101",,2745,2526,219
"46103","Pennington County","Pennington County, South Dakota","00","46","103",,37249,34641,2608
"46105","Perkins County","Perkins County, South Dakota","00","46","105",,1854,1429,425
"46107","Potter County","Potter County, South Dakota","00","46","107",,1760,1145,615
"46109","Roberts County","Roberts County, South Dakota","00","46","109",,4734,3683,1051
"46111","Sanborn County","Sanborn County, South Dakota","00","46","111",,1220,1043,177
"46113","Shannon County","Shannon County, South Dakota","00","46","113",,3123,2785,338
"46115","Spink County","Spink County, South Dakota","00","46","115",,3352,2847,505
"46117","Stanley County","Stanley County, South Dakota","00","46","117",,1277,1111,166
"46119","Sully County","Sully County, South Dakota","00","46","119",,844,630,214
"46121","Todd County","Todd County, South Dakota","00","46","121",,2766,2462,304
"46123","Tripp County","Tripp County, South Dakota","00","46","123",,3036,2550,486
"46125","Turner County","Turner County, South Dakota","00","46","125",,3852,3510,342
"46127","Union County","Union County, South Dakota","00","46","127",,5345,4927,418
"46129","Walworth County","Walworth County, South Dakota","00","46","129",,3144,2506,638
"46135","Yankton County","Yankton County, South Dakota","00","46","135",,8840,8187,653
"46137","Ziebach County","Ziebach County, South Dakota","00","46","137",,879,741,138
"47001","Anderson County","Anderson County, Tennessee","00","47","001",,32451,29780,2671
"47003","Bedford County","Bedford County, Tennessee","00","47","003",,14990,13905,1085
"47005","Benton County","Benton County, Tennessee","00","47","005",,8595,6863,1732
"47007","Bledsoe County","Bledsoe County, Tennessee","00","47","007",,5142,4430,712
"47009","Blount County","Blount County, Tennessee","00","47","009",,47059,42667,4392
"47011","Bradley County","Bradley County, Tennessee","00","47","011",,36820,34281,2539
"47013","Campbell County","Campbell County, Tennessee","00","47","013",,18527,16125,2402
"47015","Cannon County","Cannon County, Tennessee","00","47","015",,5420,4998,422
"47017","Carroll County","Carroll County, Tennessee","00","47","017",,13057,11779,1278
"47019","Carter County","Carter County, Tennessee","00","47","019",,25920,23486,2434
"47021","Cheatham County","Cheatham County, Tennessee","00","47","021",,13508,12878,630
"47023","Chester County","Chester County, Tennessee","00","47","023",,6178,5660,518
"47025","Claiborne County","Claiborne County, Tennessee","00","47","025",,13262,11799,1463
"47027","Clay County","Clay County, Tennessee","00","47","027",,3959,3379,580
"47029","Cocke County","Cocke County, Tennessee","00","47","029",,15844,13762,2082
"47031","Coffee County","Coffee County, Tennessee","00","47","031",,20746,18885,1861
"47033","Crockett County","Crockett County, Tennessee","00","47","033",,6138,5632,506
"47035","Cumberland County","Cumberland County, Tennessee","00","47","035",,22442,19508,2934
"47037","Davidson County","Davidson County, Tennessee","00","47","037",,252977,237405,15572
"47039","Decatur County","Decatur County, Tennessee","00","47","039",,6448,4908,1540
"47041","DeKalb County","DeKalb County, Tennessee","00","47","041",,8409,6984,1425
"47043","Dickson County","Dickson County, Tennessee","00","47","043",,17614,16473,1141
"47045","Dyer County","Dyer County, Tennessee","00","47","045",,16123,14751,1372
"47047","Fayette County","Fayette County, Tennessee","00","47","047",,11214,10467,747
"47049","Fentress County","Fentress County, Tennessee","00","47","049",,7598,6693,905
"47051","Franklin County","Franklin County, Tennessee","00","47","051",,16813,15003,1810
"47053","Gibson County","Gibson County, Tennessee","00","47","053",,21059,19518,1541
"47055","Giles County","Giles County, Tennessee","00","47","055",,13113,11713,1400
"47057","Grainger County","Grainger County, Tennessee","00","47","057",,9732,8270,1462
"47059","Greene County","Greene County, Tennessee","00","47","059",,28116,25756,2360
"47061","Grundy County","Grundy County, Tennessee","00","47","061",,6282,5562,720
"47063","Hamblen County","Hamblen County, Tennessee","00","47","063",,24693,23211,1482
"47065","Hamilton County","Hamilton County, Tennessee","00","47","065",,134692,124444,10248
"47067","Hancock County","Hancock County, Tennessee","00","47","067",,3280,2769,511
"47069","Hardeman County","Hardeman County, Tennessee","00","47","069",,10694,9412,1282
"47071","Hardin County","Hardin County, Tennessee","00","47","071",,12807,10426,2381
"47073","Hawkins County","Hawkins County, Tennessee","00","47","073",,24416,21936,2480
"47075","Haywood County","Haywood County, Tennessee","00","47","075",,8086,7558,528
"47077","Henderson County","Henderson County, Tennessee","00","47","077",,11446,10306,1140
"47079","Henry County","Henry County, Tennessee","00","47","079",,15783,13019,2764
"47081","Hickman County","Hickman County, Tennessee","00","47","081",,8904,8081,823
"47083","Houston County","Houston County, Tennessee","00","47","083",,3901,3216,685
"47085","Humphreys County","Humphreys County, Tennessee","00","47","085",,8482,7238,1244
"47087","Jackson County","Jackson County, Tennessee","00","47","087",,5163,4466,697
"47089","Jefferson County","Jefferson County, Tennessee","00","47","089",,19319,17155,2164
"47091","Johnson County","Johnson County, Tennessee","00","47","091",,7879,6827,1052
"47093","Knox County","Knox County, Tennessee","00","47","093",,171439,157872,13567
"47095","Lake County","Lake County, Tennessee","00","47","095",,2716,2410,306
"47097","Lauderdale County","Lauderdale County, Tennessee","00","47","097",,10563,9567,996
"47099","Lawrence County","Lawrence County, Tennessee","00","47","099",,16821,15480,1341
"47101","Lewis County","Lewis County, Tennessee","00","47","101",,4821,4381,440
"47103","Lincoln County","Lincoln County, Tennessee","00","47","103",,13999,12503,1496
"47105","Loudon County","Loudon County, Tennessee","00","47","105",,17277,15944,1333
"47107","McMinn County","McMinn County, Tennessee","00","47","107",,21626,19721,1905
"47109","McNairy County","McNairy County, Tennessee","00","47","109",,11219,9980,1239
"47111","Macon County","Macon County, Tennessee","00","47","111",,8894,7916,978
"47113","Madison County","Madison County, Tennessee","00","47","113",,38205,35552,2653
"47115","Marion County","Marion County, Tennessee","00","47","115",,12140,11037,1103
"47117","Marshall County","Marshall County, Tennessee","00","47","117",,11181,10307,874
"47119","Maury County","Maury County, Tennessee","00","47","119",,28674,26444,2230
"47121","Meigs County","Meigs County, Tennessee","00","47","121",,5188,4304,884
"47123","Monroe County","Monroe County, Tennessee","00","47","123",,17287,15329,1958
"47125","Montgomery County","Montgomery County, Tennessee","00","47","125",,52167,48330,3837
"47127","Moore County","Moore County, Tennessee","00","47","127",,2515,2211,304
"47129","Morgan County","Morgan County, Tennessee","00","47","129",,7714,6990,724
"47131","Obion County","Obion County, Tennessee","00","47","131",,14489,13182,1307
"47133","Overton County","Overton County, Tennessee","00","47","133",,9168,8110,1058
"47135","Perry County","Perry County, Tennessee","00","47","135",,4115,3023,1092
"47137","Pickett County","Pickett County, Tennessee","00","47","137",,2956,2091,865
"47139","Polk County","Polk County, Tennessee","00","47","139",,7369,6448,921
"47141","Putnam County","Putnam County, Tennessee","00","47","141",,26916,24865,2051
"47143","Rhea County","Rhea County, Tennessee","00","47","143",,12565,11184,1381
"47145","Roane County","Roane County, Tennessee","00","47","145",,23369,21200,2169
"47147","Robertson County","Robertson County, Tennessee","00","47","147",,20995,19906,1089
"47149","Rutherford County","Rutherford County, Tennessee","00","47","149",,70616,66443,4173
"47151","Scott County","Scott County, Tennessee","00","47","151",,8909,8203,706
"47153","Sequatchie County","Sequatchie County, Tennessee","00","47","153",,4916,4463,453
"47155","Sevier County","Sevier County, Tennessee","00","47","155",,37252,28467,8785
"47157","Shelby County","Shelby County, Tennessee","00","47","157",,362954,338366,24588
"47159","Smith County","Smith County, Tennessee","00","47","159",,7665,6878,787
"47161","Stewart County","Stewart County, Tennessee","00","47","161",,5977,4930,1047
"47163","Sullivan County","Sullivan County, Tennessee","00","47","163",,69052,63556,5496
"47165","Sumner County","Sumner County, Tennessee","00","47","165",,51657,48941,2716
"47167","Tipton County","Tipton County, Tennessee","00","47","167",,19064,18106,958
"47169","Trousdale County","Trousdale County, Tennessee","00","47","169",,3095,2780,315
"47171","Unicoi County","Unicoi County, Tennessee","00","47","171",,8214,7516,698
"47173","Union County","Union County, Tennessee","00","47","173",,7916,6742,1174
"47175","Van Buren County","Van Buren County, Tennessee","00","47","175",,2453,2180,273
"47177","Warren County","Warren County, Tennessee","00","47","177",,16689,15181,1508
"47179","Washington County","Washington County, Tennessee","00","47","179",,47779,44195,3584
"47181","Wayne County","Wayne County, Tennessee","00","47","181",,6701,5936,765
"47183","Weakley County","Weakley County, Tennessee","00","47","183",,14928,13599,1329
"47185","White County","White County, Tennessee","00","47","185",,10191,9229,962
"47187","Williamson County","Williamson County, Tennessee","00","47","187",,47005,44725,2280
"47189","Wilson County","Wilson County, Tennessee","00","47","189",,34921,32798,2123
"48001","Anderson County","Anderson County, Texas","00","48","001",,18436,15678,2758
"48003","Andrews County","Andrews County, Texas","00","48","003",,5400,4601,799
"48005","Angelina County","Angelina County, Texas","00","48","005",,32435,28685,3750
"48007","Aransas County","Aransas County, Texas","00","48","007",,12848,9132,3716
"48009","Archer County","Archer County, Texas","00","48","009",,3871,3345,526
"48011","Armstrong County","Armstrong County, Texas","00","48","011",,920,802,118
"48013","Atascosa County","Atascosa County, Texas","00","48","013",,14883,12816,2067
"48015","Austin County","Austin County, Texas","00","48","015",,10205,8747,1458
"48017","Bailey County","Bailey County, Texas","00","48","017",,2738,2348,390
"48019","Bandera County","Bandera County, Texas","00","48","019",,9503,7010,2493
"48021","Bastrop County","Bastrop County, Texas","00","48","021",,22254,20097,2157
"48023","Baylor County","Baylor County, Texas","00","48","023",,2820,1791,1029
"48025","Bee County","Bee County, Texas","00","48","025",,10939,9061,1878
"48027","Bell County","Bell County, Texas","00","48","027",,92782,85507,7275
"48029","Bexar County","Bexar County, Texas","00","48","029",,521359,488942,32417
"48031","Blanco County","Blanco County, Texas","00","48","031",,4031,3303,728
"48033","Borden County","Borden County, Texas","00","48","033",,435,292,143
"48035","Bosque County","Bosque County, Texas","00","48","035",,8644,6726,1918
"48037","Bowie County","Bowie County, Texas","00","48","037",,36463,33058,3405
"48039","Brazoria County","Brazoria County, Texas","00","48","039",,90628,81954,8674
"48041","Brazos County","Brazos County, Texas","00","48","041",,59023,55202,3821
"48043","Brewster County","Brewster County, Texas","00","48","043",,4614,3669,945
"48045","Briscoe County","Briscoe County, Texas","00","48","045",,1006,724,282
"48047","Brooks County","Brooks County, Texas","00","48","047",,3203,2711,492
"48049","Brown County","Brown County, Texas","00","48","049",,17889,14306,3583
"48051","Burleson County","Burleson County, Texas","00","48","051",,8197,6363,1834
"48053","Burnet County","Burnet County, Texas","00","48","053",,15933,13133,2800
"48055","Caldwell County","Caldwell County, Texas","00","48","055",,11901,10816,1085
"48057","Calhoun County","Calhoun County, Texas","00","48","057",,10238,7442,2796
"48059","Callahan County","Callahan County, Texas","00","48","059",,5925,5061,864
"48061","Cameron County","Cameron County, Texas","00","48","061",,119654,97267,22387
"48063","Camp County","Camp County, Texas","00","48","063",,5228,4336,892
"48065","Carson County","Carson County, Texas","00","48","065",,2815,2470,345
"48067","Cass County","Cass County, Texas","00","48","067",,13890,12190,1700
"48069","Castro County","Castro County, Texas","00","48","069",,3198,2761,437
"48071","Chambers County","Chambers County, Texas","00","48","071",,10336,9139,1197
"48073","Cherokee County","Cherokee County, Texas","00","48","073",,19173,16651,2522
"48075","Childress County","Childress County, Texas","00","48","075",,3059,2474,585
"48077","Clay County","Clay County, Texas","00","48","077",,4992,4323,669
"48079","Cochran County","Cochran County, Texas","00","48","079",,1587,1309,278
"48081","Coke County","Coke County, Texas","00","48","081",,2843,1544,1299
"48083","Coleman County","Coleman County, Texas","00","48","083",,5248,3889,1359
"48085","Collin County","Collin County, Texas","00","48","085",,194892,181970,12922
"48087","Collingsworth County","Collingsworth County, Texas","00","48","087",,1723,1294,429
"48089","Colorado County","Colorado County, Texas","00","48","089",,9431,7641,1790
"48091","Comal County","Comal County, Texas","00","48","091",,32718,29066,3652
"48093","Comanche County","Comanche County, Texas","00","48","093",,7105,5522,1583
"48095","Concho County","Concho County, Texas","00","48","095",,1488,1058,430
"48097","Cooke County","Cooke County, Texas","00","48","097",,15061,13643,1418
"48099","Coryell County","Coryell County, Texas","00","48","099",,21776,19950,1826
"48101","Cottle County","Cottle County, Texas","00","48","101",,1088,820,268
"48103","Crane County","Crane County, Texas","00","48","103",,1596,1360,236
"48105","Crockett County","Crockett County, Texas","00","48","105",,2049,1524,525
"48107","Crosby County","Crosby County, Texas","00","48","107",,3202,2512,690
"48109","Culberson County","Culberson County, Texas","00","48","109",,1321,1052,269
"48111","Dallam County","Dallam County, Texas","00","48","111",,2697,2317,380
"48113","Dallas County","Dallas County, Texas","00","48","113",,854119,807621,46498
"48115","Dawson County","Dawson County, Texas","00","48","115",,5500,4726,774
"48117","Deaf Smith County","Deaf Smith County, Texas","00","48","117",,6914,6180,734
"48119","Delta County","Delta County, Texas","00","48","119",,2410,2094,316
"48121","Denton County","Denton County, Texas","00","48","121",,168069,158903,9166
"48123","DeWitt County","DeWitt County, Texas","00","48","123",,8756,7207,1549
"48125","Dickens County","Dickens County, Texas","00","48","125",,1368,980,388
"48127","Dimmit County","Dimmit County, Texas","00","48","127",,4112,3308,804
"48129","Donley County","Donley County, Texas","00","48","129",,2378,1578,800
"48131","Duval County","Duval County, Texas","00","48","131",,5543,4350,1193
"48133","Eastland County","Eastland County, Texas","00","48","133",,9547,7321,2226
"48135","Ector County","Ector County, Texas","00","48","135",,49500,43846,5654
"48137","Edwards County","Edwards County, Texas","00","48","137",,1217,801,416
"48139","Ellis County","Ellis County, Texas","00","48","139",,39071,37020,2051
"48141","El Paso County","El Paso County, Texas","00","48","141",,224447,210022,14425
"48143","Erath County","Erath County, Texas","00","48","143",,14422,12568,1854
"48145","Falls County","Falls County, Texas","00","48","145",,7658,6496,1162
"48147","Fannin County","Fannin County, Texas","00","48","147",,12887,11105,1782
"48149","Fayette County","Fayette County, Texas","00","48","149",,11113,8722,2391
"48151","Fisher County","Fisher County, Texas","00","48","151",,2277,1785,492
"48153","Floyd County","Floyd County, Texas","00","48","153",,3221,2730,491
"48155","Foard County","Foard County, Texas","00","48","155",,850,664,186
"48157","Fort Bend County","Fort Bend County, Texas","00","48","157",,115991,110915,5076
"48159","Franklin County","Franklin County, Texas","00","48","159",,5132,3754,1378
"48161","Freestone County","Freestone County, Texas","00","48","161",,8138,6588,1550
"48163","Frio County","Frio County, Texas","00","48","163",,5660,4743,917
"48165","Gaines County","Gaines County, Texas","00","48","165",,5410,4681,729
"48167","Galveston County","Galveston County, Texas","00","48","167",,111733,94782,16951
"48169","Garza County","Garza County, Texas","00","48","169",,1928,1663,265
"48171","Gillespie County","Gillespie County, Texas","00","48","171",,9902,8521,1381
"48173","Glasscock County","Glasscock County, Texas","00","48","173",,660,483,177
"48175","Goliad County","Goliad County, Texas","00","48","175",,3426,2644,782
"48177","Gonzales County","Gonzales County, Texas","00","48","177",,8194,6782,1412
"48179","Gray County","Gray County, Texas","00","48","179",,10567,8793,1774
"48181","Grayson County","Grayson County, Texas","00","48","181",,48315,42849,5466
"48183","Gregg County","Gregg County, Texas","00","48","183",,46349,42687,3662
"48185","Grimes County","Grimes County, Texas","00","48","185",,9490,7753,1737
"48187","Guadalupe County","Guadalupe County, Texas","00","48","187",,33585,30900,2685
"48189","Hale County","Hale County, Texas","00","48","189",,13526,11975,1551
"48191","Hall County","Hall County, Texas","00","48","191",,1988,1548,440
"48193","Hamilton County","Hamilton County, Texas","00","48","193",,4455,3374,1081
"48195","Hansford County","Hansford County, Texas","00","48","195",,2329,2005,324
"48197","Hardeman County","Hardeman County, Texas","00","48","197",,2358,1943,415
"48199","Hardin County","Hardin County, Texas","00","48","199",,19836,17805,2031
"48201","Harris County","Harris County, Texas","00","48","201",,1298130,1205516,92614
"48203","Harrison County","Harrison County, Texas","00","48","203",,26271,23087,3184
"48205","Hartley County","Hartley County, Texas","00","48","205",,1760,1604,156
"48207","Haskell County","Haskell County, Texas","00","48","207",,3555,2569,986
"48209","Hays County","Hays County, Texas","00","48","209",,35643,33410,2233
"48211","Hemphill County","Hemphill County, Texas","00","48","211",,1548,1280,268
"48213","Henderson County","Henderson County, Texas","00","48","213",,35935,28804,7131
"48215","Hidalgo County","Hidalgo County, Texas","00","48","215",,192658,156824,35834
"48217","Hill County","Hill County, Texas","00","48","217",,14624,12204,2420
"48219","Hockley County","Hockley County, Texas","00","48","219",,9148,7994,1154
"48221","Hood County","Hood County, Texas","00","48","221",,19105,16176,2929
"48223","Hopkins County","Hopkins County, Texas","00","48","223",,14020,12286,1734
"48225","Houston County","Houston County, Texas","00","48","225",,10730,8259,2471
"48227","Howard County","Howard County, Texas","00","48","227",,13589,11389,2200
"48229","Hudspeth County","Hudspeth County, Texas","00","48","229",,1471,1092,379
"48231","Hunt County","Hunt County, Texas","00","48","231",,32490,28742,3748
"48233","Hutchinson County","Hutchinson County, Texas","00","48","233",,10871,9283,1588
"48235","Irion County","Irion County, Texas","00","48","235",,914,694,220
"48237","Jack County","Jack County, Texas","00","48","237",,3668,3047,621
"48239","Jackson County","Jackson County, Texas","00","48","239",,6545,5336,1209
"48241","Jasper County","Jasper County, Texas","00","48","241",,16576,13450,3126
"48243","Jeff Davis County","Jeff Davis County, Texas","00","48","243",,1420,896,524
"48245","Jefferson County","Jefferson County, Texas","00","48","245",,102080,92880,9200
"48247","Jim Hogg County","Jim Hogg County, Texas","00","48","247",,2308,1815,493
"48249","Jim Wells County","Jim Wells County, Texas","00","48","249",,14819,12961,1858
"48251","Johnson County","Johnson County, Texas","00","48","251",,46269,43636,2633
"48253","Jones County","Jones County, Texas","00","48","253",,7236,6140,1096
"48255","Karnes County","Karnes County, Texas","00","48","255",,5479,4454,1025
"48257","Kaufman County","Kaufman County, Texas","00","48","257",,26133,24367,1766
"48259","Kendall County","Kendall County, Texas","00","48","259",,9609,8613,996
"48261","Kenedy County","Kenedy County, Texas","00","48","261",,281,138,143
"48263","Kent County","Kent County, Texas","00","48","263",,551,353,198
"48265","Kerr County","Kerr County, Texas","00","48","265",,20228,17813,2415
"48267","Kimble County","Kimble County, Texas","00","48","267",,2996,1866,1130
"48269","King County","King County, Texas","00","48","269",,174,108,66
"48271","Kinney County","Kinney County, Texas","00","48","271",,1907,1314,593
"48273","Kleberg County","Kleberg County, Texas","00","48","273",,12743,10896,1847
"48275","Knox County","Knox County, Texas","00","48","275",,2129,1690,439
"48277","Lamar County","Lamar County, Texas","00","48","277",,21113,19077,2036
"48279","Lamb County","Lamb County, Texas","00","48","279",,6294,5360,934
"48281","Lampasas County","Lampasas County, Texas","00","48","281",,7601,6554,1047
"48283","La Salle County","La Salle County, Texas","00","48","283",,2436,1819,617
"48285","Lavaca County","Lavaca County, Texas","00","48","285",,9657,7669,1988
"48287","Lee County","Lee County, Texas","00","48","287",,6851,5663,1188
"48289","Leon County","Leon County, Texas","00","48","289",,8299,6189,2110
"48291","Liberty County","Liberty County, Texas","00","48","291",,26359,23242,3117
"48293","Limestone County","Limestone County, Texas","00","48","293",,9725,7906,1819
"48295","Lipscomb County","Lipscomb County, Texas","00","48","295",,1541,1205,336
"48297","Live Oak County","Live Oak County, Texas","00","48","297",,6196,4230,1966
"48299","Llano County","Llano County, Texas","00","48","299",,11829,7879,3950
"48301","Loving County","Loving County, Texas","00","48","301",,70,31,39
"48303","Lubbock County","Lubbock County, Texas","00","48","303",,100595,92516,8079
"48305","Lynn County","Lynn County, Texas","00","48","305",,2671,2354,317
"48307","McCulloch County","McCulloch County, Texas","00","48","307",,4184,3277,907
"48309","McLennan County","McLennan County, Texas","00","48","309",,84795,78859,5936
"48311","McMullen County","McMullen County, Texas","00","48","311",,587,355,232
"48313","Madison County","Madison County, Texas","00","48","313",,4797,3914,883
"48315","Marion County","Marion County, Texas","00","48","315",,6384,4610,1774
"48317","Martin County","Martin County, Texas","00","48","317",,1898,1624,274
"48319","Mason County","Mason County, Texas","00","48","319",,2372,1607,765
"48321","Matagorda County","Matagorda County, Texas","00","48","321",,18611,13901,4710
"48323","Maverick County","Maverick County, Texas","00","48","323",,14889,13089,1800
"48325","Medina County","Medina County, Texas","00","48","325",,14826,12880,1946
"48327","Menard County","Menard County, Texas","00","48","327",,1607,990,617
"48329","Midland County","Midland County, Texas","00","48","329",,48060,42745,5315
"48331","Milam County","Milam County, Texas","00","48","331",,10866,9199,1667
"48333","Mills County","Mills County, Texas","00","48","333",,2691,2001,690
"48335","Mitchell County","Mitchell County, Texas","00","48","335",,4168,2837,1331
"48337","Montague County","Montague County, Texas","00","48","337",,9862,7770,2092
"48339","Montgomery County","Montgomery County, Texas","00","48","339",,112770,103296,9474
"48341","Moore County","Moore County, Texas","00","48","341",,7478,6774,704
"48343","Morris County","Morris County, Texas","00","48","343",,6017,5215,802
"48345","Motley County","Motley County, Texas","00","48","345",,839,606,233
"48347","Nacogdoches County","Nacogdoches County, Texas","00","48","347",,25051,22006,3045
"48349","Navarro County","Navarro County, Texas","00","48","349",,18449,16491,1958
"48351","Newton County","Newton County, Texas","00","48","351",,7331,5583,1748
"48353","Nolan County","Nolan County, Texas","00","48","353",,7112,6170,942
"48355","Nueces County","Nueces County, Texas","00","48","355",,123041,110365,12676
"48357","Ochiltree County","Ochiltree County, Texas","00","48","357",,3769,3261,508
"48359","Oldham County","Oldham County, Texas","00","48","359",,815,735,80
"48361","Orange County","Orange County, Texas","00","48","361",,34781,31642,3139
"48363","Palo Pinto County","Palo Pinto County, Texas","00","48","363",,14102,10594,3508
"48365","Panola County","Panola County, Texas","00","48","365",,10524,8821,1703
"48367","Parker County","Parker County, Texas","00","48","367",,34084,31131,2953
"48369","Parmer County","Parmer County, Texas","00","48","369",,3732,3322,410
"48371","Pecos County","Pecos County, Texas","00","48","371",,6338,5153,1185
"48373","Polk County","Polk County, Texas","00","48","373",,21177,15119,6058
"48375","Potter County","Potter County, Texas","00","48","375",,44598,40760,3838
"48377","Presidio County","Presidio County, Texas","00","48","377",,3299,2530,769
"48379","Rains County","Rains County, Texas","00","48","379",,4523,3617,906
"48381","Randall County","Randall County, Texas","00","48","381",,43261,41240,2021
"48383","Reagan County","Reagan County, Texas","00","48","383",,1452,1107,345
"48385","Real County","Real County, Texas","00","48","385",,2007,1245,762
"48387","Red River County","Red River County, Texas","00","48","387",,6916,5827,1089
"48389","Reeves County","Reeves County, Texas","00","48","389",,5043,4091,952
"48391","Refugio County","Refugio County, Texas","00","48","391",,3669,2985,684
"48393","Roberts County","Roberts County, Texas","00","48","393",,449,362,87
"48395","Robertson County","Robertson County, Texas","00","48","395",,7874,6179,1695
"48397","Rockwall County","Rockwall County, Texas","00","48","397",,15351,14530,821
"48399","Runnels County","Runnels County, Texas","00","48","399",,5400,4428,972
"48401","Rusk County","Rusk County, Texas","00","48","401",,19867,17364,2503
"48403","Sabine County","Sabine County, Texas","00","48","403",,7659,4485,3174
"48405","San Augustine County","San Augustine County, Texas","00","48","405",,5356,3575,1781
"48407","San Jacinto County","San Jacinto County, Texas","00","48","407",,11520,8651,2869
"48409","San Patricio County","San Patricio County, Texas","00","48","409",,24864,22093,2771
"48411","San Saba County","San Saba County, Texas","00","48","411",,2951,2289,662
"48413","Schleicher County","Schleicher County, Texas","00","48","413",,1371,1115,256
"48415","Scurry County","Scurry County, Texas","00","48","415",,7112,5756,1356
"48417","Shackelford County","Shackelford County, Texas","00","48","417",,1613,1300,313
"48419","Shelby County","Shelby County, Texas","00","48","419",,11955,9595,2360
"48421","Sherman County","Sherman County, Texas","00","48","421",,1275,1124,151
"48423","Smith County","Smith County, Texas","00","48","423",,71701,65692,6009
"48425","Somervell County","Somervell County, Texas","00","48","425",,2750,2438,312
"48427","Starr County","Starr County, Texas","00","48","427",,17589,14410,3179
"48429","Stephens County","Stephens County, Texas","00","48","429",,4893,3661,1232
"48431","Sterling County","Sterling County, Texas","00","48","431",,633,513,120
"48433","Stonewall County","Stonewall County, Texas","00","48","433",,936,713,223
"48435","Sutton County","Sutton County, Texas","00","48","435",,1998,1515,483
"48437","Swisher County","Swisher County, Texas","00","48","437",,3315,2925,390
"48439","Tarrant County","Tarrant County, Texas","00","48","439",,565830,533864,31966
"48441","Taylor County","Taylor County, Texas","00","48","441",,52056,47274,4782
"48443","Terrell County","Terrell County, Texas","00","48","443",,991,443,548
"48445","Terry County","Terry County, Texas","00","48","445",,5087,4278,809
"48447","Throckmorton County","Throckmorton County, Texas","00","48","447",,1066,765,301
"48449","Titus County","Titus County, Texas","00","48","449",,10675,9552,1123
"48451","Tom Green County","Tom Green County, Texas","00","48","451",,43916,39503,4413
"48453","Travis County","Travis County, Texas","00","48","453",,335881,320766,15115
"48455","Trinity County","Trinity County, Texas","00","48","455",,8141,5723,2418
"48457","Tyler County","Tyler County, Texas","00","48","457",,10419,7775,2644
"48459","Upshur County","Upshur County, Texas","00","48","459",,14930,13290,1640
"48461","Upton County","Upton County, Texas","00","48","461",,1609,1256,353
"48463","Uvalde County","Uvalde County, Texas","00","48","463",,10166,8559,1607
"48465","Val Verde County","Val Verde County, Texas","00","48","465",,16288,14151,2137
"48467","Van Zandt County","Van Zandt County, Texas","00","48","467",,20896,18195,2701
"48469","Victoria County","Victoria County, Texas","00","48","469",,32945,30071,2874
"48471","Walker County","Walker County, Texas","00","48","471",,21099,18303,2796
"48473","Waller County","Waller County, Texas","00","48","473",,11955,10557,1398
"48475","Ward County","Ward County, Texas","00","48","475",,4832,3964,868
"48477","Washington County","Washington County, Texas","00","48","477",,13241,11322,1919
"48479","Webb County","Webb County, Texas","00","48","479",,55206,50740,4466
"48481","Wharton County","Wharton County, Texas","00","48","481",,16606,14799,1807
"48483","Wheeler County","Wheeler County, Texas","00","48","483",,2687,2152,535
"48485","Wichita County","Wichita County, Texas","00","48","485",,53304,48441,4863
"48487","Wilbarger County","Wilbarger County, Texas","00","48","487",,6371,5537,834
"48489","Willacy County","Willacy County, Texas","00","48","489",,6727,5584,1143
"48491","Williamson County","Williamson County, Texas","00","48","491",,90325,86766,3559
"48493","Wilson County","Wilson County, Texas","00","48","493",,12110,11038,1072
"48495","Winkler County","Winkler County, Texas","00","48","495",,3214,2584,630
"48497","Wise County","Wise County, Texas","00","48","497",,19242,17178,2064
"48499","Wood County","Wood County, Texas","00","48","499",,17939,14583,3356
"48501","Yoakum County","Yoakum County, Texas","00","48","501",,2974,2469,505
"48503","Young County","Young County, Texas","00","48","503",,8504,7167,1337
"48505","Zapata County","Zapata County, Texas","00","48","505",,6167,3921,2246
"48507","Zavala County","Zavala County, Texas","00","48","507",,4075,3428,647
"49001","Beaver County","Beaver County, Utah","00","49","001",,2660,1982,678
"49003","Box Elder County","Box Elder County, Utah","00","49","003",,14209,13144,1065
"49005","Cache County","Cache County, Utah","00","49","005",,29035,27543,1492
"49007","Carbon County","Carbon County, Utah","00","49","007",,8741,7413,1328
"49009","Daggett County","Daggett County, Utah","00","49","009",,1084,340,744
"49011","Davis County","Davis County, Utah","00","49","011",,74114,71201,2913
"49013","Duchesne County","Duchesne County, Utah","00","49","013",,6988,4559,2429
"49015","Emery County","Emery County, Utah","00","49","015",,4093,3468,625
"49017","Garfield County","Garfield County, Utah","00","49","017",,2767,1576,1191
"49019","Grand County","Grand County, Utah","00","49","019",,4062,3434,628
"49021","Iron County","Iron County, Utah","00","49","021",,13618,10627,2991
"49023","Juab County","Juab County, Utah","00","49","023",,2810,2456,354
"49025","Kane County","Kane County, Utah","00","49","025",,3767,2237,1530
"49027","Millard County","Millard County, Utah","00","49","027",,4522,3840,682
"49029","Morgan County","Morgan County, Utah","00","49","029",,2158,2046,112
"49031","Piute County","Piute County, Utah","00","49","031",,745,509,236
"49033","Rich County","Rich County, Utah","00","49","033",,2408,645,1763
"49035","Salt Lake County","Salt Lake County, Utah","00","49","035",,310988,295141,15847
"49037","San Juan County","San Juan County, Utah","00","49","037",,5449,4089,1360
"49039","Sanpete County","Sanpete County, Utah","00","49","039",,7879,6547,1332
"49041","Sevier County","Sevier County, Utah","00","49","041",,7016,6081,935
"49043","Summit County","Summit County, Utah","00","49","043",,17489,10332,7157
"49045","Tooele County","Tooele County, Utah","00","49","045",,13812,12677,1135
"49047","Uintah County","Uintah County, Utah","00","49","047",,9040,8187,853
"49049","Utah County","Utah County, Utah","00","49","049",,104315,99937,4378
"49051","Wasatch County","Wasatch County, Utah","00","49","051",,6564,4743,1821
"49053","Washington County","Washington County, Utah","00","49","053",,36478,29939,6539
"49055","Wayne County","Wayne County, Utah","00","49","055",,1329,890,439
"49057","Weber County","Weber County, Utah","00","49","057",,70454,65698,4756
"50001","Addison County","Addison County, Vermont","00","50","001",,15312,13068,2244
"50003","Bennington County","Bennington County, Vermont","00","50","003",,19403,14846,4557
"50005","Caledonia County","Caledonia County, Vermont","00","50","005",,14504,11663,2841
"50007","Chittenden County","Chittenden County, Vermont","00","50","007",,58864,56452,2412
"50009","Essex County","Essex County, Vermont","00","50","009",,4762,2602,2160
"50011","Franklin County","Franklin County, Vermont","00","50","011",,19191,16765,2426
"50013","Grand Isle County","Grand Isle County, Vermont","00","50","013",,4663,2761,1902
"50015","Lamoille County","Lamoille County, Vermont","00","50","015",,11009,9221,1788
"50017","Orange County","Orange County, Vermont","00","50","017",,13386,10936,2450
"50019","Orleans County","Orleans County, Vermont","00","50","019",,14673,10446,4227
"50021","Rutland County","Rutland County, Vermont","00","50","021",,32311,25678,6633
"50023","Washington County","Washington County, Vermont","00","50","023",,27644,23659,3985
"50025","Windham County","Windham County, Vermont","00","50","025",,27039,18375,8664
"50027","Windsor County","Windsor County, Vermont","00","50","027",,31621,24162,7459
"51001","Accomack County","Accomack County, Virginia","00","51","001",,19550,15299,4251
"51003","Albemarle County","Albemarle County, Virginia","00","51","003",,33720,31876,1844
"51005","Alleghany County","Alleghany County, Virginia","00","51","005",,7881,6990,891
"51007","Amelia County","Amelia County, Virginia","00","51","007",,4609,4240,369
"51009","Amherst County","Amherst County, Virginia","00","51","009",,12958,11941,1017
"51011","Appomattox County","Appomattox County, Virginia","00","51","011",,5828,5322,506
"51013","Arlington County","Arlington County, Virginia","00","51","013",,90426,86352,4074
"51015","Augusta County","Augusta County, Virginia","00","51","015",,26738,24818,1920
"51017","Bath County","Bath County, Virginia","00","51","017",,2896,2053,843
"51019","Bedford County","Bedford County, Virginia","00","51","019",,26841,23838,3003
"51021","Bland County","Bland County, Virginia","00","51","021",,3161,2568,593
"51023","Botetourt County","Botetourt County, Virginia","00","51","023",,12571,11700,871
"51025","Brunswick County","Brunswick County, Virginia","00","51","025",,7541,6277,1264
"51027","Buchanan County","Buchanan County, Virginia","00","51","027",,11887,10464,1423
"51029","Buckingham County","Buckingham County, Virginia","00","51","029",,6290,5324,966
"51031","Campbell County","Campbell County, Virginia","00","51","031",,22088,20639,1449
"51033","Caroline County","Caroline County, Virginia","00","51","033",,8889,8021,868
"51035","Carroll County","Carroll County, Virginia","00","51","035",,14680,12186,2494
"51036","Charles City County","Charles City County, Virginia","00","51","036",,2895,2670,225
"51037","Charlotte County","Charlotte County, Virginia","00","51","037",,5734,4951,783
"51041","Chesterfield County","Chesterfield County, Virginia","00","51","041",,97707,93772,3935
"51043","Clarke County","Clarke County, Virginia","00","51","043",,5388,4942,446
"51045","Craig County","Craig County, Virginia","00","51","045",,2554,2060,494
"51047","Culpeper County","Culpeper County, Virginia","00","51","047",,12871,12141,730
"51049","Cumberland County","Cumberland County, Virginia","00","51","049",,4085,3528,557
"51051","Dickenson County","Dickenson County, Virginia","00","51","051",,7684,6732,952
"51053","Dinwiddie County","Dinwiddie County, Virginia","00","51","053",,9707,9107,600
"51057","Essex County","Essex County, Virginia","00","51","057",,4926,3995,931
"51059","Fairfax County","Fairfax County, Virginia","00","51","059",,359411,350714,8697
"51061","Fauquier County","Fauquier County, Virginia","00","51","061",,21046,19842,1204
"51063","Floyd County","Floyd County, Virginia","00","51","063",,6763,5791,972
"51065","Fluvanna County","Fluvanna County, Virginia","00","51","065",,8018,7387,631
"51067","Franklin County","Franklin County, Virginia","00","51","067",,22717,18963,3754
"51069","Frederick County","Frederick County, Virginia","00","51","069",,23319,22097,1222
"51071","Giles County","Giles County, Virginia","00","51","071",,7732,6994,738
"51073","Gloucester County","Gloucester County, Virginia","00","51","073",,14494,13127,1367
"51075","Goochland County","Goochland County, Virginia","00","51","075",,6555,6158,397
"51077","Grayson County","Grayson County, Virginia","00","51","077",,9123,7259,1864
"51079","Greene County","Greene County, Virginia","00","51","079",,5986,5574,412
"51081","Greensville County","Greensville County, Virginia","00","51","081",,3765,3375,390
"51083","Halifax County","Halifax County, Virginia","00","51","083",,16953,15018,1935
"51085","Hanover County","Hanover County, Virginia","00","51","085",,32196,31121,1075
"51087","Henrico County","Henrico County, Virginia","00","51","087",,112570,108121,4449
"51089","Henry County","Henry County, Virginia","00","51","089",,25921,23910,2011
"51091","Highland County","Highland County, Virginia","00","51","091",,1822,1131,691
"51093","Isle of Wight County","Isle of Wight County, Virginia","00","51","093",,12066,11319,747
"51095","James City County","James City County, Virginia","00","51","095",,20772,19003,1769
"51097","King and Queen County","King and Queen County, Virginia","00","51","097",,3010,2673,337
"51099","King George County","King George County, Virginia","00","51","099",,6820,6091,729
"51101","King William County","King William County, Virginia","00","51","101",,5189,4846,343
"51103","Lancaster County","Lancaster County, Virginia","00","51","103",,6498,5004,1494
"51105","Lee County","Lee County, Virginia","00","51","105",,11086,9706,1380
"51107","Loudoun County","Loudoun County, Virginia","00","51","107",,62160,59900,2260
"51109","Louisa County","Louisa County, Virginia","00","51","109",,11855,9945,1910
"51111","Lunenburg County","Lunenburg County, Virginia","00","51","111",,5736,4998,738
"51113","Madison County","Madison County, Virginia","00","51","113",,5239,4739,500
"51115","Mathews County","Mathews County, Virginia","00","51","115",,5333,3932,1401
"51117","Mecklenburg County","Mecklenburg County, Virginia","00","51","117",,17403,12951,4452
"51119","Middlesex County","Middlesex County, Virginia","00","51","119",,6362,4253,2109
"51121","Montgomery County","Montgomery County, Virginia","00","51","121",,32527,30997,1530
"51125","Nelson County","Nelson County, Virginia","00","51","125",,8554,5887,2667
"51127","New Kent County","New Kent County, Virginia","00","51","127",,5203,4925,278
"51131","Northampton County","Northampton County, Virginia","00","51","131",,6547,5321,1226
"51133","Northumberland County","Northumberland County, Virginia","00","51","133",,8057,5470,2587
"51135","Nottoway County","Nottoway County, Virginia","00","51","135",,6373,5664,709
"51137","Orange County","Orange County, Virginia","00","51","137",,11354,10150,1204
"51139","Page County","Page County, Virginia","00","51","139",,10557,9305,1252
"51141","Patrick County","Patrick County, Virginia","00","51","141",,9823,8141,1682
"51143","Pittsylvania County","Pittsylvania County, Virginia","00","51","143",,28011,24684,3327
"51145","Powhatan County","Powhatan County, Virginia","00","51","145",,7509,7258,251
"51147","Prince Edward County","Prince Edward County, Virginia","00","51","147",,7527,6561,966
"51149","Prince George County","Prince George County, Virginia","00","51","149",,10726,10159,567
"51153","Prince William County","Prince William County, Virginia","00","51","153",,98052,94570,3482
"51155","Pulaski County","Pulaski County, Virginia","00","51","155",,16325,14643,1682
"51157","Rappahannock County","Rappahannock County, Virginia","00","51","157",,3303,2788,515
"51159","Richmond County","Richmond County, Virginia","00","51","159",,3512,2937,575
"51161","Roanoke County","Roanoke County, Virginia","00","51","161",,36121,34686,1435
"51163","Rockbridge County","Rockbridge County, Virginia","00","51","163",,9550,8486,1064
"51165","Rockingham County","Rockingham County, Virginia","00","51","165",,27328,25355,1973
"51167","Russell County","Russell County, Virginia","00","51","167",,13191,11789,1402
"51169","Scott County","Scott County, Virginia","00","51","169",,11355,9795,1560
"51171","Shenandoah County","Shenandoah County, Virginia","00","51","171",,16709,14296,2413
"51173","Smyth County","Smyth County, Virginia","00","51","173",,15111,13493,1618
"51175","Southampton County","Southampton County, Virginia","00","51","175",,7058,6279,779
"51177","Spotsylvania County","Spotsylvania County, Virginia","00","51","177",,33329,31308,2021
"51179","Stafford County","Stafford County, Virginia","00","51","179",,31405,30187,1218
"51181","Surry County","Surry County, Virginia","00","51","181",,3294,2619,675
"51183","Sussex County","Sussex County, Virginia","00","51","183",,4653,4126,527
"51185","Tazewell County","Tazewell County, Virginia","00","51","185",,20390,18277,2113
"51187","Warren County","Warren County, Virginia","00","51","187",,13299,12087,1212
"51191","Washington County","Washington County, Virginia","00","51","191",,22985,21056,1929
"51193","Westmoreland County","Westmoreland County, Virginia","00","51","193",,9286,6846,2440
"51195","Wise County","Wise County, Virginia","00","51","195",,17792,16013,1779
"51197","Wythe County","Wythe County, Virginia","00","51","197",,12744,11511,1233
"51199","York County","York County, Virginia","00","51","199",,20596.5862261,19899.122,697.4642261
"51510","Alexandria city","Alexandria city, Virginia","00","51","510",,64251,61889,2362
"51515","Bedford city","Bedford city, Virginia","00","51","515",,2702,2519,183
"51520","Bristol city","Bristol city, Virginia","00","51","520",,8469,7678,791
"51530","Buena Vista city","Buena Vista city, Virginia","00","51","530",,2716,2547,169
"51540","Charlottesville city","Charlottesville city, Virginia","00","51","540",,17591,16851,740
"51550","Chesapeake city","Chesapeake city, Virginia","00","51","550",,72672,69900,2772
"51570","Colonial Heights city","Colonial Heights city, Virginia","00","51","570",,7340,7027,313
"51580","Covington city","Covington city, Virginia","00","51","580",,3195,2835,360
"51590","Danville city","Danville city, Virginia","00","51","590",,23108,20607,2501
"51595","Emporia city","Emporia city, Virginia","00","51","595",,2412,2226,186
"51600","Fairfax city","Fairfax city, Virginia","00","51","600",,8204,8035,169
"51610","Falls Church city","Falls Church city, Virginia","00","51","610",,4725,4471,254
"51620","Franklin city","Franklin city, Virginia","00","51","620",,3767,3384,383
"51630","Fredericksburg city","Fredericksburg city, Virginia","00","51","630",,8888,8102,786
"51640","Galax city","Galax city, Virginia","00","51","640",,3217,2950,267
"51650","Hampton city","Hampton city, Virginia","00","51","650",,57311,53887,3424
"51660","Harrisonburg city","Harrisonburg city, Virginia","00","51","660",,13689,13133,556
"51670","Hopewell city","Hopewell city, Virginia","00","51","670",,9749,9055,694
"51678","Lexington city","Lexington city, Virginia","00","51","678",,2376,2232,144
"51680","Lynchburg city","Lynchburg city, Virginia","00","51","680",,27640,25477,2163
"51683","Manassas city","Manassas city, Virginia","00","51","683",,12114,11757,357
"51685","Manassas Park city","Manassas Park city, Virginia","00","51","685",,3365,3254,111
"51690","Martinsville city","Martinsville city, Virginia","00","51","690",,7249,6498,751
"51700","Newport News city","Newport News city, Virginia","00","51","700",,74221.4137739,69786.878,4434.5357739
"51710","Norfolk city","Norfolk city, Virginia","00","51","710",,94416,86210,8206
"51720","Norton city","Norton city, Virginia","00","51","720",,1946,1730,216
"51730","Petersburg city","Petersburg city, Virginia","00","51","730",,15955,13799,2156
"51735","Poquoson city","Poquoson city, Virginia","00","51","735",,4300,4166,134
"51740","Portsmouth city","Portsmouth city, Virginia","00","51","740",,41605,38170,3435
"51750","Radford city","Radford city, Virginia","00","51","750",,6137,5809,328
"51760","Richmond city","Richmond city, Virginia","00","51","760",,92282,84549,7733
"51770","Roanoke city","Roanoke city, Virginia","00","51","770",,45257,42003,3254
"51775","Salem city","Salem city, Virginia","00","51","775",,10403,9954,449
"51790","Staunton city","Staunton city, Virginia","00","51","790",,10427,9676,751
"51800","Suffolk city","Suffolk city, Virginia","00","51","800",,24704,23283,1421
"51810","Virginia Beach city","Virginia Beach city, Virginia","00","51","810",,162277,154455,7822
"51820","Waynesboro city","Waynesboro city, Virginia","00","51","820",,8863,8332,531
"51830","Williamsburg city","Williamsburg city, Virginia","00","51","830",,3880,3619,261
"51840","Winchester city","Winchester city, Virginia","00","51","840",,10587,10001,586
"53001","Adams County","Adams County, Washington","00","53","001",,5773,5229,544
"53003","Asotin County","Asotin County, Washington","00","53","003",,9111,8364,747
"53005","Benton County","Benton County, Washington","00","53","005",,55963,52866,3097
"53007","Chelan County","Chelan County, Washington","00","53","007",,30407,25021,5386
"53009","Clallam County","Clallam County, Washington","00","53","009",,30683,27164,3519
"53011","Clark County","Clark County, Washington","00","53","011",,134030,127208,6822
"53013","Columbia County","Columbia County, Washington","00","53","013",,2018,1687,331
"53015","Cowlitz County","Cowlitz County, Washington","00","53","015",,38624,35850,2774
"53017","Douglas County","Douglas County, Washington","00","53","017",,12944,11726,1218
"53019","Ferry County","Ferry County, Washington","00","53","019",,3775,2823,952
"53021","Franklin County","Franklin County, Washington","00","53","021",,16084,14840,1244
"53023","Garfield County","Garfield County, Washington","00","53","023",,1288,987,301
"53025","Grant County","Grant County, Washington","00","53","025",,29081,25204,3877
"53027","Grays Harbor County","Grays Harbor County, Washington","00","53","027",,32489,26808,5681
"53029","Island County","Island County, Washington","00","53","029",,32378,27784,4594
"53031","Jefferson County","Jefferson County, Washington","00","53","031",,14144,11645,2499
"53033","King County","King County, Washington","00","53","033",,742237,710916,31321
"53035","Kitsap County","Kitsap County, Washington","00","53","035",,92644,86416,6228
"53037","Kittitas County","Kittitas County, Washington","00","53","037",,16475,13382,3093
"53039","Klickitat County","Klickitat County, Washington","00","53","039",,8633,7473,1160
"53041","Lewis County","Lewis County, Washington","00","53","041",,29585,26306,3279
"53043","Lincoln County","Lincoln County, Washington","00","53","043",,5298,4151,1147
"53045","Mason County","Mason County, Washington","00","53","045",,25515,18912,6603
"53047","Okanogan County","Okanogan County, Washington","00","53","047",,19085,15027,4058
"53049","Pacific County","Pacific County, Washington","00","53","049",,13991,9096,4895
"53051","Pend Oreille County","Pend Oreille County, Washington","00","53","051",,6608,4639,1969
"53053","Pierce County","Pierce County, Washington","00","53","053",,277060,260800,16260
"53055","San Juan County","San Juan County, Washington","00","53","055",,9752,6466,3286
"53057","Skagit County","Skagit County, Washington","00","53","057",,42681,38852,3829
"53059","Skamania County","Skamania County, Washington","00","53","059",,4576,3755,821
"53061","Snohomish County","Snohomish County, Washington","00","53","061",,236205,224852,11353
"53063","Spokane County","Spokane County, Washington","00","53","063",,175005,163611,11394
"53065","Stevens County","Stevens County, Washington","00","53","065",,17599,15017,2582
"53067","Thurston County","Thurston County, Washington","00","53","067",,86652,81625,5027
"53069","Wahkiakum County","Wahkiakum County, Washington","00","53","069",,1792,1553,239
"53071","Walla Walla County","Walla Walla County, Washington","00","53","071",,21147,19647,1500
"53073","Whatcom County","Whatcom County, Washington","00","53","073",,73893,64446,9447
"53075","Whitman County","Whitman County, Washington","00","53","075",,16676,15257,1419
"53077","Yakima County","Yakima County, Washington","00","53","077",,79174,73993,5181
"54001","Barbour County","Barbour County, West Virginia","00","54","001",,7348,6123,1225
"54003","Berkeley County","Berkeley County, West Virginia","00","54","003",,32913,29569,3344
"54005","Boone County","Boone County, West Virginia","00","54","005",,11575,10291,1284
"54007","Braxton County","Braxton County, West Virginia","00","54","007",,7374,5771,1603
"54009","Brooke County","Brooke County, West Virginia","00","54","009",,11150,10396,754
"54011","Cabell County","Cabell County, West Virginia","00","54","011",,45615,41180,4435
"54013","Calhoun County","Calhoun County, West Virginia","00","54","013",,3848,3071,777
"54015","Clay County","Clay County, West Virginia","00","54","015",,4836,4020,816
"54017","Doddridge County","Doddridge County, West Virginia","00","54","017",,3661,2845,816
"54019","Fayette County","Fayette County, West Virginia","00","54","019",,21616,18945,2671
"54021","Gilmer County","Gilmer County, West Virginia","00","54","021",,3621,2768,853
"54023","Grant County","Grant County, West Virginia","00","54","023",,6105,4591,1514
"54025","Greenbrier County","Greenbrier County, West Virginia","00","54","025",,17644,14571,3073
"54027","Hampshire County","Hampshire County, West Virginia","00","54","027",,11185,7955,3230
"54029","Hancock County","Hancock County, West Virginia","00","54","029",,14728,13678,1050
"54031","Hardy County","Hardy County, West Virginia","00","54","031",,7115,5204,1911
"54033","Harrison County","Harrison County, West Virginia","00","54","033",,31112,27867,3245
"54035","Jackson County","Jackson County, West Virginia","00","54","035",,12245,11061,1184
"54037","Jefferson County","Jefferson County, West Virginia","00","54","037",,17623,16165,1458
"54039","Kanawha County","Kanawha County, West Virginia","00","54","039",,93788,86226,7562
"54041","Lewis County","Lewis County, West Virginia","00","54","041",,7944,6946,998
"54043","Lincoln County","Lincoln County, West Virginia","00","54","043",,9846,8664,1182
"54045","Logan County","Logan County, West Virginia","00","54","045",,16807,14880,1927
"54047","McDowell County","McDowell County, West Virginia","00","54","047",,13582,11169,2413
"54049","Marion County","Marion County, West Virginia","00","54","049",,26660,23652,3008
"54051","Marshall County","Marshall County, West Virginia","00","54","051",,15814,14207,1607
"54053","Mason County","Mason County, West Virginia","00","54","053",,12056,10587,1469
"54055","Mercer County","Mercer County, West Virginia","00","54","055",,30143,26509,3634
"54057","Mineral County","Mineral County, West Virginia","00","54","057",,12094,10784,1310
"54059","Mingo County","Mingo County, West Virginia","00","54","059",,12898,11303,1595
"54061","Monongalia County","Monongalia County, West Virginia","00","54","061",,36695,33446,3249
"54063","Monroe County","Monroe County, West Virginia","00","54","063",,7267,5447,1820
"54065","Morgan County","Morgan County, West Virginia","00","54","065",,8076,6145,1931
"54067","Nicholas County","Nicholas County, West Virginia","00","54","067",,12406,10722,1684
"54069","Ohio County","Ohio County, West Virginia","00","54","069",,22166,19733,2433
"54071","Pendleton County","Pendleton County, West Virginia","00","54","071",,5102,3350,1752
"54073","Pleasants County","Pleasants County, West Virginia","00","54","073",,3214,2887,327
"54075","Pocahontas County","Pocahontas County, West Virginia","00","54","075",,7594,3835,3759
"54077","Preston County","Preston County, West Virginia","00","54","077",,13444,11544,1900
"54079","Putnam County","Putnam County, West Virginia","00","54","079",,21621,20028,1593
"54081","Raleigh County","Raleigh County, West Virginia","00","54","081",,35678,31793,3885
"54083","Randolph County","Randolph County, West Virginia","00","54","083",,13478,11072,2406
"54085","Ritchie County","Ritchie County, West Virginia","00","54","085",,5513,4184,1329
"54087","Roane County","Roane County, West Virginia","00","54","087",,7360,6161,1199
"54089","Summers County","Summers County, West Virginia","00","54","089",,7331,5530,1801
"54091","Taylor County","Taylor County, West Virginia","00","54","091",,7125,6320,805
"54093","Tucker County","Tucker County, West Virginia","00","54","093",,4634,3052,1582
"54095","Tyler County","Tyler County, West Virginia","00","54","095",,4780,3836,944
"54097","Upshur County","Upshur County, West Virginia","00","54","097",,10751,8972,1779
"54099","Wayne County","Wayne County, West Virginia","00","54","099",,19107,17239,1868
"54101","Webster County","Webster County, West Virginia","00","54","101",,5273,4010,1263
"54103","Wetzel County","Wetzel County, West Virginia","00","54","103",,8313,7164,1149
"54105","Wirt County","Wirt County, West Virginia","00","54","105",,3266,2284,982
"54107","Wood County","Wood County, West Virginia","00","54","107",,39785,36275,3510
"54109","Wyoming County","Wyoming County, West Virginia","00","54","109",,11698,10454,1244
"55001","Adams County","Adams County, Wisconsin","00","55","001",,14123,7900,6223
"55003","Ashland County","Ashland County, Wisconsin","00","55","003",,8883,6718,2165
"55005","Barron County","Barron County, Wisconsin","00","55","005",,20969,17851,3118
"55007","Bayfield County","Bayfield County, Wisconsin","00","55","007",,11640,6207,5433
"55009","Brown County","Brown County, Wisconsin","00","55","009",,90199,87295,2904
"55011","Buffalo County","Buffalo County, Wisconsin","00","55","011",,6098,5511,587
"55013","Burnett County","Burnett County, Wisconsin","00","55","013",,12582,6613,5969
"55015","Calumet County","Calumet County, Wisconsin","00","55","015",,15758,14910,848
"55017","Chippewa County","Chippewa County, Wisconsin","00","55","017",,22821,21356,1465
"55019","Clark County","Clark County, Wisconsin","00","55","019",,13531,12047,1484
"55021","Columbia County","Columbia County, Wisconsin","00","55","021",,22685,20439,2246
"55023","Crawford County","Crawford County, Wisconsin","00","55","023",,8480,6677,1803
"55025","Dane County","Dane County, Wisconsin","00","55","025",,180398,173484,6914
"55027","Dodge County","Dodge County, Wisconsin","00","55","027",,33672,31417,2255
"55029","Door County","Door County, Wisconsin","00","55","029",,19587,11828,7759
"55031","Douglas County","Douglas County, Wisconsin","00","55","031",,20356,17808,2548
"55033","Dunn County","Dunn County, Wisconsin","00","55","033",,15277,14337,940
"55035","Eau Claire County","Eau Claire County, Wisconsin","00","55","035",,37474,35822,1652
"55037","Florence County","Florence County, Wisconsin","00","55","037",,4239,2133,2106
"55039","Fond du Lac County","Fond du Lac County, Wisconsin","00","55","039",,39271,36931,2340
"55041","Forest County","Forest County, Wisconsin","00","55","041",,8322,4043,4279
"55043","Grant County","Grant County, Wisconsin","00","55","043",,19940,18465,1475
"55045","Green County","Green County, Wisconsin","00","55","045",,13878,13212,666
"55047","Green Lake County","Green Lake County, Wisconsin","00","55","047",,9831,7703,2128
"55049","Iowa County","Iowa County, Wisconsin","00","55","049",,9579,8764,815
"55051","Iron County","Iron County, Wisconsin","00","55","051",,5706,3083,2623
"55053","Jackson County","Jackson County, Wisconsin","00","55","053",,8029,7070,959
"55055","Jefferson County","Jefferson County, Wisconsin","00","55","055",,30092,28205,1887
"55057","Juneau County","Juneau County, Wisconsin","00","55","057",,12370,9696,2674
"55059","Kenosha County","Kenosha County, Wisconsin","00","55","059",,59989,56057,3932
"55061","Kewaunee County","Kewaunee County, Wisconsin","00","55","061",,8221,7623,598
"55063","La Crosse County","La Crosse County, Wisconsin","00","55","063",,43479,41599,1880
"55065","Lafayette County","Lafayette County, Wisconsin","00","55","065",,6674,6211,463
"55067","Langlade County","Langlade County, Wisconsin","00","55","067",,11187,8452,2735
"55069","Lincoln County","Lincoln County, Wisconsin","00","55","069",,14681,11721,2960
"55071","Manitowoc County","Manitowoc County, Wisconsin","00","55","071",,34651,32721,1930
"55073","Marathon County","Marathon County, Wisconsin","00","55","073",,50360,47702,2658
"55075","Marinette County","Marinette County, Wisconsin","00","55","075",,26260,17585,8675
"55077","Marquette County","Marquette County, Wisconsin","00","55","077",,8664,5986,2678
"55078","Menominee County","Menominee County, Wisconsin","00","55","078",,2098,1345,753
"55079","Milwaukee County","Milwaukee County, Wisconsin","00","55","079",,400093,377729,22364
"55081","Monroe County","Monroe County, Wisconsin","00","55","081",,16672,15399,1273
"55083","Oconto County","Oconto County, Wisconsin","00","55","083",,19812,13979,5833
"55085","Oneida County","Oneida County, Wisconsin","00","55","085",,26627,15333,11294
"55087","Outagamie County","Outagamie County, Wisconsin","00","55","087",,62614,60530,2084
"55089","Ozaukee County","Ozaukee County, Wisconsin","00","55","089",,32034,30857,1177
"55091","Pepin County","Pepin County, Wisconsin","00","55","091",,3036,2759,277
"55093","Pierce County","Pierce County, Wisconsin","00","55","093",,13493,13015,478
"55095","Polk County","Polk County, Wisconsin","00","55","095",,21129,16254,4875
"55097","Portage County","Portage County, Wisconsin","00","55","097",,26589,25040,1549
"55099","Price County","Price County, Wisconsin","00","55","099",,9574,6564,3010
"55101","Racine County","Racine County, Wisconsin","00","55","101",,74718,70819,3899
"55103","Richland County","Richland County, Wisconsin","00","55","103",,8164,7118,1046
"55105","Rock County","Rock County, Wisconsin","00","55","105",,62187,58617,3570
"55107","Rusk County","Rusk County, Wisconsin","00","55","107",,7609,6095,1514
"55109","St. Croix County","St. Croix County, Wisconsin","00","55","109",,24265,23410,855
"55111","Sauk County","Sauk County, Wisconsin","00","55","111",,24297,21644,2653
"55113","Sawyer County","Sawyer County, Wisconsin","00","55","113",,13722,6640,7082
"55115","Shawano County","Shawano County, Wisconsin","00","55","115",,18317,15815,2502
"55117","Sheboygan County","Sheboygan County, Wisconsin","00","55","117",,45947,43545,2402
"55119","Taylor County","Taylor County, Wisconsin","00","55","119",,8595,7529,1066
"55121","Trempealeau County","Trempealeau County, Wisconsin","00","55","121",,11482,10747,735
"55123","Vernon County","Vernon County, Wisconsin","00","55","123",,12416,10825,1591
"55125","Vilas County","Vilas County, Wisconsin","00","55","125",,22397,9066,13331
"55127","Walworth County","Walworth County, Wisconsin","00","55","127",,43783,34522,9261
"55129","Washburn County","Washburn County, Wisconsin","00","55","129",,10814,6604,4210
"55131","Washington County","Washington County, Wisconsin","00","55","131",,45808,43842,1966
"55133","Waukesha County","Waukesha County, Wisconsin","00","55","133",,140309,135229,5080
"55135","Waupaca County","Waupaca County, Wisconsin","00","55","135",,22508,19863,2645
"55137","Waushara County","Waushara County, Wisconsin","00","55","137",,13667,9336,4331
"55139","Winnebago County","Winnebago County, Wisconsin","00","55","139",,64721,61157,3564
"55141","Wood County","Wood County, Wisconsin","00","55","141",,31691,30135,1556
"56001","Albany County","Albany County, Wyoming","00","56","001",,15215,13269,1946
"56003","Big Horn County","Big Horn County, Wyoming","00","56","003",,5105,4312,793
"56005","Campbell County","Campbell County, Wyoming","00","56","005",,13288,12207,1081
"56007","Carbon County","Carbon County, Wyoming","00","56","007",,8307,6129,2178
"56009","Converse County","Converse County, Wyoming","00","56","009",,5669,4694,975
"56011","Crook County","Crook County, Wyoming","00","56","011",,2935,2308,627
"56013","Fremont County","Fremont County, Wyoming","00","56","013",,15541,13545,1996
"56015","Goshen County","Goshen County, Wyoming","00","56","015",,5881,5061,820
"56017","Hot Springs County","Hot Springs County, Wyoming","00","56","017",,2536,2108,428
"56019","Johnson County","Johnson County, Wyoming","00","56","019",,3503,2959,544
"56021","Laramie County","Laramie County, Wyoming","00","56","021",,34213,31927,2286
"56023","Lincoln County","Lincoln County, Wyoming","00","56","023",,6831,5266,1565
"56025","Natrona County","Natrona County, Wyoming","00","56","025",,29882,26819,3063
"56027","Niobrara County","Niobrara County, Wyoming","00","56","027",,1338,1011,327
"56029","Park County","Park County, Wyoming","00","56","029",,11869,10312,1557
"56031","Platte County","Platte County, Wyoming","00","56","031",,4528,3625,903
"56033","Sheridan County","Sheridan County, Wyoming","00","56","033",,12577,11167,1410
"56035","Sublette County","Sublette County, Wyoming","00","56","035",,3552,2371,1181
"56037","Sweetwater County","Sweetwater County, Wyoming","00","56","037",,15921,14105,1816
"56039","Teton County","Teton County, Wyoming","00","56","039",,10267,7688,2579
"56041","Uinta County","Uinta County, Wyoming","00","56","041",,8011,6823,1188
"56043","Washakie County","Washakie County, Wyoming","00","56","043",,3654,3278,376
"56045","Weston County","Weston County, Wyoming","00","56","045",,3231,2624,607
"72001","Adjuntas Municipio","Adjuntas Municipio, Puerto Rico","00","72","001",,6715,5895,820
"72003","Aguada Municipio","Aguada Municipio, Puerto Rico","00","72","003",,15590,13520,2070
"72005","Aguadilla Municipio","Aguadilla Municipio, Puerto Rico","00","72","005",,24882,22087,2795
"72007","Aguas Buenas Municipio","Aguas Buenas Municipio, Puerto Rico","00","72","007",,10412,9240,1172
"72009","Aibonito Municipio","Aibonito Municipio, Puerto Rico","00","72","009",,9163,8408,755
"72011","Añasco Municipio","Añasco Municipio, Puerto Rico","00","72","011",,10723,9398,1325
"72013","Arecibo Municipio","Arecibo Municipio, Puerto Rico","00","72","013",,38974,34245,4729
"72015","Arroyo Municipio","Arroyo Municipio, Puerto Rico","00","72","015",,7287,6166,1121
"72017","Barceloneta Municipio","Barceloneta Municipio, Puerto Rico","00","72","017",,8375,7508,867
"72019","Barranquitas Municipio","Barranquitas Municipio, Puerto Rico","00","72","019",,9740,8663,1077
"72021","Bayamón Municipio","Bayamón Municipio, Puerto Rico","00","72","021",,79476,73693,5783
"72023","Cabo Rojo Municipio","Cabo Rojo Municipio, Puerto Rico","00","72","023",,23182,17114,6068
"72025","Caguas Municipio","Caguas Municipio, Puerto Rico","00","72","025",,50568,46937,3631
"72027","Camuy Municipio","Camuy Municipio, Puerto Rico","00","72","027",,12520,11457,1063
"72029","Canóvanas Municipio","Canóvanas Municipio, Puerto Rico","00","72","029",,15071,13446,1625
"72031","Carolina Municipio","Carolina Municipio, Puerto Rico","00","72","031",,71347,63546,7801
"72033","Cataño Municipio","Cataño Municipio, Puerto Rico","00","72","033",,10366,9638,728
"72035","Cayey Municipio","Cayey Municipio, Puerto Rico","00","72","035",,17782,15634,2148
"72037","Ceiba Municipio","Ceiba Municipio, Puerto Rico","00","72","037",,6742,5750,992
"72039","Ciales Municipio","Ciales Municipio, Puerto Rico","00","72","039",,6886,6047,839
"72041","Cidra Municipio","Cidra Municipio, Puerto Rico","00","72","041",,14267,13204,1063
"72043","Coamo Municipio","Coamo Municipio, Puerto Rico","00","72","043",,13249,11749,1500
"72045","Comerío Municipio","Comerío Municipio, Puerto Rico","00","72","045",,7311,6311,1000
"72047","Corozal Municipio","Corozal Municipio, Puerto Rico","00","72","047",,12386,11264,1122
"72049","Culebra Municipio","Culebra Municipio, Puerto Rico","00","72","049",,1024,699,325
"72051","Dorado Municipio","Dorado Municipio, Puerto Rico","00","72","051",,13067,10887,2180
"72053","Fajardo Municipio","Fajardo Municipio, Puerto Rico","00","72","053",,17136,14176,2960
"72054","Florida Municipio","Florida Municipio, Puerto Rico","00","72","054",,4387,3962,425
"72055","Guánica Municipio","Guánica Municipio, Puerto Rico","00","72","055",,8849,7291,1558
"72057","Guayama Municipio","Guayama Municipio, Puerto Rico","00","72","057",,16368,14225,2143
"72059","Guayanilla Municipio","Guayanilla Municipio, Puerto Rico","00","72","059",,8147,7209,938
"72061","Guaynabo Municipio","Guaynabo Municipio, Puerto Rico","00","72","061",,36826,34068,2758
"72063","Gurabo Municipio","Gurabo Municipio, Puerto Rico","00","72","063",,12854,11741,1113
"72065","Hatillo Municipio","Hatillo Municipio, Puerto Rico","00","72","065",,13929,12685,1244
"72067","Hormigueros Municipio","Hormigueros Municipio, Puerto Rico","00","72","067",,6423,5820,603
"72069","Humacao Municipio","Humacao Municipio, Puerto Rico","00","72","069",,22559,19293,3266
"72071","Isabela Municipio","Isabela Municipio, Puerto Rico","00","72","071",,17166,14970,2196
"72073","Jayuya Municipio","Jayuya Municipio, Puerto Rico","00","72","073",,5591,5083,508
"72075","Juana Díaz Municipio","Juana Díaz Municipio, Puerto Rico","00","72","075",,16490,14954,1536
"72077","Juncos Municipio","Juncos Municipio, Puerto Rico","00","72","077",,13064,11933,1131
"72079","Lajas Municipio","Lajas Municipio, Puerto Rico","00","72","079",,10947,9007,1940
"72081","Lares Municipio","Lares Municipio, Puerto Rico","00","72","081",,12060,10974,1086
"72083","Las Marías Municipio","Las Marías Municipio, Puerto Rico","00","72","083",,4124,3564,560
"72085","Las Piedras Municipio","Las Piedras Municipio, Puerto Rico","00","72","085",,12421,11145,1276
"72087","Loíza Municipio","Loíza Municipio, Puerto Rico","00","72","087",,10927,9597,1330
"72089","Luquillo Municipio","Luquillo Municipio, Puerto Rico","00","72","089",,9327,6573,2754
"72091","Manatí Municipio","Manatí Municipio, Puerto Rico","00","72","091",,17113,15266,1847
"72093","Maricao Municipio","Maricao Municipio, Puerto Rico","00","72","093",,2272,2013,259
"72095","Maunabo Municipio","Maunabo Municipio, Puerto Rico","00","72","095",,4482,3994,488
"72097","Mayagüez Municipio","Mayagüez Municipio, Puerto Rico","00","72","097",,39364,34742,4622
"72099","Moca Municipio","Moca Municipio, Puerto Rico","00","72","099",,14253,12712,1541
"72101","Morovis Municipio","Morovis Municipio, Puerto Rico","00","72","101",,9462,8801,661
"72103","Naguabo Municipio","Naguabo Municipio, Puerto Rico","00","72","103",,8875,7872,1003
"72105","Naranjito Municipio","Naranjito Municipio, Puerto Rico","00","72","105",,9758,8932,826
"72107","Orocovis Municipio","Orocovis Municipio, Puerto Rico","00","72","107",,7946,7083,863
"72109","Patillas Municipio","Patillas Municipio, Puerto Rico","00","72","109",,7677,6576,1101
"72111","Peñuelas Municipio","Peñuelas Municipio, Puerto Rico","00","72","111",,8735,7698,1037
"72113","Ponce Municipio","Ponce Municipio, Puerto Rico","00","72","113",,66471,59607,6864
"72115","Quebradillas Municipio","Quebradillas Municipio, Puerto Rico","00","72","115",,9095,8280,815
"72117","Rincón Municipio","Rincón Municipio, Puerto Rico","00","72","117",,6827,5147,1680
"72119","Río Grande Municipio","Río Grande Municipio, Puerto Rico","00","72","119",,19928,16430,3498
"72121","Sabana Grande Municipio","Sabana Grande Municipio, Puerto Rico","00","72","121",,9982,8865,1117
"72123","Salinas Municipio","Salinas Municipio, Puerto Rico","00","72","123",,11876,10184,1692
"72125","San Germán Municipio","San Germán Municipio, Puerto Rico","00","72","125",,14335,12809,1526
"72127","San Juan Municipio","San Juan Municipio, Puerto Rico","00","72","127",,182101,163462,18639
"72129","San Lorenzo Municipio","San Lorenzo Municipio, Puerto Rico","00","72","129",,14594,13138,1456
"72131","San Sebastián Municipio","San Sebastián Municipio, Puerto Rico","00","72","131",,16682,14970,1712
"72133","Santa Isabel Municipio","Santa Isabel Municipio, Puerto Rico","00","72","133",,7569,6781,788
"72135","Toa Alta Municipio","Toa Alta Municipio, Puerto Rico","00","72","135",,21075,19420,1655
"72137","Toa Baja Municipio","Toa Baja Municipio, Puerto Rico","00","72","137",,33473,30453,3020
"72139","Trujillo Alto Municipio","Trujillo Alto Municipio, Puerto Rico","00","72","139",,26241,24160,2081
"72141","Utuado Municipio","Utuado Municipio, Puerto Rico","00","72","141",,12471,11207,1264
"72143","Vega Alta Municipio","Vega Alta Municipio, Puerto Rico","00","72","143",,13526,11894,1632
"72145","Vega Baja Municipio","Vega Baja Municipio, Puerto Rico","00","72","145",,21990,19758,2232
"72147","Vieques Municipio","Vieques Municipio, Puerto Rico","00","72","147",,4388,3319,1069
"72149","Villalba Municipio","Villalba Municipio, Puerto Rico","00","72","149",,8465,7722,743
"72151","Yabucoa Municipio","Yabucoa Municipio, Puerto Rico","00","72","151",,13688,12242,1446
"72153","Yauco Municipio","Yauco Municipio, Puerto Rico","00","72","153",,17062,15012,2050
