"","GEOID","year","totalP","totalP_hh","totalP_fhh","nonRel_fhh","nonRel_fhhP","totalP_nfhh","nonRel_nfhh","nonRel_nfhhP","groupQuar","groupQuarP"
"1","01001",2010,53155,53155,46976,803,1.71,6179,808,13.08,0,0
"2","01003",2010,175791,173834,150478,2658,1.77,23356,4075,17.45,1957,1.11
"3","01005",2010,27699,24722,21132,365,1.73,3590,463,12.9,2977,10.75
"4","01007",2010,22610,22463,20223,354,1.75,2240,296,13.21,147,0.65
"5","01009",2010,56692,56263,50381,1161,2.3,5882,655,11.14,429,0.76
"6","01011",2010,10923,10647,9189,20,0.22,1458,160,10.97,276,2.53
"7","01013",2010,20895,20672,17945,443,2.47,2727,158,5.79,223,1.07
"8","01015",2010,117149,114246,95999,1653,1.72,18247,3027,16.59,2903,2.48
"9","01017",2010,34579,34312,29778,365,1.23,4534,234,5.16,267,0.77
"10","01019",2010,25700,25205,21942,225,1.03,3263,230,7.05,495,1.93
"11","01021",2010,43121,42963,38100,1195,3.14,4863,573,11.78,158,0.37
"12","01023",2010,14111,13838,12021,103,0.86,1817,159,8.75,273,1.93
"13","01025",2010,26255,25943,22503,255,1.13,3440,307,8.92,312,1.19
"14","01027",2010,14040,13134,11464,188,1.64,1670,168,10.06,906,6.45
"15","01029",2010,14823,14625,12773,314,2.46,1852,382,20.63,198,1.34
"16","01031",2010,48349,47556,40654,666,1.64,6902,1260,18.26,793,1.64
"17","01033",2010,54446,53491,45913,530,1.15,7578,805,10.62,955,1.75
"18","01035",2010,13382,13326,11647,138,1.18,1679,32,1.91,56,0.42
"19","01037",2010,11470,11067,9283,146,1.57,1784,280,15.7,403,3.51
"20","01039",2010,37608,37288,31943,598,1.87,5345,755,14.13,320,0.85
"21","01041",2010,13928,13873,11756,175,1.49,2117,244,11.53,55,0.39
"22","01043",2010,79941,78500,68287,1445,2.12,10213,1345,13.17,1441,1.8
"23","01045",2010,49730,48579,41484,754,1.82,7095,1092,15.39,1151,2.31
"24","01047",2010,44066,43683,36895,544,1.47,6788,658,9.69,383,0.87
"25","01049",2010,70038,68693,61127,1149,1.88,7566,718,9.49,1345,1.92
"26","01051",2010,77650,70844,62838,828,1.32,8006,1076,13.44,6806,8.76
"27","01053",2010,37996,34599,29586,678,2.29,5013,649,12.95,3397,8.94
"28","01055",2010,104066,102347,88231,1637,1.86,14116,1400,9.92,1719,1.65
"29","01057",2010,17472,17146,14953,97,0.65,2193,130,5.93,326,1.87
"30","01059",2010,31383,30834,26981,536,1.99,3853,411,10.67,549,1.75
"31","01061",2010,26541,26192,22235,722,3.25,3957,610,15.42,349,1.31
"32","01063",2010,9255,9047,7704,182,2.36,1343,31,2.31,208,2.25
"33","01065",2010,16168,16105,13794,216,1.57,2311,257,11.12,63,0.39
"34","01067",2010,17148,17063,15025,162,1.08,2038,183,8.98,85,0.5
"35","01069",2010,99029,97613,83474,1475,1.77,14139,2230,15.77,1416,1.43
"36","01071",2010,53386,53154,46067,755,1.64,7087,816,11.51,232,0.43
"37","01073",2010,656912,642342,532283,9848,1.85,110059,18147,16.49,14570,2.22
"38","01075",2010,14743,14470,12452,116,0.93,2018,223,11.05,273,1.85
"39","01077",2010,91762,89780,75225,994,1.32,14555,2172,14.92,1982,2.16
"40","01079",2010,34235,34005,30362,245,0.81,3643,439,12.05,230,0.67
"41","01081",2010,135010,130423,99256,2079,2.09,31167,9187,29.48,4587,3.4
"42","01083",2010,78614,75550,66099,974,1.47,9451,1194,12.63,3064,3.9
"43","01085",2010,11731,11595,10237,105,1.03,1358,190,13.99,136,1.16
"44","01087",2010,21699,18567,15250,272,1.78,3317,347,10.46,3132,14.43
"45","01089",2010,323080,315483,264072,4596,1.74,51411,8734,16.99,7597,2.35
"46","01091",2010,21296,20853,17666,182,1.03,3187,332,10.42,443,2.08
"47","01093",2010,30792,29816,25803,161,0.62,4013,331,8.25,976,3.17
"48","01095",2010,90867,90144,77911,2185,2.8,12233,2091,17.09,723,0.8
"49","01097",2010,408620,400807,342012,5952,1.74,58795,9817,16.7,7813,1.91
"50","01099",2010,23329,23090,19850,296,1.49,3240,340,10.49,239,1.02
"51","01101",2010,228018,218573,181793,4175,2.3,36780,5432,14.77,9445,4.14
"52","01103",2010,117632,115843,100160,1725,1.72,15683,2075,13.23,1789,1.52
"53","01105",2010,10684,9744,8777,229,2.61,967,8,0.83,940,8.8
"54","01107",2010,19917,19665,16796,168,1,2869,211,7.35,252,1.27
"55","01109",2010,32147,31028,24168,479,1.98,6860,1798,26.21,1119,3.48
"56","01111",2010,22817,22108,18844,460,2.44,3264,644,19.73,709,3.11
"57","01113",2010,51663,51018,42169,885,2.1,8849,1456,16.45,645,1.25
"58","01115",2010,80658,78050,69025,1310,1.9,9025,1357,15.04,2608,3.23
"59","01117",2010,187880,185876,161863,1883,1.16,24013,4040,16.82,2004,1.07
"60","01119",2010,13871,13737,11503,219,1.9,2234,375,16.79,134,0.97
"61","01121",2010,82347,78474,68145,1554,2.28,10329,1163,11.26,3873,4.7
"62","01123",2010,41534,40907,35188,832,2.36,5719,854,14.93,627,1.51
"63","01125",2010,188331,180679,144521,3147,2.18,36158,10098,27.93,7652,4.06
"64","01127",2010,67612,66981,58169,1159,1.99,8812,1326,15.05,631,0.93
"65","01129",2010,17556,17212,15187,178,1.17,2025,175,8.64,344,1.96
"66","01131",2010,12012,11258,10142,110,1.08,1116,0,0,754,6.28
"67","01133",2010,24687,23940,20969,308,1.47,2971,422,14.2,747,3.03
"68","02013",2010,3703,734,611,26,4.26,123,21,17.07,2969,80.18
"69","02016",2010,6259,1428,1146,34,2.97,282,61,21.63,4831,77.18
"70","02020",2010,284267,277683,230755,7396,3.21,46928,12738,27.14,6584,2.32
"71","02050",2010,16838,16666,15117,559,3.7,1549,416,26.86,172,1.02
"72","02060",2010,1049,1049,887,28,3.16,162,40,24.69,0,0
"73","02068",2010,1144,947,728,3,0.41,219,17,7.76,197,17.22
"74","02070",2010,4817,4817,4214,225,5.34,603,169,28.03,0,0
"75","02090",2010,94439,90844,76363,2522,3.3,14481,3527,24.36,3595,3.81
"76","02100",2010,1658,1648,1353,57,4.21,295,12,4.07,10,0.6
"77","02105",2010,2029,2029,1647,39,2.37,382,51,13.35,0,0
"78","02110",2010,30975,30249,24425,967,3.96,5824,1609,27.63,726,2.34
"79","02122",2010,53917,52450,43351,1026,2.37,9099,1454,15.98,1467,2.72
"80","02130",2010,13396,13284,10815,307,2.84,2469,434,17.58,112,0.84
"81","02150",2010,13349,12170,10350,228,2.2,1820,534,29.34,1179,8.83
"82","02164",2010,1626,1626,1463,37,2.53,163,38,23.31,0,0
"83","02170",2010,84147,82564,72011,2419,3.36,10553,2496,23.65,1583,1.88
"84","02180",2010,9315,8927,7796,390,5,1131,287,25.38,388,4.17
"85","02185",2010,8852,8840,8231,491,5.97,609,152,24.96,12,0.14
"86","02188",2010,7477,6995,6479,366,5.65,516,99,19.19,482,6.45
"87","02195",2010,3841,3755,3031,86,2.84,724,152,20.99,86,2.24
"88","02198",2010,5507,5453,4500,195,4.33,953,157,16.47,54,0.98
"89","02220",2010,8894,8819,7298,412,5.65,1521,240,15.78,75,0.84
"90","02230",2010,1140,877,737,34,4.61,140,15,10.71,263,23.07
"91","02240",2010,6935,6548,5525,231,4.18,1023,249,24.34,387,5.58
"92","02261",2010,9606,9542,8037,259,3.22,1505,206,13.69,64,0.67
"93","02270",2010,7398,7398,6984,357,5.11,414,73,17.63,0,0
"94","02275",2010,2338,2338,1926,109,5.66,412,67,16.26,0,0
"95","02282",2010,638,638,534,13,2.43,104,17,16.35,0,0
"96","02290",2010,5635,5552,4444,241,5.42,1108,217,19.58,83,1.47
"97","04001",2010,70312,68014,61525,1244,2.02,6489,889,13.7,2298,3.27
"98","04003",2010,129268,122966,104915,2380,2.27,18051,2661,14.74,6302,4.88
"99","04005",2010,131824,124046,100841,3322,3.29,23205,7475,32.21,7778,5.9
"100","04007",2010,53272,52296,43464,767,1.76,8832,1969,22.29,976,1.83
"101","04009",2010,36030,32317,29138,784,2.69,3179,498,15.67,3713,10.31
"102","04011",2010,8318,8308,7083,206,2.91,1225,251,20.49,10,0.12
"103","04012",2010,20549,20148,16036,461,2.87,4112,423,10.29,401,1.95
"104","04013",2010,3751410,3704070,3090025,89741,2.9,614045,145841,23.75,47340,1.26
"105","04015",2010,199177,196032,161528,5299,3.28,34504,7550,21.88,3145,1.58
"106","04017",2010,107060,105023,94192,3017,3.2,10831,1470,13.57,2037,1.9
"107","04019",2010,964462,939037,755497,21303,2.82,183540,39040,21.27,25425,2.64
"108","04021",2010,329297,304326,264746,6904,2.61,39580,7019,17.73,24971,7.58
"109","04023",2010,46051,45817,42256,666,1.58,3561,786,22.07,234,0.51
"110","04025",2010,209260,205098,163952,4550,2.78,41146,8358,20.31,4162,1.99
"111","04027",2010,190526,184630,165162,4058,2.46,19468,3375,17.34,5896,3.09
"112","05001",2010,19321,18676,14741,378,2.56,3935,892,22.67,645,3.34
"113","05003",2010,22126,21903,19033,289,1.52,2870,190,6.62,223,1.01
"114","05005",2010,41388,40687,32973,682,2.07,7714,1370,17.76,701,1.69
"115","05007",2010,209911,207657,181865,4061,2.23,25792,4445,17.23,2254,1.07
"116","05009",2010,36710,36191,30497,301,0.99,5694,1189,20.88,519,1.41
"117","05011",2010,11638,10920,9407,112,1.19,1513,125,8.26,718,6.17
"118","05013",2010,5529,5529,4849,144,2.97,680,65,9.56,0,0
"119","05015",2010,26971,26129,21889,371,1.69,4240,697,16.44,842,3.12
"120","05017",2010,12102,11300,9449,238,2.52,1851,204,11.02,802,6.63
"121","05019",2010,23083,19315,15611,297,1.9,3704,557,15.04,3768,16.32
"122","05021",2010,16297,16287,13724,153,1.11,2563,176,6.87,10,0.06
"123","05023",2010,25692,24837,21400,401,1.87,3437,364,10.59,855,3.33
"124","05025",2010,8769,8759,7855,108,1.37,904,59,6.53,10,0.11
"125","05027",2010,24756,23233,19309,323,1.67,3924,634,16.16,1523,6.15
"126","05029",2010,21059,20987,17829,466,2.61,3158,316,10.01,72,0.34
"127","05031",2010,93329,90349,75886,1800,2.37,14463,3170,21.92,2980,3.19
"128","05033",2010,60778,60627,54135,908,1.68,6492,1058,16.3,151,0.25
"129","05035",2010,50673,49955,43700,1052,2.41,6255,842,13.46,718,1.42
"130","05037",2010,18144,17842,15772,353,2.24,2070,177,8.55,302,1.66
"131","05039",2010,8280,7562,6454,121,1.87,1108,116,10.47,718,8.67
"132","05041",2010,13351,13351,11491,151,1.31,1860,133,7.15,0,0
"133","05043",2010,18546,17651,14644,191,1.3,3007,562,18.69,895,4.83
"134","05045",2010,108375,103682,85487,1512,1.77,18195,5058,27.8,4693,4.33
"135","05047",2010,18176,18105,15616,439,2.81,2489,381,15.31,71,0.39
"136","05049",2010,12263,11935,10255,34,0.33,1680,128,7.62,328,2.67
"137","05051",2010,95290,93590,76554,2106,2.75,17036,2621,15.39,1700,1.78
"138","05053",2010,17657,17410,15759,221,1.4,1651,176,10.66,247,1.4
"139","05055",2010,41318,40635,34840,728,2.09,5795,1083,18.69,683,1.65
"140","05057",2010,22747,21661,19058,416,2.18,2603,305,11.72,1086,4.77
"141","05059",2010,32671,31573,27005,700,2.59,4568,825,18.06,1098,3.36
"142","05061",2010,13778,13602,11965,206,1.72,1637,232,14.17,176,1.28
"143","05063",2010,35994,35118,30022,723,2.41,5096,770,15.11,876,2.43
"144","05065",2010,13636,12996,11153,158,1.42,1843,130,7.05,640,4.69
"145","05067",2010,18015,15819,13546,331,2.44,2273,208,9.15,2196,12.19
"146","05069",2010,78447,73629,62427,1444,2.31,11202,1617,14.43,4818,6.14
"147","05071",2010,25180,24734,21036,545,2.59,3698,563,15.22,446,1.77
"148","05073",2010,7764,7697,6719,71,1.06,978,67,6.85,67,0.86
"149","05075",2010,17340,16328,14014,96,0.69,2314,198,8.56,1012,5.84
"150","05077",2010,10709,9218,7801,60,0.77,1417,116,8.19,1491,13.92
"151","05079",2010,14203,11835,10588,273,2.58,1247,131,10.51,2368,16.67
"152","05081",2010,13145,12824,10876,117,1.08,1948,159,8.16,321,2.44
"153","05083",2010,22580,22580,19962,447,2.24,2618,276,10.54,0,0
"154","05085",2010,65846,65115,58292,1166,2,6823,936,13.72,731,1.11
"155","05087",2010,15507,15370,13411,232,1.73,1959,403,20.57,137,0.88
"156","05089",2010,16779,16697,14091,165,1.17,2606,449,17.23,82,0.49
"157","05091",2010,43048,41874,36310,809,2.23,5564,652,11.72,1174,2.73
"158","05093",2010,46815,46191,40143,804,2,6048,1031,17.05,624,1.33
"159","05095",2010,8492,8356,7105,142,2,1251,65,5.2,136,1.6
"160","05097",2010,9490,9372,8248,83,1.01,1124,87,7.74,118,1.24
"161","05099",2010,9149,9010,7623,91,1.19,1387,171,12.33,139,1.52
"162","05101",2010,8394,8391,7267,127,1.75,1124,89,7.92,3,0.04
"163","05103",2010,26293,25872,21970,371,1.69,3902,367,9.41,421,1.6
"164","05105",2010,10435,10271,9078,273,3.01,1193,195,16.35,164,1.57
"165","05107",2010,22412,21971,19205,552,2.87,2766,182,6.58,441,1.97
"166","05109",2010,11286,11244,10082,159,1.58,1162,83,7.14,42,0.37
"167","05111",2010,24703,24296,20562,521,2.53,3734,613,16.42,407,1.65
"168","05113",2010,20490,20257,17516,247,1.41,2741,362,13.21,233,1.14
"169","05115",2010,60460,58349,50076,1303,2.6,8273,1668,20.16,2111,3.49
"170","05117",2010,8839,8738,7462,165,2.21,1276,223,17.48,101,1.14
"171","05119",2010,377060,369790,300126,6399,2.13,69664,11904,17.09,7270,1.93
"172","05121",2010,18049,17772,15320,386,2.52,2452,248,10.11,277,1.53
"173","05123",2010,28302,24441,21055,476,2.26,3386,400,11.81,3861,13.64
"174","05125",2010,102439,99603,86639,1464,1.69,12964,2226,17.17,2836,2.77
"175","05127",2010,11226,11061,9745,368,3.78,1316,155,11.78,165,1.47
"176","05129",2010,8227,7923,6600,136,2.06,1323,151,11.41,304,3.7
"177","05131",2010,123847,122479,103337,2719,2.63,19142,3034,15.85,1368,1.1
"178","05133",2010,16636,16571,14860,456,3.07,1711,198,11.57,65,0.39
"179","05135",2010,17432,17009,14058,230,1.64,2951,444,15.05,423,2.43
"180","05137",2010,12321,12241,10394,289,2.78,1847,207,11.21,80,0.65
"181","05139",2010,42180,41339,35611,725,2.04,5728,464,8.1,841,1.99
"182","05141",2010,17237,17168,14357,270,1.88,2811,447,15.9,69,0.4
"183","05143",2010,197192,190476,155277,4598,2.96,35199,8261,23.47,6716,3.41
"184","05145",2010,74957,71023,60948,1167,1.91,10075,1787,17.74,3934,5.25
"185","05147",2010,7505,7505,6287,141,2.24,1218,90,7.39,0,0
"186","05149",2010,21895,21655,18970,447,2.36,2685,559,20.82,240,1.1
"187","06001",2010,1477980,1447524,1188323,37942,3.19,259201,67365,25.99,30456,2.06
"188","06003",2010,1176,1176,947,109,11.51,229,79,34.5,0,0
"189","06005",2010,38327,33938,27876,475,1.7,6062,1366,22.53,4389,11.45
"190","06007",2010,218635,213520,165426,6124,3.7,48094,15006,31.2,5115,2.34
"191","06009",2010,45994,45769,39018,1121,2.87,6751,1325,19.63,225,0.49
"192","06011",2010,21165,20314,18062,504,2.79,2252,360,15.99,851,4.02
"193","06013",2010,1024809,1013554,876133,24293,2.77,137421,28836,20.98,11255,1.1
"194","06015",2010,28471,25321,20668,840,4.06,4653,809,17.39,3150,11.06
"195","06017",2010,179053,177836,152459,3287,2.16,25377,6321,24.91,1217,0.68
"196","06019",2010,908830,890577,785831,24931,3.17,104746,26731,25.52,18253,2.01
"197","06021",2010,27935,27935,24939,880,3.53,2996,569,18.99,0,0
"198","06023",2010,133058,129180,98441,4185,4.25,30739,8131,26.45,3878,2.91
"199","06025",2010,168052,157851,146944,2962,2.02,10907,1749,16.04,10201,6.07
"200","06027",2010,18434,18434,14573,441,3.03,3861,717,18.57,0,0
"201","06029",2010,815693,778942,698573,26283,3.76,80369,17871,22.24,36751,4.51
"202","06031",2010,151122,133881,121883,4084,3.35,11998,3169,26.41,17241,11.41
"203","06033",2010,64371,63596,51663,2133,4.13,11933,2828,23.7,775,1.2
"204","06035",2010,35081,24471,20170,621,3.08,4301,884,20.55,10610,30.24
"205","06037",2010,9758256,9571220,8176470,282865,3.46,1394750,347088,24.89,187036,1.92
"206","06039",2010,147738,138716,126989,4958,3.9,11727,2406,20.52,9022,6.11
"207","06041",2010,248601,239634,188546,5419,2.87,51088,10602,20.75,8967,3.61
"208","06043",2010,18290,17591,14398,491,3.41,3193,558,17.48,699,3.82
"209","06045",2010,87487,85762,69197,2393,3.46,16565,3835,23.15,1725,1.97
"210","06047",2010,250699,247151,226076,8778,3.88,21075,5102,24.21,3548,1.42
"211","06049",2010,9605,9282,7718,150,1.94,1564,170,10.87,323,3.36
"212","06051",2010,13905,13789,10339,179,1.73,3450,1298,37.62,116,0.83
"213","06053",2010,407435,389956,341875,15564,4.55,48081,12724,26.46,17479,4.29
"214","06055",2010,134051,128581,108029,3236,3,20552,4290,20.87,5470,4.08
"215","06057",2010,98186,97393,80402,2765,3.44,16991,3654,21.51,793,0.81
"216","06059",2010,2965525,2924882,2534974,93403,3.68,389908,104738,26.86,40643,1.37
"217","06061",2010,336477,333581,286826,5369,1.87,46755,9856,21.08,2896,0.86
"218","06063",2010,20392,20271,15788,414,2.62,4483,567,12.65,121,0.59
"219","06065",2010,2109464,2080083,1849120,58227,3.15,230963,57172,24.75,29381,1.39
"220","06067",2010,1395144,1366701,1136856,36532,3.21,229845,54365,23.65,28443,2.04
"221","06069",2010,54492,52768,48482,1124,2.32,4286,851,19.86,1724,3.16
"222","06071",2010,2005287,1963927,1780128,60970,3.43,183799,44101,23.99,41360,2.06
"223","06073",2010,3022468,2918121,2418290,70529,2.92,499831,141789,28.37,104347,3.45
"224","06075",2010,789172,774391,502794,19155,3.81,271597,85970,31.65,14781,1.87
"225","06077",2010,673613,654192,583608,19599,3.36,70584,16676,23.63,19421,2.88
"226","06079",2010,265577,248706,193973,6305,3.25,54733,16549,30.24,16871,6.35
"227","06081",2010,704327,695442,586732,17234,2.94,108710,25469,23.43,8885,1.26
"228","06083",2010,416051,398027,319762,15654,4.9,78265,27580,35.24,18024,4.33
"229","06085",2010,1739396,1707744,1472924,43905,2.98,234820,59416,25.3,31652,1.82
"230","06087",2010,256901,246603,195083,8095,4.15,51520,16675,32.37,10298,4.01
"231","06089",2010,176906,174380,145019,5408,3.73,29361,6066,20.66,2526,1.43
"232","06091",2010,3366,3366,2699,52,1.93,667,99,14.84,0,0
"233","06093",2010,44690,43740,34466,962,2.79,9274,1453,15.67,950,2.13
"234","06095",2010,410042,397964,347263,10374,2.99,50701,11597,22.87,12078,2.95
"235","06097",2010,474047,464272,374719,13027,3.48,89553,22219,24.81,9775,2.06
"236","06099",2010,509682,501948,447886,13433,3,54062,12476,23.08,7734,1.52
"237","06101",2010,93420,92536,82299,2041,2.48,10237,2175,21.25,884,0.95
"238","06103",2010,62575,61048,51651,2017,3.91,9397,1777,18.91,1527,2.44
"239","06105",2010,13701,12988,10262,401,3.91,2726,559,20.51,713,5.2
"240","06107",2010,429404,424071,390233,12543,3.21,33838,7106,21,5333,1.24
"241","06109",2010,56074,50602,40704,818,2.01,9898,1935,19.55,5472,9.76
"242","06111",2010,809080,798835,706564,23558,3.33,92271,23545,25.52,10245,1.27
"243","06113",2010,196418,187027,143528,4009,2.79,43499,16963,39,9391,4.78
"244","06115",2010,71160,69483,60893,3342,5.49,8590,1982,23.07,1677,2.36
"245","08001",2010,425330,422042,366531,10540,2.88,55511,12459,22.44,3288,0.77
"246","08003",2010,15293,13823,11241,187,1.66,2582,426,16.5,1470,9.61
"247","08005",2010,552860,547460,454895,11177,2.46,92565,17025,18.39,5400,0.98
"248","08007",2010,12136,12125,11069,115,1.04,1056,251,23.77,11,0.09
"249","08009",2010,3833,3750,3002,30,1,748,122,16.31,83,2.17
"250","08011",2010,6125,4476,3772,141,3.74,704,72,10.23,1649,26.92
"251","08013",2010,290177,278976,209610,4946,2.36,69366,20690,29.83,11201,3.86
"252","08014",2010,52872,52872,44560,718,1.61,8312,1725,20.75,0,0
"253","08015",2010,17540,16159,12835,286,2.23,3324,627,18.86,1381,7.87
"254","08017",2010,2194,2085,1734,12,0.69,351,46,13.11,109,4.97
"255","08019",2010,9088,9079,6966,113,1.62,2113,483,22.86,9,0.1
"256","08021",2010,8220,8083,7247,48,0.66,836,39,4.67,137,1.67
"257","08023",2010,3536,3536,2937,110,3.75,599,36,6.01,0,0
"258","08025",2010,5897,3675,3216,153,4.76,459,85,18.52,2222,37.68
"259","08027",2010,3899,3882,3171,106,3.34,711,52,7.31,17,0.44
"260","08029",2010,30533,29806,25283,333,1.32,4523,571,12.62,727,2.38
"261","08031",2010,578087,565752,396892,10947,2.76,168860,37176,22.02,12335,2.13
"262","08033",2010,2027,2027,1792,55,3.07,235,32,13.62,0,0
"263","08035",2010,273440,272603,246378,2741,1.11,26225,4698,17.91,837,0.31
"264","08037",2010,50793,50699,38165,1560,4.09,12534,5567,44.42,94,0.19
"265","08039",2010,22712,22702,20595,165,0.8,2107,478,22.69,10,0.04
"266","08041",2010,599988,582623,490961,11217,2.28,91662,18136,19.79,17365,2.89
"267","08043",2010,46941,34360,28341,571,2.01,6019,605,10.05,12581,26.8
"268","08045",2010,54761,53877,46213,1419,3.07,7664,1760,22.96,884,1.61
"269","08047",2010,5126,5116,3579,81,2.26,1537,323,21.01,10,0.2
"270","08049",2010,14526,14452,10486,230,2.19,3966,1730,43.62,74,0.51
"271","08051",2010,15136,14042,9756,172,1.76,4286,1386,32.34,1094,7.23
"272","08053",2010,489,489,359,3,0.84,130,30,23.08,0,0
"273","08055",2010,6948,6206,4829,30,0.62,1377,106,7.7,742,10.68
"274","08057",2010,1464,1464,1258,5,0.4,206,14,6.8,0,0
"275","08059",2010,528614,521938,432018,8505,1.97,89920,16638,18.5,6676,1.26
"276","08061",2010,1643,1583,1298,8,0.62,285,40,14.04,60,3.65
"277","08063",2010,8156,7430,6358,128,2.01,1072,100,9.33,726,8.9
"278","08065",2010,7039,6900,5348,270,5.05,1552,363,23.39,139,1.97
"279","08067",2010,50149,48462,38116,877,2.3,10346,2942,28.44,1687,3.36
"280","08069",2010,291162,281654,221746,4173,1.88,59908,16817,28.07,9508,3.27
"281","08071",2010,15675,15314,12543,265,2.11,2771,408,14.72,361,2.3
"282","08073",2010,5476,4512,3754,68,1.81,758,61,8.05,964,17.6
"283","08075",2010,22278,20700,17603,498,2.83,3097,499,16.11,1578,7.08
"284","08077",2010,142284,139285,114797,2958,2.58,24488,5318,21.72,2999,2.11
"285","08079",2010,1020,908,766,13,1.7,142,4,2.82,112,10.98
"286","08081",2010,13519,13486,11605,234,2.02,1881,306,16.27,33,0.24
"287","08083",2010,25279,25166,21376,505,2.36,3790,458,12.08,113,0.45
"288","08085",2010,40266,39898,34169,448,1.31,5729,799,13.95,368,0.91
"289","08087",2010,27911,27521,23454,504,2.15,4067,820,20.16,390,1.4
"290","08089",2010,18830,17546,14686,449,3.06,2860,365,12.76,1284,6.82
"291","08091",2010,4319,4319,3728,53,1.42,591,121,20.47,0,0
"292","08093",2010,16286,15386,12383,105,0.85,3003,552,18.38,900,5.53
"293","08095",2010,4394,4384,3694,91,2.46,690,50,7.25,10,0.23
"294","08097",2010,16389,16389,11578,404,3.49,4811,1316,27.35,0,0
"295","08099",2010,12734,12171,10372,237,2.28,1799,164,9.12,563,4.42
"296","08101",2010,156244,151944,126410,3189,2.52,25534,4363,17.09,4300,2.75
"297","08103",2010,6494,6373,5341,116,2.17,1032,112,10.85,121,1.86
"298","08105",2010,11926,11455,9926,100,1.01,1529,354,23.15,471,3.95
"299","08107",2010,22924,22514,17954,456,2.54,4560,916,20.09,410,1.79
"300","08109",2010,6161,5954,4888,147,3.01,1066,127,11.91,207,3.36
"301","08111",2010,752,752,409,0,0,343,94,27.41,0,0
"302","08113",2010,7299,7289,5059,133,2.63,2230,761,34.13,10,0.14
"303","08115",2010,2412,2223,1837,23,1.25,386,27,6.99,189,7.84
"304","08117",2010,27105,26583,18340,757,4.13,8243,3542,42.97,522,1.93
"305","08119",2010,22821,22546,19440,318,1.64,3106,667,21.47,275,1.21
"306","08121",2010,4773,4763,3961,51,1.29,802,103,12.84,10,0.21
"307","08123",2010,242860,237763,204393,5025,2.46,33370,8598,25.77,5097,2.1
"308","08125",2010,9896,9896,8600,93,1.08,1296,119,9.18,0,0
"309","09001",2010,905342,883383,758923,15124,1.99,124460,23239,18.67,21959,2.43
"310","09003",2010,887976,860732,714652,17106,2.39,146080,25678,17.58,27244,3.07
"311","09005",2010,189916,187766,159165,3115,1.96,28601,4576,16,2150,1.13
"312","09007",2010,164774,157782,130393,2190,1.68,27389,5088,18.58,6992,4.24
"313","09009",2010,856688,829695,689958,14699,2.13,139737,26067,18.65,26993,3.15
"314","09011",2010,272360,258614,214159,4927,2.3,44455,8707,19.59,13746,5.05
"315","09013",2010,151073,137014,115600,2037,1.76,21414,5309,24.79,14059,9.31
"316","09015",2010,117708,113554,95579,3555,3.72,17975,3882,21.6,4154,3.53
"317","10001",2010,156918,153044,132212,3772,2.85,20832,4147,19.91,3874,2.47
"318","10003",2010,533514,515696,431783,10917,2.53,83913,18244,21.74,17818,3.34
"319","10005",2010,190846,187971,155910,4771,3.06,32061,7572,23.62,2875,1.51
"320","11001",2010,584400,545221,352070,10349,2.94,193151,45005,23.3,39179,6.7
"321","12001",2010,244247,226341,157311,3434,2.18,69030,23652,34.26,17906,7.33
"322","12003",2010,26548,23702,21554,307,1.42,2148,326,15.18,2846,10.72
"323","12005",2010,166798,162186,131748,3985,3.02,30438,6111,20.08,4612,2.77
"324","12007",2010,28750,24664,21466,847,3.95,3198,663,20.73,4086,14.21
"325","12009",2010,540583,533020,438891,10303,2.35,94129,18367,19.51,7563,1.4
"326","12011",2010,1734139,1716278,1398820,37009,2.65,317458,69199,21.8,17861,1.03
"327","12013",2010,14372,12382,10711,409,3.82,1671,233,13.94,1990,13.85
"328","12015",2010,159385,157192,128362,2889,2.25,28830,4883,16.94,2193,1.38
"329","12017",2010,140686,138708,113878,2883,2.53,24830,4655,18.75,1978,1.41
"330","12019",2010,186076,184441,164840,4140,2.51,19601,3898,19.89,1635,0.88
"331","12021",2010,316931,314753,263850,9065,3.44,50903,12521,24.6,2178,0.69
"332","12023",2010,66964,63353,53693,1695,3.16,9660,1427,14.77,3611,5.39
"333","12027",2010,34557,31041,26146,1233,4.72,4895,1599,32.67,3516,10.17
"334","12029",2010,16196,15798,13253,286,2.16,2545,783,30.77,398,2.46
"335","12031",2010,854848,837597,682238,16713,2.45,155359,33239,21.39,17251,2.02
"336","12033",2010,297940,276645,226676,5583,2.46,49969,10030,20.07,21295,7.15
"337","12035",2010,91806,91308,78681,1914,2.43,12627,2547,20.17,498,0.54
"338","12037",2010,11470,10279,8343,235,2.82,1936,379,19.58,1191,10.38
"339","12039",2010,46031,42851,36394,1065,2.93,6457,854,13.23,3180,6.91
"340","12041",2010,16683,15736,13437,336,2.5,2299,627,27.27,947,5.68
"341","12043",2010,12617,11631,9652,145,1.5,1979,563,28.45,986,7.81
"342","12045",2010,15879,13345,11407,397,3.48,1938,328,16.92,2534,15.96
"343","12047",2010,14696,11688,10108,217,2.15,1580,135,8.54,3008,20.47
"344","12049",2010,27521,25064,23031,623,2.71,2033,342,16.82,2457,8.93
"345","12051",2010,39030,35046,31084,1339,4.31,3962,1304,32.91,3984,10.21
"346","12053",2010,170337,167801,142324,4055,2.85,25477,4314,16.93,2536,1.49
"347","12055",2010,98807,97694,80872,2047,2.53,16822,3222,19.15,1113,1.13
"348","12057",2010,1200236,1181675,965413,26405,2.74,216262,49751,23,18561,1.55
"349","12059",2010,19992,18367,15373,413,2.69,2994,719,24.01,1625,8.13
"350","12061",2010,135518,134183,109353,2840,2.6,24830,4584,18.46,1335,0.99
"351","12063",2010,49334,38354,32043,538,1.68,6311,734,11.63,10980,22.26
"352","12065",2010,14583,13921,11899,255,2.14,2022,437,21.61,662,4.54
"353","12067",2010,8506,8026,6940,77,1.11,1086,417,38.4,480,5.64
"354","12069",2010,291671,288991,246139,4107,1.67,42852,7590,17.71,2680,0.92
"355","12071",2010,606165,598884,490741,13393,2.73,108143,25317,23.41,7281,1.2
"356","12073",2010,270409,256699,182857,4633,2.53,73842,24982,33.83,13710,5.07
"357","12075",2010,40415,39718,33710,915,2.71,6008,1139,18.96,697,1.72
"358","12077",2010,8230,6960,6109,232,3.8,851,287,33.73,1270,15.43
"359","12079",2010,19300,17255,15143,296,1.95,2112,289,13.68,2045,10.6
"360","12081",2010,318619,315291,256108,6762,2.64,59183,12430,21,3328,1.04
"361","12083",2010,326833,320653,269048,7330,2.72,51605,9152,17.73,6180,1.89
"362","12085",2010,144322,141293,114071,3131,2.74,27222,5273,19.37,3029,2.1
"363","12086",2010,2445374,2379278,2053783,62027,3.02,325495,69828,21.45,66096,2.7
"364","12087",2010,73065,72183,54301,2072,3.82,17882,5460,30.53,882,1.21
"365","12089",2010,71099,70329,61296,1422,2.32,9033,1854,20.52,770,1.08
"366","12091",2010,182076,176866,147075,3826,2.6,29791,6175,20.73,5210,2.86
"367","12093",2010,39883,38705,33681,1497,4.44,5024,1247,24.82,1178,2.95
"368","12095",2010,1116094,1096423,898290,25843,2.88,198133,57937,29.24,19671,1.76
"369","12097",2010,258531,255641,225681,6849,3.03,29960,7238,24.16,2890,1.12
"370","12099",2010,1299356,1281052,1025846,29068,2.83,255206,56905,22.3,18304,1.41
"371","12101",2010,456514,452394,375342,10127,2.7,77052,15823,20.54,4120,0.9
"372","12103",2010,918263,896944,681661,17264,2.53,215283,39586,18.39,21319,2.32
"373","12105",2010,590116,576965,492535,13634,2.77,84430,17963,21.28,13151,2.23
"374","12107",2010,74715,72524,60964,2018,3.31,11560,2045,17.69,2191,2.93
"375","12109",2010,180624,178223,150486,2609,1.73,27737,5754,20.74,2401,1.33
"376","12111",2010,269659,266254,226121,6383,2.82,40133,8708,21.7,3405,1.26
"377","12113",2010,147838,144450,126627,3073,2.43,17823,4074,22.86,3388,2.29
"378","12115",2010,376200,371766,291626,6484,2.22,80140,14913,18.61,4434,1.18
"379","12117",2010,417330,412986,347562,7354,2.12,65424,16161,24.7,4344,1.04
"380","12119",2010,85891,77077,63621,993,1.56,13456,2057,15.29,8814,10.26
"381","12121",2010,40675,39971,34701,1220,3.52,5270,743,14.1,704,1.73
"382","12123",2010,22000,20660,18057,458,2.54,2603,405,15.56,1340,6.09
"383","12125",2010,15375,12017,10427,74,0.71,1590,681,42.83,3358,21.84
"384","12127",2010,496053,480815,388661,11546,2.97,92154,18461,20.03,15238,3.07
"385","12129",2010,29368,26608,22864,270,1.18,3744,726,19.39,2760,9.4
"386","12131",2010,53366,50924,41626,1025,2.46,9298,1567,16.85,2442,4.58
"387","12133",2010,24125,22755,18922,614,3.24,3833,763,19.91,1370,5.68
"388","13001",2010,18050,17901,15353,297,1.93,2548,238,9.34,149,0.83
"389","13003",2010,8332,8332,7385,227,3.07,947,214,22.6,0,0
"390","13005",2010,10969,10472,9035,147,1.63,1437,241,16.77,497,4.53
"391","13007",2010,3657,3657,3200,72,2.25,457,40,8.75,0,0
"392","13009",2010,46905,40716,32244,720,2.23,8472,2520,29.75,6189,13.19
"393","13011",2010,17840,17840,15677,175,1.12,2163,438,20.25,0,0
"394","13013",2010,66359,66024,59200,1821,3.08,6824,994,14.57,335,0.5
"395","13015",2010,97423,96530,86228,1820,2.11,10302,1961,19.04,893,0.92
"396","13017",2010,17631,17234,14669,296,2.02,2565,442,17.23,397,2.25
"397","13019",2010,18708,17946,15239,186,1.22,2707,509,18.8,762,4.07
"398","13021",2010,154810,147831,121180,2529,2.09,26651,5392,20.23,6979,4.51
"399","13023",2010,12937,12334,10855,282,2.6,1479,182,12.31,603,4.66
"400","13025",2010,17650,17640,15430,350,2.27,2210,492,22.26,10,0.06
"401","13027",2010,16338,15753,13923,177,1.27,1830,175,9.56,585,3.58
"402","13029",2010,29039,29029,26005,536,2.06,3024,673,22.26,10,0.03
"403","13031",2010,67298,62386,45994,884,1.92,16392,6525,39.81,4912,7.3
"404","13033",2010,23083,22518,19682,357,1.81,2836,347,12.24,565,2.45
"405","13035",2010,23401,21267,19028,500,2.63,2239,365,16.3,2134,9.12
"406","13037",2010,6488,4690,4010,57,1.42,680,45,6.62,1798,27.71
"407","13039",2010,49293,48354,42286,1015,2.4,6068,1236,20.37,939,1.9
"408","13043",2010,10715,10387,9224,374,4.05,1163,221,19,328,3.06
"409","13045",2010,109227,106448,91368,2582,2.83,15080,3621,24.01,2779,2.54
"410","13047",2010,62951,62419,54930,1363,2.48,7489,996,13.3,532,0.85
"411","13049",2010,12310,11678,9726,408,4.19,1952,739,37.86,632,5.13
"412","13051",2010,256428,248668,198429,4046,2.04,50239,12166,24.22,7760,3.03
"413","13053",2010,11702,8590,7757,136,1.75,833,273,32.77,3112,26.59
"414","13055",2010,25985,24528,21351,313,1.47,3177,658,20.71,1457,5.61
"415","13057",2010,206283,205086,183648,2725,1.48,21438,4205,19.61,1197,0.58
"416","13059",2010,115070,105107,68410,1850,2.7,36697,15947,43.46,9963,8.66
"417","13061",2010,2981,2898,2484,60,2.42,414,31,7.49,83,2.78
"418","13063",2010,260156,254763,216635,6977,3.22,38128,9217,24.17,5393,2.07
"419","13065",2010,6841,6771,5760,136,2.36,1011,188,18.6,70,1.02
"420","13067",2010,677402,672148,566931,13472,2.38,105217,22634,21.51,5254,0.78
"421","13069",2010,41647,39138,34627,906,2.62,4511,648,14.36,2509,6.02
"422","13071",2010,44712,44094,39088,1489,3.81,5006,873,17.44,618,1.38
"423","13073",2010,117858,117188,106231,1727,1.63,10957,1837,16.77,670,0.57
"424","13075",2010,16976,16641,14245,334,2.34,2396,384,16.03,335,1.97
"425","13077",2010,121528,120773,108090,2018,1.87,12683,2370,18.69,755,0.62
"426","13079",2010,12821,12811,11267,242,2.15,1544,335,21.7,10,0.08
"427","13081",2010,23182,22837,19545,592,3.03,3292,515,15.64,345,1.49
"428","13083",2010,16595,15586,13851,190,1.37,1735,86,4.96,1009,6.08
"429","13085",2010,21758,21692,19037,542,2.85,2655,685,25.8,66,0.3
"430","13087",2010,27920,26872,22889,624,2.73,3983,500,12.55,1048,3.75
"431","13089",2010,685371,670285,528535,14580,2.76,141750,32954,23.25,15086,2.2
"432","13091",2010,21402,18974,15731,265,1.68,3243,422,13.01,2428,11.34
"433","13093",2010,14283,11683,9784,251,2.57,1899,204,10.74,2600,18.2
"434","13095",2010,94514,89658,74299,2276,3.06,15359,2316,15.08,4856,5.14
"435","13097",2010,127800,127194,112657,2788,2.47,14537,2807,19.31,606,0.47
"436","13099",2010,11286,11087,9639,84,0.87,1448,133,9.19,199,1.76
"437","13101",2010,3973,3973,3699,166,4.49,274,38,13.87,0,0
"438","13103",2010,50513,50206,45918,1030,2.24,4288,653,15.23,307,0.61
"439","13105",2010,20421,20280,17621,286,1.62,2659,417,15.68,141,0.69
"440","13107",2010,22348,21496,18654,491,2.63,2842,402,14.14,852,3.81
"441","13109",2010,10966,10459,8798,292,3.32,1661,347,20.89,507,4.62
"442","13111",2010,23337,23268,19537,127,0.65,3731,485,13,69,0.3
"443","13113",2010,105344,104736,95806,1125,1.17,8930,1086,12.16,608,0.58
"444","13115",2010,95810,91964,78689,1938,2.46,13275,2654,19.99,3846,4.01
"445","13117",2010,163885,163537,149234,2447,1.64,14303,3291,23.01,348,0.21
"446","13119",2010,22121,21766,18796,545,2.9,2970,401,13.5,355,1.6
"447","13121",2010,886982,855674,656457,13039,1.99,199217,41981,21.07,31308,3.53
"448","13123",2010,28076,27856,23003,661,2.87,4853,1136,23.41,220,0.78
"449","13125",2010,3007,2944,2608,27,1.04,336,31,9.23,63,2.1
"450","13127",2010,77632,76770,64408,1498,2.33,12362,2116,17.12,862,1.11
"451","13129",2010,54059,53297,46284,678,1.46,7013,1487,21.2,762,1.41
"452","13131",2010,24738,24696,21288,372,1.75,3408,545,15.99,42,0.17
"453","13133",2010,15844,15715,13584,117,0.86,2131,484,22.71,129,0.81
"454","13135",2010,778022,773327,688637,16798,2.44,84690,21032,24.83,4695,0.6
"455","13137",2010,42212,37907,33299,519,1.56,4608,595,12.91,4305,10.2
"456","13139",2010,175001,170486,151084,3961,2.62,19402,4401,22.68,4515,2.58
"457","13141",2010,9649,7944,6779,72,1.06,1165,21,1.8,1705,17.67
"458","13143",2010,28574,27867,24645,676,2.74,3222,334,10.37,707,2.47
"459","13145",2010,30807,30049,27595,526,1.91,2454,235,9.58,758,2.46
"460","13147",2010,25024,24253,21380,342,1.6,2873,188,6.54,771,3.08
"461","13149",2010,11720,11646,10297,163,1.58,1349,175,12.97,74,0.63
"462","13151",2010,193717,192867,173796,3509,2.02,19071,3550,18.61,850,0.44
"463","13153",2010,134880,132964,113979,2579,2.26,18985,3694,19.46,1916,1.42
"464","13155",2010,9642,8374,7427,183,2.46,947,82,8.66,1268,13.15
"465","13157",2010,58347,57001,50802,874,1.72,6199,1152,18.58,1346,2.31
"466","13159",2010,13695,13623,12095,250,2.07,1528,213,13.94,72,0.53
"467","13161",2010,14558,14346,12721,191,1.5,1625,212,13.05,212,1.46
"468","13163",2010,16919,16570,14344,188,1.31,2226,199,8.94,349,2.06
"469","13165",2010,8400,8333,7149,288,4.03,1184,118,9.97,67,0.8
"470","13167",2010,9967,8411,7212,152,2.11,1199,168,14.01,1556,15.61
"471","13169",2010,28292,27378,24412,211,0.86,2966,527,17.77,914,3.23
"472","13171",2010,17837,17166,14887,381,2.56,2279,404,17.73,671,3.76
"473","13173",2010,9404,9121,8465,150,1.77,656,65,9.91,283,3.01
"474","13175",2010,48034,46698,40443,922,2.28,6255,801,12.81,1336,2.78
"475","13177",2010,27998,26809,24223,315,1.3,2586,331,12.8,1189,4.25
"476","13179",2010,63854,62532,55389,1187,2.14,7143,1196,16.74,1322,2.07
"477","13181",2010,8111,7954,6881,102,1.48,1073,63,5.87,157,1.94
"478","13183",2010,13142,12873,10941,239,2.18,1932,555,28.73,269,2.05
"479","13185",2010,104916,100510,82150,2367,2.88,18360,5492,29.91,4406,4.2
"480","13187",2010,28875,27044,22444,771,3.44,4600,1132,24.61,1831,6.34
"481","13189",2010,21719,21362,18727,364,1.94,2635,218,8.27,357,1.64
"482","13191",2010,13817,13817,11659,167,1.43,2158,296,13.72,0,0
"483","13193",2010,14553,12838,10620,219,2.06,2218,458,20.65,1715,11.78
"484","13195",2010,27798,27569,24960,570,2.28,2609,484,18.55,229,0.82
"485","13197",2010,8403,8393,6990,261,3.73,1403,142,10.12,10,0.12
"486","13199",2010,22425,21832,18753,515,2.75,3079,503,16.34,593,2.64
"487","13201",2010,6128,5903,5136,80,1.56,767,1,0.13,225,3.67
"488","13205",2010,23697,22042,19046,208,1.09,2996,439,14.65,1655,6.98
"489","13207",2010,25864,24742,21944,634,2.89,2798,455,16.26,1122,4.34
"490","13209",2010,9138,8163,7029,82,1.17,1134,169,14.9,975,10.67
"491","13211",2010,17741,17299,15352,249,1.62,1947,286,14.69,442,2.49
"492","13213",2010,39925,39925,34990,628,1.79,4935,1013,20.53,0,0
"493","13215",2010,187629,172025,142583,2988,2.1,29442,4120,13.99,15604,8.32
"494","13217",2010,96833,95215,85387,1786,2.09,9828,1961,19.95,1618,1.67
"495","13219",2010,31508,31036,28401,337,1.19,2635,398,15.1,472,1.5
"496","13221",2010,14556,14546,12820,588,4.59,1726,261,15.12,10,0.07
"497","13223",2010,134875,134126,122176,2729,2.23,11950,2358,19.73,749,0.56
"498","13225",2010,26883,24495,21348,522,2.45,3147,523,16.62,2388,8.88
"499","13227",2010,29155,28825,25175,444,1.76,3650,584,16,330,1.13
"500","13229",2010,18205,18011,15848,215,1.36,2163,321,14.84,194,1.07
"501","13231",2010,17411,17248,15968,368,2.3,1280,216,16.88,163,0.94
"502","13233",2010,41095,40573,35869,1033,2.88,4704,824,17.52,522,1.27
"503","13235",2010,11632,10338,8822,265,3,1516,116,7.65,1294,11.12
"504","13237",2010,20925,20680,18025,196,1.09,2655,298,11.22,245,1.17
"505","13239",2010,2528,2528,2102,20,0.95,426,75,17.61,0,0
"506","13241",2010,16266,16131,12866,142,1.1,3265,616,18.87,135,0.83
"507","13243",2010,7724,7382,6327,126,1.99,1055,58,5.5,342,4.43
"508","13245",2010,198170,185894,152820,4347,2.84,33074,5601,16.93,12276,6.19
"509","13247",2010,83135,82593,72907,1786,2.45,9686,2174,22.44,542,0.65
"510","13249",2010,4755,4755,4121,61,1.48,634,76,11.99,0,0
"511","13251",2010,14799,14193,12363,214,1.73,1830,327,17.87,606,4.09
"512","13253",2010,8797,8648,7548,311,4.12,1100,175,15.91,149,1.69
"513","13255",2010,63304,62625,54055,1365,2.53,8570,1686,19.67,679,1.07
"514","13257",2010,25876,24825,21414,861,4.02,3411,598,17.53,1051,4.06
"515","13259",2010,5831,5693,4758,38,0.8,935,100,10.7,138,2.37
"516","13261",2010,32865,31924,26956,670,2.49,4968,866,17.43,941,2.86
"517","13263",2010,6920,6911,5974,102,1.71,937,116,12.38,9,0.13
"518","13265",2010,2041,2031,1740,37,2.13,291,32,11,10,0.49
"519","13267",2010,24263,21672,19079,498,2.61,2593,425,16.39,2591,10.68
"520","13269",2010,8875,8361,7401,151,2.04,960,53,5.52,514,5.79
"521","13271",2010,16052,13082,10457,157,1.5,2625,423,16.11,2970,18.5
"522","13273",2010,9647,8985,7852,125,1.59,1133,70,6.18,662,6.86
"523","13275",2010,44451,43527,36688,1073,2.92,6839,968,14.15,924,2.08
"524","13277",2010,39823,38668,33926,1001,2.95,4742,676,14.26,1155,2.9
"525","13279",2010,27151,26554,22578,424,1.88,3976,711,17.88,597,2.2
"526","13281",2010,10430,9530,7874,128,1.63,1656,85,5.13,900,8.63
"527","13283",2010,6835,6472,5681,48,0.84,791,5,0.63,363,5.31
"528","13285",2010,65652,63245,54956,939,1.71,8289,1447,17.46,2407,3.67
"529","13287",2010,9025,8393,7497,100,1.33,896,36,4.02,632,7
"530","13289",2010,9385,9333,7979,104,1.3,1354,268,19.79,52,0.55
"531","13291",2010,21083,20667,17773,153,0.86,2894,228,7.88,416,1.97
"532","13293",2010,27308,26971,23074,487,2.11,3897,736,18.89,337,1.23
"533","13295",2010,67845,66707,58635,1775,3.03,8072,869,10.77,1138,1.68
"534","13297",2010,81491,81003,73276,1688,2.3,7727,1135,14.69,488,0.6
"535","13299",2010,36006,33716,28571,452,1.58,5145,798,15.51,2290,6.36
"536","13301",2010,5936,5863,4991,106,2.12,872,98,11.24,73,1.23
"537","13303",2010,21112,19199,16790,315,1.88,2409,229,9.51,1913,9.06
"538","13305",2010,29705,27213,23795,340,1.43,3418,544,15.92,2492,8.39
"539","13307",2010,2727,2727,2302,35,1.52,425,44,10.35,0,0
"540","13309",2010,7093,4702,4113,44,1.07,589,103,17.49,2391,33.71
"541","13311",2010,26498,26216,22731,445,1.96,3485,199,5.71,282,1.06
"542","13313",2010,99910,98778,86789,2319,2.67,11989,2701,22.53,1132,1.13
"543","13315",2010,9041,7167,6194,153,2.47,973,91,9.35,1874,20.73
"544","13317",2010,10580,10443,8728,160,1.83,1715,211,12.3,137,1.29
"545","13319",2010,9685,9330,8149,143,1.75,1181,90,7.62,355,3.67
"546","13321",2010,21712,21569,19018,516,2.71,2551,299,11.72,143,0.66
"547","15001",2010,180362,175900,147230,6248,4.24,28670,7172,25.02,4462,2.47
"548","15003",2010,936984,902832,786792,26086,3.32,116040,26576,22.9,34152,3.64
"549","15005",2010,74,74,15,0,0,59,0,0,0,0
"550","15007",2010,65460,64659,56238,2070,3.68,8421,2040,24.23,801,1.22
"551","15009",2010,150711,148282,126250,5835,4.62,22032,5692,25.84,2429,1.61
"552","16001",2010,380718,371878,307708,5974,1.94,64170,16172,25.2,8840,2.32
"553","16003",2010,3942,3932,3379,92,2.72,553,74,13.38,10,0.25
"554","16005",2010,80701,79090,66355,1315,1.98,12735,3130,24.58,1611,2
"555","16007",2010,6026,6026,5376,16,0.3,650,71,10.92,0,0
"556","16009",2010,9302,9184,8051,175,2.17,1133,143,12.62,118,1.27
"557","16011",2010,44496,44080,40255,516,1.28,3825,567,14.82,416,0.93
"558","16013",2010,21329,20859,16751,289,1.73,4108,757,18.43,470,2.2
"559","16015",2010,7122,6970,5940,112,1.89,1030,117,11.36,152,2.13
"560","16017",2010,40711,40152,33282,610,1.83,6870,1028,14.96,559,1.37
"561","16019",2010,100213,99420,87995,1542,1.75,11425,2339,20.47,793,0.79
"562","16021",2010,10792,10781,9252,479,5.18,1529,255,16.68,11,0.1
"563","16023",2010,2842,2776,2348,40,1.7,428,78,18.22,66,2.32
"564","16025",2010,1216,1216,1082,72,6.65,134,48,35.82,0,0
"565","16027",2010,182723,179069,158691,4209,2.65,20378,4739,23.26,3654,2
"566","16029",2010,6900,6838,6142,129,2.1,696,58,8.33,62,0.9
"567","16031",2010,22109,21806,19639,258,1.31,2167,292,13.47,303,1.37
"568","16033",2010,857,857,781,30,3.84,76,5,6.58,0,0
"569","16035",2010,8766,8044,6703,164,2.45,1341,182,13.57,722,8.24
"570","16037",2010,4277,4277,3440,52,1.51,837,78,9.32,0,0
"571","16039",2010,26669,26147,23315,382,1.64,2832,550,19.42,522,1.96
"572","16041",2010,12497,12497,11657,100,0.86,840,61,7.26,0,0
"573","16043",2010,13062,12987,11760,89,0.76,1227,137,11.17,75,0.57
"574","16045",2010,16778,16652,14308,285,1.99,2344,468,19.97,126,0.75
"575","16047",2010,15140,14955,12897,298,2.31,2058,339,16.47,185,1.22
"576","16049",2010,15947,15285,12741,319,2.5,2544,432,16.98,662,4.15
"577","16051",2010,24523,24415,22855,285,1.25,1560,274,17.56,108,0.44
"578","16053",2010,21282,21282,18690,305,1.63,2592,594,22.92,0,0
"579","16055",2010,134851,133750,112571,2852,2.53,21179,4517,21.33,1101,0.82
"580","16057",2010,36645,33130,24721,695,2.81,8409,2335,27.77,3515,9.59
"581","16059",2010,7861,7852,6368,315,4.95,1484,204,13.75,9,0.11
"582","16061",2010,3761,3751,2923,99,3.39,828,158,19.08,10,0.27
"583","16063",2010,5021,4906,4287,161,3.76,619,103,16.64,115,2.29
"584","16065",2010,36413,34451,26559,533,2.01,7892,5465,69.25,1962,5.39
"585","16067",2010,19524,19303,17355,611,3.52,1948,246,12.63,221,1.13
"586","16069",2010,38886,38258,31102,855,2.75,7156,1352,18.89,628,1.61
"587","16071",2010,4212,4202,3729,68,1.82,473,53,11.21,10,0.24
"588","16073",2010,11389,11283,10037,319,3.18,1246,249,19.98,106,0.93
"589","16075",2010,22451,22451,20001,472,2.36,2450,326,13.31,0,0
"590","16077",2010,7633,7510,6979,130,1.86,531,34,6.4,123,1.61
"591","16079",2010,12917,12727,10212,550,5.39,2515,341,13.56,190,1.47
"592","16081",2010,9413,9342,7886,241,3.06,1456,280,19.23,71,0.75
"593","16083",2010,74929,73777,63277,1472,2.33,10500,2182,20.78,1152,1.54
"594","16085",2010,9846,9797,8164,126,1.54,1633,237,14.51,49,0.5
"595","16087",2010,10105,9973,8675,135,1.56,1298,170,13.1,132,1.31
"596","17001",2010,67030,64689,53330,1130,2.12,11359,1868,16.45,2341,3.49
"597","17003",2010,8449,7902,6582,139,2.11,1320,47,3.56,547,6.47
"598","17005",2010,17904,17403,14855,449,3.02,2548,750,29.43,501,2.8
"599","17007",2010,53567,53338,48240,1200,2.49,5098,1000,19.62,229,0.43
"600","17009",2010,6897,4631,3836,79,2.06,795,64,8.05,2266,32.85
"601","17011",2010,35083,34716,29277,606,2.07,5439,752,13.83,367,1.05
"602","17013",2010,5118,5015,4137,50,1.21,878,163,18.56,103,2.01
"603","17015",2010,15615,15285,12864,387,3.01,2421,216,8.92,330,2.11
"604","17017",2010,13648,13158,11153,398,3.57,2005,442,22.04,490,3.59
"605","17019",2010,197867,180723,129746,3663,2.82,50977,16249,31.88,17144,8.66
"606","17021",2010,34936,33038,27140,623,2.3,5898,1002,16.99,1898,5.43
"607","17023",2010,16545,16089,13702,387,2.82,2387,281,11.77,456,2.76
"608","17025",2010,13927,13765,11234,395,3.52,2531,390,15.41,162,1.16
"609","17027",2010,37395,34570,29871,694,2.32,4699,700,14.9,2825,7.55
"610","17029",2010,53568,45562,34502,844,2.45,11060,2348,21.23,8006,14.95
"611","17031",2010,5172848,5089453,4184645,97623,2.33,904808,171748,18.98,83395,1.61
"612","17033",2010,19864,19306,16471,533,3.24,2835,253,8.92,558,2.81
"613","17035",2010,11073,11063,9695,309,3.19,1368,145,10.6,10,0.09
"614","17037",2010,104026,95445,74495,1466,1.97,20950,6705,32,8581,8.25
"615","17039",2010,16672,16672,14008,289,2.06,2664,506,18.99,0,0
"616","17041",2010,20012,19729,17149,336,1.96,2580,369,14.3,283,1.41
"617","17043",2010,911481,897835,781776,12697,1.62,116059,18435,15.88,13646,1.5
"618","17045",2010,18776,18270,15159,504,3.32,3111,334,10.74,506,2.69
"619","17047",2010,6707,6561,5530,19,0.34,1031,47,4.56,146,2.18
"620","17049",2010,34232,33906,28713,563,1.96,5193,797,15.35,326,0.95
"621","17051",2010,22007,21781,18515,493,2.66,3266,653,19.99,226,1.03
"622","17053",2010,14113,13397,11273,239,2.12,2124,199,9.37,716,5.07
"623","17055",2010,39528,39066,32484,926,2.85,6582,927,14.08,462,1.17
"624","17057",2010,37205,34367,28351,564,1.99,6016,1147,19.07,2838,7.63
"625","17059",2010,5773,5708,4752,122,2.57,956,192,20.08,65,1.13
"626","17061",2010,13983,13799,11718,250,2.13,2081,222,10.67,184,1.32
"627","17063",2010,48744,48599,42412,859,2.03,6187,1204,19.46,145,0.3
"628","17065",2010,8453,8361,7326,204,2.78,1035,42,4.06,92,1.09
"629","17067",2010,19227,19053,16032,308,1.92,3021,432,14.3,174,0.9
"630","17069",2010,4402,4261,3423,117,3.42,838,79,9.43,141,3.2
"631","17071",2010,7462,7385,6082,117,1.92,1303,179,13.74,77,1.03
"632","17073",2010,50477,49771,42255,749,1.77,7516,1215,16.17,706,1.4
"633","17075",2010,30068,28556,24586,498,2.03,3970,564,14.21,1512,5.03
"634","17077",2010,59864,54485,37328,947,2.54,17157,5540,32.29,5379,8.99
"635","17079",2010,9752,9612,8334,238,2.86,1278,117,9.15,140,1.44
"636","17081",2010,39202,36805,30750,774,2.52,6055,940,15.52,2397,6.11
"637","17083",2010,22932,22187,19398,491,2.53,2789,403,14.45,745,3.25
"638","17085",2010,22728,22426,18481,369,2,3945,666,16.88,302,1.33
"639","17087",2010,12710,9868,8502,41,0.48,1366,111,8.13,2842,22.36
"640","17089",2010,502628,497093,445933,9207,2.06,51160,9628,18.82,5535,1.1
"641","17091",2010,112100,107809,91957,3184,3.46,15852,3152,19.88,4291,3.83
"642","17093",2010,105602,105001,95783,1477,1.54,9218,1805,19.58,601,0.57
"643","17095",2010,52932,48253,39069,1208,3.09,9184,1112,12.11,4679,8.84
"644","17097",2010,697179,678511,604816,12174,2.01,73695,12521,16.99,18668,2.68
"645","17099",2010,113789,112104,95699,2359,2.47,16405,2044,12.46,1685,1.48
"646","17101",2010,16849,14126,11797,413,3.5,2329,224,9.62,2723,16.16
"647","17103",2010,36100,34575,29476,766,2.6,5099,715,14.02,1525,4.22
"648","17105",2010,39010,34784,29344,669,2.28,5440,571,10.5,4226,10.83
"649","17107",2010,30440,24901,20575,587,2.85,4326,528,12.21,5539,18.2
"650","17109",2010,32730,26990,19378,290,1.5,7612,1826,23.99,5740,17.54
"651","17111",2010,306050,304576,271728,4634,1.71,32848,6429,19.57,1474,0.48
"652","17113",2010,166706,157624,123005,2336,1.9,34619,10697,30.9,9082,5.45
"653","17115",2010,110719,107350,88099,2107,2.39,19251,2818,14.64,3369,3.04
"654","17117",2010,47980,46276,39067,857,2.19,7209,1134,15.73,1704,3.55
"655","17119",2010,268005,260774,216860,4284,1.98,43914,8539,19.44,7231,2.7
"656","17121",2010,39722,39189,33282,1014,3.05,5907,711,12.04,533,1.34
"657","17123",2010,12763,12425,10136,172,1.7,2289,395,17.26,338,2.65
"658","17125",2010,14921,14773,12365,247,2,2408,300,12.46,148,0.99
"659","17127",2010,15425,15118,12511,246,1.97,2607,451,17.3,307,1.99
"660","17129",2010,12702,12538,10939,170,1.55,1599,219,13.7,164,1.29
"661","17131",2010,16551,16226,14232,282,1.98,1994,284,14.24,325,1.96
"662","17133",2010,32431,32275,28673,606,2.11,3602,624,17.32,156,0.48
"663","17135",2010,30230,27322,22895,451,1.97,4427,576,13.01,2908,9.62
"664","17137",2010,35755,32004,26501,732,2.76,5503,692,12.57,3751,10.49
"665","17139",2010,14723,14253,12428,137,1.1,1825,217,11.89,470,3.19
"666","17141",2010,53578,52740,45673,942,2.06,7067,1074,15.2,838,1.56
"667","17143",2010,185108,178320,143911,3562,2.48,34409,5946,17.28,6788,3.67
"668","17145",2010,22488,19654,16404,503,3.07,3250,325,10,2834,12.6
"669","17147",2010,16708,16321,14256,187,1.31,2065,283,13.7,387,2.32
"670","17149",2010,16580,16062,13531,295,2.18,2531,432,17.07,518,3.12
"671","17151",2010,4426,4267,3633,13,0.36,634,67,10.57,159,3.59
"672","17153",2010,6262,6167,5334,196,3.67,833,43,5.16,95,1.52
"673","17155",2010,5982,5982,5027,93,1.85,955,157,16.44,0,0
"674","17157",2010,33567,28537,24476,500,2.04,4061,413,10.17,5030,14.98
"675","17159",2010,16166,15922,13443,236,1.76,2479,291,11.74,244,1.51
"676","17161",2010,147524,143039,116934,2651,2.27,26105,3714,14.23,4485,3.04
"677","17163",2010,266727,262379,222189,4819,2.17,40190,6184,15.39,4348,1.63
"678","17165",2010,25171,24442,20292,404,1.99,4150,566,13.64,729,2.9
"679","17167",2010,195288,191407,154915,3875,2.5,36492,5674,15.55,3881,1.99
"680","17169",2010,7527,7456,6321,305,4.83,1135,244,21.5,71,0.94
"681","17171",2010,5374,5364,4632,118,2.55,732,40,5.46,10,0.19
"682","17173",2010,22362,21824,18520,325,1.75,3304,309,9.35,538,2.41
"683","17175",2010,6086,6010,5219,190,3.64,791,80,10.11,76,1.25
"684","17177",2010,47791,47154,39156,868,2.22,7998,1158,14.48,637,1.33
"685","17179",2010,133863,130813,111858,1775,1.59,18955,2430,12.82,3050,2.28
"686","17181",2010,17959,16814,14647,504,3.44,2167,165,7.61,1145,6.38
"687","17183",2010,82033,80615,66546,2042,3.07,14069,2492,17.71,1418,1.73
"688","17185",2010,12141,12077,10445,372,3.56,1632,185,11.34,64,0.53
"689","17187",2010,17745,16655,13893,300,2.16,2762,367,13.29,1090,6.14
"690","17189",2010,14841,14522,12490,210,1.68,2032,248,12.2,319,2.15
"691","17191",2010,16846,16807,14173,231,1.63,2634,311,11.81,39,0.23
"692","17193",2010,14800,14409,12059,204,1.69,2350,279,11.87,391,2.64
"693","17195",2010,58750,57738,48558,1372,2.83,9180,1581,17.22,1012,1.72
"694","17197",2010,667977,660372,599584,10442,1.74,60788,11270,18.54,7605,1.14
"695","17199",2010,65579,63871,53377,1173,2.2,10494,1562,14.88,1708,2.6
"696","17201",2010,293972,288156,242942,6443,2.65,45214,7762,17.17,5816,1.98
"697","17203",2010,38226,36972,33106,438,1.32,3866,434,11.23,1254,3.28
"698","18001",2010,34162,33768,29985,494,1.65,3783,426,11.26,394,1.15
"699","18003",2010,351332,345819,289961,6880,2.37,55858,9977,17.86,5513,1.57
"700","18005",2010,75855,74680,63201,1408,2.23,11479,2437,21.23,1175,1.55
"701","18007",2010,8820,8820,7329,157,2.14,1491,270,18.11,0,0
"702","18009",2010,12960,12915,10852,421,3.88,2063,284,13.77,45,0.35
"703","18011",2010,54796,53752,47707,739,1.55,6045,907,15,1044,1.91
"704","18013",2010,15271,15183,13310,276,2.07,1873,197,10.52,88,0.58
"705","18015",2010,20135,19919,17223,306,1.78,2696,340,12.61,216,1.07
"706","18017",2010,39058,37590,31813,773,2.43,5777,1201,20.79,1468,3.76
"707","18019",2010,107381,106085,88548,2553,2.88,17537,2966,16.91,1296,1.21
"708","18021",2010,26983,26720,23319,595,2.55,3401,670,19.7,263,0.97
"709","18023",2010,33270,32355,28238,846,3,4117,546,13.26,915,2.75
"710","18025",2010,10825,10692,9237,203,2.2,1455,166,11.41,133,1.23
"711","18027",2010,31045,30809,26791,662,2.47,4018,652,16.23,236,0.76
"712","18029",2010,49580,49231,43338,947,2.19,5893,1119,18.99,349,0.7
"713","18031",2010,25584,25080,22016,585,2.66,3064,356,11.62,504,1.97
"714","18033",2010,41968,41418,35988,881,2.45,5430,789,14.53,550,1.31
"715","18035",2010,117344,109540,84019,2145,2.55,25521,7650,29.98,7804,6.65
"716","18037",2010,41809,40223,34987,534,1.53,5236,607,11.59,1586,3.79
"717","18039",2010,196855,194358,169627,5319,3.14,24731,5072,20.51,2497,1.27
"718","18041",2010,24367,23969,20308,515,2.54,3661,517,14.12,398,1.63
"719","18043",2010,73594,72423,62408,1410,2.26,10015,1579,15.77,1171,1.59
"720","18045",2010,17329,17115,14592,357,2.45,2523,364,14.43,214,1.23
"721","18047",2010,23194,22915,20230,344,1.7,2685,581,21.64,279,1.2
"722","18049",2010,20684,20293,17350,466,2.69,2943,512,17.4,391,1.89
"723","18051",2010,33386,32485,27206,462,1.7,5279,795,15.06,901,2.7
"724","18053",2010,70176,65939,55044,1479,2.69,10895,1784,16.37,4237,6.04
"725","18055",2010,33084,32847,28027,937,3.34,4820,641,13.3,237,0.72
"726","18057",2010,261244,260256,232533,2272,0.98,27723,4487,16.19,988,0.38
"727","18059",2010,68011,67182,60007,941,1.57,7175,1206,16.81,829,1.22
"728","18061",2010,38616,38346,33989,556,1.64,4357,754,17.31,270,0.7
"729","18063",2010,140028,137041,123037,1860,1.51,14004,2149,15.35,2987,2.13
"730","18065",2010,48921,46125,39560,796,2.01,6565,715,10.89,2796,5.72
"731","18067",2010,83326,80855,68335,1495,2.19,12520,1609,12.85,2471,2.97
"732","18069",2010,37321,36082,31075,761,2.45,5007,752,15.02,1239,3.32
"733","18071",2010,41902,41533,36059,734,2.04,5474,858,15.67,369,0.88
"734","18073",2010,33055,31851,28414,563,1.98,3437,425,12.37,1204,3.64
"735","18075",2010,21441,21182,18187,637,3.5,2995,470,15.69,259,1.21
"736","18077",2010,32393,30353,25217,508,2.01,5136,794,15.46,2040,6.3
"737","18079",2010,28470,28069,24303,648,2.67,3766,615,16.33,401,1.41
"738","18081",2010,135994,131342,114050,2304,2.02,17292,2781,16.08,4652,3.42
"739","18083",2010,38425,35638,29773,657,2.21,5865,711,12.12,2787,7.25
"740","18085",2010,76982,76005,65984,1675,2.54,10021,1564,15.61,977,1.27
"741","18087",2010,36996,36928,33753,751,2.22,3175,595,18.74,68,0.18
"742","18089",2010,494417,488011,418403,9217,2.2,69608,10065,14.46,6406,1.3
"743","18091",2010,110937,103546,87653,2207,2.52,15893,2384,15,7391,6.66
"744","18093",2010,46192,45673,39116,710,1.82,6557,929,14.17,519,1.12
"745","18095",2010,131444,126212,104464,2978,2.85,21748,3884,17.86,5232,3.98
"746","18097",2010,890976,872726,688912,22930,3.33,183814,38022,20.69,18250,2.05
"747","18099",2010,46976,46453,40789,987,2.42,5664,788,13.91,523,1.11
"748","18101",2010,10324,10245,8808,172,1.95,1437,187,13.01,79,0.77
"749","18103",2010,37307,35588,30818,853,2.77,4770,777,16.29,1719,4.61
"750","18105",2010,134442,120060,78884,1918,2.43,41176,16637,40.4,14382,10.7
"751","18107",2010,38138,36679,31407,584,1.86,5272,971,18.42,1459,3.83
"752","18109",2010,68654,68020,61320,1526,2.49,6700,886,13.22,634,0.92
"753","18111",2010,14300,14099,12279,201,1.64,1820,317,17.42,201,1.41
"754","18113",2010,47513,46715,41206,1102,2.67,5509,836,15.18,798,1.68
"755","18115",2010,6067,6057,5311,177,3.33,746,141,18.9,10,0.16
"756","18117",2010,19820,19441,16520,320,1.94,2921,519,17.77,379,1.91
"757","18119",2010,21737,21574,18293,908,4.96,3281,668,20.36,163,0.75
"758","18121",2010,17394,15376,12910,457,3.54,2466,402,16.3,2018,11.6
"759","18123",2010,19316,17751,14842,369,2.49,2909,428,14.71,1565,8.1
"760","18125",2010,12955,12639,10836,272,2.51,1803,315,17.47,316,2.44
"761","18127",2010,162026,159177,136242,3325,2.44,22935,4328,18.87,2849,1.76
"762","18129",2010,26100,25728,22710,273,1.2,3018,361,11.96,372,1.43
"763","18131",2010,13596,13423,11912,233,1.96,1511,186,12.31,173,1.27
"764","18133",2010,38048,32927,28423,617,2.17,4504,848,18.83,5121,13.46
"765","18135",2010,26262,26013,22519,550,2.44,3494,453,12.97,249,0.95
"766","18137",2010,28570,28336,24694,438,1.77,3642,591,16.23,234,0.82
"767","18139",2010,17568,17290,15448,317,2.05,1842,172,9.34,278,1.58
"768","18141",2010,266522,253262,209735,4754,2.27,43527,7957,18.28,13260,4.98
"769","18143",2010,24109,23688,20626,638,3.09,3062,442,14.44,421,1.75
"770","18145",2010,44237,43554,37835,868,2.29,5719,755,13.2,683,1.54
"771","18147",2010,20977,20670,17830,197,1.1,2840,592,20.85,307,1.46
"772","18149",2010,23343,23105,20157,446,2.21,2948,415,14.08,238,1.02
"773","18151",2010,34092,33399,28420,715,2.52,4979,935,18.78,693,2.03
"774","18153",2010,21520,19386,16011,223,1.39,3375,658,19.5,2134,9.92
"775","18155",2010,10393,10265,8577,275,3.21,1688,363,21.5,128,1.23
"776","18157",2010,168635,153493,112564,3229,2.87,40929,13985,34.17,15142,8.98
"777","18159",2010,16132,15747,13317,240,1.8,2430,447,18.4,385,2.39
"778","18161",2010,7463,7463,6655,93,1.4,808,81,10.02,0,0
"779","18163",2010,178298,171874,137018,3393,2.48,34856,6516,18.69,6424,3.6
"780","18165",2010,16412,15881,13255,204,1.54,2626,424,16.15,531,3.24
"781","18167",2010,107151,98005,78352,2040,2.6,19653,4231,21.53,9146,8.54
"782","18169",2010,33225,31026,26517,518,1.95,4509,537,11.91,2199,6.62
"783","18171",2010,8563,8356,7401,140,1.89,955,128,13.4,207,2.42
"784","18173",2010,58393,57792,51378,1052,2.05,6414,1162,18.12,601,1.03
"785","18175",2010,28226,27946,24335,602,2.47,3611,585,16.2,280,0.99
"786","18177",2010,69187,66920,56161,1573,2.8,10759,1631,15.16,2267,3.28
"787","18179",2010,27744,27061,23585,341,1.45,3476,563,16.2,683,2.46
"788","18181",2010,24734,24334,21061,665,3.16,3273,540,16.5,400,1.62
"789","18183",2010,32991,32681,27501,373,1.36,5180,930,17.95,310,0.94
"790","19001",2010,7779,7778,6279,121,1.93,1499,256,17.08,1,0.01
"791","19003",2010,4127,3944,3220,131,4.07,724,71,9.81,183,4.43
"792","19005",2010,14331,13762,11368,235,2.07,2394,425,17.75,569,3.97
"793","19007",2010,13029,12954,10767,289,2.68,2187,175,8,75,0.58
"794","19009",2010,6186,5996,4850,57,1.18,1146,147,12.83,190,3.07
"795","19011",2010,26098,25964,23050,406,1.76,2914,324,11.12,134,0.51
"796","19013",2010,129252,123346,96195,2443,2.54,27151,7738,28.5,5906,4.57
"797","19015",2010,26424,25754,21368,431,2.02,4386,796,18.15,670,2.54
"798","19017",2010,24185,23073,19475,284,1.46,3598,894,24.85,1112,4.6
"799","19019",2010,21026,20388,17698,332,1.88,2690,443,16.47,638,3.03
"800","19021",2010,19980,19022,15887,403,2.54,3135,570,18.18,958,4.79
"801","19023",2010,14892,14540,12455,160,1.28,2085,281,13.48,352,2.36
"802","19025",2010,9846,9129,7618,140,1.84,1511,155,10.26,717,7.28
"803","19027",2010,20805,19852,16449,327,1.99,3403,351,10.31,953,4.58
"804","19029",2010,13969,13546,11183,240,2.15,2363,312,13.2,423,3.03
"805","19031",2010,18414,18321,15593,288,1.85,2728,424,15.54,93,0.51
"806","19033",2010,44324,43124,33537,656,1.96,9587,1604,16.73,1200,2.71
"807","19035",2010,12086,11885,9514,108,1.14,2371,271,11.43,201,1.66
"808","19037",2010,12499,12138,10178,200,1.97,1960,214,10.92,361,2.89
"809","19039",2010,9218,9141,7861,496,6.31,1280,172,13.44,77,0.84
"810","19041",2010,16718,16306,13368,258,1.93,2938,297,10.11,412,2.46
"811","19043",2010,18202,17754,14681,317,2.16,3073,473,15.39,448,2.46
"812","19045",2010,49274,48537,40328,1018,2.52,8209,1355,16.51,737,1.5
"813","19047",2010,16951,16317,13897,335,2.41,2420,331,13.68,634,3.74
"814","19049",2010,61714,61331,52311,925,1.77,9020,1662,18.43,383,0.62
"815","19051",2010,8687,8608,7678,47,0.61,930,59,6.34,79,0.91
"816","19053",2010,8508,7721,6355,140,2.2,1366,270,19.77,787,9.25
"817","19055",2010,17857,17769,14954,209,1.4,2815,419,14.88,88,0.49
"818","19057",2010,40266,39869,32608,829,2.54,7261,1426,19.64,397,0.99
"819","19059",2010,16665,16384,13024,311,2.39,3360,410,12.2,281,1.69
"820","19061",2010,92547,87983,73064,1053,1.44,14919,2737,18.35,4564,4.93
"821","19063",2010,10389,9868,8086,221,2.73,1782,318,17.85,521,5.01
"822","19065",2010,20992,20152,16715,423,2.53,3437,582,16.93,840,4
"823","19067",2010,16394,15937,13268,221,1.67,2669,287,10.75,457,2.79
"824","19069",2010,10697,10456,8656,183,2.11,1800,401,22.28,241,2.25
"825","19071",2010,7528,7414,6272,179,2.85,1142,122,10.68,114,1.51
"826","19073",2010,9448,9379,7667,102,1.33,1712,218,12.73,69,0.73
"827","19075",2010,12401,12250,10594,108,1.02,1656,203,12.26,151,1.22
"828","19077",2010,11040,10830,9208,156,1.69,1622,174,10.73,210,1.9
"829","19079",2010,15874,15661,12877,251,1.95,2784,437,15.7,213,1.34
"830","19081",2010,11505,11340,9839,253,2.57,1501,186,12.39,165,1.43
"831","19083",2010,17685,16747,13704,255,1.86,3043,466,15.31,938,5.3
"832","19085",2010,15073,14768,12839,184,1.43,1929,184,9.54,305,2.02
"833","19087",2010,20263,19833,17134,574,3.35,2699,353,13.08,430,2.12
"834","19089",2010,9610,9205,7449,146,1.96,1756,286,16.29,405,4.21
"835","19091",2010,9905,9741,8015,188,2.35,1726,240,13.9,164,1.66
"836","19093",2010,7172,7092,5741,97,1.69,1351,249,18.43,80,1.12
"837","19095",2010,16353,15883,13622,220,1.62,2261,315,13.93,470,2.87
"838","19097",2010,19942,19619,16588,151,0.91,3031,371,12.24,323,1.62
"839","19099",2010,37050,34576,28778,724,2.52,5798,930,16.04,2474,6.68
"840","19101",2010,16643,15726,12592,185,1.47,3134,542,17.29,917,5.51
"841","19103",2010,126994,118370,81569,1610,1.97,36801,13134,35.69,8624,6.79
"842","19105",2010,20708,18934,15778,326,2.07,3156,519,16.44,1774,8.57
"843","19107",2010,10614,10411,8528,130,1.52,1883,277,14.71,203,1.91
"844","19109",2010,15748,15417,12814,67,0.52,2603,324,12.45,331,2.1
"845","19111",2010,35991,33678,28375,1055,3.72,5303,693,13.07,2313,6.43
"846","19113",2010,207765,202389,162903,4132,2.54,39486,7945,20.12,5376,2.59
"847","19115",2010,11683,11423,9992,332,3.32,1431,234,16.35,260,2.23
"848","19117",2010,9116,9056,7705,180,2.34,1351,146,10.81,60,0.66
"849","19119",2010,11564,11170,9860,84,0.85,1310,137,10.46,394,3.41
"850","19121",2010,15488,15216,13368,287,2.15,1848,310,16.77,272,1.76
"851","19123",2010,22382,21464,18071,529,2.93,3393,593,17.48,918,4.1
"852","19125",2010,33378,31854,27763,331,1.19,4091,631,15.42,1524,4.57
"853","19127",2010,40131,38849,32611,645,1.98,6238,928,14.88,1282,3.19
"854","19129",2010,15157,14298,12599,128,1.02,1699,218,12.83,859,5.67
"855","19131",2010,10801,10530,9036,156,1.73,1494,108,7.23,271,2.51
"856","19133",2010,9346,9162,7443,226,3.04,1719,204,11.87,184,1.97
"857","19135",2010,7918,7846,6746,76,1.13,1100,103,9.36,72,0.91
"858","19137",2010,10901,10680,8885,285,3.21,1795,249,13.87,221,2.03
"859","19139",2010,42501,42103,35782,960,2.68,6321,1191,18.84,398,0.94
"860","19141",2010,14419,14110,11863,168,1.42,2247,168,7.48,309,2.14
"861","19143",2010,6576,6474,5446,83,1.52,1028,92,8.95,102,1.55
"862","19145",2010,16095,13986,11750,241,2.05,2236,173,7.74,2109,13.1
"863","19147",2010,9508,8923,7161,46,0.64,1762,224,12.71,585,6.15
"864","19149",2010,24933,24851,21748,304,1.4,3103,398,12.83,82,0.33
"865","19151",2010,7509,7222,5726,123,2.15,1496,184,12.3,287,3.82
"866","19153",2010,419301,411028,337527,7634,2.26,73501,13966,19,8273,1.97
"867","19155",2010,91928,89368,75205,2130,2.83,14163,2627,18.55,2560,2.78
"868","19157",2010,19012,17094,13808,259,1.88,3286,494,15.03,1918,10.09
"869","19159",2010,5169,5043,4306,61,1.42,737,91,12.35,126,2.44
"870","19161",2010,10480,10281,8535,87,1.02,1746,171,9.79,199,1.9
"871","19163",2010,162184,158921,129115,2946,2.28,29806,5585,18.74,3263,2.01
"872","19165",2010,12328,11998,10216,188,1.84,1782,171,9.6,330,2.68
"873","19167",2010,33377,31295,27815,540,1.94,3480,491,14.11,2082,6.24
"874","19169",2010,87594,80065,54832,1088,1.98,25233,9581,37.97,7529,8.6
"875","19171",2010,17952,17425,14912,388,2.6,2513,454,18.07,527,2.94
"876","19173",2010,6402,6374,5332,87,1.63,1042,126,12.09,28,0.44
"877","19175",2010,12409,12122,9917,343,3.46,2205,345,15.65,287,2.31
"878","19177",2010,7645,7404,6274,94,1.5,1130,167,14.78,241,3.15
"879","19179",2010,35553,35053,28931,993,3.43,6122,1024,16.73,500,1.41
"880","19181",2010,45346,43719,38077,577,1.52,5642,1070,18.96,1627,3.59
"881","19183",2010,21626,21384,18156,551,3.03,3228,434,13.44,242,1.12
"882","19185",2010,6404,6375,5257,65,1.24,1118,157,14.04,29,0.45
"883","19187",2010,38286,37209,29832,1013,3.4,7377,1202,16.29,1077,2.81
"884","19189",2010,10962,10524,8757,104,1.19,1767,156,8.83,438,4
"885","19191",2010,21031,18872,15743,231,1.47,3129,634,20.26,2159,10.27
"886","19193",2010,101217,97652,81804,2351,2.87,15848,2830,17.86,3565,3.52
"887","19195",2010,7628,7576,6431,212,3.3,1145,121,10.57,52,0.68
"888","19197",2010,13384,13134,10827,346,3.2,2307,339,14.69,250,1.87
"889","20001",2010,13473,13176,11086,208,1.88,2090,324,15.5,297,2.2
"890","20003",2010,8084,7927,7011,45,0.64,916,90,9.83,157,1.94
"891","20005",2010,16889,15628,13248,384,2.9,2380,267,11.22,1261,7.47
"892","20007",2010,4900,4807,3880,67,1.73,927,97,10.46,93,1.9
"893","20009",2010,27499,27103,22833,644,2.82,4270,445,10.42,396,1.44
"894","20011",2010,15097,14871,12848,409,3.18,2023,201,9.94,226,1.5
"895","20013",2010,10019,9948,8399,246,2.93,1549,142,9.17,71,0.71
"896","20015",2010,64853,63074,56136,898,1.6,6938,904,13.03,1779,2.74
"897","20017",2010,2834,2824,2423,31,1.28,401,29,7.23,10,0.35
"898","20019",2010,3736,3583,2966,78,2.63,617,85,13.78,153,4.1
"899","20021",2010,21740,21518,18373,557,3.03,3145,405,12.88,222,1.02
"900","20023",2010,2783,2773,2243,24,1.07,530,23,4.34,10,0.36
"901","20025",2010,2231,2221,1858,58,3.12,363,8,2.2,10,0.45
"902","20027",2010,8531,8244,6889,161,2.34,1355,162,11.96,287,3.36
"903","20029",2010,9538,9046,7437,131,1.76,1609,156,9.7,492,5.16
"904","20031",2010,8587,8189,7084,231,3.26,1105,123,11.13,398,4.63
"905","20033",2010,1865,1789,1440,3,0.21,349,18,5.16,76,4.08
"906","20035",2010,36140,34390,28824,952,3.3,5566,938,16.85,1750,4.84
"907","20037",2010,38985,37246,28743,884,3.08,8503,2138,25.14,1739,4.46
"908","20039",2010,3015,2900,2296,26,1.13,604,25,4.14,115,3.81
"909","20041",2010,19643,19559,16898,441,2.61,2661,404,15.18,84,0.43
"910","20043",2010,7957,7683,6400,125,1.95,1283,215,16.76,274,3.44
"911","20045",2010,109052,99067,68884,1747,2.54,30183,10575,35.04,9985,9.16
"912","20047",2010,3052,2976,2549,57,2.24,427,12,2.81,76,2.49
"913","20049",2010,2930,2804,2400,16,0.67,404,16,3.96,126,4.3
"914","20051",2010,28039,26236,19761,393,1.99,6475,1445,22.32,1803,6.43
"915","20053",2010,6476,5832,4704,92,1.96,1128,175,15.51,644,9.94
"916","20055",2010,36139,35668,31728,890,2.81,3940,887,22.51,471,1.3
"917","20057",2010,32727,32489,28001,1084,3.87,4488,1337,29.79,238,0.73
"918","20059",2010,25841,25384,21698,513,2.36,3686,618,16.77,457,1.77
"919","20061",2010,30537,30302,26313,479,1.82,3989,799,20.03,235,0.77
"920","20063",2010,2721,2711,2357,20,0.85,354,22,6.21,10,0.37
"921","20065",2010,2663,2651,2125,67,3.15,526,45,8.56,12,0.45
"922","20067",2010,7744,7593,6927,68,0.98,666,38,5.71,151,1.95
"923","20069",2010,5870,5858,5320,54,1.02,538,68,12.64,12,0.2
"924","20071",2010,1294,1284,1136,18,1.58,148,14,9.46,10,0.77
"925","20073",2010,6824,6769,5521,141,2.55,1248,127,10.18,55,0.81
"926","20075",2010,2643,2550,2207,44,1.99,343,13,3.79,93,3.52
"927","20077",2010,6033,5785,4804,94,1.96,981,125,12.74,248,4.11
"928","20079",2010,34150,32695,27498,564,2.05,5197,951,18.3,1455,4.26
"929","20081",2010,4196,4186,3696,35,0.95,490,88,17.96,10,0.24
"930","20083",2010,1955,1945,1690,4,0.24,255,6,2.35,10,0.51
"931","20085",2010,13360,13005,11634,260,2.23,1371,153,11.16,355,2.66
"932","20087",2010,19059,19000,16748,296,1.77,2252,461,20.47,59,0.31
"933","20089",2010,3151,3151,2606,26,1,545,61,11.19,0,0
"934","20091",2010,531228,527148,445591,7718,1.73,81557,14788,18.13,4080,0.77
"935","20093",2010,3966,3955,3482,75,2.15,473,63,13.32,11,0.28
"936","20095",2010,7949,7679,6382,105,1.65,1297,188,14.49,270,3.4
"937","20097",2010,2671,2442,2155,41,1.9,287,23,8.01,229,8.57
"938","20099",2010,21791,20660,17358,374,2.15,3302,395,11.96,1131,5.19
"939","20101",2010,1725,1653,1366,11,0.81,287,11,3.83,72,4.17
"940","20103",2010,74611,67780,59402,1006,1.69,8378,1282,15.3,6831,9.16
"941","20105",2010,3308,3156,2600,64,2.46,556,49,8.81,152,4.59
"942","20107",2010,9782,9772,8426,155,1.84,1346,131,9.73,10,0.1
"943","20109",2010,2774,2764,2167,11,0.51,597,47,7.87,10,0.36
"944","20111",2010,34974,32972,25701,869,3.38,7271,1819,25.02,2002,5.72
"945","20113",2010,29178,27389,23877,298,1.25,3512,207,5.89,1789,6.13
"946","20115",2010,12689,11573,10038,122,1.22,1535,130,8.47,1116,8.8
"947","20117",2010,10147,9870,8276,125,1.51,1594,121,7.59,277,2.73
"948","20119",2010,4523,4513,3924,55,1.4,589,63,10.7,10,0.22
"949","20121",2010,32116,31470,28227,810,2.87,3243,445,13.72,646,2.01
"950","20123",2010,6383,6309,5263,29,0.55,1046,99,9.46,74,1.16
"951","20125",2010,35453,34891,29129,683,2.34,5762,933,16.19,562,1.59
"952","20127",2010,5946,5838,4775,21,0.44,1063,107,10.07,108,1.82
"953","20129",2010,3244,3120,2756,9,0.33,364,45,12.36,124,3.82
"954","20131",2010,10253,9548,8214,105,1.28,1334,96,7.2,705,6.88
"955","20133",2010,16538,14824,12111,126,1.04,2713,343,12.64,1714,10.36
"956","20135",2010,3120,3048,2594,28,1.08,454,18,3.96,72,2.31
"957","20137",2010,5692,4782,3725,91,2.44,1057,87,8.23,910,15.99
"958","20139",2010,16426,16334,14438,364,2.52,1896,177,9.34,92,0.56
"959","20141",2010,3906,3830,3097,30,0.97,733,67,9.14,76,1.95
"960","20143",2010,6107,6025,5256,101,1.92,769,176,22.89,82,1.34
"961","20145",2010,6913,4988,4180,39,0.93,808,64,7.92,1925,27.85
"962","20147",2010,5601,5338,4474,100,2.24,864,94,10.88,263,4.7
"963","20149",2010,20781,20662,18062,154,0.85,2600,452,17.38,119,0.57
"964","20151",2010,9670,8981,7374,89,1.21,1607,153,9.52,689,7.13
"965","20153",2010,2594,2594,2106,42,1.99,488,56,11.48,0,0
"966","20155",2010,64054,60118,49879,1301,2.61,10239,1356,13.24,3936,6.14
"967","20157",2010,5069,4834,3909,29,0.74,925,51,5.51,235,4.64
"968","20159",2010,10128,9724,8179,243,2.97,1545,204,13.2,404,3.99
"969","20161",2010,69035,60877,40822,829,2.03,20055,8546,42.61,8158,11.82
"970","20163",2010,5241,5193,4274,84,1.97,919,69,7.51,48,0.92
"971","20165",2010,3290,3280,2606,51,1.96,674,77,11.42,10,0.3
"972","20167",2010,6915,6915,5532,116,2.1,1383,142,10.27,0,0
"973","20169",2010,54982,53701,44495,1293,2.91,9206,1429,15.52,1281,2.33
"974","20171",2010,4832,4822,4186,12,0.29,636,53,8.33,10,0.21
"975","20173",2010,486123,481153,401987,8880,2.21,79166,13336,16.85,4970,1.02
"976","20175",2010,22588,21980,19314,487,2.52,2666,678,25.43,608,2.69
"977","20177",2010,175537,171841,140434,4335,3.09,31407,5017,15.97,3696,2.11
"978","20179",2010,2578,2501,1996,56,2.81,505,96,19.01,77,2.99
"979","20181",2010,6002,5873,4881,185,3.79,992,125,12.6,129,2.15
"980","20183",2010,3934,3847,3312,123,3.71,535,20,3.74,87,2.21
"981","20185",2010,4433,4337,3524,48,1.36,813,80,9.84,96,2.17
"982","20187",2010,2197,2029,1810,27,1.49,219,29,13.24,168,7.65
"983","20189",2010,5533,5288,4760,4,0.08,528,60,11.36,245,4.43
"984","20191",2010,24257,24068,20584,379,1.84,3484,448,12.86,189,0.78
"985","20193",2010,7757,7138,5693,197,3.46,1445,207,14.33,619,7.98
"986","20195",2010,2979,2918,2482,30,1.21,436,21,4.82,61,2.05
"987","20197",2010,7004,6994,6190,114,1.84,804,53,6.59,10,0.14
"988","20199",2010,1440,1372,1158,10,0.86,214,7,3.27,68,4.72
"989","20201",2010,5851,5690,4659,45,0.97,1031,100,9.7,161,2.75
"990","20203",2010,2244,2234,1941,46,2.37,293,46,15.7,10,0.45
"991","20205",2010,9598,9273,7955,323,4.06,1318,163,12.37,325,3.39
"992","20207",2010,3352,3343,2505,97,3.87,838,163,19.45,9,0.27
"993","20209",2010,155462,154076,128460,4784,3.72,25616,4825,18.84,1386,0.89
"994","21001",2010,18542,17550,14967,313,2.09,2583,315,12.2,992,5.35
"995","21003",2010,19688,19274,16643,324,1.95,2631,346,13.15,414,2.1
"996","21005",2010,21080,20899,18180,421,2.32,2719,548,20.15,181,0.86
"997","21007",2010,8225,8225,7050,196,2.78,1175,220,18.72,0,0
"998","21009",2010,41685,41103,35423,565,1.6,5680,675,11.88,582,1.4
"999","21011",2010,11565,11329,9855,215,2.18,1474,224,15.2,236,2.04
"1000","21013",2010,28793,27634,23744,612,2.58,3890,563,14.47,1159,4.03
"1001","21015",2010,114723,114026,100252,1794,1.79,13774,2681,19.46,697,0.61
"1002","21017",2010,19947,19563,16656,553,3.32,2907,323,11.11,384,1.93
"1003","21019",2010,49330,46747,39497,932,2.36,7250,744,10.26,2583,5.24
"1004","21021",2010,28245,25607,21910,595,2.72,3697,453,12.25,2638,9.34
"1005","21023",2010,8479,8479,7359,173,2.35,1120,187,16.7,0,0
"1006","21025",2010,14202,14005,11824,239,2.02,2181,262,12.01,197,1.39
"1007","21027",2010,19893,19473,16975,338,1.99,2498,447,17.89,420,2.11
"1008","21029",2010,72515,72124,63801,1729,2.71,8323,1475,17.72,391,0.54
"1009","21031",2010,12763,12597,10763,230,2.14,1834,262,14.29,166,1.3
"1010","21033",2010,12934,12866,10592,154,1.45,2274,431,18.95,68,0.53
"1011","21035",2010,36763,33518,26218,562,2.14,7300,1564,21.42,3245,8.83
"1012","21037",2010,89016,84982,70126,1168,1.67,14856,2013,13.55,4034,4.53
"1013","21039",2010,5126,5038,4432,112,2.53,606,54,8.91,88,1.72
"1014","21041",2010,10703,10583,8838,244,2.76,1745,507,29.05,120,1.12
"1015","21043",2010,27821,26709,22987,401,1.74,3722,655,17.6,1112,4
"1016","21045",2010,15939,15664,13678,257,1.88,1986,189,9.52,275,1.73
"1017","21047",2010,72678,67236,58975,1054,1.79,8261,1084,13.12,5442,7.49
"1018","21049",2010,35305,35105,30134,1018,3.38,4971,801,16.11,200,0.57
"1019","21051",2010,22197,20897,18471,382,2.07,2426,398,16.41,1300,5.86
"1020","21053",2010,10161,10151,8736,87,1,1415,78,5.51,10,0.1
"1021","21055",2010,9313,9183,7634,70,0.92,1549,252,16.27,130,1.4
"1022","21057",2010,6931,6865,5862,23,0.39,1003,108,10.77,66,0.95
"1023","21059",2010,95398,92060,77814,1824,2.34,14246,1807,12.68,3338,3.5
"1024","21061",2010,12086,11530,10056,92,0.91,1474,228,15.47,556,4.6
"1025","21063",2010,7493,6468,5643,112,1.98,825,60,7.27,1025,13.68
"1026","21065",2010,14733,14599,12756,322,2.52,1843,169,9.17,134,0.91
"1027","21067",2010,288045,276491,207367,5308,2.56,69124,17953,25.97,11554,4.01
"1028","21069",2010,14318,14186,12460,167,1.34,1726,150,8.69,132,0.92
"1029","21071",2010,39949,38597,32702,636,1.94,5895,1084,18.39,1352,3.38
"1030","21073",2010,49067,47071,37632,952,2.53,9439,1312,13.9,1996,4.07
"1031","21075",2010,6858,6498,5565,139,2.5,933,67,7.18,360,5.25
"1032","21077",2010,8428,8182,6789,202,2.98,1393,385,27.64,246,2.92
"1033","21079",2010,16842,16833,14827,618,4.17,2006,239,11.91,9,0.05
"1034","21081",2010,24604,24527,21991,651,2.96,2536,528,20.82,77,0.31
"1035","21083",2010,36958,36250,31008,618,1.99,5242,743,14.17,708,1.92
"1036","21085",2010,25540,25306,21438,315,1.47,3868,718,18.56,234,0.92
"1037","21087",2010,11377,11217,9897,222,2.24,1320,115,8.71,160,1.41
"1038","21089",2010,36962,36459,31732,497,1.57,4727,415,8.78,503,1.36
"1039","21091",2010,8555,8483,7434,83,1.12,1049,176,16.78,72,0.84
"1040","21093",2010,100876,96627,84158,1719,2.04,12469,2214,17.76,4249,4.21
"1041","21095",2010,29688,29378,25804,481,1.86,3574,287,8.03,310,1.04
"1042","21097",2010,18761,18541,15629,224,1.43,2912,415,14.25,220,1.17
"1043","21099",2010,18201,17830,15367,449,2.92,2463,295,11.98,371,2.04
"1044","21101",2010,45943,45011,38302,1227,3.2,6709,676,10.08,932,2.03
"1045","21103",2010,15474,15239,13037,550,4.22,2202,433,19.66,235,1.52
"1046","21105",2010,4949,4785,3933,84,2.14,852,49,5.75,164,3.31
"1047","21107",2010,46886,46508,40075,897,2.24,6433,888,13.8,378,0.81
"1048","21109",2010,13560,13547,11694,330,2.82,1853,163,8.8,13,0.1
"1049","21111",2010,729452,715629,575715,13120,2.28,139914,24422,17.46,13823,1.89
"1050","21113",2010,47073,45439,40061,811,2.02,5378,1033,19.21,1634,3.47
"1051","21115",2010,23325,22962,20246,568,2.81,2716,267,9.83,363,1.56
"1052","21117",2010,158034,155997,129315,2736,2.12,26682,5008,18.77,2037,1.29
"1053","21119",2010,16587,15925,14145,227,1.6,1780,107,6.01,662,3.99
"1054","21121",2010,31765,30731,26073,574,2.2,4658,464,9.96,1034,3.26
"1055","21123",2010,14080,13915,12256,348,2.84,1659,216,13.02,165,1.17
"1056","21125",2010,58155,57367,50163,1346,2.68,7204,1339,18.59,788,1.35
"1057","21127",2010,15841,15667,13691,295,2.15,1976,287,14.52,174,1.1
"1058","21129",2010,7865,6860,6028,141,2.34,832,11,1.32,1005,12.78
"1059","21131",2010,11470,11395,9707,92,0.95,1688,189,11.2,75,0.65
"1060","21133",2010,24462,24237,20986,361,1.72,3251,351,10.8,225,0.92
"1061","21135",2010,13968,13772,12242,177,1.45,1530,217,14.18,196,1.4
"1062","21137",2010,24779,24611,20937,481,2.3,3674,455,12.38,168,0.68
"1063","21139",2010,9514,9463,8270,92,1.11,1193,212,17.77,51,0.54
"1064","21141",2010,26838,25571,22060,385,1.75,3511,335,9.54,1267,4.72
"1065","21143",2010,8367,6606,5602,22,0.39,1004,67,6.67,1761,21.05
"1066","21145",2010,65217,64028,53131,933,1.76,10897,1544,14.17,1189,1.82
"1067","21147",2010,18122,16543,14462,395,2.73,2081,329,15.81,1579,8.71
"1068","21149",2010,9635,9387,8213,227,2.76,1174,125,10.65,248,2.57
"1069","21151",2010,81580,75357,61074,2124,3.48,14283,3580,25.06,6223,7.63
"1070","21153",2010,13294,13218,11659,151,1.3,1559,133,8.53,76,0.57
"1071","21155",2010,19619,18113,15267,369,2.42,2846,389,13.67,1506,7.68
"1072","21157",2010,31386,30992,27074,516,1.91,3918,335,8.55,394,1.26
"1073","21159",2010,13138,12858,11408,310,2.72,1450,248,17.1,280,2.13
"1074","21161",2010,17362,16445,14195,381,2.68,2250,334,14.84,917,5.28
"1075","21163",2010,28907,28897,25593,668,2.61,3304,607,18.37,10,0.03
"1076","21165",2010,6427,6353,5501,115,2.09,852,73,8.57,74,1.15
"1077","21167",2010,21272,21209,18352,261,1.42,2857,352,12.32,63,0.3
"1078","21169",2010,10130,9950,8539,315,3.69,1411,229,16.23,180,1.78
"1079","21171",2010,11089,10929,9163,272,2.97,1766,254,14.38,160,1.44
"1080","21173",2010,25908,25723,21971,551,2.51,3752,625,16.66,185,0.71
"1081","21175",2010,14055,11995,10475,385,3.68,1520,179,11.78,2060,14.66
"1082","21177",2010,31541,30040,26155,502,1.92,3885,450,11.58,1501,4.76
"1083","21179",2010,42523,41530,36227,1107,3.06,5303,755,14.24,993,2.34
"1084","21181",2010,7136,6983,6107,140,2.29,876,148,16.89,153,2.14
"1085","21183",2010,23837,23300,20089,352,1.75,3211,472,14.7,537,2.25
"1086","21185",2010,58784,53776,49612,731,1.47,4164,702,16.86,5008,8.52
"1087","21187",2010,10928,10918,9395,129,1.37,1523,113,7.42,10,0.09
"1088","21189",2010,4742,4547,3947,11,0.28,600,184,30.67,195,4.11
"1089","21191",2010,14894,14471,12670,199,1.57,1801,305,16.94,423,2.84
"1090","21193",2010,28739,28486,24689,862,3.49,3797,491,12.93,253,0.88
"1091","21195",2010,65309,64406,55542,1084,1.95,8864,1024,11.55,903,1.38
"1092","21197",2010,12786,12440,10983,546,4.97,1457,165,11.32,346,2.71
"1093","21199",2010,62062,61441,51746,1123,2.17,9695,1488,15.35,621,1
"1094","21201",2010,2278,2278,1854,14,0.76,424,49,11.56,0,0
"1095","21203",2010,17075,16713,14754,407,2.76,1959,125,6.38,362,2.12
"1096","21205",2010,23075,20405,16994,767,4.51,3411,689,20.2,2670,11.57
"1097","21207",2010,17445,17445,14534,445,3.06,2911,339,11.65,0,0
"1098","21209",2010,44868,43075,37751,804,2.13,5324,870,16.34,1793,4
"1099","21211",2010,40899,39324,34495,868,2.52,4829,790,16.36,1575,3.85
"1100","21213",2010,17214,16830,14629,477,3.26,2201,260,11.81,384,2.23
"1101","21215",2010,16582,16419,14678,290,1.98,1741,344,19.76,163,0.98
"1102","21217",2010,24247,23382,19959,568,2.85,3423,356,10.4,865,3.57
"1103","21219",2010,12307,12232,10790,224,2.08,1442,185,12.83,75,0.61
"1104","21221",2010,14117,14117,12268,188,1.53,1849,154,8.33,0,0
"1105","21223",2010,8872,8807,7915,133,1.68,892,67,7.51,65,0.73
"1106","21225",2010,15077,13845,12017,225,1.87,1828,119,6.51,1232,8.17
"1107","21227",2010,109775,104240,83240,1988,2.39,21000,5900,28.1,5535,5.04
"1108","21229",2010,11593,11506,10157,285,2.81,1349,188,13.94,87,0.75
"1109","21231",2010,20716,20636,17722,233,1.31,2914,339,11.63,80,0.39
"1110","21233",2010,13734,13428,11903,183,1.54,1525,177,11.61,306,2.23
"1111","21235",2010,36006,34416,29750,874,2.94,4666,689,14.77,1590,4.42
"1112","21237",2010,7315,7234,6287,257,4.09,947,145,15.31,81,1.11
"1113","21239",2010,24523,24459,20766,351,1.69,3693,672,18.2,64,0.26
"1114","22001",2010,61139,60445,53653,735,1.37,6792,951,14,694,1.14
"1115","22003",2010,25816,21522,18953,632,3.33,2569,193,7.51,4294,16.63
"1116","22005",2010,102501,101488,91017,1656,1.82,10471,2094,20,1013,0.99
"1117","22007",2010,23487,23309,20593,555,2.7,2716,373,13.73,178,0.76
"1118","22009",2010,42013,38864,33365,1021,3.06,5499,787,14.31,3149,7.5
"1119","22011",2010,35000,33846,30149,689,2.29,3697,493,13.34,1154,3.3
"1120","22013",2010,14546,14169,12156,192,1.58,2013,162,8.05,377,2.59
"1121","22015",2010,113837,111563,94697,2101,2.22,16866,2891,17.14,2274,2
"1122","22017",2010,253048,245754,202551,4284,2.12,43203,6945,16.08,7294,2.88
"1123","22019",2010,189134,185883,158732,3665,2.31,27151,4955,18.25,3251,1.72
"1124","22021",2010,10188,9806,8301,200,2.41,1505,236,15.68,382,3.75
"1125","22023",2010,7280,7208,6493,185,2.85,715,130,18.18,72,0.99
"1126","22025",2010,10465,9769,8610,125,1.45,1159,190,16.39,696,6.65
"1127","22027",2010,17160,15638,13488,261,1.94,2150,205,9.53,1522,8.87
"1128","22029",2010,20502,19763,16970,604,3.56,2793,259,9.27,739,3.6
"1129","22031",2010,26465,26113,22608,500,2.21,3505,333,9.5,352,1.33
"1130","22033",2010,435815,424645,341986,7364,2.15,82659,20081,24.29,11170,2.56
"1131","22035",2010,7964,6330,5413,97,1.79,917,154,16.79,1634,20.52
"1132","22037",2010,20417,18337,16164,261,1.61,2173,192,8.84,2080,10.19
"1133","22039",2010,34419,32497,28370,934,3.29,4127,304,7.37,1922,5.58
"1134","22041",2010,20727,19661,17060,426,2.5,2601,241,9.27,1066,5.14
"1135","22043",2010,21675,19751,17326,313,1.81,2425,314,12.95,1924,8.88
"1136","22045",2010,73395,71749,63477,2194,3.46,8272,1152,13.93,1646,2.24
"1137","22047",2010,33513,29119,25424,478,1.88,3695,388,10.5,4394,13.11
"1138","22049",2010,16078,15870,13910,194,1.39,1960,245,12.5,208,1.29
"1139","22051",2010,431019,425916,357716,9021,2.52,68200,12574,18.44,5103,1.18
"1140","22053",2010,31500,31264,27306,479,1.75,3958,564,14.25,236,0.75
"1141","22055",2010,215581,210586,171488,4346,2.53,39098,8760,22.41,4995,2.32
"1142","22057",2010,95428,93505,81622,1794,2.2,11883,2749,23.13,1923,2.02
"1143","22059",2010,14680,13958,12522,156,1.25,1436,102,7.1,722,4.92
"1144","22061",2010,45797,41636,32008,644,2.01,9628,3223,33.48,4161,9.09
"1145","22063",2010,122798,122230,108597,2694,2.48,13633,2723,19.97,568,0.46
"1146","22065",2010,12286,10405,8837,153,1.73,1568,118,7.53,1881,15.31
"1147","22067",2010,28388,27479,23992,449,1.87,3487,281,8.06,909,3.2
"1148","22069",2010,39274,38281,31199,796,2.55,7082,1809,25.54,993,2.53
"1149","22071",2010,295285,284052,216631,5944,2.74,67421,14921,22.13,11233,3.8
"1150","22073",2010,152207,147394,126048,2404,1.91,21346,2845,13.33,4813,3.16
"1151","22075",2010,22710,21916,19211,179,0.93,2705,725,26.8,794,3.5
"1152","22077",2010,22837,22536,19281,263,1.36,3255,318,9.77,301,1.32
"1153","22079",2010,130800,125199,107059,2027,1.89,18140,3043,16.78,5601,4.28
"1154","22081",2010,9181,8902,7964,183,2.3,938,114,12.15,279,3.04
"1155","22083",2010,20692,19372,17208,329,1.91,2164,102,4.71,1320,6.38
"1156","22085",2010,24119,23852,20616,351,1.7,3236,330,10.2,267,1.11
"1157","22087",2010,27739,27609,23816,690,2.9,3793,798,21.04,130,0.47
"1158","22089",2010,52645,51923,47279,1202,2.54,4644,902,19.42,722,1.37
"1159","22091",2010,11125,11115,9736,177,1.82,1379,89,6.45,10,0.09
"1160","22093",2010,22096,21981,20238,311,1.54,1743,209,11.99,115,0.52
"1161","22095",2010,46728,45922,41138,1151,2.8,4784,771,16.12,806,1.72
"1162","22097",2010,84309,82970,72298,1253,1.73,10672,1492,13.98,1339,1.59
"1163","22099",2010,51721,50001,43796,984,2.25,6205,778,12.54,1720,3.33
"1164","22101",2010,54348,53935,46393,1384,2.98,7542,1761,23.35,413,0.76
"1165","22103",2010,228894,226460,197814,3584,1.81,28646,5508,19.23,2434,1.06
"1166","22105",2010,118190,116059,99173,2032,2.05,16886,3740,22.15,2131,1.8
"1167","22107",2010,5430,4938,4248,76,1.79,690,85,12.32,492,9.06
"1168","22109",2010,111131,109980,96764,2668,2.76,13216,2837,21.47,1151,1.04
"1169","22111",2010,22750,22437,20078,294,1.46,2359,176,7.46,313,1.38
"1170","22113",2010,57280,56461,49425,1170,2.37,7036,1116,15.86,819,1.43
"1171","22115",2010,50451,48241,42585,930,2.18,5656,864,15.28,2210,4.38
"1172","22117",2010,46578,45197,39307,1376,3.5,5890,540,9.17,1381,2.96
"1173","22119",2010,41238,40052,34171,1006,2.94,5881,789,13.42,1186,2.88
"1174","22121",2010,23274,22787,19820,599,3.02,2967,487,16.41,487,2.09
"1175","22123",2010,11689,10222,8770,98,1.12,1452,205,14.12,1467,12.55
"1176","22125",2010,15681,10352,9187,113,1.23,1165,97,8.33,5329,33.98
"1177","22127",2010,15477,13736,11846,163,1.38,1890,45,2.38,1741,11.25
"1178","23001",2010,107882,103149,83173,2842,3.42,19976,4186,20.96,4733,4.39
"1179","23003",2010,72412,70527,57403,1686,2.94,13124,2056,15.67,1885,2.6
"1180","23005",2010,279994,271142,213054,4805,2.26,58088,13271,22.85,8852,3.16
"1181","23007",2010,30657,29216,23798,928,3.9,5418,1138,21,1441,4.7
"1182","23009",2010,54309,52659,42372,1219,2.88,10287,2020,19.64,1650,3.04
"1183","23011",2010,121925,118959,95190,3165,3.32,23769,5198,21.87,2966,2.43
"1184","23013",2010,40111,39338,31720,1544,4.87,7618,1429,18.76,773,1.93
"1185","23015",2010,34719,34392,27801,583,2.1,6591,1328,20.15,327,0.94
"1186","23017",2010,57867,56962,47096,1742,3.7,9866,1760,17.84,905,1.56
"1187","23019",2010,152934,145491,114771,3522,3.07,30720,7908,25.74,7443,4.87
"1188","23021",2010,17555,17497,14359,387,2.7,3138,379,12.08,58,0.33
"1189","23023",2010,35688,35569,29321,652,2.22,6248,1201,19.22,119,0.33
"1190","23025",2010,52261,51483,42535,1443,3.39,8948,1592,17.79,778,1.49
"1191","23027",2010,38740,38382,31686,1324,4.18,6696,1068,15.95,358,0.92
"1192","23029",2010,33154,32309,26122,766,2.93,6187,983,15.89,845,2.55
"1193","23031",2010,197457,194949,162047,4951,3.06,32902,7067,21.48,2508,1.27
"1194","24001",2010,74638,67361,53709,1543,2.87,13652,2609,19.11,7277,9.75
"1195","24003",2010,527020,508132,434544,9364,2.15,73588,14294,19.42,18888,3.58
"1196","24005",2010,799195,780463,641154,16920,2.64,139309,27042,19.41,18732,2.34
"1197","24009",2010,87891,87084,78281,1650,2.11,8803,1698,19.29,807,0.92
"1198","24011",2010,32805,32233,28122,967,3.44,4111,956,23.25,572,1.74
"1199","24013",2010,167208,162209,144430,2338,1.62,17779,3230,18.17,4999,2.99
"1200","24015",2010,100139,99021,86993,2242,2.58,12028,2256,18.76,1118,1.12
"1201","24017",2010,143912,142931,128001,3371,2.63,14930,2975,19.93,981,0.68
"1202","24019",2010,32287,31690,26834,971,3.62,4856,675,13.9,597,1.85
"1203","24021",2010,229205,224043,195599,4506,2.3,28444,5506,19.36,5162,2.25
"1204","24023",2010,30145,29727,25261,537,2.13,4466,684,15.32,418,1.39
"1205","24025",2010,242888,240182,210734,4043,1.92,29448,5121,17.39,2706,1.11
"1206","24027",2010,279366,275730,242670,3900,1.61,33060,6009,18.18,3636,1.3
"1207","24029",2010,20018,18603,15124,288,1.9,3479,895,25.73,1415,7.07
"1208","24031",2010,947230,938934,799735,19928,2.49,139199,28972,20.81,8296,0.88
"1209","24033",2010,854722,834209,697487,27889,4,136722,33331,24.38,20513,2.4
"1210","24035",2010,46945,46266,40846,915,2.24,5420,1154,21.29,679,1.45
"1211","24037",2010,102086,99264,87092,2198,2.52,12172,2540,20.87,2822,2.76
"1212","24039",2010,26411,19549,15827,263,1.66,3722,673,18.08,6862,25.98
"1213","24041",2010,37361,36963,31521,481,1.53,5442,593,10.9,398,1.07
"1214","24043",2010,146329,139585,117964,3145,2.67,21621,4019,18.59,6744,4.61
"1215","24045",2010,96951,93444,74098,2439,3.29,19346,6455,33.37,3507,3.62
"1216","24047",2010,51133,50677,42156,862,2.04,8521,1255,14.73,456,0.89
"1217","24510",2010,620538,600193,456036,19149,4.2,144157,33685,23.37,20345,3.28
"1218","25001",2010,217483,213336,170829,3360,1.97,42507,6109,14.37,4147,1.91
"1219","25003",2010,131528,125580,98926,2789,2.82,26654,4233,15.88,5948,4.52
"1220","25005",2010,546433,531740,448451,12391,2.76,83289,14626,17.56,14693,2.69
"1221","25007",2010,16155,16145,13591,361,2.66,2554,721,28.23,10,0.06
"1222","25009",2010,735642,721655,605103,14411,2.38,116552,20551,17.63,13987,1.9
"1223","25011",2010,71523,70546,55589,1617,2.91,14957,3509,23.46,977,1.37
"1224","25013",2010,462270,445413,369402,10577,2.86,76011,12762,16.79,16857,3.65
"1225","25015",2010,157326,134579,102566,2521,2.46,32013,8085,25.26,22747,14.46
"1226","25017",2010,1479491,1424208,1152798,22495,1.95,271410,64601,23.8,55283,3.74
"1227","25019",2010,10069,9337,7750,238,3.07,1587,364,22.94,732,7.27
"1228","25021",2010,662077,643606,533796,7798,1.46,109810,22863,20.82,18471,2.79
"1229","25023",2010,490784,477299,412732,9317,2.26,64567,12314,19.07,13485,2.75
"1230","25025",2010,704460,661700,453219,16024,3.54,208481,63947,30.67,42760,6.07
"1231","25027",2010,791855,764050,644168,15248,2.37,119882,23625,19.71,27805,3.51
"1232","26001",2010,11238,11176,9303,216,2.32,1873,354,18.9,62,0.55
"1233","26003",2010,9604,8258,6807,194,2.85,1451,183,12.61,1346,14.01
"1234","26005",2010,111385,110179,96545,2299,2.38,13634,2566,18.82,1206,1.08
"1235","26007",2010,29958,29537,24144,442,1.83,5393,803,14.89,421,1.41
"1236","26009",2010,23975,23390,19798,433,2.19,3592,601,16.73,585,2.44
"1237","26011",2010,16487,15580,13110,316,2.41,2470,311,12.59,907,5.5
"1238","26013",2010,8882,7989,6843,123,1.8,1146,94,8.2,893,10.05
"1239","26015",2010,59576,59418,52336,1243,2.38,7082,1224,17.28,158,0.27
"1240","26017",2010,108156,106845,89212,2389,2.68,17633,3087,17.51,1311,1.21
"1241","26019",2010,17705,17304,14375,466,3.24,2929,472,16.11,401,2.26
"1242","26021",2010,157232,153578,129076,2886,2.24,24502,3447,14.07,3654,2.32
"1243","26023",2010,46083,42668,36698,1109,3.02,5970,960,16.08,3415,7.41
"1244","26025",2010,137112,134381,112897,3877,3.43,21484,3418,15.91,2731,1.99
"1245","26027",2010,52429,51842,45502,1184,2.6,6340,868,13.69,587,1.12
"1246","26029",2010,26228,25703,21746,437,2.01,3957,622,15.72,525,2
"1247","26031",2010,26699,26403,21892,569,2.6,4511,603,13.37,296,1.11
"1248","26033",2010,39078,33843,27100,687,2.54,6743,1247,18.49,5235,13.4
"1249","26035",2010,31162,30737,25378,655,2.58,5359,865,16.14,425,1.36
"1250","26037",2010,74235,73739,63820,1149,1.8,9919,2250,22.68,496,0.67
"1251","26039",2010,14325,13530,11256,353,3.14,2274,506,22.25,795,5.55
"1252","26041",2010,37403,36820,30283,754,2.49,6537,924,14.13,583,1.56
"1253","26043",2010,26584,26159,21881,480,2.19,4278,408,9.54,425,1.6
"1254","26045",2010,108002,106741,89576,1873,2.09,17165,2851,16.61,1261,1.17
"1255","26047",2010,32806,32139,26368,544,2.06,5771,970,16.81,667,2.03
"1256","26049",2010,433054,428092,358527,8115,2.26,69565,11492,16.52,4962,1.15
"1257","26051",2010,26076,25650,21709,493,2.27,3941,527,13.37,426,1.63
"1258","26053",2010,16471,15121,11970,256,2.14,3151,345,10.95,1350,8.2
"1259","26055",2010,86061,83007,68332,1716,2.51,14675,2840,19.35,3054,3.55
"1260","26057",2010,42612,37982,32770,969,2.96,5212,927,17.79,4630,10.87
"1261","26059",2010,47033,45495,39322,885,2.25,6173,1167,18.9,1538,3.27
"1262","26061",2010,36192,32907,24966,481,1.93,7941,2067,26.03,3285,9.08
"1263","26063",2010,33642,33332,27469,554,2.02,5863,750,12.79,310,0.92
"1264","26065",2010,281365,260517,196810,5214,2.65,63707,18182,28.54,20848,7.41
"1265","26067",2010,64651,59486,51554,1587,3.08,7932,1544,19.47,5165,7.99
"1266","26069",2010,26422,26009,21655,610,2.82,4354,560,12.86,413,1.56
"1267","26071",2010,12057,11579,9015,145,1.61,2564,370,14.43,478,3.96
"1268","26073",2010,69451,62799,43144,1470,3.41,19655,8747,44.5,6652,9.58
"1269","26075",2010,161569,152836,129769,2818,2.17,23067,3963,17.18,8733,5.41
"1270","26077",2010,247246,239376,184956,4608,2.49,54420,14950,27.47,7870,3.18
"1271","26079",2010,17400,16904,13812,435,3.15,3092,637,20.6,496,2.85
"1272","26081",2010,599432,587186,492766,11169,2.27,94420,19953,21.13,12246,2.04
"1273","26083",2010,2122,2122,1720,81,4.71,402,28,6.97,0,0
"1274","26085",2010,11625,11328,9565,360,3.76,1763,261,14.8,297,2.55
"1275","26087",2010,89944,87874,78704,1759,2.23,9170,1278,13.94,2070,2.3
"1276","26089",2010,21757,21335,18489,175,0.95,2846,305,10.72,422,1.94
"1277","26091",2010,100911,97289,83969,1977,2.35,13320,2073,15.56,3622,3.59
"1278","26093",2010,181350,179298,159926,2377,1.49,19372,3220,16.62,2052,1.13
"1279","26095",2010,6685,5512,4427,109,2.46,1085,228,21.01,1173,17.55
"1280","26097",2010,11281,11029,8914,160,1.79,2115,384,18.16,252,2.23
"1281","26099",2010,837490,828456,701410,11601,1.65,127046,17190,13.53,9034,1.08
"1282","26101",2010,24951,23646,19144,469,2.45,4502,714,15.86,1305,5.23
"1283","26103",2010,66514,62628,50491,953,1.89,12137,2793,23.01,3886,5.84
"1284","26105",2010,28715,28567,24198,590,2.44,4369,497,11.38,148,0.52
"1285","26107",2010,42730,37656,29179,745,2.55,8477,2430,28.67,5074,11.87
"1286","26109",2010,24245,23728,19602,432,2.2,4126,516,12.51,517,2.13
"1287","26111",2010,83626,81855,68928,1382,2,12927,2427,18.77,1771,2.12
"1288","26113",2010,14962,14768,12803,326,2.55,1965,292,14.86,194,1.3
"1289","26115",2010,152784,151294,132171,2516,1.9,19123,3003,15.7,1490,0.98
"1290","26117",2010,63553,62040,53860,2150,3.99,8180,1444,17.65,1513,2.38
"1291","26119",2010,9920,9845,8184,312,3.81,1661,221,13.31,75,0.76
"1292","26121",2010,173223,166681,142442,3401,2.39,24239,3827,15.79,6542,3.78
"1293","26123",2010,48962,48067,41320,1228,2.97,6747,1317,19.52,895,1.83
"1294","26125",2010,1201113,1188554,997145,14426,1.45,191409,29623,15.48,12559,1.05
"1295","26127",2010,27029,25738,22251,563,2.53,3487,576,16.52,1291,4.78
"1296","26129",2010,21862,21662,18361,413,2.25,3301,715,21.66,200,0.91
"1297","26131",2010,6976,6976,5465,58,1.06,1511,193,12.77,0,0
"1298","26133",2010,23681,23401,20303,623,3.07,3098,511,16.49,280,1.18
"1299","26135",2010,8884,8800,7114,222,3.12,1686,242,14.35,84,0.95
"1300","26137",2010,24445,23947,20224,393,1.94,3723,609,16.36,498,2.04
"1301","26139",2010,261376,253387,221123,3813,1.72,32264,7783,24.12,7989,3.06
"1302","26141",2010,13697,13675,11234,280,2.49,2441,302,12.37,22,0.16
"1303","26143",2010,24932,24834,20002,703,3.51,4832,733,15.17,98,0.39
"1304","26145",2010,202336,197067,165178,3602,2.18,31889,6243,19.58,5269,2.6
"1305","26147",2010,165719,163746,139806,2926,2.09,23940,4231,17.67,1973,1.19
"1306","26149",2010,61848,61008,52990,1353,2.55,8018,1400,17.46,840,1.36
"1307","26151",2010,44010,43492,37385,892,2.39,6107,941,15.41,518,1.18
"1308","26153",2010,8640,8303,7050,231,3.28,1253,101,8.06,337,3.9
"1309","26155",2010,71621,71082,61914,2028,3.28,9168,1303,14.21,539,0.75
"1310","26157",2010,56543,55165,47846,1240,2.59,7319,1250,17.08,1378,2.44
"1311","26159",2010,76585,75353,65299,2221,3.4,10054,1397,13.89,1232,1.61
"1312","26161",2010,343947,319790,242180,4399,1.82,77610,22587,29.1,24157,7.02
"1313","26163",2010,1870362,1847241,1553192,40006,2.58,294049,44612,15.17,23121,1.24
"1314","26165",2010,32653,32361,27429,744,2.71,4932,935,18.96,292,0.89
"1315","27001",2010,16325,16176,13143,326,2.48,3033,382,12.59,149,0.91
"1316","27003",2010,327544,323210,281630,6874,2.44,41580,8534,20.52,4334,1.32
"1317","27005",2010,32274,31809,26853,668,2.49,4956,720,14.53,465,1.44
"1318","27007",2010,43781,41705,34565,1049,3.03,7140,1338,18.74,2076,4.74
"1319","27009",2010,38148,37449,30698,646,2.1,6751,1633,24.19,699,1.83
"1320","27011",2010,5324,5243,4389,66,1.5,854,52,6.09,81,1.52
"1321","27013",2010,62719,59074,42183,1374,3.26,16891,6904,40.87,3645,5.81
"1322","27015",2010,26030,24744,20467,410,2,4277,520,12.16,1286,4.94
"1323","27017",2010,34958,33338,28456,733,2.58,4882,607,12.43,1620,4.63
"1324","27019",2010,88668,87964,78703,1137,1.44,9261,1527,16.49,704,0.79
"1325","27021",2010,28648,28288,23726,579,2.44,4562,577,12.65,360,1.26
"1326","27023",2010,12426,12217,9973,251,2.52,2244,273,12.17,209,1.68
"1327","27025",2010,52844,50390,43978,1070,2.43,6412,1286,20.06,2454,4.64
"1328","27027",2010,57089,52900,43334,915,2.11,9566,2221,23.22,4189,7.34
"1329","27029",2010,8593,8375,7029,111,1.58,1346,168,12.48,218,2.54
"1330","27031",2010,5211,5203,4094,75,1.83,1109,135,12.17,8,0.15
"1331","27033",2010,11712,11577,9732,187,1.92,1845,156,8.46,135,1.15
"1332","27035",2010,61836,60864,50193,1196,2.38,10671,1635,15.32,972,1.57
"1333","27037",2010,393380,390767,334917,6121,1.83,55850,10495,18.79,2613,0.66
"1334","27039",2010,19829,19771,17581,314,1.79,2190,343,15.66,58,0.29
"1335","27041",2010,35909,35516,28621,615,2.15,6895,1181,17.13,393,1.09
"1336","27043",2010,14819,14528,11993,273,2.28,2535,316,12.47,291,1.96
"1337","27045",2010,20978,20453,17265,361,2.09,3188,452,14.18,525,2.5
"1338","27047",2010,31387,30433,25383,635,2.5,5050,554,10.97,954,3.04
"1339","27049",2010,45930,45225,38560,698,1.81,6665,949,14.24,705,1.53
"1340","27051",2010,6082,5874,4833,105,2.17,1041,147,14.12,208,3.42
"1341","27053",2010,1136522,1110990,853511,21936,2.57,257479,57863,22.47,25532,2.25
"1342","27055",2010,19226,18870,16163,271,1.68,2707,348,12.86,356,1.85
"1343","27057",2010,20205,20205,17285,434,2.51,2920,371,12.71,0,0
"1344","27059",2010,37682,37097,32285,838,2.6,4812,955,19.85,585,1.55
"1345","27061",2010,44835,43802,36493,900,2.47,7309,1307,17.88,1033,2.3
"1346","27063",2010,10403,10233,8468,114,1.35,1765,214,12.12,170,1.63
"1347","27065",2010,16379,16369,13861,364,2.63,2508,576,22.97,10,0.06
"1348","27067",2010,41869,40781,34267,771,2.25,6514,1091,16.75,1088,2.6
"1349","27069",2010,4620,4467,3646,23,0.63,821,110,13.4,153,3.31
"1350","27071",2010,13461,13375,10582,140,1.32,2793,356,12.75,86,0.64
"1351","27073",2010,7343,7089,6015,107,1.78,1074,131,12.2,254,3.46
"1352","27075",2010,10900,10598,8501,189,2.22,2097,243,11.59,302,2.77
"1353","27077",2010,4147,4137,3634,79,2.17,503,52,10.34,10,0.24
"1354","27079",2010,27719,27346,23513,566,2.41,3833,655,17.09,373,1.35
"1355","27081",2010,5935,5925,4897,99,2.02,1028,103,10.02,10,0.17
"1356","27083",2010,25606,24144,19287,608,3.15,4857,851,17.52,1462,5.71
"1357","27085",2010,36789,36255,31241,674,2.16,5014,702,14,534,1.45
"1358","27087",2010,5359,5268,4508,174,3.86,760,121,15.92,91,1.7
"1359","27089",2010,9580,9462,8027,122,1.52,1435,166,11.57,118,1.23
"1360","27091",2010,20865,20490,17021,345,2.03,3469,330,9.51,375,1.8
"1361","27093",2010,23371,23062,19899,457,2.3,3163,557,17.61,309,1.32
"1362","27095",2010,26075,25201,20845,931,4.47,4356,700,16.07,874,3.35
"1363","27097",2010,33093,32125,27118,719,2.65,5007,720,14.38,968,2.93
"1364","27099",2010,38855,38378,31405,1095,3.49,6973,1207,17.31,477,1.23
"1365","27101",2010,8779,8454,7051,83,1.18,1403,192,13.68,325,3.7
"1366","27103",2010,32271,29954,24122,706,2.93,5832,1700,29.15,2317,7.18
"1367","27105",2010,21030,20640,17470,729,4.17,3170,608,19.18,390,1.85
"1368","27107",2010,6865,6763,5605,98,1.75,1158,142,12.26,102,1.49
"1369","27109",2010,141244,138327,115234,2074,1.8,23093,4341,18.8,2917,2.07
"1370","27111",2010,57539,56361,47180,1091,2.31,9181,1234,13.44,1178,2.05
"1371","27113",2010,13862,13528,11064,251,2.27,2464,333,13.51,334,2.41
"1372","27115",2010,29413,28204,23343,755,3.23,4861,1025,21.09,1209,4.11
"1373","27117",2010,9570,9560,8153,90,1.1,1407,119,8.46,10,0.1
"1374","27119",2010,31336,29070,24043,445,1.85,5027,786,15.64,2266,7.23
"1375","27121",2010,11064,10816,8987,118,1.31,1829,226,12.36,248,2.24
"1376","27123",2010,503113,486803,379106,9557,2.52,107697,21927,20.36,16310,3.24
"1377","27125",2010,4094,3959,3320,60,1.81,639,78,12.21,135,3.3
"1378","27127",2010,16069,15529,13137,248,1.89,2392,148,6.19,540,3.36
"1379","27129",2010,16007,15726,13385,274,2.05,2341,215,9.18,281,1.76
"1380","27131",2010,63087,55846,47224,873,1.85,8622,1812,21.02,7241,11.48
"1381","27133",2010,9606,9523,7935,162,2.04,1588,306,19.27,83,0.86
"1382","27135",2010,15864,15625,13379,417,3.12,2246,397,17.68,239,1.51
"1383","27137",2010,199472,190097,145840,3919,2.69,44257,9302,21.02,9375,4.7
"1384","27139",2010,126139,125665,112174,2020,1.8,13491,3079,22.82,474,0.38
"1385","27141",2010,86823,84444,74608,1575,2.11,9836,2697,27.42,2379,2.74
"1386","27143",2010,15219,15145,12871,359,2.79,2274,351,15.44,74,0.49
"1387","27145",2010,147927,137908,111138,2114,1.9,26770,7375,27.55,10019,6.77
"1388","27147",2010,36434,36204,31312,662,2.11,4892,714,14.6,230,0.63
"1389","27149",2010,9711,8133,6282,172,2.74,1851,322,17.4,1578,16.25
"1390","27151",2010,9946,8997,7259,133,1.83,1738,136,7.83,949,9.54
"1391","27153",2010,24804,24477,21066,489,2.32,3411,494,14.48,327,1.32
"1392","27155",2010,3657,3493,2794,57,2.04,699,63,9.01,164,4.48
"1393","27157",2010,21743,21538,18365,278,1.51,3173,435,13.71,205,0.94
"1394","27159",2010,13809,13314,11016,180,1.63,2298,216,9.4,495,3.58
"1395","27161",2010,19168,18238,15517,265,1.71,2721,445,16.35,930,4.85
"1396","27163",2010,232536,230399,202215,3300,1.63,28184,5212,18.49,2137,0.92
"1397","27165",2010,11212,11141,9265,171,1.85,1876,314,16.74,71,0.63
"1398","27167",2010,6636,6384,5421,167,3.08,963,157,16.3,252,3.8
"1399","27169",2010,51304,47186,36571,476,1.3,10615,3016,28.41,4118,8.03
"1400","27171",2010,120764,119544,105727,1857,1.76,13817,2547,18.43,1220,1.01
"1401","27173",2010,10514,10411,8969,233,2.6,1442,212,14.7,103,0.98
"1402","28001",2010,32659,32212,26899,446,1.66,5313,470,8.85,447,1.37
"1403","28003",2010,36708,36365,31505,412,1.31,4860,613,12.61,343,0.93
"1404","28005",2010,13318,13318,11505,170,1.48,1813,51,2.81,0,0
"1405","28007",2010,19545,19309,16731,210,1.26,2578,179,6.94,236,1.21
"1406","28009",2010,8652,8652,7503,218,2.91,1149,27,2.35,0,0
"1407","28011",2010,35063,34122,28719,676,2.35,5403,986,18.25,941,2.68
"1408","28013",2010,14945,14632,12585,359,2.85,2047,203,9.92,313,2.09
"1409","28015",2010,10608,10191,9117,16,0.18,1074,32,2.98,417,3.93
"1410","28017",2010,17689,17452,15028,289,1.92,2424,211,8.7,237,1.34
"1411","28019",2010,8680,8598,7242,63,0.87,1356,108,7.96,82,0.94
"1412","28021",2010,9928,9103,7625,306,4.01,1478,134,9.07,825,8.31
"1413","28023",2010,16808,16734,14798,116,0.78,1936,104,5.37,74,0.44
"1414","28025",2010,20883,20369,18243,139,0.76,2126,99,4.66,514,2.46
"1415","28027",2010,26681,26229,22763,595,2.61,3466,458,13.21,452,1.69
"1416","28029",2010,29521,28353,24214,383,1.58,4139,699,16.89,1168,3.96
"1417","28031",2010,19557,19371,17138,196,1.14,2233,169,7.57,186,0.95
"1418","28033",2010,154715,153905,138442,3132,2.26,15463,2483,16.06,810,0.52
"1419","28035",2010,74290,70845,56595,1242,2.19,14250,3381,23.73,3445,4.64
"1420","28037",2010,8130,8120,7138,149,2.09,982,46,4.68,10,0.12
"1421","28039",2010,22061,21410,19226,422,2.19,2184,338,15.48,651,2.95
"1422","28041",2010,14009,11089,10352,174,1.68,737,84,11.4,2920,20.84
"1423","28043",2010,22169,21376,18307,717,3.92,3069,376,12.25,793,3.58
"1424","28045",2010,42408,42045,36925,966,2.62,5120,912,17.81,363,0.86
"1425","28047",2010,181791,177411,149144,4926,3.3,28267,6492,22.97,4380,2.41
"1426","28049",2010,246067,237607,200825,5136,2.56,36782,6632,18.03,8460,3.44
"1427","28051",2010,19597,18539,15832,235,1.48,2707,252,9.31,1058,5.4
"1428","28053",2010,9610,9573,8455,236,2.79,1118,79,7.07,37,0.39
"1429","28055",2010,1893,1793,1472,18,1.22,321,89,27.73,100,5.28
"1430","28057",2010,23329,22347,19928,344,1.73,2419,258,10.67,982,4.21
"1431","28059",2010,137082,135919,118576,3080,2.6,17343,3552,20.48,1163,0.85
"1432","28061",2010,17383,17222,14728,219,1.49,2494,140,5.61,161,0.93
"1433","28063",2010,7970,7312,6410,120,1.87,902,16,1.77,658,8.26
"1434","28065",2010,12666,12384,10793,345,3.2,1591,84,5.28,282,2.23
"1435","28067",2010,67144,65239,56714,1332,2.35,8525,1459,17.11,1905,2.84
"1436","28069",2010,10470,9024,7797,122,1.56,1227,24,1.96,1446,13.81
"1437","28071",2010,45859,40759,29338,872,2.97,11421,4083,35.75,5100,11.12
"1438","28073",2010,52559,52121,43357,727,1.68,8764,2110,24.08,438,0.83
"1439","28075",2010,79405,72677,62011,1368,2.21,10666,1036,9.71,6728,8.47
"1440","28077",2010,13016,12919,11160,393,3.52,1759,307,17.45,97,0.75
"1441","28079",2010,23547,22323,20200,401,1.99,2123,108,5.09,1224,5.2
"1442","28081",2010,81446,79825,69628,1382,1.98,10197,1340,13.14,1621,1.99
"1443","28083",2010,33109,31824,27354,698,2.55,4470,437,9.78,1285,3.88
"1444","28085",2010,34622,33941,30161,435,1.44,3780,343,9.07,681,1.97
"1445","28087",2010,59482,57364,48955,509,1.04,8409,998,11.87,2118,3.56
"1446","28089",2010,91987,90644,78069,1547,1.98,12575,1864,14.82,1343,1.46
"1447","28091",2010,26758,26071,23086,324,1.4,2985,164,5.49,687,2.57
"1448","28093",2010,37002,35345,31243,953,3.05,4102,499,12.16,1657,4.48
"1449","28095",2010,37282,36747,32706,609,1.86,4041,355,8.78,535,1.44
"1450","28097",2010,11138,11071,9711,175,1.8,1360,116,8.53,67,0.6
"1451","28099",2010,29545,28910,25342,824,3.25,3568,312,8.74,635,2.15
"1452","28101",2010,21828,20732,18570,304,1.64,2162,124,5.74,1096,5.02
"1453","28103",2010,11747,11602,10179,148,1.45,1423,117,8.22,145,1.23
"1454","28105",2010,46529,43049,29646,567,1.91,13403,5096,38.02,3480,7.48
"1455","28107",2010,34782,34214,30056,626,2.08,4158,577,13.88,568,1.63
"1456","28109",2010,55923,54491,47641,836,1.75,6850,1355,19.78,1432,2.56
"1457","28111",2010,12243,12035,10850,226,2.08,1185,48,4.05,208,1.7
"1458","28113",2010,40284,38798,33474,642,1.92,5324,557,10.46,1486,3.69
"1459","28115",2010,29523,29127,25984,551,2.12,3143,445,14.16,396,1.34
"1460","28117",2010,25411,24686,21626,158,0.73,3060,433,14.15,725,2.85
"1461","28119",2010,8551,8354,6952,116,1.67,1402,328,23.4,197,2.3
"1462","28121",2010,138523,134118,116890,2077,1.78,17228,2643,15.34,4405,3.18
"1463","28123",2010,28180,27738,23509,891,3.79,4229,1229,29.06,442,1.57
"1464","28125",2010,4797,4776,4096,65,1.59,680,88,12.94,21,0.44
"1465","28127",2010,27575,26753,23538,503,2.14,3215,388,12.07,822,2.98
"1466","28129",2010,16443,16433,14811,233,1.57,1622,57,3.51,10,0.06
"1467","28131",2010,16923,14901,13432,201,1.5,1469,260,17.7,2022,11.95
"1468","28133",2010,30504,25868,23060,576,2.5,2808,205,7.3,4636,15.2
"1469","28135",2010,15270,14255,12506,400,3.2,1749,356,20.35,1015,6.65
"1470","28137",2010,28198,26597,23280,409,1.76,3317,488,14.71,1601,5.68
"1471","28139",2010,21993,21143,18710,507,2.71,2433,250,10.28,850,3.86
"1472","28141",2010,19535,19354,16855,361,2.14,2499,327,13.09,181,0.93
"1473","28143",2010,10817,10451,8220,336,4.09,2231,438,19.63,366,3.38
"1474","28145",2010,26922,26912,24133,441,1.83,2779,240,8.64,10,0.04
"1475","28147",2010,15530,15371,13326,232,1.74,2045,297,14.52,159,1.02
"1476","28149",2010,48890,48509,41023,1265,3.08,7486,855,11.42,381,0.78
"1477","28151",2010,52455,52122,44884,1335,2.97,7238,922,12.74,333,0.63
"1478","28153",2010,20971,20202,17760,289,1.63,2442,146,5.98,769,3.67
"1479","28155",2010,10139,9786,8666,147,1.7,1120,72,6.43,353,3.48
"1480","28157",2010,10070,8624,7470,209,2.8,1154,87,7.54,1446,14.36
"1481","28159",2010,19378,18985,16237,210,1.29,2748,393,14.3,393,2.03
"1482","28161",2010,12869,12643,10876,188,1.73,1767,213,12.05,226,1.76
"1483","28163",2010,28402,25439,22331,319,1.43,3108,469,15.09,2963,10.43
"1484","29001",2010,25315,22372,16694,375,2.25,5678,1725,30.38,2943,11.63
"1485","29003",2010,17006,16885,14796,246,1.66,2089,419,20.06,121,0.71
"1486","29005",2010,5811,5606,4578,93,2.03,1028,189,18.39,205,3.53
"1487","29007",2010,25684,23496,20124,463,2.3,3372,436,12.93,2188,8.52
"1488","29009",2010,35753,35470,30071,778,2.59,5399,969,17.95,283,0.79
"1489","29011",2010,12634,12561,10973,294,2.68,1588,211,13.29,73,0.58
"1490","29013",2010,17132,16838,14618,318,2.18,2220,207,9.32,294,1.72
"1491","29015",2010,18975,18625,15634,198,1.27,2991,487,16.28,350,1.84
"1492","29017",2010,12445,12356,10838,200,1.85,1518,119,7.84,89,0.72
"1493","29019",2010,158067,148378,107958,2316,2.15,40420,13273,32.84,9689,6.13
"1494","29021",2010,88195,83669,68256,2469,3.62,15413,3151,20.44,4526,5.13
"1495","29023",2010,42437,41207,34381,852,2.48,6826,981,14.37,1230,2.9
"1496","29025",2010,9380,9141,7987,122,1.53,1154,98,8.49,239,2.55
"1497","29027",2010,43769,40094,34359,674,1.96,5735,924,16.11,3675,8.4
"1498","29029",2010,43157,42720,35544,844,2.37,7176,1765,24.6,437,1.01
"1499","29031",2010,74283,70777,58246,1243,2.13,12531,2701,21.55,3506,4.72
"1500","29033",2010,9485,9476,8177,165,2.02,1299,146,11.24,9,0.09
"1501","29035",2010,6141,6131,5083,108,2.12,1048,151,14.41,10,0.16
"1502","29037",2010,97598,96849,86760,2405,2.77,10089,1598,15.84,749,0.77
"1503","29039",2010,14091,13927,11961,181,1.51,1966,154,7.83,164,1.16
"1504","29041",2010,7871,7514,6437,75,1.17,1077,99,9.19,357,4.54
"1505","29043",2010,74156,73788,65950,799,1.21,7838,1395,17.8,368,0.5
"1506","29045",2010,7169,7087,6034,92,1.52,1053,127,12.06,82,1.14
"1507","29047",2010,215015,211959,178408,3274,1.84,33551,5753,17.15,3056,1.42
"1508","29049",2010,20682,20320,17298,301,1.74,3022,674,22.3,362,1.75
"1509","29051",2010,74767,69505,57578,1076,1.87,11927,1824,15.29,5262,7.04
"1510","29053",2010,17583,15777,13195,318,2.41,2582,475,18.4,1806,10.27
"1511","29055",2010,24640,24371,20516,596,2.91,3855,740,19.2,269,1.09
"1512","29057",2010,7929,7919,6685,159,2.38,1234,123,9.97,10,0.13
"1513","29059",2010,16813,16612,14554,393,2.7,2058,309,15.01,201,1.2
"1514","29061",2010,8359,8306,7168,163,2.27,1138,160,14.06,53,0.63
"1515","29063",2010,12872,9801,8376,90,1.07,1425,90,6.32,3071,23.86
"1516","29065",2010,15497,15323,13072,428,3.27,2251,386,17.15,174,1.12
"1517","29067",2010,13689,13500,11772,315,2.68,1728,174,10.07,189,1.38
"1518","29069",2010,32140,30583,25448,807,3.17,5135,719,14,1557,4.84
"1519","29071",2010,100737,100033,86702,1815,2.09,13331,2459,18.45,704,0.7
"1520","29073",2010,15334,15254,12702,355,2.79,2552,392,15.36,80,0.52
"1521","29075",2010,6760,6590,5502,95,1.73,1088,159,14.61,170,2.51
"1522","29077",2010,270190,257206,201019,5469,2.72,56187,11786,20.98,12984,4.81
"1523","29079",2010,10214,9912,8135,240,2.95,1777,152,8.55,302,2.96
"1524","29081",2010,8941,8786,7367,163,2.21,1419,197,13.88,155,1.73
"1525","29083",2010,22373,22089,18344,507,2.76,3745,533,14.23,284,1.27
"1526","29085",2010,9579,9522,7831,202,2.58,1691,177,10.47,57,0.6
"1527","29087",2010,4944,4931,4157,121,2.91,774,81,10.47,13,0.26
"1528","29089",2010,10120,9045,7664,137,1.79,1381,124,8.98,1075,10.62
"1529","29091",2010,39763,39447,34083,588,1.73,5364,935,17.43,316,0.79
"1530","29093",2010,10670,10297,8467,259,3.06,1830,322,17.6,373,3.5
"1531","29095",2010,666997,659285,531010,15745,2.97,128275,23894,18.63,7712,1.16
"1532","29097",2010,115029,112386,92645,2970,3.21,19741,4649,23.55,2643,2.3
"1533","29099",2010,216262,214719,187946,4432,2.36,26773,5541,20.7,1543,0.71
"1534","29101",2010,52041,47876,38514,743,1.93,9362,2792,29.82,4165,8
"1535","29103",2010,4134,3984,3285,79,2.4,699,61,8.73,150,3.63
"1536","29105",2010,35357,35051,30264,1016,3.36,4787,595,12.43,306,0.87
"1537","29107",2010,33313,32215,27664,672,2.43,4551,543,11.93,1098,3.3
"1538","29109",2010,38373,37688,32965,775,2.35,4723,453,9.59,685,1.79
"1539","29111",2010,10235,9441,8182,139,1.7,1259,163,12.95,794,7.76
"1540","29113",2010,51333,50802,45213,1109,2.45,5589,1039,18.59,531,1.03
"1541","29115",2010,12824,12824,10795,227,2.1,2029,247,12.17,0,0
"1542","29117",2010,14961,13886,11519,285,2.47,2367,323,13.65,1075,7.19
"1543","29119",2010,23016,22879,20033,445,2.22,2846,497,17.46,137,0.6
"1544","29121",2010,15539,14831,12389,376,3.03,2442,300,12.29,708,4.56
"1545","29123",2010,12269,12092,10225,248,2.43,1867,397,21.26,177,1.44
"1546","29125",2010,9203,9076,7960,134,1.68,1116,108,9.68,127,1.38
"1547","29127",2010,28579,27254,22857,609,2.66,4397,614,13.96,1325,4.64
"1548","29129",2010,3731,3702,3141,68,2.16,561,72,12.83,29,0.78
"1549","29131",2010,24805,24303,20068,471,2.35,4235,607,14.33,502,2.02
"1550","29133",2010,14143,13794,11323,275,2.43,2471,606,24.52,349,2.47
"1551","29135",2010,15468,14193,12393,321,2.59,1800,257,14.28,1275,8.24
"1552","29137",2010,9078,8873,7557,143,1.89,1316,146,11.09,205,2.26
"1553","29139",2010,12247,11951,10308,296,2.87,1643,236,14.36,296,2.42
"1554","29141",2010,20631,20159,17473,460,2.63,2686,390,14.52,472,2.29
"1555","29143",2010,18847,18780,15901,376,2.36,2879,278,9.66,67,0.36
"1556","29145",2010,57561,56934,50219,1320,2.63,6715,967,14.4,627,1.09
"1557","29147",2010,23031,20280,14782,308,2.08,5498,1947,35.41,2751,11.94
"1558","29149",2010,10739,10672,8942,245,2.74,1730,227,13.12,67,0.62
"1559","29151",2010,13768,13675,11813,121,1.02,1862,340,18.26,93,0.68
"1560","29153",2010,9688,9678,8323,229,2.75,1355,281,20.74,10,0.1
"1561","29155",2010,18587,18273,15373,324,2.11,2900,479,16.52,314,1.69
"1562","29157",2010,18919,18846,15987,382,2.39,2859,458,16.02,73,0.39
"1563","29159",2010,41587,41028,34407,732,2.13,6621,974,14.71,559,1.34
"1564","29161",2010,44473,40880,32589,749,2.3,8291,2193,26.45,3593,8.08
"1565","29163",2010,18590,16174,14025,233,1.66,2149,218,10.14,2416,13
"1566","29165",2010,86894,86113,72175,1118,1.55,13938,2666,19.13,781,0.9
"1567","29167",2010,30729,29096,24689,635,2.57,4407,889,20.17,1633,5.31
"1568","29169",2010,49114,39698,33270,650,1.95,6428,1162,18.08,9416,19.17
"1569","29171",2010,5040,5030,4256,128,3.01,774,124,16.02,10,0.2
"1570","29173",2010,10127,10066,8809,233,2.65,1257,149,11.85,61,0.6
"1571","29175",2010,25495,22688,19233,471,2.45,3455,523,15.14,2807,11.01
"1572","29177",2010,23667,23445,20519,428,2.09,2926,342,11.69,222,0.94
"1573","29179",2010,6698,6523,5107,291,5.7,1416,352,24.86,175,2.61
"1574","29181",2010,14057,13837,12210,138,1.13,1627,127,7.81,220,1.57
"1575","29183",2010,350606,345515,302263,4257,1.41,43252,7615,17.61,5091,1.45
"1576","29185",2010,9757,9678,8156,228,2.8,1522,127,8.34,79,0.81
"1577","29186",2010,18205,17803,15268,349,2.29,2535,404,15.94,402,2.21
"1578","29187",2010,64239,57561,47427,1189,2.51,10134,1974,19.48,6678,10.4
"1579","29189",2010,999454,976478,812487,12916,1.59,163991,23504,14.33,22976,2.3
"1580","29195",2010,23126,21575,17523,681,3.89,4052,865,21.35,1551,6.71
"1581","29197",2010,4361,4351,3467,53,1.53,884,66,7.47,10,0.23
"1582","29199",2010,4831,4708,3998,69,1.73,710,57,8.03,123,2.55
"1583","29201",2010,39370,38543,33093,809,2.44,5450,740,13.58,827,2.1
"1584","29203",2010,8404,8394,7359,106,1.44,1035,143,13.82,10,0.12
"1585","29205",2010,6439,6212,5198,121,2.33,1014,54,5.33,227,3.53
"1586","29207",2010,30089,29524,25023,749,2.99,4501,740,16.44,565,1.88
"1587","29209",2010,32003,31766,27308,613,2.24,4458,811,18.19,237,0.74
"1588","29211",2010,6728,6670,5527,122,2.21,1143,213,18.64,58,0.86
"1589","29213",2010,49324,47487,39673,803,2.02,7814,1255,16.06,1837,3.72
"1590","29215",2010,25662,23993,20471,264,1.29,3522,574,16.3,1669,6.5
"1591","29217",2010,20917,20398,17175,647,3.77,3223,393,12.19,519,2.48
"1592","29219",2010,31635,31088,27036,523,1.93,4052,797,19.67,547,1.73
"1593","29221",2010,24981,23836,20669,615,2.98,3167,573,18.09,1145,4.58
"1594","29223",2010,13433,13345,10959,156,1.42,2386,370,15.51,88,0.66
"1595","29225",2010,35678,35030,31538,884,2.8,3492,355,10.17,648,1.82
"1596","29227",2010,2188,2132,1830,11,0.6,302,47,15.56,56,2.56
"1597","29229",2010,18731,18568,15824,393,2.48,2744,467,17.02,163,0.87
"1598","29510",2010,318809,307537,219826,6631,3.02,87711,15384,17.54,11272,3.54
"1599","30001",2010,9132,8845,7095,65,0.92,1750,370,21.14,287,3.14
"1600","30003",2010,12663,12605,11336,653,5.76,1269,285,22.46,58,0.46
"1601","30005",2010,6472,6330,5538,186,3.36,792,88,11.11,142,2.19
"1602","30007",2010,5287,5186,4203,122,2.9,983,339,34.49,101,1.91
"1603","30009",2010,9994,9834,8003,154,1.92,1831,476,26,160,1.6
"1604","30011",2010,1289,1279,1073,11,1.03,206,24,11.65,10,0.78
"1605","30013",2010,80562,78443,65154,1110,1.7,13289,2090,15.73,2119,2.63
"1606","30015",2010,5765,5635,5002,73,1.46,633,36,5.69,130,2.25
"1607","30017",2010,11548,11265,8926,276,3.09,2339,223,9.53,283,2.45
"1608","30019",2010,1649,1639,1325,20,1.51,314,50,15.92,10,0.61
"1609","30021",2010,8933,8051,6857,135,1.97,1194,52,4.36,882,9.87
"1610","30023",2010,9270,7936,6263,307,4.9,1673,78,4.66,1334,14.39
"1611","30025",2010,2813,2813,2339,46,1.97,474,57,12.03,0,0
"1612","30027",2010,11513,11211,9211,174,1.89,2000,195,9.75,302,2.62
"1613","30029",2010,89215,88478,73620,1950,2.65,14858,2877,19.36,737,0.83
"1614","30031",2010,87676,83754,61725,1519,2.46,22029,7337,33.31,3922,4.47
"1615","30033",2010,1224,1224,1026,0,0,198,25,12.63,0,0
"1616","30035",2010,13251,13133,11748,426,3.63,1385,201,14.51,118,0.89
"1617","30037",2010,810,810,652,22,3.37,158,30,18.99,0,0
"1618","30039",2010,3044,3034,2364,54,2.28,670,107,15.97,10,0.33
"1619","30041",2010,16007,15467,13110,287,2.19,2357,370,15.7,540,3.37
"1620","30043",2010,11166,10389,8830,128,1.45,1559,294,18.86,777,6.96
"1621","30045",2010,1967,1967,1578,7,0.44,389,67,17.22,0,0
"1622","30047",2010,28493,28054,23336,872,3.74,4718,652,13.82,439,1.54
"1623","30049",2010,61643,59516,47078,856,1.82,12438,2284,18.36,2127,3.45
"1624","30051",2010,2261,2251,1998,28,1.4,253,18,7.11,10,0.44
"1625","30053",2010,19507,19231,15573,315,2.02,3658,435,11.89,276,1.41
"1626","30055",2010,1714,1714,1499,3,0.2,215,9,4.19,0,0
"1627","30057",2010,7588,7497,5734,125,2.18,1763,189,10.72,91,1.2
"1628","30059",2010,2024,2014,1706,93,5.45,308,22,7.14,10,0.49
"1629","30061",2010,4193,4183,3367,88,2.61,816,217,26.59,10,0.24
"1630","30063",2010,107288,103946,77194,2291,2.97,26752,8065,30.15,3342,3.11
"1631","30065",2010,4339,4334,3734,30,0.8,600,52,8.67,5,0.12
"1632","30067",2010,15752,15283,12248,256,2.09,3035,475,15.65,469,2.98
"1633","30069",2010,598,598,506,9,1.78,92,2,2.17,0,0
"1634","30071",2010,4206,3996,3181,67,2.11,815,100,12.27,210,4.99
"1635","30073",2010,6145,6134,5374,58,1.08,760,32,4.21,11,0.18
"1636","30075",2010,1659,1649,1403,10,0.71,246,42,17.07,10,0.6
"1637","30077",2010,7077,5726,4962,361,7.28,764,74,9.69,1351,19.09
"1638","30079",2010,1089,1079,905,9,0.99,174,15,8.62,10,0.92
"1639","30081",2010,40013,39059,33016,525,1.59,6043,886,14.66,954,2.38
"1640","30083",2010,9498,9043,7645,235,3.07,1398,108,7.73,455,4.79
"1641","30085",2010,10273,10194,8765,216,2.46,1429,166,11.62,79,0.77
"1642","30087",2010,9134,9050,7967,154,1.93,1083,190,17.54,84,0.92
"1643","30089",2010,11366,11201,9141,149,1.63,2060,378,18.35,165,1.45
"1644","30091",2010,3505,3258,2479,18,0.73,779,58,7.45,247,7.05
"1645","30093",2010,33797,32445,24966,733,2.94,7479,1114,14.9,1352,4
"1646","30095",2010,8934,8889,7738,171,2.21,1151,126,10.95,45,0.5
"1647","30097",2010,3717,3661,3062,18,0.59,599,73,12.19,56,1.51
"1648","30099",2010,6105,5972,5170,24,0.46,802,110,13.72,133,2.18
"1649","30101",2010,5143,4320,3504,7,0.2,816,106,12.99,823,16
"1650","30103",2010,848,848,708,33,4.66,140,40,28.57,0,0
"1651","30105",2010,7345,7208,5914,138,2.33,1294,111,8.58,137,1.87
"1652","30107",2010,2118,2118,1730,9,0.52,388,11,2.84,0,0
"1653","30109",2010,1067,1057,930,27,2.9,127,15,11.81,10,0.94
"1654","30111",2010,144050,140457,113739,2915,2.56,26718,5019,18.79,3593,2.49
"1655","31001",2010,31126,30019,24676,451,1.83,5343,1209,22.63,1107,3.56
"1656","31003",2010,6742,6549,5714,70,1.23,835,51,6.11,193,2.86
"1657","31005",2010,426,426,355,10,2.82,71,14,19.72,0,0
"1658","31007",2010,720,720,608,0,0,112,9,8.04,0,0
"1659","31009",2010,539,539,486,4,0.82,53,8,15.09,0,0
"1660","31011",2010,5553,5433,4581,64,1.4,852,49,5.75,120,2.16
"1661","31013",2010,11372,11211,9521,180,1.89,1690,175,10.36,161,1.42
"1662","31015",2010,2107,2097,1727,76,4.4,370,35,9.46,10,0.47
"1663","31017",2010,3192,3007,2343,59,2.52,664,78,11.75,185,5.8
"1664","31019",2010,45437,42622,34106,868,2.55,8516,2248,26.4,2815,6.2
"1665","31021",2010,6964,6777,5711,67,1.17,1066,134,12.57,187,2.69
"1666","31023",2010,8382,8316,6909,77,1.11,1407,218,15.49,66,0.79
"1667","31025",2010,25246,25066,21898,378,1.73,3168,531,16.76,180,0.71
"1668","31027",2010,8906,8742,7407,50,0.68,1335,182,13.63,164,1.84
"1669","31029",2010,3927,3858,3242,12,0.37,616,61,9.9,69,1.76
"1670","31031",2010,5783,5726,4802,156,3.25,924,47,5.09,57,0.99
"1671","31033",2010,10049,9982,8202,132,1.61,1780,264,14.83,67,0.67
"1672","31035",2010,6554,6430,5544,138,2.49,886,85,9.59,124,1.89
"1673","31037",2010,10201,10140,8674,297,3.42,1466,374,25.51,61,0.6
"1674","31039",2010,9243,9135,7865,85,1.08,1270,175,13.78,108,1.17
"1675","31041",2010,11001,10642,9150,132,1.44,1492,129,8.65,359,3.26
"1676","31043",2010,20674,20218,18071,521,2.88,2147,387,18.03,456,2.21
"1677","31045",2010,9149,8043,5878,112,1.91,2165,551,25.45,1106,12.09
"1678","31047",2010,24245,23975,20812,960,4.61,3163,347,10.97,270,1.11
"1679","31049",2010,1963,1953,1618,14,0.87,335,20,5.97,10,0.51
"1680","31051",2010,6000,5898,5135,76,1.48,763,74,9.7,102,1.7
"1681","31053",2010,36621,35522,29470,733,2.49,6052,954,15.76,1099,3
"1682","31055",2010,505545,494905,399700,10335,2.59,95205,20722,21.77,10640,2.1
"1683","31057",2010,1963,1911,1588,13,0.82,323,21,6.5,52,2.65
"1684","31059",2010,5953,5586,4604,77,1.67,982,120,12.22,367,6.16
"1685","31061",2010,3229,3111,2531,35,1.38,580,85,14.66,118,3.65
"1686","31063",2010,2808,2807,2289,26,1.14,518,131,25.29,1,0.04
"1687","31065",2010,4942,4932,4149,96,2.31,783,23,2.94,10,0.2
"1688","31067",2010,22591,22289,18657,430,2.3,3632,473,13.02,302,1.34
"1689","31069",2010,2060,1924,1579,23,1.46,345,22,6.38,136,6.6
"1690","31071",2010,2081,2025,1749,27,1.54,276,18,6.52,56,2.69
"1691","31073",2010,2058,2003,1711,21,1.23,292,64,21.92,55,2.67
"1692","31075",2010,661,661,565,21,3.72,96,10,10.42,0,0
"1693","31077",2010,2542,2413,2091,35,1.67,322,17,5.28,129,5.07
"1694","31079",2010,56899,56123,47190,1442,3.06,8933,1886,21.11,776,1.36
"1695","31081",2010,9160,9150,8072,182,2.25,1078,137,12.71,10,0.11
"1696","31083",2010,3460,3450,2889,76,2.63,561,37,6.6,10,0.29
"1697","31085",2010,1025,1025,892,3,0.34,133,5,3.76,0,0
"1698","31087",2010,2925,2915,2502,78,3.12,413,17,4.12,10,0.34
"1699","31089",2010,10479,10049,8548,59,0.69,1501,146,9.73,430,4.1
"1700","31091",2010,690,680,560,4,0.71,120,0,0,10,1.45
"1701","31093",2010,6302,6292,5414,78,1.44,878,62,7.06,10,0.16
"1702","31095",2010,7708,7672,6297,102,1.62,1375,195,14.18,36,0.47
"1703","31097",2010,5211,4225,3394,16,0.47,831,91,10.95,986,18.92
"1704","31099",2010,6552,6531,5696,54,0.95,835,114,13.65,21,0.32
"1705","31101",2010,8356,8159,6818,64,0.94,1341,105,7.83,197,2.36
"1706","31103",2010,740,740,617,0,0,123,4,3.25,0,0
"1707","31105",2010,3814,3804,3175,45,1.42,629,34,5.41,10,0.26
"1708","31107",2010,8762,8655,7123,77,1.08,1532,186,12.14,107,1.22
"1709","31109",2010,279428,264765,208797,5047,2.42,55968,13408,23.96,14663,5.25
"1710","31111",2010,36167,35592,29322,882,3.01,6270,1058,16.87,575,1.59
"1711","31113",2010,682,682,564,0,0,118,17,14.41,0,0
"1712","31115",2010,635,635,559,2,0.36,76,4,5.26,0,0
"1713","31117",2010,489,489,448,19,4.24,41,3,7.32,0,0
"1714","31119",2010,34720,33196,27203,606,2.23,5993,948,15.82,1524,4.39
"1715","31121",2010,7784,7758,6683,78,1.17,1075,177,16.47,26,0.33
"1716","31123",2010,5071,5061,4322,139,3.22,739,66,8.93,10,0.2
"1717","31125",2010,3755,3549,2984,86,2.88,565,51,9.03,206,5.49
"1718","31127",2010,7249,6588,5300,137,2.58,1288,170,13.2,661,9.12
"1719","31129",2010,4583,4573,3787,56,1.48,786,82,10.43,10,0.22
"1720","31131",2010,15741,15374,13101,352,2.69,2273,252,11.09,367,2.33
"1721","31133",2010,2767,2693,2205,19,0.86,488,22,4.51,74,2.67
"1722","31135",2010,2983,2921,2444,28,1.15,477,77,16.14,62,2.08
"1723","31137",2010,9234,8916,7355,72,0.98,1561,227,14.54,318,3.44
"1724","31139",2010,7308,7020,6167,91,1.48,853,52,6.1,288,3.94
"1725","31141",2010,31675,31466,26858,373,1.39,4608,662,14.37,209,0.66
"1726","31143",2010,5412,5412,4744,76,1.6,668,56,8.38,0,0
"1727","31145",2010,11069,10639,8752,48,0.55,1887,256,13.57,430,3.88
"1728","31147",2010,8455,8455,6714,181,2.7,1741,145,8.33,0,0
"1729","31149",2010,1651,1641,1388,28,2.02,253,7,2.77,10,0.61
"1730","31151",2010,14098,12939,11029,205,1.86,1910,311,16.28,1159,8.22
"1731","31153",2010,152180,151294,133706,2682,2.01,17588,2945,16.74,886,0.58
"1732","31155",2010,20543,20149,17753,207,1.17,2396,342,14.27,394,1.92
"1733","31157",2010,36569,35497,29524,881,2.98,5973,863,14.45,1072,2.93
"1734","31159",2010,16628,15702,13386,177,1.32,2316,377,16.28,926,5.57
"1735","31161",2010,5538,5312,4223,50,1.18,1089,148,13.59,226,4.08
"1736","31163",2010,3144,3134,2629,11,0.42,505,29,5.74,10,0.32
"1737","31165",2010,1340,1340,1125,0,0,215,12,5.58,0,0
"1738","31167",2010,6207,6207,5533,134,2.42,674,60,8.9,0,0
"1739","31169",2010,5262,5068,4203,23,0.55,865,68,7.86,194,3.69
"1740","31171",2010,756,756,625,0,0,131,13,9.92,0,0
"1741","31173",2010,6907,6818,6218,201,3.23,600,91,15.17,89,1.29
"1742","31175",2010,4284,4236,3530,34,0.96,706,45,6.37,48,1.12
"1743","31177",2010,20148,19417,16827,149,0.89,2590,425,16.41,731,3.63
"1744","31179",2010,9573,8339,6620,92,1.39,1719,596,34.67,1234,12.89
"1745","31181",2010,3815,3310,2737,29,1.06,573,62,10.82,505,13.24
"1746","31183",2010,751,751,624,4,0.64,127,12,9.45,0,0
"1747","31185",2010,13886,13104,10654,297,2.79,2450,539,22,782,5.63
"1748","32001",2010,24946,24639,20582,476,2.31,4057,848,20.9,307,1.23
"1749","32003",2010,1895521,1874478,1552376,56579,3.64,322102,83993,26.08,21043,1.11
"1750","32005",2010,47042,46762,39518,1119,2.83,7244,1540,21.26,280,0.6
"1751","32007",2010,47707,47284,40906,802,1.96,6378,1297,20.34,423,0.89
"1752","32009",2010,892,892,567,0,0,325,42,12.92,0,0
"1753","32011",2010,1724,1724,1386,6,0.43,338,49,14.5,0,0
"1754","32013",2010,15986,15740,13411,418,3.12,2329,395,16.96,246,1.54
"1755","32015",2010,5545,5398,4798,142,2.96,600,180,30,147,2.65
"1756","32017",2010,5060,4727,4176,5,0.12,551,76,13.79,333,6.58
"1757","32019",2010,51515,50776,44427,1466,3.3,6349,1132,17.83,739,1.43
"1758","32021",2010,4812,4658,3571,44,1.23,1087,148,13.62,154,3.2
"1759","32023",2010,43878,43452,36318,913,2.51,7134,1316,18.45,426,0.97
"1760","32027",2010,6703,4704,4182,122,2.92,522,20,3.83,1999,29.82
"1761","32029",2010,4016,4016,3403,52,1.53,613,137,22.35,0,0
"1762","32031",2010,412844,404572,325341,10274,3.16,79231,20095,25.36,8272,2
"1763","32033",2010,9765,9577,8180,289,3.53,1397,177,12.67,188,1.93
"1764","32510",2010,55375,54288,44497,1621,3.64,9791,1882,19.22,1087,1.96
"1765","33001",2010,60142,58690,49091,1704,3.47,9599,1551,16.16,1452,2.41
"1766","33003",2010,47772,47401,38802,1096,2.82,8599,1757,20.43,371,0.78
"1767","33005",2010,77445,72721,58073,1367,2.35,14648,4013,27.4,4724,6.1
"1768","33007",2010,33445,32071,25642,639,2.49,6429,983,15.29,1374,4.11
"1769","33009",2010,88356,82322,65274,1695,2.6,17048,4463,26.18,6034,6.83
"1770","33011",2010,399555,390671,327844,8425,2.57,62827,14614,23.26,8884,2.22
"1771","33013",2010,146785,139974,116008,2925,2.52,23966,5354,22.34,6811,4.64
"1772","33015",2010,294638,292643,248846,4432,1.78,43797,9213,21.04,1995,0.68
"1773","33017",2010,122158,114772,91517,3113,3.4,23255,6321,27.18,7386,6.05
"1774","33019",2010,43643,43211,35970,1086,3.02,7241,1464,20.22,432,0.99
"1775","34001",2010,273162,259589,218179,5980,2.74,41410,7021,16.95,13573,4.97
"1776","34003",2010,896482,885788,773196,10938,1.41,112592,15990,14.2,10694,1.19
"1777","34005",2010,447861,434911,375675,6174,1.64,59236,10311,17.41,12950,2.89
"1778","34007",2010,513574,504977,431339,10803,2.5,73638,12801,17.38,8597,1.67
"1779","34009",2010,97684,95547,77834,1839,2.36,17713,2196,12.4,2137,2.19
"1780","34011",2010,155456,144339,125331,4807,3.84,19008,3393,17.85,11117,7.15
"1781","34013",2010,780872,759269,643210,19785,3.08,116059,21459,18.49,21603,2.77
"1782","34015",2010,285223,279707,245500,4923,2.01,34207,6080,17.77,5516,1.93
"1783","34017",2010,622123,615416,490633,17022,3.47,124783,31781,25.47,6707,1.08
"1784","34019",2010,128458,123209,108022,1236,1.14,15187,2206,14.53,5249,4.09
"1785","34021",2010,364445,349330,294081,7731,2.63,55249,13421,24.29,15115,4.15
"1786","34023",2010,798882,771480,671764,13511,2.01,99716,22238,22.3,27402,3.43
"1787","34025",2010,628112,620961,534674,8806,1.65,86287,15397,17.84,7151,1.14
"1788","34027",2010,489811,480034,421716,6083,1.44,58318,9903,16.98,9777,2
"1789","34029",2010,569374,563245,480768,9411,1.96,82477,11479,13.92,6129,1.08
"1790","34031",2010,496204,484431,426014,9756,2.29,58417,10477,17.93,11773,2.37
"1791","34033",2010,65982,64841,55564,1123,2.02,9277,1428,15.39,1141,1.73
"1792","34035",2010,319347,316053,277941,3869,1.39,38112,7038,18.47,3294,1.03
"1793","34037",2010,149996,148540,131994,1633,1.24,16546,2940,17.77,1456,0.97
"1794","34039",2010,529547,524310,457502,16009,3.5,66808,11916,17.84,5237,0.99
"1795","34041",2010,108982,107116,92970,1667,1.79,14146,2292,16.2,1866,1.71
"1796","35001",2010,646881,637250,512126,14675,2.87,125124,25297,20.22,9631,1.49
"1797","35003",2010,3652,3652,2746,64,2.33,906,158,17.44,0,0
"1798","35005",2010,64268,61862,53506,1674,3.13,8356,1261,15.09,2406,3.74
"1799","35006",2010,27179,25173,22408,759,3.39,2765,410,14.83,2006,7.38
"1800","35007",2010,13827,13433,10681,220,2.06,2752,479,17.41,394,2.85
"1801","35009",2010,46924,45598,38692,1328,3.43,6906,1194,17.29,1326,2.83
"1802","35011",2010,1772,1772,1474,28,1.9,298,30,10.07,0,0
"1803","35013",2010,201670,195771,167432,3214,1.92,28339,6611,23.33,5899,2.93
"1804","35015",2010,52665,51794,44150,1127,2.55,7644,1735,22.7,871,1.65
"1805","35017",2010,29706,29263,24359,699,2.87,4904,721,14.7,443,1.49
"1806","35019",2010,4698,3736,3048,105,3.44,688,175,25.44,962,20.48
"1807","35021",2010,943,943,735,8,1.09,208,84,40.38,0,0
"1808","35023",2010,4964,4964,4324,33,0.76,640,189,29.53,0,0
"1809","35025",2010,62503,59883,53136,1825,3.43,6747,1088,16.13,2620,4.19
"1810","35027",2010,20502,20036,16023,287,1.79,4013,746,18.59,466,2.27
"1811","35028",2010,18091,17998,15319,178,1.16,2679,361,13.48,93,0.51
"1812","35029",2010,25252,24938,21464,417,1.94,3474,460,13.24,314,1.24
"1813","35031",2010,70663,69749,63831,1410,2.21,5918,676,11.42,914,1.29
"1814","35033",2010,4923,4923,4066,66,1.62,857,159,18.55,0,0
"1815","35035",2010,62782,61461,52889,1333,2.52,8572,1350,15.75,1321,2.1
"1816","35037",2010,9002,8943,7214,224,3.11,1729,152,8.79,59,0.66
"1817","35039",2010,40195,39558,34267,1226,3.58,5291,840,15.88,637,1.58
"1818","35041",2010,19372,18605,15357,571,3.72,3248,1058,32.57,767,3.96
"1819","35043",2010,124263,123575,108540,2820,2.6,15035,2861,19.03,688,0.55
"1820","35045",2010,127517,125840,112662,3203,2.84,13178,2363,17.93,1677,1.32
"1821","35047",2010,29321,27221,21651,888,4.1,5570,847,15.21,2100,7.16
"1822","35049",2010,141702,138859,108178,3452,3.19,30681,6294,20.51,2843,2.01
"1823","35051",2010,11938,11735,9033,201,2.23,2702,405,14.99,203,1.7
"1824","35053",2010,17964,17527,14668,476,3.25,2859,689,24.1,437,2.43
"1825","35055",2010,32574,32454,25857,710,2.75,6597,1037,15.72,120,0.37
"1826","35057",2010,16467,15261,13038,306,2.35,2223,285,12.82,1206,7.32
"1827","35059",2010,4388,4375,3777,119,3.15,598,52,8.7,13,0.3
"1828","35061",2010,74554,72612,63686,2039,3.2,8926,1620,18.15,1942,2.6
"1829","36001",2010,304032,286281,217789,4848,2.23,68492,15376,22.45,17751,5.84
"1830","36003",2010,49105,44672,37111,1289,3.47,7561,1161,15.36,4433,9.03
"1831","36005",2010,1365725,1319805,1125504,40531,3.6,194301,32447,16.7,45920,3.36
"1832","36007",2010,200804,190599,151991,5184,3.41,38608,7417,19.21,10205,5.08
"1833","36009",2010,80776,77724,64043,2260,3.53,13681,2296,16.78,3052,3.78
"1834","36011",2010,80431,75020,61693,1747,2.83,13327,2153,16.16,5411,6.73
"1835","36013",2010,135263,128929,104381,2891,2.77,24548,4374,17.82,6334,4.68
"1836","36015",2010,88708,82772,67919,2068,3.04,14853,2397,16.14,5936,6.69
"1837","36017",2010,51045,49524,42319,1780,4.21,7205,981,13.62,1521,2.98
"1838","36019",2010,82380,75191,59849,1968,3.29,15342,3922,25.56,7189,8.73
"1839","36021",2010,63241,59050,47994,1437,2.99,11056,2169,19.62,4191,6.63
"1840","36023",2010,49452,46017,36596,1011,2.76,9421,2767,29.37,3435,6.95
"1841","36025",2010,48220,46925,38592,1142,2.96,8333,1395,16.74,1295,2.69
"1842","36027",2010,296152,277539,236253,5546,2.35,41286,7978,19.32,18613,6.28
"1843","36029",2010,921202,893822,714496,14527,2.03,179326,32359,18.04,27380,2.97
"1844","36031",2010,39416,35931,29236,628,2.15,6695,1049,15.67,3485,8.84
"1845","36033",2010,51697,44681,37189,1206,3.24,7492,1096,14.63,7016,13.57
"1846","36035",2010,55497,53208,44474,2036,4.58,8734,1388,15.89,2289,4.12
"1847","36037",2010,59952,58881,49237,1324,2.69,9644,1737,18.01,1071,1.79
"1848","36039",2010,49410,45127,36507,1037,2.84,8620,1675,19.43,4283,8.67
"1849","36041",2010,4908,4816,3808,58,1.52,1008,159,15.77,92,1.87
"1850","36043",2010,64332,63248,52756,1496,2.84,10492,1597,15.22,1084,1.69
"1851","36045",2010,115069,111484,94890,2933,3.09,16594,3135,18.89,3585,3.12
"1852","36047",2010,2466782,2426921,2018003,51724,2.56,408918,86272,21.1,39861,1.62
"1853","36049",2010,27017,26721,22717,678,2.98,4004,767,19.16,296,1.1
"1854","36051",2010,65441,59165,48143,1265,2.63,11022,2846,25.82,6276,9.59
"1855","36053",2010,72887,67634,56694,1693,2.99,10940,2417,22.09,5253,7.21
"1856","36055",2010,741274,712157,575678,12161,2.11,136479,28107,20.59,29117,3.93
"1857","36057",2010,49945,49358,40738,1353,3.32,8620,1368,15.87,587,1.18
"1858","36059",2010,1329083,1306363,1183490,21552,1.82,122873,20162,16.41,22720,1.71
"1859","36061",2010,1583345,1528295,961177,24073,2.5,567118,135061,23.82,55050,3.48
"1860","36063",2010,216064,211871,174256,4182,2.4,37615,6019,16,4193,1.94
"1861","36065",2010,234533,220034,181321,4620,2.55,38713,6208,16.04,14499,6.18
"1862","36067",2010,463704,448775,361163,8501,2.35,87612,17980,20.52,14929,3.22
"1863","36069",2010,106298,103082,85371,2231,2.61,17711,3051,17.23,3216,3.03
"1864","36071",2010,370201,354895,312891,7564,2.42,42004,7981,19,15306,4.13
"1865","36073",2010,43169,39924,33326,901,2.7,6598,1470,22.28,3245,7.52
"1866","36075",2010,122220,116565,95870,2988,3.12,20695,5161,24.94,5655,4.63
"1867","36077",2010,62604,57647,45790,1473,3.22,11857,2644,22.3,4957,7.92
"1868","36079",2010,99545,94649,84775,1437,1.7,9874,1507,15.26,4896,4.92
"1869","36081",2010,2199169,2176751,1857740,59681,3.21,319011,72210,22.64,22418,1.02
"1870","36083",2010,158629,154109,122738,3516,2.86,31371,7307,23.29,4520,2.85
"1871","36085",2010,463450,453074,404534,6464,1.6,48540,6938,14.29,10376,2.24
"1872","36087",2010,305461,294709,266602,5859,2.2,28107,4562,16.23,10752,3.52
"1873","36089",2010,111778,98193,81305,3061,3.76,16888,2958,17.52,13585,12.15
"1874","36091",2010,217264,213107,177098,3497,1.97,36009,7160,19.88,4157,1.91
"1875","36093",2010,153268,148143,121118,2702,2.23,27025,5138,19.01,5125,3.34
"1876","36095",2010,32789,30864,25353,674,2.66,5511,1088,19.74,1925,5.87
"1877","36097",2010,18566,18069,15192,343,2.26,2877,516,17.94,497,2.68
"1878","36099",2010,35309,32011,26938,802,2.98,5073,940,18.53,3298,9.34
"1879","36101",2010,98724,97524,81002,2306,2.85,16522,2665,16.13,1200,1.22
"1880","36103",2010,1482548,1453635,1300213,31306,2.41,153422,33063,21.55,28913,1.95
"1881","36105",2010,77625,72556,60368,2085,3.45,12188,2263,18.57,5069,6.53
"1882","36107",2010,51377,50986,44022,1514,3.44,6964,1077,15.47,391,0.76
"1883","36109",2010,100612,87129,58332,1361,2.33,28797,10149,35.24,13483,13.4
"1884","36111",2010,182782,170787,138002,3646,2.64,32785,7295,22.25,11995,6.56
"1885","36113",2010,65707,64129,51991,1740,3.35,12138,1943,16.01,1578,2.4
"1886","36115",2010,63088,59229,49917,1483,2.97,9312,1478,15.87,3859,6.12
"1887","36117",2010,93654,91720,78845,2443,3.1,12875,2305,17.9,1934,2.07
"1888","36119",2010,939406,913355,784638,16968,2.16,128717,20324,15.79,26051,2.77
"1889","36121",2010,42367,37801,31868,884,2.77,5933,1156,19.48,4566,10.78
"1890","36123",2010,25250,23633,20169,553,2.74,3464,592,17.09,1617,6.4
"1891","37001",2010,147072,143237,120098,2912,2.42,23139,4126,17.83,3835,2.61
"1892","37003",2010,36797,36699,31470,638,2.03,5229,739,14.13,98,0.27
"1893","37005",2010,11084,10246,8142,140,1.72,2104,213,10.12,838,7.56
"1894","37007",2010,26785,24244,21018,228,1.08,3226,258,8,2541,9.49
"1895","37009",2010,26787,26418,21783,499,2.29,4635,689,14.87,369,1.38
"1896","37011",2010,17951,15914,12762,257,2.01,3152,583,18.5,2037,11.35
"1897","37013",2010,47185,46592,39902,646,1.62,6690,762,11.39,593,1.26
"1898","37015",2010,20890,20328,17518,340,1.94,2810,133,4.73,562,2.69
"1899","37017",2010,34629,33785,28350,903,3.19,5435,464,8.54,844,2.44
"1900","37019",2010,101994,100776,83833,1637,1.95,16943,2537,14.97,1218,1.19
"1901","37021",2010,233249,226505,177979,4114,2.31,48526,10103,20.82,6744,2.89
"1902","37023",2010,90557,87376,74430,2060,2.77,12946,2226,17.19,3181,3.51
"1903","37025",2010,169990,168756,146487,2994,2.04,22269,3654,16.41,1234,0.73
"1904","37027",2010,82162,81038,69227,1297,1.87,11811,2182,18.47,1124,1.37
"1905","37029",2010,9719,9701,8505,182,2.14,1196,295,24.67,18,0.19
"1906","37031",2010,65068,64355,52348,1262,2.41,12007,1899,15.82,713,1.1
"1907","37033",2010,23848,22099,19257,350,1.82,2842,399,14.04,1749,7.33
"1908","37035",2010,153149,151209,127929,2506,1.96,23280,4115,17.68,1940,1.27
"1909","37037",2010,61426,60388,51522,1385,2.69,8866,1454,16.4,1038,1.69
"1910","37039",2010,27317,26821,23220,318,1.37,3601,429,11.91,496,1.82
"1911","37041",2010,14859,14374,12094,253,2.09,2280,218,9.56,485,3.26
"1912","37043",2010,10418,10122,8423,123,1.46,1699,147,8.65,296,2.84
"1913","37045",2010,97786,95582,82740,1738,2.1,12842,1898,14.78,2204,2.25
"1914","37047",2010,56856,55147,47659,855,1.79,7488,777,10.38,1709,3.01
"1915","37049",2010,100001,95334,80496,1617,2.01,14838,2554,17.21,4667,4.67
"1916","37051",2010,312994,298972,253089,5417,2.14,45883,8951,19.51,14022,4.48
"1917","37053",2010,23299,23289,20008,444,2.22,3281,632,19.26,10,0.04
"1918","37055",2010,33650,33295,26485,820,3.1,6810,1188,17.44,355,1.05
"1919","37057",2010,160638,158657,136499,3078,2.25,22158,2832,12.78,1981,1.23
"1920","37059",2010,40581,40347,35893,409,1.14,4454,512,11.5,234,0.58
"1921","37061",2010,56657,55768,46508,1181,2.54,9260,2100,22.68,889,1.57
"1922","37063",2010,258578,244160,189456,5550,2.93,54704,11753,21.48,14418,5.58
"1923","37065",2010,56247,54233,46254,987,2.13,7979,877,10.99,2014,3.58
"1924","37067",2010,342989,333383,274763,4891,1.78,58620,9709,16.56,9606,2.8
"1925","37069",2010,58473,56991,49557,1005,2.03,7434,911,12.25,1482,2.53
"1926","37071",2010,202642,199997,172420,4176,2.42,27577,4230,15.34,2645,1.31
"1927","37073",2010,12039,11730,10512,138,1.31,1218,162,13.3,309,2.57
"1928","37075",2010,8702,8615,7188,44,0.61,1427,137,9.6,87,1
"1929","37077",2010,58071,53862,47225,862,1.83,6637,910,13.71,4209,7.25
"1930","37079",2010,21157,19073,17172,593,3.45,1901,132,6.94,2084,9.85
"1931","37081",2010,475786,460683,372986,7664,2.05,87697,17519,19.98,15103,3.17
"1932","37083",2010,55293,53909,45785,952,2.08,8124,841,10.35,1384,2.5
"1933","37085",2010,109031,104520,91229,1862,2.04,13291,2102,15.82,4511,4.14
"1934","37087",2010,58597,57710,48120,793,1.65,9590,1270,13.24,887,1.51
"1935","37089",2010,103881,101819,84814,1137,1.34,17005,2233,13.13,2062,1.98
"1936","37091",2010,24384,22660,19105,515,2.7,3555,461,12.97,1724,7.07
"1937","37093",2010,44128,42761,37792,1132,3,4969,1294,26.04,1367,3.1
"1938","37095",2010,5721,4275,3651,66,1.81,624,18,2.88,1446,25.28
"1939","37097",2010,154632,152942,132555,2597,1.96,20387,3744,18.36,1690,1.09
"1940","37099",2010,39144,35333,27436,699,2.55,7897,1811,22.93,3811,9.74
"1941","37101",2010,160675,159371,140556,3314,2.36,18815,3148,16.73,1304,0.81
"1942","37103",2010,10060,10050,8404,199,2.37,1646,331,20.11,10,0.1
"1943","37105",2010,55576,54857,47516,791,1.66,7341,1126,15.34,719,1.29
"1944","37107",2010,59307,57522,48085,1266,2.63,9437,1250,13.25,1785,3.01
"1945","37109",2010,75697,74496,65357,1216,1.86,9139,1556,17.03,1201,1.59
"1946","37111",2010,44593,43746,36561,1170,3.2,7185,1137,15.82,847,1.9
"1947","37113",2010,33453,32413,26594,548,2.06,5819,574,9.86,1040,3.11
"1948","37115",2010,20549,19039,16340,185,1.13,2699,343,12.71,1510,7.35
"1949","37117",2010,24471,23994,20388,252,1.24,3606,535,14.84,477,1.95
"1950","37119",2010,882761,868011,698456,17050,2.44,169555,38010,22.42,14750,1.67
"1951","37121",2010,15680,15579,12997,193,1.48,2582,371,14.37,101,0.64
"1952","37123",2010,27611,26538,22547,554,2.46,3991,633,15.86,1073,3.89
"1953","37125",2010,85914,84749,72131,1429,1.98,12618,1755,13.91,1165,1.36
"1954","37127",2010,94402,92611,78480,1660,2.12,14131,1772,12.54,1791,1.9
"1955","37129",2010,197272,192365,145527,2717,1.87,46838,12029,25.68,4907,2.49
"1956","37131",2010,22161,21735,17960,323,1.8,3775,577,15.28,426,1.92
"1957","37133",2010,169207,150371,131834,3534,2.68,18537,3635,19.61,18836,11.13
"1958","37135",2010,129562,120581,91565,1761,1.92,29016,9131,31.47,8981,6.93
"1959","37137",2010,13072,12259,10585,132,1.25,1674,147,8.78,813,6.22
"1960","37139",2010,40167,37933,32700,736,2.25,5233,951,18.17,2234,5.56
"1961","37141",2010,50256,48935,42070,1004,2.39,6865,1047,15.25,1321,2.63
"1962","37143",2010,13091,12986,11518,266,2.31,1468,198,13.49,105,0.8
"1963","37145",2010,38942,38353,32652,785,2.4,5701,1070,18.77,589,1.51
"1964","37147",2010,161385,155153,117123,2081,1.78,38030,11259,29.61,6232,3.86
"1965","37149",2010,20289,19801,16254,177,1.09,3547,438,12.35,488,2.41
"1966","37151",2010,140034,138724,119446,2792,2.34,19278,3241,16.81,1310,0.94
"1967","37153",2010,46477,45368,38659,1266,3.27,6709,953,14.2,1109,2.39
"1968","37155",2010,131708,128782,112587,3259,2.89,16195,2764,17.07,2926,2.22
"1969","37157",2010,93322,92133,79217,1874,2.37,12916,1509,11.68,1189,1.27
"1970","37159",2010,136880,133020,113999,2614,2.29,19021,3260,17.14,3860,2.82
"1971","37161",2010,66928,65577,54727,1086,1.98,10850,1835,16.91,1351,2.02
"1972","37163",2010,62832,62432,53636,2021,3.77,8796,1574,17.89,400,0.64
"1973","37165",2010,36325,34114,29427,696,2.37,4687,563,12.01,2211,6.09
"1974","37167",2010,60109,58119,50326,973,1.93,7793,1164,14.94,1990,3.31
"1975","37169",2010,47194,46640,41302,612,1.48,5338,597,11.18,554,1.17
"1976","37171",2010,73287,72381,61453,1079,1.76,10928,1366,12.5,906,1.24
"1977","37173",2010,13861,13603,11264,117,1.04,2339,444,18.98,258,1.86
"1978","37175",2010,32404,30933,25479,265,1.04,5454,624,11.44,1471,4.54
"1979","37177",2010,4374,3526,3115,138,4.43,411,24,5.84,848,19.39
"1980","37179",2010,190346,188600,172471,2226,1.29,16129,3135,19.44,1746,0.92
"1981","37181",2010,44975,43992,38218,978,2.56,5774,528,9.14,983,2.19
"1982","37183",2010,850546,830030,685095,13593,1.98,144935,33271,22.96,20516,2.41
"1983","37185",2010,20810,20479,17549,232,1.32,2930,411,14.03,331,1.59
"1984","37187",2010,13248,12875,11128,254,2.28,1747,111,6.35,373,2.82
"1985","37189",2010,49705,44214,30161,447,1.48,14053,4124,29.35,5491,11.05
"1986","37191",2010,120102,116082,99100,1868,1.88,16982,2803,16.51,4020,3.35
"1987","37193",2010,69063,68143,58245,1208,2.07,9898,1618,16.35,920,1.33
"1988","37195",2010,79533,77681,65469,1383,2.11,12212,1930,15.8,1852,2.33
"1989","37197",2010,38158,37559,32560,565,1.74,4999,449,8.98,599,1.57
"1990","37199",2010,17911,17825,15448,355,2.3,2377,344,14.47,86,0.48
"1991","38001",2010,2348,2108,1725,28,1.62,383,14,3.66,240,10.22
"1992","38003",2010,11056,10645,8327,72,0.86,2318,349,15.06,411,3.72
"1993","38005",2010,6662,6662,5844,221,3.78,818,155,18.95,0,0
"1994","38007",2010,897,897,779,7,0.9,118,0,0,0,0
"1995","38009",2010,6430,6039,4832,52,1.08,1207,73,6.05,391,6.08
"1996","38011",2010,3102,2919,2475,29,1.17,444,17,3.83,183,5.9
"1997","38013",2010,1948,1948,1544,5,0.32,404,22,5.45,0,0
"1998","38015",2010,78776,76235,61621,851,1.38,14614,2797,19.14,2541,3.23
"1999","38017",2010,144410,138717,102528,2025,1.98,36189,7853,21.7,5693,3.94
"2000","38019",2010,4046,3952,3449,25,0.72,503,32,6.36,94,2.32
"2001","38021",2010,5340,5147,4188,58,1.38,959,68,7.09,193,3.61
"2002","38023",2010,2050,1990,1561,16,1.02,429,47,10.96,60,2.93
"2003","38025",2010,3477,3404,2839,27,0.95,565,139,24.6,73,2.1
"2004","38027",2010,2455,2445,2015,34,1.69,430,40,9.3,10,0.41
"2005","38029",2010,3617,3530,2916,40,1.37,614,37,6.03,87,2.41
"2006","38031",2010,3434,3389,2846,54,1.9,543,29,5.34,45,1.31
"2007","38033",2010,1539,1502,1165,0,0,337,13,3.86,37,2.4
"2008","38035",2010,66771,62830,45262,917,2.03,17568,5743,32.69,3941,5.9
"2009","38037",2010,2486,2353,1903,12,0.63,450,29,6.44,133,5.35
"2010","38039",2010,2426,2374,1893,7,0.37,481,54,11.23,52,2.14
"2011","38041",2010,2506,2496,2078,27,1.3,418,29,6.94,10,0.4
"2012","38043",2010,2521,2498,2085,17,0.82,413,25,6.05,23,0.91
"2013","38045",2010,4233,4187,3432,3,0.09,755,40,5.3,46,1.09
"2014","38047",2010,2001,1843,1576,4,0.25,267,6,2.25,158,7.9
"2015","38049",2010,5400,5390,4234,64,1.51,1156,124,10.73,10,0.19
"2016","38051",2010,2917,2712,2180,48,2.2,532,42,7.89,205,7.03
"2017","38053",2010,6004,5994,5060,162,3.2,934,155,16.6,10,0.17
"2018","38055",2010,8861,8548,7034,53,0.75,1514,216,14.27,313,3.53
"2019","38057",2010,8353,8208,7080,139,1.96,1128,33,2.93,145,1.74
"2020","38059",2010,26712,26396,22431,592,2.64,3965,507,12.79,316,1.18
"2021","38061",2010,7228,6943,6071,163,2.68,872,64,7.34,285,3.94
"2022","38063",2010,3185,3096,2434,11,0.45,662,38,5.74,89,2.79
"2023","38065",2010,1808,1808,1573,35,2.23,235,24,10.21,0,0
"2024","38067",2010,7530,7232,6070,84,1.38,1162,113,9.72,298,3.96
"2025","38069",2010,4364,3840,3117,41,1.32,723,13,1.8,524,12.01
"2026","38071",2010,11371,11035,8960,213,2.38,2075,331,15.95,336,2.95
"2027","38073",2010,5624,5372,4563,74,1.62,809,53,6.55,252,4.48
"2028","38075",2010,2442,2395,2019,22,1.09,376,52,13.83,47,1.92
"2029","38077",2010,16507,15146,12431,266,2.14,2715,351,12.93,1361,8.24
"2030","38079",2010,13766,13652,12052,558,4.63,1600,179,11.19,114,0.83
"2031","38081",2010,3971,3961,3242,38,1.17,719,74,10.29,10,0.25
"2032","38083",2010,1293,1293,1123,1,0.09,170,19,11.18,0,0
"2033","38085",2010,4121,4121,3808,222,5.83,313,46,14.7,0,0
"2034","38087",2010,727,727,630,11,1.75,97,6,6.19,0,0
"2035","38089",2010,23486,22822,18199,269,1.48,4623,1008,21.8,664,2.83
"2036","38091",2010,1977,1977,1703,17,1,274,27,9.85,0,0
"2037","38093",2010,20984,19070,15203,236,1.55,3867,536,13.86,1914,9.12
"2038","38095",2010,2289,2256,1793,32,1.78,463,44,9.5,33,1.44
"2039","38097",2010,8190,7988,6564,106,1.61,1424,206,14.47,202,2.47
"2040","38099",2010,11286,10723,8710,111,1.27,2013,159,7.9,563,4.99
"2041","38101",2010,59461,57306,47017,1104,2.35,10289,1847,17.95,2155,3.62
"2042","38103",2010,4276,4189,3345,5,0.15,844,61,7.23,87,2.03
"2043","38105",2010,21194,20369,16619,260,1.56,3750,427,11.39,825,3.89
"2044","39001",2010,28578,28252,24536,481,1.96,3716,560,15.07,326,1.14
"2045","39003",2010,106586,102350,86928,2397,2.76,15422,2472,16.03,4236,3.97
"2046","39005",2010,53341,50409,43585,492,1.13,6824,1077,15.78,2932,5.5
"2047","39007",2010,101867,98683,83501,2804,3.36,15182,2744,18.07,3184,3.13
"2048","39009",2010,64455,54427,37990,1148,3.02,16437,6395,38.91,10028,15.56
"2049","39011",2010,46023,45300,39515,630,1.59,5785,742,12.83,723,1.57
"2050","39013",2010,70403,65572,55156,1297,2.35,10416,1097,10.53,4831,6.86
"2051","39015",2010,44618,44250,39270,1027,2.62,4980,741,14.88,368,0.82
"2052","39017",2010,363465,348796,296915,7311,2.46,51881,11110,21.41,14669,4.04
"2053","39019",2010,28988,28356,24417,525,2.15,3939,522,13.25,632,2.18
"2054","39021",2010,40140,39716,34649,793,2.29,5067,793,15.65,424,1.06
"2055","39023",2010,139374,136356,113663,3229,2.84,22693,4232,18.65,3018,2.17
"2056","39025",2010,195312,193679,169855,4123,2.43,23824,4444,18.65,1633,0.84
"2057","39027",2010,42416,41500,36286,1326,3.65,5214,654,12.54,916,2.16
"2058","39029",2010,108609,104447,89152,1882,2.11,15295,2546,16.65,4162,3.83
"2059","39031",2010,37046,36836,31159,928,2.98,5677,943,16.61,210,0.57
"2060","39033",2010,44294,43716,36813,1121,3.05,6903,1062,15.38,578,1.3
"2061","39035",2010,1293825,1265067,1009636,21766,2.16,255431,35536,13.91,28758,2.22
"2062","39037",2010,52945,52316,44854,1028,2.29,7462,1223,16.39,629,1.19
"2063","39039",2010,39119,38452,33361,743,2.23,5091,858,16.85,667,1.71
"2064","39041",2010,166108,163193,146728,1907,1.3,16465,2564,15.57,2915,1.75
"2065","39043",2010,77454,75718,63371,1560,2.46,12347,1871,15.15,1736,2.24
"2066","39045",2010,143949,141535,124642,3048,2.45,16893,2789,16.51,2414,1.68
"2067","39047",2010,28913,28504,23877,896,3.75,4627,718,15.52,409,1.41
"2068","39049",2010,1141117,1118712,867796,24450,2.82,250916,63658,25.37,22405,1.96
"2069","39051",2010,42756,42382,37427,644,1.72,4955,724,14.61,374,0.87
"2070","39053",2010,30943,29923,25370,501,1.97,4553,718,15.77,1020,3.3
"2071","39055",2010,93604,91882,82239,1164,1.42,9643,1263,13.1,1722,1.84
"2072","39057",2010,159940,150309,125534,2411,1.92,24775,4871,19.66,9631,6.02
"2073","39059",2010,40351,40075,33959,851,2.51,6116,877,14.34,276,0.68
"2074","39061",2010,802194,784515,623200,13526,2.17,161315,29713,18.42,17679,2.2
"2075","39063",2010,74670,72734,60543,1632,2.7,12191,1969,16.15,1936,2.59
"2076","39065",2010,32104,29856,25086,567,2.26,4770,806,16.9,2248,7
"2077","39067",2010,15867,15662,13184,341,2.59,2478,320,12.91,205,1.29
"2078","39069",2010,28546,27805,23784,408,1.72,4021,644,16.02,741,2.6
"2079","39071",2010,43648,43157,37391,1305,3.49,5766,923,16.01,491,1.12
"2080","39073",2010,29338,28545,24691,733,2.97,3854,462,11.99,793,2.7
"2081","39075",2010,42068,41227,38246,393,1.03,2981,491,16.47,841,2
"2082","39077",2010,59932,59102,51315,1676,3.27,7787,1411,18.12,830,1.38
"2083","39079",2010,33165,32984,28244,879,3.11,4740,635,13.4,181,0.55
"2084","39081",2010,70041,67390,55590,1138,2.05,11800,1684,14.27,2651,3.78
"2085","39083",2010,60201,56833,48616,1062,2.18,8217,1221,14.86,3368,5.59
"2086","39085",2010,229418,226664,189058,3534,1.87,37606,5563,14.79,2754,1.2
"2087","39087",2010,62647,61529,52598,1340,2.55,8931,1179,13.2,1118,1.78
"2088","39089",2010,163708,160119,138599,3810,2.75,21520,3634,16.89,3589,2.19
"2089","39091",2010,46006,45133,38493,973,2.53,6640,1016,15.3,873,1.9
"2090","39093",2010,299605,289508,248946,6022,2.42,40562,6313,15.56,10097,3.37
"2091","39095",2010,444046,435577,350729,8675,2.47,84848,16606,19.57,8469,1.91
"2092","39097",2010,42844,37368,32108,590,1.84,5260,834,15.86,5476,12.78
"2093","39099",2010,241899,235361,194416,3656,1.88,40945,5694,13.91,6538,2.7
"2094","39101",2010,66530,60862,51734,1557,3.01,9128,1291,14.14,5668,8.52
"2095","39103",2010,170137,168976,149878,2296,1.53,19098,3118,16.33,1161,0.68
"2096","39105",2010,23649,23649,19688,531,2.7,3961,640,16.16,0,0
"2097","39107",2010,40958,40631,35750,487,1.36,4881,660,13.52,327,0.8
"2098","39109",2010,102315,101053,86044,2229,2.59,15009,2286,15.23,1262,1.23
"2099","39111",2010,14751,14571,12495,257,2.06,2076,111,5.35,180,1.22
"2100","39113",2010,538461,523431,420316,10052,2.39,103115,17787,17.25,15030,2.79
"2101","39115",2010,15113,15103,13107,363,2.77,1996,216,10.82,10,0.07
"2102","39117",2010,34815,34286,30178,619,2.05,4108,842,20.5,529,1.52
"2103","39119",2010,85951,84524,70700,1743,2.47,13824,2772,20.05,1427,1.66
"2104","39121",2010,14634,11895,10353,460,4.44,1542,118,7.65,2739,18.72
"2105","39123",2010,41553,41211,34813,613,1.76,6398,888,13.88,342,0.82
"2106","39125",2010,19679,19561,17108,461,2.69,2453,388,15.82,118,0.6
"2107","39127",2010,35843,35707,30985,1015,3.28,4722,879,18.61,136,0.38
"2108","39129",2010,55128,50051,44012,1085,2.47,6039,1028,17.02,5077,9.21
"2109","39131",2010,28674,28109,24876,925,3.72,3233,348,10.76,565,1.97
"2110","39133",2010,159943,152176,124738,3033,2.43,27438,6659,24.27,7767,4.86
"2111","39135",2010,42502,42011,36683,616,1.68,5328,838,15.73,491,1.16
"2112","39137",2010,34647,34447,30709,420,1.37,3738,570,15.25,200,0.58
"2113","39139",2010,125980,118907,100563,2326,2.31,18344,2631,14.34,7073,5.61
"2114","39141",2010,77537,70763,60196,1579,2.62,10567,1826,17.28,6774,8.74
"2115","39143",2010,61284,60452,51783,1437,2.78,8669,1306,15.07,832,1.36
"2116","39145",2010,78988,75842,63965,1206,1.89,11877,2002,16.86,3146,3.98
"2117","39147",2010,57091,55182,46574,1301,2.79,8608,1657,19.25,1909,3.34
"2118","39149",2010,49350,48678,42643,1234,2.89,6035,987,16.35,672,1.36
"2119","39151",2010,376346,367326,308501,7824,2.54,58825,8878,15.09,9020,2.4
"2120","39153",2010,543150,535339,438813,8356,1.9,96526,15960,16.53,7811,1.44
"2121","39155",2010,212780,208878,173557,3849,2.22,35321,5023,14.22,3902,1.83
"2122","39157",2010,92508,91425,77957,1967,2.52,13468,2114,15.7,1083,1.17
"2123","39159",2010,50708,47752,42054,514,1.22,5698,1087,19.08,2956,5.83
"2124","39161",2010,29029,28692,24474,287,1.17,4218,730,17.31,337,1.16
"2125","39163",2010,13485,13353,11692,521,4.46,1661,167,10.05,132,0.98
"2126","39165",2010,207790,201169,179699,2538,1.41,21470,4106,19.12,6621,3.19
"2127","39167",2010,62066,60392,50657,1135,2.24,9735,1385,14.23,1674,2.7
"2128","39169",2010,114438,111965,97624,1754,1.8,14341,2192,15.28,2473,2.16
"2129","39171",2010,38172,37239,32074,788,2.46,5165,689,13.34,933,2.44
"2130","39173",2010,125295,116589,92784,1609,1.73,23805,6193,26.02,8706,6.95
"2131","39175",2010,22665,22389,18914,369,1.95,3475,592,17.04,276,1.22
"2132","40001",2010,22424,22291,20062,401,2,2229,210,9.42,133,0.59
"2133","40003",2010,5621,4494,3826,78,2.04,668,48,7.19,1127,20.05
"2134","40005",2010,14140,12230,10251,187,1.82,1979,95,4.8,1910,13.51
"2135","40007",2010,5564,5479,4786,76,1.59,693,138,19.91,85,1.53
"2136","40009",2010,21817,20805,17594,608,3.46,3211,425,13.24,1012,4.64
"2137","40011",2010,11972,10525,9128,211,2.31,1397,85,6.08,1447,12.09
"2138","40013",2010,41195,39032,32400,805,2.48,6632,1064,16.04,2163,5.25
"2139","40015",2010,28951,27034,23411,508,2.17,3623,647,17.86,1917,6.62
"2140","40017",2010,109814,106375,94539,1533,1.62,11836,2146,18.13,3439,3.13
"2141","40019",2010,46993,45967,39247,1057,2.69,6720,1068,15.89,1026,2.18
"2142","40021",2010,46182,44650,37311,1068,2.86,7339,1687,22.99,1532,3.32
"2143","40023",2010,15190,14807,12528,209,1.67,2279,169,7.42,383,2.52
"2144","40025",2010,2503,2503,2109,26,1.23,394,43,10.91,0,0
"2145","40027",2010,246831,235951,193554,3928,2.03,42397,11042,26.04,10880,4.41
"2146","40029",2010,5801,5714,4827,83,1.72,887,43,4.85,87,1.5
"2147","40031",2010,119902,108456,91861,2357,2.57,16595,3107,18.72,11446,9.55
"2148","40033",2010,6230,6080,5200,110,2.12,880,128,14.55,150,2.41
"2149","40035",2010,14951,13588,11758,427,3.63,1830,180,9.84,1363,9.12
"2150","40037",2010,68914,68367,59245,1554,2.62,9122,1286,14.1,547,0.79
"2151","40039",2010,26824,25318,20234,483,2.39,5084,1437,28.27,1506,5.61
"2152","40041",2010,41017,40020,34784,835,2.4,5236,740,14.13,997,2.43
"2153","40043",2010,4720,4458,3895,49,1.26,563,24,4.26,262,5.55
"2154","40045",2010,4041,4031,3475,65,1.87,556,48,8.63,10,0.25
"2155","40047",2010,59093,57275,47480,993,2.09,9795,1562,15.95,1818,3.08
"2156","40049",2010,27462,26618,23536,463,1.97,3082,397,12.88,844,3.07
"2157","40051",2010,51545,50900,45364,873,1.92,5536,715,12.92,645,1.25
"2158","40053",2010,4579,4569,3948,52,1.32,621,69,11.11,10,0.22
"2159","40055",2010,6182,4531,3780,22,0.58,751,11,1.46,1651,26.71
"2160","40057",2010,2875,2761,2398,120,5,363,40,11.02,114,3.97
"2161","40059",2010,3607,3542,3093,36,1.16,449,13,2.9,65,1.8
"2162","40061",2010,12577,12198,10308,353,3.42,1890,350,18.52,379,3.01
"2163","40063",2010,13606,12416,10880,179,1.65,1536,83,5.4,1190,8.75
"2164","40065",2010,26386,25567,21804,654,3,3763,595,15.81,819,3.1
"2165","40067",2010,6435,6209,5324,153,2.87,885,122,13.79,226,3.51
"2166","40069",2010,10816,9656,8171,199,2.44,1485,153,10.3,1160,10.72
"2167","40071",2010,46473,45636,38448,926,2.41,7188,1087,15.12,837,1.8
"2168","40073",2010,14776,14503,12701,102,0.8,1802,289,16.04,273,1.85
"2169","40075",2010,9540,9146,7578,107,1.41,1568,180,11.48,394,4.13
"2170","40077",2010,11015,10565,9280,303,3.27,1285,80,6.23,450,4.09
"2171","40079",2010,49822,47985,41886,1188,2.84,6099,822,13.48,1837,3.69
"2172","40081",2010,33823,33376,29341,448,1.53,4035,627,15.54,447,1.32
"2173","40083",2010,39777,38352,33660,653,1.94,4692,794,16.92,1425,3.58
"2174","40085",2010,9306,9155,8119,209,2.57,1036,137,13.22,151,1.62
"2175","40087",2010,33107,32781,29419,712,2.42,3362,694,20.64,326,0.98
"2176","40089",2010,33130,32304,27605,528,1.91,4699,419,8.92,826,2.49
"2177","40091",2010,20012,19809,16669,336,2.02,3140,509,16.21,203,1.01
"2178","40093",2010,7487,7418,6426,95,1.48,992,90,9.07,69,0.92
"2179","40095",2010,15465,15368,13141,388,2.95,2227,512,22.99,97,0.63
"2180","40097",2010,40807,40434,34777,800,2.3,5657,946,16.72,373,0.91
"2181","40099",2010,13193,13001,11109,300,2.7,1892,286,15.12,192,1.46
"2182","40101",2010,70383,66112,55581,1146,2.06,10531,1355,12.87,4271,6.07
"2183","40103",2010,11509,11424,9774,206,2.11,1650,122,7.39,85,0.74
"2184","40105",2010,10674,10663,9587,340,3.55,1076,43,4,11,0.1
"2185","40107",2010,12036,10811,9390,154,1.64,1421,142,9.99,1225,10.18
"2186","40109",2010,704023,692437,560677,13538,2.41,131760,25969,19.71,11586,1.65
"2187","40111",2010,39664,38707,33340,827,2.48,5367,737,13.73,957,2.41
"2188","40113",2010,47192,45531,39925,503,1.26,5606,644,11.49,1661,3.52
"2189","40115",2010,32193,30847,26477,782,2.95,4370,702,16.06,1346,4.18
"2190","40117",2010,16564,16327,14309,346,2.42,2018,184,9.12,237,1.43
"2191","40119",2010,75687,68905,49394,1231,2.49,19511,6831,35.01,6782,8.96
"2192","40121",2010,45417,42461,35160,708,2.01,7301,917,12.56,2956,6.51
"2193","40123",2010,36644,35221,28939,830,2.87,6282,1129,17.97,1423,3.88
"2194","40125",2010,68751,66317,58118,1602,2.76,8199,1134,13.83,2434,3.54
"2195","40127",2010,11500,11265,9334,144,1.54,1931,282,14.6,235,2.04
"2196","40129",2010,3530,3530,3182,46,1.45,348,32,9.2,0,0
"2197","40131",2010,85044,84416,75558,1687,2.23,8858,1507,17.01,628,0.74
"2198","40133",2010,25224,24253,20738,539,2.6,3515,377,10.73,971,3.85
"2199","40135",2010,41855,41537,36570,1105,3.02,4967,727,14.64,318,0.76
"2200","40137",2010,44454,43898,37755,559,1.48,6143,651,10.6,556,1.25
"2201","40139",2010,19826,19588,16864,422,2.5,2724,676,24.82,238,1.2
"2202","40141",2010,8154,7941,6925,203,2.93,1016,76,7.48,213,2.61
"2203","40143",2010,589757,579896,473388,10749,2.27,106508,18370,17.25,9861,1.67
"2204","40145",2010,70232,70157,63506,1138,1.79,6651,1290,19.4,75,0.11
"2205","40147",2010,50339,49524,41227,815,1.98,8297,1036,12.49,815,1.62
"2206","40149",2010,11571,11571,9967,191,1.92,1604,218,13.59,0,0
"2207","40151",2010,8656,7081,5663,97,1.71,1418,186,13.12,1575,18.2
"2208","40153",2010,19967,18827,16029,372,2.32,2798,608,21.73,1140,5.71
"2209","41001",2010,16150,15988,13162,288,2.19,2826,501,17.73,162,1
"2210","41003",2010,84158,78644,56352,1451,2.57,22292,7843,35.18,5514,6.55
"2211","41005",2010,370479,367579,312155,7039,2.25,55424,11152,20.12,2900,0.78
"2212","41007",2010,36858,35434,28153,952,3.38,7281,1100,15.11,1424,3.86
"2213","41009",2010,49006,48924,41828,1300,3.11,7096,1392,19.62,82,0.17
"2214","41011",2010,63319,62499,49047,1347,2.75,13452,2982,22.17,820,1.3
"2215","41013",2010,21515,21446,18620,472,2.53,2826,480,16.99,69,0.32
"2216","41015",2010,22411,22377,17769,452,2.54,4608,726,15.76,34,0.15
"2217","41017",2010,154568,153664,127834,3137,2.45,25830,6074,23.52,904,0.58
"2218","41019",2010,107209,106041,88666,2832,3.19,17375,3183,18.32,1168,1.09
"2219","41021",2010,1731,1731,1309,44,3.36,422,53,12.56,0,0
"2220","41023",2010,7349,7349,6051,119,1.97,1298,204,15.72,0,0
"2221","41025",2010,7364,7172,5810,56,0.96,1362,188,13.8,192,2.61
"2222","41027",2010,21706,20843,17822,404,2.27,3021,700,23.17,863,3.98
"2223","41029",2010,200587,197388,160333,4601,2.87,37055,7625,20.58,3199,1.59
"2224","41031",2010,21652,21181,18572,541,2.91,2609,479,18.36,471,2.18
"2225","41033",2010,82172,81478,66971,1865,2.78,14507,2573,17.74,694,0.84
"2226","41035",2010,66520,65873,54387,1452,2.67,11486,2346,20.42,647,0.97
"2227","41037",2010,7882,7480,6101,136,2.23,1379,246,17.84,402,5.1
"2228","41039",2010,347156,337155,259000,9350,3.61,78155,21208,27.14,10001,2.88
"2229","41041",2010,45857,45101,35434,1140,3.22,9667,1529,15.82,756,1.65
"2230","41043",2010,114315,112485,94672,2862,3.02,17813,3848,21.6,1830,1.6
"2231","41045",2010,31326,27291,23444,664,2.83,3847,677,17.6,4035,12.88
"2232","41047",2010,309894,298314,253927,8881,3.5,44387,8715,19.63,11580,3.74
"2233","41049",2010,11112,11112,9600,277,2.89,1512,400,26.46,0,0
"2234","41051",2010,712036,695059,509524,19258,3.78,185535,49242,26.54,16977,2.38
"2235","41053",2010,73745,71049,60020,1383,2.3,11029,2478,22.47,2696,3.66
"2236","41055",2010,1819,1819,1490,60,4.03,329,34,10.33,0,0
"2237","41057",2010,25200,24639,19870,749,3.77,4769,627,13.15,561,2.23
"2238","41059",2010,74804,69838,60364,2355,3.9,9474,1645,17.36,4966,6.64
"2239","41061",2010,25373,25131,20799,456,2.19,4332,1055,24.35,242,0.95
"2240","41063",2010,6919,6835,5633,99,1.76,1202,112,9.32,84,1.21
"2241","41065",2010,24695,23765,19657,613,3.12,4108,741,18.04,930,3.77
"2242","41067",2010,516665,510803,423254,11308,2.67,87549,21383,24.42,5862,1.13
"2243","41069",2010,1443,1306,1076,6,0.56,230,5,2.17,137,9.49
"2244","41071",2010,96930,92248,80089,2522,3.15,12159,2548,20.96,4682,4.83
"2245","42001",2010,100839,96923,83901,1806,2.15,13022,2296,17.63,3916,3.88
"2246","42003",2010,1223066,1186796,926661,15471,1.67,260135,44201,16.99,36270,2.97
"2247","42005",2010,69489,68372,58176,1311,2.25,10196,1200,11.77,1117,1.61
"2248","42007",2010,171569,167501,141300,1908,1.35,26201,3670,14.01,4068,2.37
"2249","42009",2010,49882,49528,42890,909,2.12,6638,844,12.71,354,0.71
"2250","42011",2010,407310,392650,335115,9520,2.84,57535,11223,19.51,14660,3.6
"2251","42013",2010,127071,123571,102303,2346,2.29,21268,3677,17.29,3500,2.75
"2252","42015",2010,62415,61768,52205,1446,2.77,9563,1534,16.04,647,1.04
"2253","42017",2010,622859,609439,532001,8367,1.57,77438,13147,16.98,13420,2.15
"2254","42019",2010,182554,178041,151384,2280,1.51,26657,4725,17.73,4513,2.47
"2255","42021",2010,144741,137150,114008,2249,1.97,23142,2870,12.4,7591,5.24
"2256","42023",2010,5197,5124,4167,86,2.06,957,134,14,73,1.4
"2257","42025",2010,64563,63872,53968,1247,2.31,9904,1856,18.74,691,1.07
"2258","42027",2010,151411,132606,94168,1908,2.03,38438,15031,39.1,18805,12.42
"2259","42029",2010,490571,475836,409687,6422,1.57,66149,13988,21.15,14735,3
"2260","42031",2010,40290,38330,31250,749,2.4,7080,1699,24,1960,4.86
"2261","42033",2010,82131,77823,65590,1695,2.58,12233,1475,12.06,4308,5.25
"2262","42035",2010,38970,36225,28892,850,2.94,7333,1852,25.26,2745,7.04
"2263","42037",2010,66642,62398,49287,1314,2.67,13111,3875,29.56,4244,6.37
"2264","42039",2010,89153,85853,72055,2041,2.83,13798,1949,14.13,3300,3.7
"2265","42041",2010,231336,216753,176573,2844,1.61,40180,7071,17.6,14583,6.3
"2266","42043",2010,264823,260537,210492,5537,2.63,50045,9120,18.22,4286,1.62
"2267","42045",2010,556468,535515,453864,8595,1.89,81651,13020,15.95,20953,3.77
"2268","42047",2010,32480,32036,26668,727,2.73,5368,684,12.74,444,1.37
"2269","42049",2010,279234,266403,219295,5313,2.42,47108,8731,18.53,12831,4.6
"2270","42051",2010,138807,134320,112809,2693,2.39,21511,3205,14.9,4487,3.23
"2271","42053",2010,7585,5370,4529,123,2.72,841,131,15.58,2215,29.2
"2272","42055",2010,146558,143173,121189,2968,2.45,21984,3596,16.36,3385,2.31
"2273","42057",2010,14839,14839,12701,300,2.36,2138,413,19.32,0,0
"2274","42059",2010,39003,36213,31143,719,2.31,5070,789,15.56,2790,7.15
"2275","42061",2010,45830,40819,34457,781,2.27,6362,859,13.5,5011,10.93
"2276","42063",2010,88745,83797,67112,1568,2.34,16685,4843,29.03,4948,5.58
"2277","42065",2010,45244,45076,38114,799,2.1,6962,1134,16.29,168,0.37
"2278","42067",2010,24385,24306,21583,295,1.37,2723,418,15.35,79,0.32
"2279","42069",2010,213731,204573,167854,3358,2,36719,6338,17.26,9158,4.28
"2280","42071",2010,511250,496821,427934,7781,1.82,68887,13129,19.06,14429,2.82
"2281","42073",2010,91682,89281,76386,1334,1.75,12895,1415,10.97,2401,2.62
"2282","42075",2010,131341,127503,108252,2451,2.26,19251,3505,18.21,3838,2.92
"2283","42077",2010,343946,334590,282864,6909,2.44,51726,9018,17.43,9356,2.72
"2284","42079",2010,319120,309320,254311,6396,2.52,55009,7616,13.85,9800,3.07
"2285","42081",2010,116376,111689,92469,2634,2.85,19220,3921,20.4,4687,4.03
"2286","42083",2010,43853,41227,34586,1006,2.91,6641,837,12.6,2626,5.99
"2287","42085",2010,117296,109836,92324,1932,2.09,17512,2131,12.17,7460,6.36
"2288","42087",2010,46583,46171,38833,792,2.04,7338,965,13.15,412,0.88
"2289","42089",2010,168080,164476,143867,3804,2.64,20609,5107,24.78,3604,2.14
"2290","42091",2010,790497,768322,650338,9212,1.42,117984,19879,16.85,22175,2.81
"2291","42093",2010,18152,17355,14676,302,2.06,2679,396,14.78,797,4.39
"2292","42095",2010,294536,281570,239127,5718,2.39,42443,8288,19.53,12966,4.4
"2293","42097",2010,94099,90811,74793,1797,2.4,16018,2699,16.85,3288,3.49
"2294","42099",2010,45599,44827,38581,781,2.02,6246,1342,21.49,772,1.69
"2295","42101",2010,1504950,1454290,1121832,32864,2.93,332458,69346,20.86,50660,3.37
"2296","42103",2010,56993,56611,49565,1038,2.09,7046,1286,18.25,382,0.67
"2297","42105",2010,17583,17273,14775,450,3.05,2498,315,12.61,310,1.76
"2298","42107",2010,148288,141298,117517,3328,2.83,23781,3298,13.87,6990,4.71
"2299","42109",2010,39400,36836,31794,761,2.39,5042,952,18.88,2564,6.51
"2300","42111",2010,78219,74603,63160,922,1.46,11443,1594,13.93,3616,4.62
"2301","42113",2010,6467,6099,5157,73,1.42,942,127,13.48,368,5.69
"2302","42115",2010,43343,42711,36449,1055,2.89,6262,1035,16.53,632,1.46
"2303","42117",2010,41631,40220,33775,1024,3.03,6445,1223,18.98,1411,3.39
"2304","42119",2010,44866,34990,29849,552,1.85,5141,769,14.96,9876,22.01
"2305","42121",2010,55320,53909,44952,1106,2.46,8957,1620,18.09,1411,2.55
"2306","42123",2010,41877,41072,34122,711,2.08,6950,999,14.37,805,1.92
"2307","42125",2010,206987,202221,168832,2278,1.35,33389,5412,16.21,4766,2.3
"2308","42127",2010,52302,48241,41128,942,2.29,7113,986,13.86,4061,7.76
"2309","42129",2010,365841,357516,299281,5156,1.72,58235,7727,13.27,8325,2.28
"2310","42131",2010,28262,27728,23632,691,2.92,4096,804,19.63,534,1.89
"2311","42133",2010,428175,420626,359889,8237,2.29,60737,12239,20.15,7549,1.76
"2312","44001",2010,50501,48165,40290,457,1.13,7875,1544,19.61,2336,4.63
"2313","44003",2010,167235,165512,135614,3193,2.35,29898,4634,15.5,1723,1.03
"2314","44005",2010,83253,80125,64343,1243,1.93,15782,2813,17.82,3128,3.76
"2315","44007",2010,628413,597626,482209,12859,2.67,115417,24710,21.41,30787,4.9
"2316","44009",2010,126987,121346,99792,1605,1.61,21554,5092,23.62,5641,4.44
"2317","45001",2010,25643,24597,20915,359,1.72,3682,486,13.2,1046,4.08
"2318","45003",2010,156670,154312,132889,2771,2.09,21423,2625,12.25,2358,1.51
"2319","45005",2010,10688,9081,7934,169,2.13,1147,26,2.27,1607,15.04
"2320","45007",2010,183691,179753,155620,2943,1.89,24133,3626,15.03,3938,2.14
"2321","45009",2010,16139,14531,12286,279,2.27,2245,334,14.88,1608,9.96
"2322","45011",2010,22748,22663,19186,421,2.19,3477,593,17.05,85,0.37
"2323","45013",2010,155550,147991,125104,2040,1.63,22887,3994,17.45,7559,4.86
"2324","45015",2010,169878,165902,144993,4129,2.85,20909,4158,19.89,3976,2.34
"2325","45017",2010,15212,15097,12737,162,1.27,2360,253,10.72,115,0.76
"2326","45019",2010,342434,332071,255595,5282,2.07,76476,20530,26.85,10363,3.03
"2327","45021",2010,54832,54578,45967,782,1.7,8611,1205,13.99,254,0.46
"2328","45023",2010,33246,32841,28456,575,2.02,4385,537,12.25,405,1.22
"2329","45025",2010,46087,45946,39485,1506,3.81,6461,893,13.82,141,0.31
"2330","45027",2010,34621,32961,28307,451,1.59,4654,886,19.04,1660,4.79
"2331","45029",2010,38833,38599,32814,794,2.42,5785,850,14.69,234,0.6
"2332","45031",2010,68602,67432,57697,1053,1.83,9735,1298,13.33,1170,1.71
"2333","45033",2010,31666,31342,26641,994,3.73,4701,731,15.55,324,1.02
"2334","45035",2010,129618,127587,112600,2450,2.18,14987,2593,17.3,2031,1.57
"2335","45037",2010,26680,23869,20728,330,1.59,3141,615,19.58,2811,10.54
"2336","45039",2010,24040,23562,19950,587,2.94,3612,255,7.06,478,1.99
"2337","45041",2010,134897,131306,112993,2401,2.12,18313,2729,14.9,3591,2.66
"2338","45043",2010,60236,59719,51364,755,1.47,8355,1526,18.26,517,0.86
"2339","45045",2010,436437,423955,354742,7270,2.05,69213,10985,15.87,12482,2.86
"2340","45047",2010,68890,67324,57074,1409,2.47,10250,1653,16.13,1566,2.27
"2341","45049",2010,21173,19707,17173,327,1.9,2534,215,8.48,1466,6.92
"2342","45051",2010,258267,255730,205177,5951,2.9,50553,11596,22.94,2537,0.98
"2343","45053",2010,23634,22371,18929,1111,5.87,3442,766,22.25,1263,5.34
"2344","45055",2010,60166,59523,52632,1361,2.59,6891,759,11.01,643,1.07
"2345","45057",2010,72302,70844,61531,1362,2.21,9313,1061,11.39,1458,2.02
"2346","45059",2010,67026,64127,54706,1209,2.21,9421,1498,15.9,2899,4.33
"2347","45061",2010,19615,17657,14935,204,1.37,2722,378,13.89,1958,9.98
"2348","45063",2010,252563,250170,210232,4039,1.92,39938,8159,20.43,2393,0.95
"2349","45065",2010,10203,8951,7749,66,0.85,1202,55,4.58,1252,12.27
"2350","45067",2010,33568,33092,28804,533,1.85,4288,724,16.88,476,1.42
"2351","45069",2010,29112,26210,22841,546,2.39,3369,245,7.27,2902,9.97
"2352","45071",2010,37197,36171,31064,824,2.65,5107,1009,19.76,1026,2.76
"2353","45073",2010,73035,72700,61641,1481,2.4,11059,1841,16.65,335,0.46
"2354","45075",2010,92475,88233,74420,1762,2.37,13813,1977,14.31,4242,4.59
"2355","45077",2010,117823,108952,88008,1416,1.61,20944,5931,28.32,8871,7.53
"2356","45079",2010,372597,343372,272554,6856,2.52,70818,15863,22.4,29225,7.84
"2357","45081",2010,19567,19443,16832,297,1.76,2611,733,28.07,124,0.63
"2358","45083",2010,278167,270539,233391,4592,1.97,37148,4974,13.39,7628,2.74
"2359","45085",2010,106601,103703,89446,1933,2.16,14257,2145,15.05,2898,2.72
"2360","45087",2010,29089,28172,24075,415,1.72,4097,452,11.03,917,3.15
"2361","45089",2010,34994,33645,29340,671,2.29,4305,745,17.31,1349,3.85
"2362","45091",2010,214916,211496,181610,3263,1.8,29886,6071,20.31,3420,1.59
"2363","46003",2010,2739,2647,2228,34,1.53,419,102,24.34,92,3.36
"2364","46005",2010,16829,16228,12800,510,3.98,3428,539,15.72,601,3.57
"2365","46007",2010,3441,3238,2915,190,6.52,323,58,17.96,203,5.9
"2366","46009",2010,7080,6126,5280,80,1.52,846,58,6.86,954,13.47
"2367","46011",2010,31250,28098,19119,390,2.04,8979,3668,40.85,3152,10.09
"2368","46013",2010,36011,34454,27530,382,1.39,6924,981,14.17,1557,4.32
"2369","46015",2010,5128,4716,3927,54,1.38,789,84,10.65,412,8.03
"2370","46017",2010,1932,1932,1847,80,4.33,85,12,14.12,0,0
"2371","46019",2010,9888,9878,8451,280,3.31,1427,170,11.91,10,0.1
"2372","46021",2010,1431,1431,1222,40,3.27,209,23,11,0,0
"2373","46023",2010,9075,8932,7856,272,3.46,1076,81,7.53,143,1.58
"2374","46025",2010,3702,3692,3215,54,1.68,477,23,4.82,10,0.27
"2375","46027",2010,13816,11004,7456,105,1.41,3548,1073,30.24,2812,20.35
"2376","46029",2010,27040,26583,21567,370,1.72,5016,862,17.19,457,1.69
"2377","46031",2010,4053,4053,3669,205,5.59,384,76,19.79,0,0
"2378","46033",2010,8085,7691,6202,176,2.84,1489,158,10.61,394,4.87
"2379","46035",2010,19397,18216,14633,431,2.95,3583,480,13.4,1181,6.09
"2380","46037",2010,5714,5428,4403,76,1.73,1025,62,6.05,286,5.01
"2381","46039",2010,4373,4298,3638,38,1.04,660,79,11.97,75,1.72
"2382","46041",2010,5354,5306,4695,171,3.64,611,144,23.57,48,0.9
"2383","46043",2010,3046,2923,2564,26,1.01,359,23,6.41,123,4.04
"2384","46045",2010,4047,4013,3500,36,1.03,513,61,11.89,34,0.84
"2385","46047",2010,7078,5778,4286,108,2.52,1492,66,4.42,1300,18.37
"2386","46049",2010,2386,2376,1989,22,1.11,387,63,16.28,10,0.42
"2387","46051",2010,7382,7088,5881,69,1.17,1207,109,9.03,294,3.98
"2388","46053",2010,4272,4169,3415,30,0.88,754,25,3.32,103,2.41
"2389","46055",2010,1886,1684,1438,19,1.32,246,29,11.79,202,10.71
"2390","46057",2010,5761,5709,5062,100,1.98,647,66,10.2,52,0.9
"2391","46059",2010,3402,3250,2789,57,2.04,461,32,6.94,152,4.47
"2392","46061",2010,3382,3382,3040,11,0.36,342,21,6.14,0,0
"2393","46063",2010,1250,1240,1075,14,1.3,165,25,15.15,10,0.8
"2394","46065",2010,16827,16416,13540,359,2.65,2876,292,10.15,411,2.44
"2395","46067",2010,7388,7129,6165,40,0.65,964,39,4.05,259,3.51
"2396","46069",2010,1520,1445,1218,0,0,227,14,6.17,75,4.93
"2397","46071",2010,2991,2981,2743,106,3.86,238,30,12.61,10,0.33
"2398","46073",2010,2038,2028,1716,15,0.87,312,19,6.09,10,0.49
"2399","46075",2010,1076,1076,921,28,3.04,155,19,12.26,0,0
"2400","46077",2010,5169,4994,4201,52,1.24,793,42,5.3,175,3.39
"2401","46079",2010,11008,10302,8366,75,0.9,1936,297,15.34,706,6.41
"2402","46081",2010,23670,21983,16703,303,1.81,5280,783,14.83,1687,7.13
"2403","46083",2010,41289,40959,36202,562,1.55,4757,780,16.4,330,0.8
"2404","46085",2010,3736,3706,3161,163,5.16,545,55,10.09,30,0.8
"2405","46087",2010,5639,5493,4790,90,1.88,703,76,10.81,146,2.59
"2406","46089",2010,2506,2496,2084,5,0.24,412,22,5.34,10,0.4
"2407","46091",2010,4618,4516,3659,64,1.75,857,211,24.62,102,2.21
"2408","46093",2010,25156,24317,20498,323,1.58,3819,805,21.08,839,3.34
"2409","46095",2010,2032,2022,1824,75,4.11,198,34,17.17,10,0.49
"2410","46097",2010,2411,2401,1972,17,0.86,429,49,11.42,10,0.41
"2411","46099",2010,165799,159756,131193,3802,2.9,28563,5529,19.36,6043,3.64
"2412","46101",2010,6511,6459,5681,183,3.22,778,53,6.81,52,0.8
"2413","46103",2010,97922,95177,77572,2125,2.74,17605,3916,22.24,2745,2.8
"2414","46105",2010,2976,2904,2324,17,0.73,580,34,5.86,72,2.42
"2415","46107",2010,2380,2370,1985,25,1.26,385,46,11.95,10,0.42
"2416","46109",2010,10033,9870,8681,222,2.56,1189,114,9.59,163,1.62
"2417","46111",2010,2380,2370,2024,3,0.15,346,26,7.51,10,0.42
"2418","46113",2010,13437,12594,11886,451,3.79,708,248,35.03,843,6.27
"2419","46115",2010,6518,5944,4894,94,1.92,1050,115,10.95,574,8.81
"2420","46117",2010,2896,2896,2438,75,3.08,458,52,11.35,0,0
"2421","46119",2010,1328,1328,1102,7,0.64,226,24,10.62,0,0
"2422","46121",2010,9575,9575,8759,344,3.93,816,125,15.32,0,0
"2423","46123",2010,5743,5657,4930,137,2.78,727,2,0.28,86,1.5
"2424","46125",2010,8368,8208,7059,174,2.46,1149,111,9.66,160,1.91
"2425","46127",2010,13903,13893,11695,155,1.33,2198,337,15.33,10,0.07
"2426","46129",2010,5408,4851,4154,41,0.99,697,30,4.3,557,10.3
"2427","46135",2010,22216,19763,16049,221,1.38,3714,564,15.19,2453,11.04
"2428","46137",2010,2765,2765,2573,95,3.69,192,18,9.38,0,0
"2429","47001",2010,74257,73647,61552,1229,2,12095,1564,12.93,610,0.82
"2430","47003",2010,44172,43046,37290,1147,3.08,5756,1069,18.57,1126,2.55
"2431","47005",2010,16456,16327,13661,250,1.83,2666,313,11.74,129,0.78
"2432","47007",2010,12946,11192,9704,317,3.27,1488,253,17,1754,13.55
"2433","47009",2010,121140,119063,101501,2264,2.23,17562,3185,18.14,2077,1.71
"2434","47011",2010,97192,94759,80705,1872,2.32,14054,2946,20.96,2433,2.5
"2435","47013",2010,40623,40060,34466,714,2.07,5594,933,16.68,563,1.39
"2436","47015",2010,13631,13444,11737,310,2.64,1707,226,13.24,187,1.37
"2437","47017",2010,28644,27763,23504,628,2.67,4259,574,13.48,881,3.08
"2438","47019",2010,57710,56116,47015,1161,2.47,9101,1460,16.04,1594,2.76
"2439","47021",2010,38809,37867,33571,629,1.87,4296,757,17.62,942,2.43
"2440","47023",2010,16793,15658,13906,426,3.06,1752,285,16.27,1135,6.76
"2441","47025",2010,31901,31017,27009,468,1.73,4008,215,5.36,884,2.77
"2442","47027",2010,7888,7748,6450,85,1.32,1298,126,9.71,140,1.77
"2443","47029",2010,35473,35118,29219,718,2.46,5899,1131,19.17,355,1
"2444","47031",2010,52344,51913,44518,789,1.77,7395,1087,14.7,431,0.82
"2445","47033",2010,14524,14231,12342,305,2.47,1889,287,15.19,293,2.02
"2446","47035",2010,54977,54533,46274,704,1.52,8259,1158,14.02,444,0.81
"2447","47037",2010,612884,589927,447565,11848,2.65,142362,31764,22.31,22957,3.75
"2448","47039",2010,11716,11482,9615,249,2.59,1867,65,3.48,234,2
"2449","47041",2010,18569,17612,15057,190,1.26,2555,373,14.6,957,5.15
"2450","47043",2010,48712,48588,41893,1335,3.19,6695,1139,17.01,124,0.25
"2451","47045",2010,38174,37455,32302,528,1.63,5153,775,15.04,719,1.88
"2452","47047",2010,37458,36756,33514,739,2.21,3242,418,12.89,702,1.87
"2453","47049",2010,17777,17722,15056,231,1.53,2666,490,18.38,55,0.31
"2454","47051",2010,41054,39301,33735,334,0.99,5566,733,13.17,1753,4.27
"2455","47053",2010,49015,48240,40837,822,2.01,7403,616,8.32,775,1.58
"2456","47055",2010,29558,29132,25196,485,1.92,3936,424,10.77,426,1.44
"2457","47057",2010,22419,21961,18832,284,1.51,3129,514,16.43,458,2.04
"2458","47059",2010,68172,66091,56850,1285,2.26,9241,1386,15,2081,3.05
"2459","47061",2010,13910,13758,11825,246,2.08,1933,345,17.85,152,1.09
"2460","47063",2010,61857,61248,52475,1567,2.99,8773,1258,14.34,609,0.98
"2461","47065",2010,328960,321016,263666,5077,1.93,57350,10197,17.78,7944,2.41
"2462","47067",2010,6782,6637,5518,38,0.69,1119,121,10.81,145,2.14
"2463","47069",2010,27655,23558,20785,235,1.13,2773,258,9.3,4097,14.81
"2464","47071",2010,25995,25815,21733,357,1.64,4082,594,14.55,180,0.69
"2465","47073",2010,56562,56197,48644,875,1.8,7553,948,12.55,365,0.65
"2466","47075",2010,19010,18866,16243,280,1.72,2623,358,13.65,144,0.76
"2467","47077",2010,27518,27065,23771,880,3.7,3294,330,10.02,453,1.65
"2468","47079",2010,32042,31500,26565,330,1.24,4935,605,12.26,542,1.69
"2469","47081",2010,24506,23125,20301,537,2.65,2824,388,13.74,1381,5.64
"2470","47083",2010,8286,8151,6954,366,5.26,1197,141,11.78,135,1.63
"2471","47085",2010,18416,18323,15435,341,2.21,2888,525,18.18,93,0.5
"2472","47087",2010,11491,11427,9674,286,2.96,1753,230,13.12,64,0.56
"2473","47089",2010,50600,48756,41164,1150,2.79,7592,1357,17.87,1844,3.64
"2474","47091",2010,18190,16704,14114,259,1.84,2590,305,11.78,1486,8.17
"2475","47093",2010,423748,410260,325726,6054,1.86,84534,15410,18.23,13488,3.18
"2476","47095",2010,7827,5606,4650,157,3.38,956,43,4.5,2221,28.38
"2477","47097",2010,27745,24900,21218,444,2.09,3682,708,19.23,2845,10.25
"2478","47099",2010,41319,41017,36109,713,1.97,4908,479,9.76,302,0.73
"2479","47101",2010,12003,11929,10323,333,3.23,1606,225,14.01,74,0.62
"2480","47103",2010,32885,32289,27476,356,1.3,4813,760,15.79,596,1.81
"2481","47105",2010,47102,46869,40606,724,1.78,6263,916,14.63,233,0.49
"2482","47107",2010,52075,50896,43800,868,1.98,7096,1020,14.37,1179,2.26
"2483","47109",2010,25760,25538,21891,384,1.75,3647,604,16.56,222,0.86
"2484","47111",2010,21934,21419,18552,585,3.15,2867,552,19.25,515,2.35
"2485","47113",2010,97378,94801,80542,1793,2.23,14259,1966,13.79,2577,2.65
"2486","47115",2010,28123,28042,24365,681,2.79,3677,324,8.81,81,0.29
"2487","47117",2010,29902,29672,25753,686,2.66,3919,638,16.28,230,0.77
"2488","47119",2010,79029,77672,65875,1480,2.25,11797,2209,18.73,1357,1.72
"2489","47121",2010,11581,11431,10204,336,3.29,1227,184,15,150,1.3
"2490","47123",2010,44015,43539,37200,680,1.83,6339,1042,16.44,476,1.08
"2491","47125",2010,163603,159707,138449,3696,2.67,21258,4588,21.58,3896,2.38
"2492","47127",2010,6266,6256,5363,27,0.5,893,279,31.24,10,0.16
"2493","47129",2010,21664,19554,17320,369,2.13,2234,204,9.13,2110,9.74
"2494","47131",2010,31905,31703,26703,432,1.62,5000,963,19.26,202,0.63
"2495","47133",2010,21777,21324,18324,247,1.35,3000,321,10.7,453,2.08
"2496","47135",2010,7778,7711,6515,121,1.86,1196,176,14.72,67,0.86
"2497","47137",2010,5072,4934,4253,51,1.2,681,20,2.94,138,2.72
"2498","47139",2010,16690,16493,14091,427,3.03,2402,428,17.82,197,1.18
"2499","47141",2010,70570,67116,54977,1334,2.43,12139,2416,19.9,3454,4.89
"2500","47143",2010,31215,30265,26032,570,2.19,4233,821,19.4,950,3.04
"2501","47145",2010,54156,53264,45705,639,1.4,7559,728,9.63,892,1.65
"2502","47147",2010,64347,64033,56859,1647,2.9,7174,1262,17.59,314,0.49
"2503","47149",2010,250517,244523,205870,5624,2.73,38653,10705,27.7,5994,2.39
"2504","47151",2010,22171,21969,18829,203,1.08,3140,389,12.39,202,0.91
"2505","47153",2010,13814,13738,12161,327,2.69,1577,112,7.1,76,0.55
"2506","47155",2010,87507,86856,74142,1351,1.82,12714,2254,17.73,651,0.74
"2507","47157",2010,922696,901445,758326,21226,2.8,143119,25715,17.97,21251,2.3
"2508","47159",2010,19035,18954,16717,306,1.83,2237,305,13.63,81,0.43
"2509","47161",2010,13133,13123,11399,185,1.62,1724,186,10.79,10,0.08
"2510","47163",2010,155815,152201,127605,2746,2.15,24596,2930,11.91,3614,2.32
"2511","47165",2010,155592,154452,135591,2776,2.05,18861,3112,16.5,1140,0.73
"2512","47167",2010,59689,58213,51850,1105,2.13,6363,1391,21.86,1476,2.47
"2513","47169",2010,7751,7751,6694,21,0.31,1057,287,27.15,0,0
"2514","47171",2010,18257,17961,15068,308,2.04,2893,342,11.82,296,1.62
"2515","47173",2010,19088,19007,16691,239,1.43,2316,212,9.15,81,0.42
"2516","47175",2010,5503,5335,4637,53,1.14,698,53,7.59,168,3.05
"2517","47177",2010,39539,38921,33603,660,1.96,5318,661,12.43,618,1.56
"2518","47179",2010,119768,115479,92920,1732,1.86,22559,4612,20.44,4289,3.58
"2519","47181",2010,17016,14901,13034,294,2.26,1867,201,10.77,2115,12.43
"2520","47183",2010,34557,32430,26068,281,1.08,6362,1498,23.55,2127,6.16
"2521","47185",2010,25460,25401,22239,579,2.6,3162,372,11.76,59,0.23
"2522","47187",2010,174260,173822,159023,1429,0.9,14799,2304,15.57,438,0.25
"2523","47189",2010,109563,108217,95869,1586,1.65,12348,2171,17.58,1346,1.23
"2524","48001",2010,58016,45533,39343,1061,2.7,6190,1128,18.22,12483,21.52
"2525","48003",2010,14048,14048,12434,297,2.39,1614,301,18.65,0,0
"2526","48005",2010,85254,82184,72149,1451,2.01,10035,1402,13.97,3070,3.6
"2527","48007",2010,23247,23010,19474,710,3.65,3536,506,14.31,237,1.02
"2528","48009",2010,9055,8983,8056,167,2.07,927,85,9.17,72,0.8
"2529","48011",2010,1958,1837,1703,24,1.41,134,0,0,121,6.18
"2530","48013",2010,44049,43576,39791,1155,2.9,3785,588,15.54,473,1.07
"2531","48015",2010,27783,27715,24362,787,3.23,3353,498,14.85,68,0.24
"2532","48017",2010,7027,7017,6148,93,1.51,869,324,37.28,10,0.14
"2533","48019",2010,20265,20161,17576,324,1.84,2585,262,10.14,104,0.51
"2534","48021",2010,72289,70344,62484,1746,2.79,7860,1461,18.59,1945,2.69
"2535","48023",2010,3795,3785,3144,112,3.56,641,23,3.59,10,0.26
"2536","48025",2010,31896,22484,19774,361,1.83,2710,334,12.32,9412,29.51
"2537","48027",2010,294689,284357,247702,5467,2.21,36655,7898,21.55,10332,3.51
"2538","48029",2010,1650052,1610841,1381467,34287,2.48,229374,43490,18.96,39211,2.38
"2539","48031",2010,10085,10066,8565,193,2.25,1501,190,12.66,19,0.19
"2540","48033",2010,564,564,481,13,2.7,83,2,2.41,0,0
"2541","48035",2010,18067,17134,15003,357,2.38,2131,319,14.97,933,5.16
"2542","48037",2010,91399,87326,74780,1585,2.12,12546,1731,13.8,4073,4.46
"2543","48039",2010,300522,288345,258371,4843,1.87,29974,5671,18.92,12177,4.05
"2544","48041",2010,185426,171961,120802,3822,3.16,51159,22351,43.69,13465,7.26
"2545","48043",2010,8971,8751,6441,86,1.34,2310,424,18.35,220,2.45
"2546","48045",2010,1723,1723,1497,16,1.07,226,16,7.08,0,0
"2547","48047",2010,7349,7146,6099,187,3.07,1047,127,12.13,203,2.76
"2548","48049",2010,38199,36171,31000,702,2.26,5171,987,19.09,2028,5.31
"2549","48051",2010,17058,16932,14768,399,2.7,2164,241,11.14,126,0.74
"2550","48053",2010,42215,41254,36131,1038,2.87,5123,755,14.74,961,2.28
"2551","48055",2010,37416,33641,30036,1195,3.98,3605,504,13.98,3775,10.09
"2552","48057",2010,21120,20732,18150,227,1.25,2582,381,14.76,388,1.84
"2553","48059",2010,13458,13403,11635,194,1.67,1768,355,20.08,55,0.41
"2554","48061",2010,393566,390882,364617,5271,1.45,26265,4211,16.03,2684,0.68
"2555","48063",2010,12288,12010,10696,158,1.48,1314,122,9.28,278,2.26
"2556","48065",2010,6284,6274,5635,78,1.38,639,41,6.42,10,0.16
"2557","48067",2010,30254,30048,26027,554,2.13,4021,449,11.17,206,0.68
"2558","48069",2010,7848,7768,7086,70,0.99,682,72,10.56,80,1.02
"2559","48071",2010,32371,32156,29476,608,2.06,2680,592,22.09,215,0.66
"2560","48073",2010,50035,47522,41678,842,2.02,5844,1018,17.42,2513,5.02
"2561","48075",2010,7115,5294,4562,118,2.59,732,125,17.08,1821,25.59
"2562","48077",2010,10922,10912,9566,194,2.03,1346,159,11.81,10,0.09
"2563","48079",2010,3155,3020,2752,40,1.45,268,18,6.72,135,4.28
"2564","48081",2010,3301,3118,2667,60,2.25,451,16,3.55,183,5.54
"2565","48083",2010,8857,8671,7442,170,2.28,1229,58,4.72,186,2.1
"2566","48085",2010,738745,734049,645870,9026,1.4,88179,16130,18.29,4696,0.64
"2567","48087",2010,3009,3009,2574,25,0.97,435,26,5.98,0,0
"2568","48089",2010,20751,20370,17231,418,2.43,3139,408,13,381,1.84
"2569","48091",2010,102836,101106,89176,2119,2.38,11930,2378,19.93,1730,1.68
"2570","48093",2010,13863,13649,11813,331,2.8,1836,229,12.47,214,1.54
"2571","48095",2010,4047,2568,2350,122,5.19,218,7,3.21,1479,36.55
"2572","48097",2010,38316,37635,32995,676,2.05,4640,619,13.34,681,1.78
"2573","48099",2010,74082,66665,60753,1075,1.77,5912,1518,25.68,7417,10.01
"2574","48101",2010,1618,1608,1430,55,3.85,178,3,1.69,10,0.62
"2575","48103",2010,4141,3976,3676,48,1.31,300,32,10.67,165,3.98
"2576","48105",2010,3746,3746,3498,128,3.66,248,0,0,0,0
"2577","48107",2010,6207,6092,5397,66,1.22,695,70,10.07,115,1.85
"2578","48109",2010,2480,2403,2143,13,0.61,260,27,10.38,77,3.1
"2579","48111",2010,6471,6471,5696,125,2.19,775,200,25.81,0,0
"2580","48113",2010,2321014,2285991,1928226,50756,2.63,357765,70138,19.6,35023,1.51
"2581","48115",2010,13853,11400,10047,219,2.18,1353,75,5.54,2453,17.71
"2582","48117",2010,19054,18685,16958,312,1.84,1727,208,12.04,369,1.94
"2583","48119",2010,5248,5232,4384,32,0.73,848,122,14.39,16,0.3
"2584","48121",2010,628084,614154,524942,9637,1.84,89212,22377,25.08,13930,2.22
"2585","48123",2010,20025,18192,15523,232,1.49,2669,296,11.09,1833,9.15
"2586","48125",2010,2441,1995,1719,31,1.8,276,23,8.33,446,18.27
"2587","48127",2010,9908,9627,8901,146,1.64,726,34,4.68,281,2.84
"2588","48129",2010,3655,3291,2919,70,2.4,372,43,11.56,364,9.96
"2589","48131",2010,11999,11373,9953,191,1.92,1420,172,12.11,626,5.22
"2590","48133",2010,18560,17552,14509,131,0.9,3043,515,16.92,1008,5.43
"2591","48135",2010,133015,131375,113708,3533,3.11,17667,3403,19.26,1640,1.23
"2592","48137",2010,2029,2011,1608,12,0.75,403,35,8.68,18,0.89
"2593","48139",2010,143502,141727,128851,3014,2.34,12876,2770,21.51,1775,1.24
"2594","48141",2010,772280,759822,693144,11715,1.69,66678,10422,15.63,12458,1.61
"2595","48143",2010,37142,35219,27894,704,2.52,7325,2284,31.18,1923,5.18
"2596","48145",2010,17799,16486,14424,374,2.59,2062,220,10.67,1313,7.38
"2597","48147",2010,33765,31690,27704,601,2.17,3986,670,16.81,2075,6.15
"2598","48149",2010,24175,23484,19613,196,1,3871,429,11.08,691,2.86
"2599","48151",2010,4057,3961,3446,22,0.64,515,25,4.85,96,2.37
"2600","48153",2010,6599,6589,5964,19,0.32,625,59,9.44,10,0.15
"2601","48155",2010,1379,1369,1164,48,4.12,205,18,8.78,10,0.73
"2602","48157",2010,541983,535851,500946,7710,1.54,34905,6789,19.45,6132,1.13
"2603","48159",2010,10675,10596,9364,245,2.62,1232,145,11.77,79,0.74
"2604","48161",2010,19461,17720,14772,180,1.22,2948,380,12.89,1741,8.95
"2605","48163",2010,16956,14844,13585,152,1.12,1259,121,9.61,2112,12.46
"2606","48165",2010,16658,16658,15164,168,1.11,1494,143,9.57,0,0
"2607","48167",2010,286326,281797,241625,5507,2.28,40172,7644,19.03,4529,1.58
"2608","48169",2010,6204,4450,3911,48,1.23,539,69,12.8,1754,28.27
"2609","48171",2010,24197,23586,20172,324,1.61,3414,324,9.49,611,2.53
"2610","48173",2010,1317,1317,1205,7,0.58,112,20,17.86,0,0
"2611","48175",2010,7161,7132,6273,255,4.07,859,53,6.17,29,0.4
"2612","48177",2010,19635,18739,16507,265,1.61,2232,284,12.72,896,4.56
"2613","48179",2010,22497,20257,17520,283,1.62,2737,352,12.86,2240,9.96
"2614","48181",2010,119111,115995,99124,2012,2.03,16871,3094,18.34,3116,2.62
"2615","48183",2010,119525,116826,99363,2933,2.95,17463,3176,18.19,2699,2.26
"2616","48185",2010,26208,22622,19821,482,2.43,2801,494,17.64,3586,13.68
"2617","48187",2010,122728,121292,110029,1992,1.81,11263,1898,16.85,1436,1.17
"2618","48189",2010,36041,32032,28454,576,2.02,3578,605,16.91,4009,11.12
"2619","48191",2010,3424,3414,2906,53,1.82,508,34,6.69,10,0.29
"2620","48193",2010,8473,8320,7246,135,1.86,1074,129,12.01,153,1.81
"2621","48195",2010,5470,5401,4833,166,3.43,568,63,11.09,69,1.26
"2622","48197",2010,4226,4226,3695,33,0.89,531,79,14.88,0,0
"2623","48199",2010,53220,52866,46628,912,1.96,6238,1206,19.33,354,0.67
"2624","48201",2010,3950999,3911572,3369318,85061,2.52,542254,113484,20.93,39427,1
"2625","48203",2010,64484,62445,54869,1200,2.19,7576,1162,15.34,2039,3.16
"2626","48205",2010,5963,4470,4024,100,2.49,446,30,6.73,1493,25.04
"2627","48207",2010,5842,5842,5044,122,2.42,798,33,4.14,0,0
"2628","48209",2010,146439,136927,111311,2841,2.55,25616,7971,31.12,9512,6.5
"2629","48211",2010,3668,3668,3205,27,0.84,463,34,7.34,0,0
"2630","48213",2010,78299,76884,65820,1453,2.21,11064,1853,16.75,1415,1.81
"2631","48215",2010,736973,732353,689397,11125,1.61,42956,7488,17.43,4620,0.63
"2632","48217",2010,34854,33697,28997,632,2.18,4700,800,17.02,1157,3.32
"2633","48219",2010,22933,21731,19527,478,2.45,2204,207,9.39,1202,5.24
"2634","48221",2010,49816,49387,42527,752,1.77,6860,1289,18.79,429,0.86
"2635","48223",2010,34540,33944,29806,383,1.28,4138,526,12.71,596,1.73
"2636","48225",2010,23642,23152,20399,505,2.48,2753,318,11.55,490,2.07
"2637","48227",2010,34285,28599,24466,559,2.28,4133,529,12.8,5686,16.58
"2638","48229",2010,3441,3413,3025,0,0,388,52,13.4,28,0.81
"2639","48231",2010,84836,82161,71059,1945,2.74,11102,1988,17.91,2675,3.15
"2640","48233",2010,22094,21838,18918,344,1.82,2920,431,14.76,256,1.16
"2641","48235",2010,1673,1673,1481,5,0.34,192,5,2.6,0,0
"2642","48237",2010,9072,7915,6759,154,2.28,1156,205,17.73,1157,12.75
"2643","48239",2010,13987,13839,12073,230,1.91,1766,311,17.61,148,1.06
"2644","48241",2010,35248,34169,30286,720,2.38,3883,428,11.02,1079,3.06
"2645","48243",2010,2340,2124,1836,25,1.36,288,26,9.03,216,9.23
"2646","48245",2010,249349,233113,197110,4565,2.32,36003,5856,16.27,16236,6.51
"2647","48247",2010,5211,5201,4828,69,1.43,373,29,7.77,10,0.19
"2648","48249",2010,40631,39027,35209,827,2.35,3818,350,9.17,1604,3.95
"2649","48251",2010,147611,144895,130404,3479,2.67,14491,3116,21.5,2716,1.84
"2650","48253",2010,20157,14444,12299,108,0.88,2145,171,7.97,5713,28.34
"2651","48255",2010,14880,8890,7624,218,2.86,1266,61,4.82,5990,40.26
"2652","48257",2010,98402,97059,88746,1990,2.24,8313,1504,18.09,1343,1.36
"2653","48259",2010,31515,30929,27730,410,1.48,3199,421,13.16,586,1.86
"2654","48261",2010,241,241,212,0,0,29,0,0,0,0
"2655","48263",2010,772,762,589,3,0.51,173,10,5.78,10,1.3
"2656","48265",2010,48826,46892,39538,667,1.69,7354,1304,17.73,1934,3.96
"2657","48267",2010,4568,4558,3740,32,0.86,818,147,17.97,10,0.22
"2658","48269",2010,219,219,194,12,6.19,25,0,0,0,0
"2659","48271",2010,3555,3443,2898,36,1.24,545,115,21.1,112,3.15
"2660","48273",2010,31611,29902,24925,590,2.37,4977,1439,28.91,1709,5.41
"2661","48275",2010,3708,3654,3058,38,1.24,596,32,5.37,54,1.46
"2662","48277",2010,49536,48921,42719,844,1.98,6202,873,14.08,615,1.24
"2663","48279",2010,14092,13918,12564,344,2.74,1354,103,7.61,174,1.23
"2664","48281",2010,19677,18760,16461,219,1.33,2299,428,18.62,917,4.66
"2665","48283",2010,6709,5938,5194,60,1.16,744,195,26.21,771,11.49
"2666","48285",2010,19217,18846,16157,200,1.24,2689,235,8.74,371,1.93
"2667","48287",2010,16499,16165,14120,222,1.57,2045,248,12.13,334,2.02
"2668","48289",2010,16640,16407,13968,466,3.34,2439,399,16.36,233,1.4
"2669","48291",2010,74922,68859,61676,1507,2.44,7183,1001,13.94,6063,8.09
"2670","48293",2010,23170,19808,17359,346,1.99,2449,191,7.8,3362,14.51
"2671","48295",2010,3218,3208,2746,15,0.55,462,128,27.71,10,0.31
"2672","48297",2010,11507,10109,8783,226,2.57,1326,176,13.27,1398,12.15
"2673","48299",2010,18992,18713,15256,449,2.94,3457,465,13.45,279,1.47
"2674","48301",2010,41,41,38,0,0,3,0,0,0,0
"2675","48303",2010,269932,258272,207212,5493,2.65,51060,13831,27.09,11660,4.32
"2676","48305",2010,5988,5988,5481,163,2.97,507,45,8.88,0,0
"2677","48307",2010,8220,8053,6829,233,3.41,1224,164,13.4,167,2.03
"2678","48309",2010,229587,222319,185122,4404,2.38,37197,9769,26.26,7268,3.17
"2679","48311",2010,897,897,745,0,0,152,17,11.18,0,0
"2680","48313",2010,13433,10214,9028,197,2.18,1186,135,11.38,3219,23.96
"2681","48315",2010,10771,10684,8800,396,4.5,1884,213,11.31,87,0.81
"2682","48317",2010,4606,4596,4243,106,2.5,353,8,2.27,10,0.22
"2683","48319",2010,3928,3928,3446,46,1.33,482,31,6.43,0,0
"2684","48321",2010,36647,36207,31818,608,1.91,4389,840,19.14,440,1.2
"2685","48323",2010,52493,52493,49631,972,1.96,2862,305,10.66,0,0
"2686","48325",2010,45073,42727,38693,507,1.31,4034,746,18.49,2346,5.2
"2687","48327",2010,2212,2145,1874,51,2.72,271,12,4.43,67,3.03
"2688","48329",2010,132103,130794,114657,2351,2.05,16137,2381,14.75,1309,0.99
"2689","48331",2010,24934,24601,21378,561,2.62,3223,391,12.13,333,1.34
"2690","48333",2010,4887,4822,4104,135,3.29,718,133,18.52,65,1.33
"2691","48335",2010,9342,6275,5488,37,0.67,787,65,8.26,3067,32.83
"2692","48337",2010,19789,19509,16749,183,1.09,2760,337,12.21,280,1.41
"2693","48339",2010,427717,425141,379797,9146,2.41,45344,8931,19.7,2576,0.6
"2694","48341",2010,21102,20985,19074,491,2.57,1911,281,14.7,117,0.55
"2695","48343",2010,13077,13067,11203,238,2.12,1864,160,8.58,10,0.08
"2696","48345",2010,1123,1123,938,13,1.39,185,11,5.95,0,0
"2697","48347",2010,63141,58511,47638,1247,2.62,10873,2676,24.61,4630,7.33
"2698","48349",2010,47483,45919,40225,1301,3.23,5694,809,14.21,1564,3.29
"2699","48351",2010,14389,13842,12128,340,2.8,1714,229,13.36,547,3.8
"2700","48353",2010,14990,14684,12300,210,1.71,2384,420,17.62,306,2.04
"2701","48355",2010,334370,327813,280385,7420,2.65,47428,9042,19.06,6557,1.96
"2702","48357",2010,9953,9870,8723,284,3.26,1147,124,10.81,83,0.83
"2703","48359",2010,2020,1929,1700,54,3.18,229,45,19.65,91,4.5
"2704","48361",2010,82014,81437,71377,1785,2.5,10060,1526,15.17,577,0.7
"2705","48363",2010,27927,27627,24178,969,4.01,3449,477,13.83,300,1.07
"2706","48365",2010,23569,22996,20445,306,1.5,2551,303,11.88,573,2.43
"2707","48367",2010,112158,108409,96737,1768,1.83,11672,1963,16.82,3749,3.34
"2708","48369",2010,10098,10032,9260,149,1.61,772,75,9.72,66,0.65
"2709","48371",2010,15400,12445,10984,180,1.64,1461,133,9.1,2955,19.19
"2710","48373",2010,45590,41661,35173,1268,3.61,6488,1025,15.8,3929,8.62
"2711","48375",2010,120124,117632,99795,3878,3.89,17837,3633,20.37,2492,2.07
"2712","48377",2010,7703,7699,6672,30,0.45,1027,105,10.22,4,0.05
"2713","48379",2010,10942,10863,9560,296,3.1,1303,204,15.66,79,0.72
"2714","48381",2010,116811,114676,97016,1613,1.66,17660,3143,17.8,2135,1.83
"2715","48383",2010,3298,3288,2989,30,1,299,27,9.03,10,0.3
"2716","48385",2010,3279,3194,2747,78,2.84,447,56,12.53,85,2.59
"2717","48387",2010,12987,12769,11201,152,1.36,1568,156,9.95,218,1.68
"2718","48389",2010,13269,12323,11096,359,3.24,1227,200,16.3,946,7.13
"2719","48391",2010,7434,6776,6034,98,1.62,742,44,5.93,658,8.85
"2720","48393",2010,877,877,824,35,4.25,53,0,0,0,0
"2721","48395",2010,16574,16291,14404,221,1.53,1887,274,14.52,283,1.71
"2722","48397",2010,73311,72583,66891,1795,2.68,5692,1101,19.34,728,0.99
"2723","48399",2010,10492,10073,8905,277,3.11,1168,118,10.1,419,3.99
"2724","48401",2010,52016,46896,41529,589,1.42,5367,672,12.52,5120,9.84
"2725","48403",2010,10653,10643,9103,375,4.12,1540,200,12.99,10,0.09
"2726","48405",2010,8996,8912,7231,152,2.1,1681,281,16.72,84,0.93
"2727","48407",2010,25859,25618,23041,469,2.04,2577,369,14.32,241,0.93
"2728","48409",2010,66100,64551,58028,1140,1.96,6523,949,14.55,1549,2.34
"2729","48411",2010,6023,5704,4835,85,1.76,869,212,24.4,319,5.3
"2730","48413",2010,3343,3201,2991,67,2.24,210,25,11.9,142,4.25
"2731","48415",2010,16579,14133,12429,113,0.91,1704,121,7.1,2446,14.75
"2732","48417",2010,3182,3140,2618,62,2.37,522,80,15.33,42,1.32
"2733","48419",2010,25423,25011,22014,468,2.13,2997,407,13.58,412,1.62
"2734","48421",2010,3000,3000,2710,16,0.59,290,34,11.72,0,0
"2735","48423",2010,203393,200099,172068,3191,1.85,28031,4717,16.83,3294,1.62
"2736","48425",2010,8200,8190,7136,93,1.3,1054,95,9.01,10,0.12
"2737","48427",2010,59989,59241,56583,523,0.92,2658,226,8.5,748,1.25
"2738","48429",2010,9562,8863,7622,149,1.95,1241,130,10.48,699,7.31
"2739","48431",2010,1160,1150,1018,26,2.55,132,0,0,10,0.86
"2740","48433",2010,1434,1424,1239,26,2.1,185,17,9.19,10,0.7
"2741","48435",2010,4257,4257,3719,62,1.67,538,186,34.57,0,0
"2742","48437",2010,7828,7057,6037,104,1.72,1020,145,14.22,771,9.85
"2743","48439",2010,1743300,1718456,1481731,33655,2.27,236725,44113,18.63,24844,1.43
"2744","48441",2010,129477,121742,101051,2410,2.38,20691,3913,18.91,7735,5.97
"2745","48443",2010,850,850,685,4,0.58,165,0,0,0,0
"2746","48445",2010,12498,11369,10016,186,1.86,1353,41,3.03,1129,9.03
"2747","48447",2010,1814,1804,1543,8,0.52,261,2,0.77,10,0.55
"2748","48449",2010,30995,29722,26637,658,2.47,3085,430,13.94,1273,4.11
"2749","48451",2010,108000,102505,85972,1671,1.94,16533,2838,17.17,5495,5.09
"2750","48453",2010,979712,958967,727638,20111,2.76,231329,63847,27.6,20745,2.12
"2751","48455",2010,14451,14120,12309,403,3.27,1811,160,8.83,331,2.29
"2752","48457",2010,21472,19661,16827,538,3.2,2834,422,14.89,1811,8.43
"2753","48459",2010,38685,37372,32741,828,2.53,4631,633,13.67,1313,3.39
"2754","48461",2010,3243,2754,2425,60,2.47,329,24,7.29,489,15.08
"2755","48463",2010,26285,25595,23007,238,1.03,2588,392,15.15,690,2.63
"2756","48465",2010,48088,47630,43547,820,1.88,4083,681,16.68,458,0.95
"2757","48467",2010,52362,51046,44789,885,1.98,6257,682,10.9,1316,2.51
"2758","48469",2010,85813,84737,73978,2123,2.87,10759,1919,17.84,1076,1.25
"2759","48471",2010,66353,45482,34310,616,1.8,11172,2626,23.51,20871,31.45
"2760","48473",2010,40831,39727,33666,665,1.98,6061,2299,37.93,1104,2.7
"2761","48475",2010,10505,10315,9099,258,2.84,1216,185,15.21,190,1.81
"2762","48477",2010,32949,30031,25371,239,0.94,4660,470,10.09,2918,8.86
"2763","48479",2010,240346,239014,224995,5210,2.32,14019,3165,22.58,1332,0.55
"2764","48481",2010,41036,40351,35287,591,1.67,5064,589,11.63,685,1.67
"2765","48483",2010,5235,5179,4473,145,3.24,706,96,13.6,56,1.07
"2766","48485",2010,130976,119588,98953,2253,2.28,20635,4100,19.87,11388,8.69
"2767","48487",2010,13637,12941,10979,321,2.92,1962,296,15.09,696,5.1
"2768","48489",2010,21769,20422,19171,340,1.77,1251,185,14.79,1347,6.19
"2769","48491",2010,391715,388596,342151,6654,1.94,46445,9213,19.84,3119,0.8
"2770","48493",2010,41264,40755,37464,543,1.45,3291,553,16.8,509,1.23
"2771","48495",2010,6933,6845,5664,172,3.04,1181,305,25.83,88,1.27
"2772","48497",2010,58054,57000,51878,844,1.63,5122,885,17.28,1054,1.82
"2773","48499",2010,41625,39199,34304,779,2.27,4895,569,11.62,2426,5.83
"2774","48501",2010,7706,7611,7017,196,2.79,594,111,18.69,95,1.23
"2775","48503",2010,18298,18138,15520,516,3.32,2618,244,9.32,160,0.87
"2776","48505",2010,13609,13599,12760,215,1.68,839,143,17.04,10,0.07
"2777","48507",2010,11658,11280,10365,293,2.83,915,82,8.96,378,3.24
"2778","49001",2010,6431,6149,5544,80,1.44,605,77,12.73,282,4.39
"2779","49003",2010,48221,47610,44421,370,0.83,3189,414,12.98,611,1.27
"2780","49005",2010,107078,104335,90219,1225,1.36,14116,5848,41.43,2743,2.56
"2781","49007",2010,20765,20030,17066,327,1.92,2964,430,14.51,735,3.54
"2782","49009",2010,839,769,581,0,0,188,57,30.32,70,8.34
"2783","49011",2010,294532,292103,270240,2635,0.98,21863,4557,20.84,2429,0.82
"2784","49013",2010,17408,17111,15915,395,2.48,1196,52,4.35,297,1.71
"2785","49015",2010,10728,10667,9663,167,1.73,1004,175,17.43,61,0.57
"2786","49017",2010,4958,4956,4304,24,0.56,652,61,9.36,2,0.04
"2787","49019",2010,8987,8872,6939,278,4.01,1933,397,20.54,115,1.28
"2788","49021",2010,44439,42976,37349,588,1.57,5627,1824,32.42,1463,3.29
"2789","49023",2010,9855,9804,9305,48,0.52,499,69,13.83,51,0.52
"2790","49025",2010,6893,6714,5732,140,2.44,982,70,7.13,179,2.6
"2791","49027",2010,12189,12121,11086,93,0.84,1035,149,14.4,68,0.56
"2792","49029",2010,9013,9013,8557,120,1.4,456,44,9.65,0,0
"2793","49031",2010,1661,1493,1315,3,0.23,178,34,19.1,168,10.11
"2794","49033",2010,2181,2177,2034,13,0.64,143,18,12.59,4,0.18
"2795","49035",2010,1000155,986118,853727,19104,2.24,132391,33820,25.55,14037,1.4
"2796","49037",2010,14299,14131,12902,243,1.88,1229,127,10.33,168,1.17
"2797","49039",2010,26651,24753,21606,247,1.14,3147,1341,42.61,1898,7.12
"2798","49041",2010,20438,19721,17938,171,0.95,1783,244,13.68,717,3.51
"2799","49043",2010,35295,35241,30882,584,1.89,4359,831,19.06,54,0.15
"2800","49045",2010,55398,54777,50242,711,1.42,4535,831,18.32,621,1.12
"2801","49047",2010,30991,30874,28020,666,2.38,2854,611,21.41,117,0.38
"2802","49049",2010,486067,472436,424195,7584,1.79,48241,22291,46.21,13631,2.8
"2803","49051",2010,22176,22123,20770,290,1.4,1353,226,16.7,53,0.24
"2804","49053",2010,134033,132886,119195,1803,1.51,13691,3109,22.71,1147,0.86
"2805","49055",2010,2706,2706,2466,45,1.82,240,63,26.25,0,0
"2806","49057",2010,222849,220198,194235,4242,2.18,25963,5538,21.33,2651,1.19
"2807","50001",2010,36841,34143,28207,737,2.61,5936,1318,22.2,2698,7.32
"2808","50003",2010,37122,35814,29174,465,1.59,6640,1141,17.18,1308,3.52
"2809","50005",2010,31214,29909,24334,1015,4.17,5575,1061,19.03,1305,4.18
"2810","50007",2010,154729,145845,111249,2641,2.37,34596,9813,28.36,8884,5.74
"2811","50009",2010,6359,6359,5120,134,2.62,1239,217,17.51,0,0
"2812","50011",2010,47547,46899,39595,1419,3.58,7304,1709,23.4,648,1.36
"2813","50013",2010,7105,7105,6050,145,2.4,1055,200,18.96,0,0
"2814","50015",2010,24040,23338,18539,553,2.98,4799,1008,21,702,2.92
"2815","50017",2010,29059,28315,23294,711,3.05,5021,1027,20.45,744,2.56
"2816","50019",2010,27256,26551,21802,625,2.87,4749,1062,22.36,705,2.59
"2817","50021",2010,62278,59693,47798,1635,3.42,11895,2472,20.78,2585,4.15
"2818","50023",2010,59379,56583,44362,1256,2.83,12221,2816,23.04,2796,4.71
"2819","50025",2010,44438,43359,33751,1099,3.26,9608,1956,20.36,1079,2.43
"2820","50027",2010,56891,55808,44545,1118,2.51,11263,2241,19.9,1083,1.9
"2821","51001",2010,34066,33675,27876,782,2.81,5799,768,13.24,391,1.15
"2822","51003",2010,96633,91916,75191,1257,1.67,16725,3570,21.35,4717,4.88
"2823","51005",2010,16406,15967,13503,216,1.6,2464,265,10.75,439,2.68
"2824","51007",2010,12517,12301,10583,313,2.96,1718,246,14.32,216,1.73
"2825","51009",2010,32315,29928,25185,510,2.03,4743,858,18.09,2387,7.39
"2826","51011",2010,14653,14572,12571,419,3.33,2001,377,18.84,81,0.55
"2827","51013",2010,197467,194129,122853,3297,2.68,71276,20163,28.29,3338,1.69
"2828","51015",2010,73201,69253,60820,933,1.53,8433,864,10.25,3948,5.39
"2829","51017",2010,4779,4733,4132,153,3.7,601,70,11.65,46,0.96
"2830","51019",2010,67697,67569,59391,895,1.51,8178,1132,13.84,128,0.19
"2831","51021",2010,6873,6308,5663,74,1.31,645,57,8.84,565,8.22
"2832","51023",2010,32867,32144,28566,339,1.19,3578,467,13.05,723,2.2
"2833","51025",2010,17707,14977,12647,161,1.27,2330,257,11.03,2730,15.42
"2834","51027",2010,24459,23650,20497,240,1.17,3153,409,12.97,809,3.31
"2835","51029",2010,16874,9775,8141,200,2.46,1634,113,6.92,7099,42.07
"2836","51031",2010,54174,53879,45329,920,2.03,8550,1530,17.89,295,0.54
"2837","51033",2010,27844,27261,23777,522,2.2,3484,529,15.18,583,2.09
"2838","51035",2010,29985,29593,25401,352,1.39,4192,267,6.37,392,1.31
"2839","51036",2010,7205,7205,6110,100,1.64,1095,197,17.99,0,0
"2840","51037",2010,12644,12562,11194,207,1.85,1368,103,7.53,82,0.65
"2841","51041",2010,308633,304352,270235,5102,1.89,34117,6299,18.46,4281,1.39
"2842","51043",2010,14013,13801,11614,297,2.56,2187,490,22.41,212,1.51
"2843","51045",2010,5173,5044,4370,187,4.28,674,143,21.22,129,2.49
"2844","51047",2010,45749,43914,38811,756,1.95,5103,1203,23.57,1835,4.01
"2845","51049",2010,9855,9845,8405,179,2.13,1440,126,8.75,10,0.1
"2846","51051",2010,15966,15826,13444,155,1.15,2382,337,14.15,140,0.88
"2847","51053",2010,27449,26523,23225,562,2.42,3298,623,18.89,926,3.37
"2848","51057",2010,10901,10742,9118,265,2.91,1624,226,13.92,159,1.46
"2849","51059",2010,1048554,1040341,891063,21470,2.41,149278,34090,22.84,8213,0.78
"2850","51061",2010,64546,64047,56939,1325,2.33,7108,1315,18.5,499,0.77
"2851","51063",2010,15030,15020,12708,230,1.81,2312,310,13.41,10,0.07
"2852","51065",2010,25308,24257,21537,291,1.35,2720,434,15.96,1051,4.15
"2853","51067",2010,54938,53674,45621,1005,2.2,8053,1363,16.93,1264,2.3
"2854","51069",2010,75835,74537,65330,1649,2.52,9207,1810,19.66,1298,1.71
"2855","51071",2010,17205,16973,14466,402,2.78,2507,343,13.68,232,1.35
"2856","51073",2010,36610,36117,31914,587,1.84,4203,845,20.1,493,1.35
"2857","51075",2010,21136,15932,14389,59,0.41,1543,180,11.67,5204,24.62
"2858","51077",2010,15855,15607,13016,300,2.3,2591,229,8.84,248,1.56
"2859","51079",2010,18082,17767,15450,331,2.14,2317,358,15.45,315,1.74
"2860","51081",2010,12181,9934,8813,277,3.14,1121,105,9.37,2247,18.45
"2861","51083",2010,36311,35834,30035,552,1.84,5799,916,15.8,477,1.31
"2862","51085",2010,99172,97093,87629,1228,1.4,9464,1494,15.79,2079,2.1
"2863","51087",2010,300053,296169,243474,5385,2.21,52695,9289,17.63,3884,1.29
"2864","51089",2010,54860,54317,46431,885,1.91,7886,677,8.58,543,0.99
"2865","51091",2010,2395,2395,2055,25,1.22,340,23,6.76,0,0
"2866","51093",2010,34762,34609,30864,648,2.1,3745,458,12.23,153,0.44
"2867","51095",2010,64386,63399,54794,581,1.06,8605,1794,20.85,987,1.53
"2868","51097",2010,6926,6926,6006,299,4.98,920,66,7.17,0,0
"2869","51099",2010,22794,21738,19210,323,1.68,2528,361,14.28,1056,4.63
"2870","51101",2010,15509,15461,13910,351,2.52,1551,182,11.73,48,0.31
"2871","51103",2010,11478,11150,9210,313,3.4,1940,175,9.02,328,2.86
"2872","51105",2010,25434,24673,21281,615,2.89,3392,384,11.32,761,2.99
"2873","51107",2010,291653,290784,260110,5793,2.23,30674,6532,21.29,869,0.3
"2874","51109",2010,32248,32248,27946,820,2.93,4302,764,17.76,0,0
"2875","51111",2010,12968,11900,10074,291,2.89,1826,313,17.14,1068,8.24
"2876","51113",2010,13342,13342,11694,158,1.35,1648,436,26.46,0,0
"2877","51115",2010,9004,8929,7754,219,2.82,1175,128,10.89,75,0.83
"2878","51117",2010,32774,31209,25871,542,2.1,5338,851,15.94,1565,4.78
"2879","51119",2010,10831,10597,9211,172,1.87,1386,245,17.68,234,2.16
"2880","51121",2010,92527,80485,55381,1003,1.81,25104,10011,39.88,12042,13.01
"2881","51125",2010,14989,14917,12486,256,2.05,2431,419,17.24,72,0.48
"2882","51127",2010,17655,16916,15328,196,1.28,1588,246,15.49,739,4.19
"2883","51131",2010,12572,12364,10242,261,2.55,2122,241,11.36,208,1.65
"2884","51133",2010,12419,12419,10243,116,1.13,2176,398,18.29,0,0
"2885","51135",2010,15819,15275,13219,620,4.69,2056,407,19.8,544,3.44
"2886","51137",2010,32730,31953,28116,488,1.74,3837,476,12.41,777,2.37
"2887","51139",2010,24116,23890,20318,597,2.94,3572,476,13.33,226,0.94
"2888","51141",2010,18643,18373,15795,214,1.35,2578,325,12.61,270,1.45
"2889","51143",2010,63147,62148,53362,758,1.42,8786,894,10.18,999,1.58
"2890","51145",2010,27758,21276,19196,116,0.6,2080,279,13.41,6482,23.35
"2891","51147",2010,22723,19483,15641,220,1.41,3842,1079,28.08,3240,14.26
"2892","51149",2010,35129,29637,27175,460,1.69,2462,310,12.59,5492,15.63
"2893","51153",2010,379415,374441,337110,10811,3.21,37331,8893,23.82,4974,1.31
"2894","51155",2010,34963,33849,28243,770,2.73,5606,704,12.56,1114,3.19
"2895","51157",2010,7376,7376,6104,127,2.08,1272,260,20.44,0,0
"2896","51159",2010,9328,7754,6479,245,3.78,1275,180,14.12,1574,16.87
"2897","51161",2010,91583,89742,75764,870,1.15,13978,1797,12.86,1841,2.01
"2898","51163",2010,22217,22217,18785,268,1.43,3432,648,18.88,0,0
"2899","51165",2010,74922,72672,63492,1135,1.79,9180,1156,12.59,2250,3
"2900","51167",2010,28842,28842,24834,239,0.96,4008,585,14.6,0,0
"2901","51169",2010,23234,22735,19508,367,1.88,3227,267,8.27,499,2.15
"2902","51171",2010,41468,41365,34658,892,2.57,6707,1027,15.31,103,0.25
"2903","51173",2010,32383,31361,26517,716,2.7,4844,630,13.01,1022,3.16
"2904","51175",2010,18493,16976,14814,327,2.21,2162,249,11.52,1517,8.2
"2905","51177",2010,120212,119269,107969,2396,2.22,11300,2447,21.65,943,0.78
"2906","51179",2010,124587,120770,111408,2340,2.1,9362,1799,19.22,3817,3.06
"2907","51181",2010,7039,7039,6083,150,2.47,956,152,15.9,0,0
"2908","51183",2010,12167,10868,9107,206,2.26,1761,309,17.55,1299,10.68
"2909","51185",2010,44706,44058,38236,542,1.42,5822,741,12.73,648,1.45
"2910","51187",2010,37044,36559,31139,628,2.02,5420,1025,18.91,485,1.31
"2911","51191",2010,54322,52863,44791,1043,2.33,8072,1438,17.81,1459,2.69
"2912","51193",2010,17237,17237,14329,545,3.8,2908,467,16.06,0,0
"2913","51195",2010,41496,39087,33644,844,2.51,5443,600,11.02,2409,5.81
"2914","51197",2010,29005,28743,24285,555,2.29,4458,746,16.73,262,0.9
"2915","51199",2010,64846,62575,56578,453,0.8,5997,852,14.21,2271,3.5
"2916","51510",2010,133647,132259,88933,3033,3.41,43326,8598,19.84,1388,1.04
"2917","51515",2010,6177,6147,4952,13,0.26,1195,141,11.8,30,0.49
"2918","51520",2010,17704,17263,13831,241,1.74,3432,383,11.16,441,2.49
"2919","51530",2010,6653,6556,5442,141,2.59,1114,228,20.47,97,1.46
"2920","51540",2010,42267,38381,21306,579,2.72,17075,6833,40.02,3886,9.19
"2921","51550",2010,219268,215277,192177,3920,2.04,23100,3933,17.03,3991,1.82
"2922","51570",2010,17472,17400,14260,384,2.69,3140,620,19.75,72,0.41
"2923","51580",2010,5989,5989,4627,194,4.19,1362,249,18.28,0,0
"2924","51590",2010,43787,41686,33034,396,1.2,8652,963,11.13,2101,4.8
"2925","51595",2010,5822,5678,4380,212,4.84,1298,248,19.11,144,2.47
"2926","51600",2010,22058,21451,17544,210,1.2,3907,1012,25.9,607,2.75
"2927","51610",2010,11465,11465,9243,166,1.8,2222,446,20.07,0,0
"2928","51620",2010,8549,8330,7122,72,1.01,1208,74,6.13,219,2.56
"2929","51630",2010,23375,20857,14652,232,1.58,6205,1489,24,2518,10.77
"2930","51640",2010,6936,6471,4555,182,4,1916,328,17.12,465,6.7
"2931","51650",2010,139046,135222,109676,2493,2.27,25546,5569,21.8,3824,2.75
"2932","51660",2010,47406,38267,23396,1018,4.35,14871,7332,49.3,9139,19.28
"2933","51670",2010,22506,22349,17870,807,4.52,4479,908,20.27,157,0.7
"2934","51678",2010,6990,4480,2836,4,0.14,1644,509,30.96,2510,35.91
"2935","51680",2010,73726,65378,50057,1072,2.14,15321,3714,24.24,8348,11.32
"2936","51683",2010,36067,35914,31951,1745,5.46,3963,1008,25.44,153,0.42
"2937","51685",2010,13195,13195,11978,500,4.17,1217,267,21.94,0,0
"2938","51690",2010,14029,13323,10637,63,0.59,2686,330,12.29,706,5.03
"2939","51700",2010,181822,172810,140761,3571,2.54,32049,6678,20.84,9012,4.96
"2940","51710",2010,242143,223635,175595,5472,3.12,48040,13187,27.45,18508,7.64
"2941","51720",2010,3886,3820,2804,50,1.78,1016,207,20.37,66,1.7
"2942","51730",2010,32303,31753,24913,578,2.32,6840,1602,23.42,550,1.7
"2943","51735",2010,12099,12089,11077,139,1.25,1012,189,18.68,10,0.08
"2944","51740",2010,96785,92964,76229,2074,2.72,16735,3189,19.06,3821,3.95
"2945","51750",2010,16318,12591,7165,229,3.2,5426,2244,41.36,3727,22.84
"2946","51760",2010,201828,191703,130510,5158,3.95,61193,17742,28.99,10125,5.02
"2947","51770",2010,95793,93771,70574,2246,3.18,23197,3745,16.14,2022,2.11
"2948","51775",2010,24641,22705,18154,366,2.02,4551,897,19.71,1936,7.86
"2949","51790",2010,23806,21806,16656,353,2.12,5150,549,10.66,2000,8.4
"2950","51800",2010,82544,81489,72723,1062,1.46,8766,1528,17.43,1055,1.28
"2951","51810",2010,435996,426379,357548,7843,2.19,68831,17480,25.4,9617,2.21
"2952","51820",2010,20885,20607,16843,841,4.99,3764,664,17.64,278,1.33
"2953","51830",2010,13421,8524,5783,158,2.73,2741,758,27.65,4897,36.49
"2954","51840",2010,25953,24787,18678,638,3.42,6109,1467,24.01,1166,4.49
"2955","53001",2010,17884,17636,16370,524,3.2,1266,265,20.93,248,1.39
"2956","53003",2010,21363,21180,17141,639,3.73,4039,756,18.72,183,0.86
"2957","53005",2010,167077,165558,142936,3707,2.59,22622,4316,19.08,1519,0.91
"2958","53007",2010,70995,69847,59697,1639,2.75,10150,1840,18.13,1148,1.62
"2959","53009",2010,70638,68610,55219,1678,3.04,13391,2197,16.41,2028,2.87
"2960","53011",2010,414816,410771,351374,10964,3.12,59397,12776,21.51,4045,0.98
"2961","53013",2010,3957,3947,3171,60,1.89,776,144,18.56,10,0.25
"2962","53015",2010,101244,98728,82967,2584,3.11,15761,3289,20.87,2516,2.49
"2963","53017",2010,37160,37042,31781,879,2.77,5261,1379,26.21,118,0.32
"2964","53019",2010,7504,7373,6212,194,3.12,1161,314,27.05,131,1.75
"2965","53021",2010,71329,70461,63823,2242,3.51,6638,1560,23.5,868,1.22
"2966","53023",2010,2240,2157,1796,25,1.39,361,60,16.62,83,3.71
"2967","53025",2010,85142,83519,73454,2253,3.07,10065,1823,18.11,1623,1.91
"2968","53027",2010,72092,69577,57180,2215,3.87,12397,2376,19.17,2515,3.49
"2969","53029",2010,78633,75822,63862,1251,1.96,11960,1918,16.04,2811,3.57
"2970","53031",2010,29574,28690,21939,410,1.87,6751,1111,16.46,884,2.99
"2971","53033",2010,1879189,1845400,1415678,35933,2.54,429722,103774,24.15,33789,1.8
"2972","53035",2010,247336,242143,202406,5921,2.93,39737,9194,23.14,5193,2.1
"2973","53037",2010,39869,37729,27776,842,3.03,9953,2974,29.88,2140,5.37
"2974","53039",2010,20055,19916,16691,394,2.36,3225,587,18.2,139,0.69
"2975","53041",2010,74650,73787,61954,2163,3.49,11833,2293,19.38,863,1.16
"2976","53043",2010,10533,10494,8963,225,2.51,1531,174,11.37,39,0.37
"2977","53045",2010,59287,57308,47973,2134,4.45,9335,2267,24.28,1979,3.34
"2978","53047",2010,40238,39948,34006,1323,3.89,5942,999,16.81,290,0.72
"2979","53049",2010,21192,20860,16669,296,1.78,4191,580,13.84,332,1.57
"2980","53051",2010,12904,12817,10554,424,4.02,2263,396,17.5,87,0.67
"2981","53053",2010,782681,758349,632567,19519,3.09,125782,28773,22.88,24332,3.11
"2982","53055",2010,15551,15495,11895,254,2.14,3600,547,15.19,56,0.36
"2983","53057",2010,115231,113535,95483,3159,3.31,18052,3695,20.47,1696,1.47
"2984","53059",2010,10869,10869,9028,243,2.69,1841,408,22.16,0,0
"2985","53061",2010,694219,685238,577456,17412,3.02,107782,23914,22.19,8981,1.29
"2986","53063",2010,461262,445228,360251,9958,2.76,84977,18076,21.27,16034,3.48
"2987","53065",2010,43171,43133,37135,991,2.67,5998,1024,17.07,38,0.09
"2988","53067",2010,243563,239925,196754,5752,2.92,43171,9952,23.05,3638,1.49
"2989","53069",2010,3982,3972,3232,97,3,740,106,14.32,10,0.25
"2990","53071",2010,57585,52919,44040,1261,2.86,8879,1519,17.11,4666,8.1
"2991","53073",2010,195993,190725,147237,3845,2.61,43488,13000,29.89,5268,2.69
"2992","53075",2010,43747,37896,24463,501,2.05,13433,5889,43.84,5851,13.37
"2993","53077",2010,236542,232218,205497,7548,3.67,26721,5930,22.19,4324,1.83
"2994","54001",2010,16256,15962,13795,385,2.79,2167,193,8.91,294,1.81
"2995","54003",2010,100910,99414,84152,2634,3.13,15262,3007,19.7,1496,1.48
"2996","54005",2010,24872,24779,21635,488,2.26,3144,301,9.57,93,0.37
"2997","54007",2010,14558,13845,11311,135,1.19,2534,410,16.18,713,4.9
"2998","54009",2010,24194,23599,19968,592,2.96,3631,385,10.6,595,2.46
"2999","54011",2010,95526,93454,73397,1274,1.74,20057,4188,20.88,2072,2.17
"3000","54013",2010,7588,7578,6499,142,2.18,1079,112,10.38,10,0.13
"3001","54015",2010,9572,9271,8071,226,2.8,1200,98,8.17,301,3.14
"3002","54017",2010,8035,8035,6960,93,1.34,1075,214,19.91,0,0
"3003","54019",2010,46138,44053,37203,1125,3.02,6850,1054,15.39,2085,4.52
"3004","54021",2010,8394,5833,4712,87,1.85,1121,210,18.73,2561,30.51
"3005","54023",2010,11942,11856,10178,258,2.53,1678,230,13.71,86,0.72
"3006","54025",2010,35373,34605,28400,726,2.56,6205,880,14.18,768,2.17
"3007","54027",2010,23594,23002,18660,524,2.81,4342,391,9.01,592,2.51
"3008","54029",2010,30866,30503,25447,562,2.21,5056,642,12.7,363,1.18
"3009","54031",2010,13832,13822,11539,385,3.34,2283,422,18.48,10,0.07
"3010","54033",2010,68490,67637,57518,1059,1.84,10119,1347,13.31,853,1.25
"3011","54035",2010,29084,28701,24670,279,1.13,4031,811,20.12,383,1.32
"3012","54037",2010,52033,50634,43050,867,2.01,7584,2010,26.5,1399,2.69
"3013","54039",2010,192770,190213,153340,3422,2.23,36873,5436,14.74,2557,1.33
"3014","54041",2010,16406,15661,12849,343,2.67,2812,528,18.78,745,4.54
"3015","54043",2010,21879,21789,19434,534,2.75,2355,196,8.32,90,0.41
"3016","54045",2010,36564,35764,30737,617,2.01,5027,801,15.93,800,2.19
"3017","54047",2010,22555,22229,18782,456,2.43,3447,599,17.38,326,1.45
"3018","54049",2010,56356,55003,45288,926,2.04,9715,1998,20.57,1353,2.4
"3019","54051",2010,33369,32496,27099,553,2.04,5397,785,14.55,873,2.62
"3020","54053",2010,27016,26475,22520,783,3.48,3955,617,15.6,541,2
"3021","54055",2010,61844,60960,49978,1184,2.37,10982,1649,15.02,884,1.43
"3022","54057",2010,27796,27255,23196,536,2.31,4059,461,11.36,541,1.95
"3023","54059",2010,26956,26808,22678,374,1.65,4130,681,16.49,148,0.55
"3024","54061",2010,92715,84868,60216,1611,2.68,24652,8364,33.93,7847,8.46
"3025","54063",2010,13495,13402,11508,211,1.83,1894,222,11.72,93,0.69
"3026","54065",2010,17409,17300,13881,562,4.05,3419,433,12.66,109,0.63
"3027","54067",2010,26189,26117,23272,481,2.07,2845,212,7.45,72,0.27
"3028","54069",2010,44582,42870,34406,604,1.76,8464,1100,13,1712,3.84
"3029","54071",2010,7773,7666,6144,150,2.44,1522,217,14.26,107,1.38
"3030","54073",2010,7664,7303,6212,95,1.53,1091,174,15.95,361,4.71
"3031","54075",2010,8808,8325,7079,109,1.54,1246,137,11,483,5.48
"3032","54077",2010,32976,30875,26360,637,2.42,4515,668,14.8,2101,6.37
"3033","54079",2010,54940,54626,48580,664,1.37,6046,1000,16.54,314,0.57
"3034","54081",2010,78513,73949,62482,1129,1.81,11467,1285,11.21,4564,5.81
"3035","54083",2010,29233,26703,22740,350,1.54,3963,335,8.45,2530,8.65
"3036","54085",2010,10514,10504,8979,283,3.15,1525,236,15.48,10,0.1
"3037","54087",2010,15116,15007,12585,310,2.46,2422,415,17.13,109,0.72
"3038","54089",2010,13847,12543,10398,159,1.53,2145,266,12.4,1304,9.42
"3039","54091",2010,16732,16193,13914,242,1.74,2279,288,12.64,539,3.22
"3040","54093",2010,7137,7127,5914,162,2.74,1213,153,12.61,10,0.14
"3041","54095",2010,9339,9250,7811,136,1.74,1439,232,16.12,89,0.95
"3042","54097",2010,23984,22492,18607,290,1.56,3885,790,20.33,1492,6.22
"3043","54099",2010,42647,42647,36960,590,1.6,5687,692,12.17,0,0
"3044","54101",2010,9247,9050,7712,143,1.85,1338,149,11.14,197,2.13
"3045","54103",2010,16697,16697,14333,185,1.29,2364,192,8.12,0,0
"3046","54105",2010,5753,5753,4821,153,3.17,932,265,28.43,0,0
"3047","54107",2010,86731,85888,71497,2090,2.92,14391,2103,14.61,843,0.97
"3048","54109",2010,23993,23984,20831,369,1.77,3153,592,18.78,9,0.04
"3049","55001",2010,21044,19621,16163,401,2.48,3458,434,12.55,1423,6.76
"3050","55003",2010,16212,15626,12536,461,3.68,3090,463,14.98,586,3.61
"3051","55005",2010,45915,45231,37620,957,2.54,7611,1127,14.81,684,1.49
"3052","55007",2010,15114,14712,12266,216,1.76,2446,285,11.65,402,2.66
"3053","55009",2010,244376,237006,194766,4451,2.29,42240,8634,20.44,7370,3.02
"3054","55011",2010,13744,13634,11256,269,2.39,2378,455,19.13,110,0.8
"3055","55013",2010,15749,15420,12490,321,2.57,2930,451,15.39,329,2.09
"3056","55015",2010,47902,47654,42343,703,1.66,5311,951,17.91,248,0.52
"3057","55017",2010,61466,60523,51011,1315,2.58,9512,2072,21.78,943,1.53
"3058","55019",2010,34552,33998,29310,499,1.7,4688,694,14.8,554,1.6
"3059","55021",2010,56350,54562,45769,1128,2.46,8793,1576,17.92,1788,3.17
"3060","55023",2010,16801,16095,13453,341,2.53,2642,319,12.07,706,4.2
"3061","55025",2010,477748,463832,347132,8437,2.43,116700,34006,29.14,13916,2.91
"3062","55027",2010,88935,81823,69475,1618,2.33,12348,1918,15.53,7112,8
"3063","55029",2010,27959,27880,22704,411,1.81,5176,616,11.9,79,0.28
"3064","55031",2010,43907,42249,33866,730,2.16,8383,1404,16.75,1658,3.78
"3065","55033",2010,43365,39661,31153,773,2.48,8508,2904,34.13,3704,8.54
"3066","55035",2010,97381,92274,70254,1488,2.12,22020,6222,28.26,5107,5.24
"3067","55037",2010,4587,4523,3864,66,1.71,659,78,11.84,64,1.4
"3068","55039",2010,100919,98427,82731,1805,2.18,15696,2618,16.68,2492,2.47
"3069","55041",2010,9534,9031,7291,214,2.94,1740,307,17.64,503,5.28
"3070","55043",2010,50716,46790,37325,900,2.41,9465,2641,27.9,3926,7.74
"3071","55045",2010,36448,35909,30374,588,1.94,5535,1030,18.61,539,1.48
"3072","55047",2010,19107,19021,15975,286,1.79,3046,417,13.69,86,0.45
"3073","55049",2010,23646,23508,20081,343,1.71,3427,520,15.17,138,0.58
"3074","55051",2010,6075,5852,4426,53,1.2,1426,193,13.53,223,3.67
"3075","55053",2010,20284,18837,15796,422,2.67,3041,409,13.45,1447,7.13
"3076","55055",2010,82778,80087,68433,1386,2.03,11654,2076,17.81,2691,3.25
"3077","55057",2010,26733,26561,22546,617,2.74,4015,626,15.59,172,0.64
"3078","55059",2010,164328,158499,134123,3345,2.49,24376,4358,17.88,5829,3.55
"3079","55061",2010,20642,20488,17593,341,1.94,2895,457,15.79,154,0.75
"3080","55063",2010,112819,107559,82666,1997,2.42,24893,6846,27.5,5260,4.66
"3081","55065",2010,16775,16705,14190,254,1.79,2515,504,20.04,70,0.42
"3082","55067",2010,20218,19840,16911,399,2.36,2929,299,10.21,378,1.87
"3083","55069",2010,29075,28570,23942,417,1.74,4628,504,10.89,505,1.74
"3084","55071",2010,81678,80453,66327,1219,1.84,14126,2123,15.03,1225,1.5
"3085","55073",2010,132644,131071,110972,2333,2.1,20099,3719,18.5,1573,1.19
"3086","55075",2010,42019,40165,32065,795,2.48,8100,1102,13.6,1854,4.41
"3087","55077",2010,15421,15421,12842,333,2.59,2579,432,16.75,0,0
"3088","55078",2010,4251,4251,3830,50,1.31,421,57,13.54,0,0
"3089","55079",2010,937616,914177,713020,22971,3.22,201157,40986,20.38,23439,2.5
"3090","55081",2010,44053,43610,36700,1135,3.09,6910,1076,15.57,443,1.01
"3091","55083",2010,37737,37450,31758,853,2.69,5692,828,14.55,287,0.76
"3092","55085",2010,36379,35479,28807,824,2.86,6672,717,10.75,900,2.47
"3093","55087",2010,174457,171769,144433,2304,1.6,27336,4663,17.06,2688,1.54
"3094","55089",2010,85945,84721,73097,739,1.01,11624,1920,16.52,1224,1.42
"3095","55091",2010,7517,7358,6183,99,1.6,1175,153,13.02,159,2.12
"3096","55093",2010,40530,37691,30911,512,1.66,6780,2170,32.01,2839,7
"3097","55095",2010,44310,43952,37413,930,2.49,6539,1034,15.81,358,0.81
"3098","55097",2010,69437,65965,52248,1078,2.06,13717,3802,27.72,3472,5
"3099","55099",2010,14452,14252,11428,177,1.55,2824,348,12.32,200,1.38
"3100","55101",2010,194736,188130,158433,4106,2.59,29697,4712,15.87,6606,3.39
"3101","55103",2010,18205,18049,15134,465,3.07,2915,428,14.68,156,0.86
"3102","55105",2010,159964,157240,133171,3749,2.82,24069,4323,17.96,2724,1.7
"3103","55107",2010,14855,14559,11916,289,2.43,2643,366,13.85,296,1.99
"3104","55109",2010,82636,82007,71492,1281,1.79,10515,2053,19.52,629,0.76
"3105","55111",2010,60957,60411,50538,1538,3.04,9873,1548,15.68,546,0.9
"3106","55113",2010,16615,16347,13386,582,4.35,2961,398,13.44,268,1.61
"3107","55115",2010,41842,41045,35039,934,2.67,6006,891,14.84,797,1.9
"3108","55117",2010,115328,112248,93373,1597,1.71,18875,3088,16.36,3080,2.67
"3109","55119",2010,20557,20424,17138,355,2.07,3286,450,13.69,133,0.65
"3110","55121",2010,28523,28002,23512,642,2.73,4490,805,17.93,521,1.83
"3111","55123",2010,29460,28987,24503,483,1.97,4484,724,16.15,473,1.61
"3112","55125",2010,21750,21486,17400,529,3.04,4086,489,11.97,264,1.21
"3113","55127",2010,101735,98596,81654,1948,2.39,16942,3997,23.59,3139,3.09
"3114","55129",2010,16001,15139,12095,295,2.44,3044,538,17.67,862,5.39
"3115","55131",2010,130206,129355,112166,1603,1.43,17189,3053,17.76,851,0.65
"3116","55133",2010,386130,381290,331776,3877,1.17,49514,7503,15.15,4840,1.25
"3117","55135",2010,52533,50930,42115,956,2.27,8815,1498,16.99,1603,3.05
"3118","55137",2010,24631,23249,19327,405,2.1,3922,632,16.11,1382,5.61
"3119","55139",2010,165032,155408,121303,3000,2.47,34105,8048,23.6,9624,5.83
"3120","55141",2010,74601,74031,61491,1312,2.13,12540,1778,14.18,570,0.76
"3121","56001",2010,34926,32464,20957,606,2.89,11507,4065,35.33,2462,7.05
"3122","56003",2010,11448,11379,9918,183,1.85,1461,163,11.16,69,0.6
"3123","56005",2010,43179,43054,37599,1247,3.32,5455,1222,22.4,125,0.29
"3124","56007",2010,15624,14104,11920,278,2.33,2184,326,14.93,1520,9.73
"3125","56009",2010,13404,13321,11059,343,3.1,2262,373,16.49,83,0.62
"3126","56011",2010,6761,6678,5795,76,1.31,883,100,11.33,83,1.23
"3127","56013",2010,38875,38193,32335,1015,3.14,5858,859,14.66,682,1.75
"3128","56015",2010,12844,12034,9797,229,2.34,2237,337,15.06,810,6.31
"3129","56017",2010,4720,4703,3732,151,4.05,971,159,16.37,17,0.36
"3130","56019",2010,8307,8207,6721,117,1.74,1486,122,8.21,100,1.2
"3131","56021",2010,89221,87470,73125,2052,2.81,14345,2326,16.21,1751,1.96
"3132","56023",2010,17447,17415,15546,309,1.99,1869,190,10.17,32,0.18
"3133","56025",2010,73520,71490,59846,1656,2.77,11644,1799,15.45,2030,2.76
"3134","56027",2010,2430,2159,1740,27,1.55,419,69,16.47,271,11.15
"3135","56029",2010,27574,26608,21901,371,1.69,4707,641,13.62,966,3.5
"3136","56031",2010,8655,8641,7152,258,3.61,1489,190,12.76,14,0.16
"3137","56033",2010,28380,27812,22221,505,2.27,5591,960,17.17,568,2
"3138","56035",2010,9322,9204,8242,418,5.07,962,184,19.13,118,1.27
"3139","56037",2010,42266,41479,35588,1002,2.82,5891,1106,18.77,787,1.86
"3140","56039",2010,20802,20473,14889,577,3.88,5584,2421,43.36,329,1.58
"3141","56041",2010,20537,20228,18030,546,3.03,2198,275,12.51,309,1.5
"3142","56043",2010,8271,8111,6742,100,1.48,1369,213,15.56,160,1.93
"3143","56045",2010,7066,6780,5571,205,3.68,1209,137,11.33,286,4.05
"3144","72001",2010,19541,19447,18216,576,3.16,1231,113,9.18,94,0.48
"3145","72003",2010,42232,42172,38888,717,1.84,3284,441,13.43,60,0.14
"3146","72005",2010,61965,60551,54803,1200,2.19,5748,599,10.42,1414,2.28
"3147","72007",2010,28827,28750,26776,468,1.75,1974,60,3.04,77,0.27
"3148","72009",2010,26161,26161,24072,577,2.4,2089,183,8.76,0,0
"3149","72011",2010,29254,29244,26922,493,1.83,2322,233,10.03,10,0.03
"3150","72013",2010,97633,96377,87454,2034,2.33,8923,1378,15.44,1256,1.29
"3151","72015",2010,19607,19606,17655,606,3.43,1951,269,13.79,1,0.01
"3152","72017",2010,24506,24034,22104,392,1.77,1930,308,15.96,472,1.93
"3153","72019",2010,30272,29907,27989,859,3.07,1918,184,9.59,365,1.21
"3154","72021",2010,212183,206530,185725,5178,2.79,20805,3257,15.65,5653,2.66
"3155","72023",2010,50468,50382,45174,919,2.03,5208,656,12.6,86,0.17
"3156","72025",2010,143301,142415,129175,3522,2.73,13240,1958,14.79,886,0.62
"3157","72027",2010,35381,35368,32796,416,1.27,2572,235,9.14,13,0.04
"3158","72029",2010,47151,47016,43498,1194,2.74,3518,518,14.72,135,0.29
"3159","72031",2010,179356,178693,159432,4328,2.71,19261,2864,14.87,663,0.37
"3160","72033",2010,28663,28663,26114,545,2.09,2549,314,12.32,0,0
"3161","72035",2010,48255,48116,43018,1624,3.78,5098,893,17.52,139,0.29
"3162","72037",2010,14493,14493,12993,463,3.56,1500,141,9.4,0,0
"3163","72039",2010,19067,19057,17880,416,2.33,1177,104,8.84,10,0.05
"3164","72041",2010,43604,43604,40167,1578,3.93,3437,654,19.03,0,0
"3165","72043",2010,40229,40219,37405,1143,3.06,2814,160,5.69,10,0.02
"3166","72045",2010,20773,20746,19409,253,1.3,1337,103,7.7,27,0.13
"3167","72047",2010,37312,37312,34989,1046,2.99,2323,101,4.35,0,0
"3168","72049",2010,1939,1939,1697,40,2.36,242,50,20.66,0,0
"3169","72051",2010,37631,37572,34248,750,2.19,3324,467,14.05,59,0.16
"3170","72053",2010,37875,37467,33144,1233,3.72,4323,704,16.28,408,1.08
"3171","72054",2010,12697,12697,11632,278,2.39,1065,105,9.86,0,0
"3172","72055",2010,19990,19983,18228,418,2.29,1755,175,9.97,7,0.04
"3173","72057",2010,45416,45331,41440,1567,3.78,3891,252,6.48,85,0.19
"3174","72059",2010,21986,21960,20598,745,3.62,1362,197,14.46,26,0.12
"3175","72061",2010,98875,96987,85735,2063,2.41,11252,1591,14.14,1888,1.91
"3176","72063",2010,44073,43658,40710,1090,2.68,2948,485,16.45,415,0.94
"3177","72065",2010,41645,41645,38688,565,1.46,2957,275,9.3,0,0
"3178","72067",2010,17213,17096,15398,408,2.65,1698,34,2,117,0.68
"3179","72069",2010,58924,58679,52256,1550,2.97,6423,1217,18.95,245,0.42
"3180","72071",2010,45681,45445,41289,824,2,4156,500,12.03,236,0.52
"3181","72073",2010,16865,16635,15651,643,4.11,984,130,13.21,230,1.36
"3182","72075",2010,51020,50640,46520,1565,3.36,4120,573,13.91,380,0.74
"3183","72077",2010,39829,39501,35779,1285,3.59,3722,768,20.63,328,0.82
"3184","72079",2010,26000,26000,23610,464,1.97,2390,231,9.67,0,0
"3185","72081",2010,31600,31362,29149,802,2.75,2213,157,7.09,238,0.75
"3186","72083",2010,10156,10000,9261,348,3.76,739,93,12.58,156,1.54
"3187","72085",2010,38146,37757,34104,1386,4.06,3653,819,22.42,389,1.02
"3188","72087",2010,30703,30703,28327,979,3.46,2376,238,10.02,0,0
"3189","72089",2010,20131,20021,17836,548,3.07,2185,506,23.16,110,0.55
"3190","72091",2010,44631,44468,39625,1218,3.07,4843,719,14.85,163,0.37
"3191","72093",2010,6244,6231,5631,111,1.97,600,149,24.83,13,0.21
"3192","72095",2010,12393,12392,11048,415,3.76,1344,268,19.94,1,0.01
"3193","72097",2010,91205,89325,75352,1666,2.21,13973,3711,26.56,1880,2.06
"3194","72099",2010,40280,39930,37222,534,1.43,2708,300,11.08,350,0.87
"3195","72101",2010,32339,32137,30594,1116,3.65,1543,243,15.75,202,0.62
"3196","72103",2010,26331,26282,23520,674,2.87,2762,617,22.34,49,0.19
"3197","72105",2010,30460,30377,28922,448,1.55,1455,93,6.39,83,0.27
"3198","72107",2010,23646,23517,21870,889,4.06,1647,209,12.69,129,0.55
"3199","72109",2010,19552,19552,17538,471,2.69,2014,253,12.56,0,0
"3200","72111",2010,24879,24879,23417,824,3.52,1462,203,13.89,0,0
"3201","72113",2010,170920,166071,148981,5139,3.45,17090,2385,13.96,4849,2.84
"3202","72115",2010,25985,25985,23823,288,1.21,2162,118,5.46,0,0
"3203","72117",2010,15203,15201,13474,335,2.49,1727,149,8.63,2,0.01
"3204","72119",2010,54270,52804,48357,1459,3.02,4447,553,12.44,1466,2.7
"3205","72121",2010,25532,25479,23374,740,3.17,2105,183,8.69,53,0.21
"3206","72123",2010,31265,31265,28300,932,3.29,2965,463,15.62,0,0
"3207","72125",2010,35997,35506,31562,821,2.6,3944,479,12.15,491,1.36
"3208","72127",2010,404748,394029,326164,11318,3.47,67865,12878,18.98,10719,2.65
"3209","72129",2010,41300,41300,37435,1396,3.73,3865,743,19.22,0,0
"3210","72131",2010,42982,42982,39900,1130,2.83,3082,304,9.86,0,0
"3211","72133",2010,23113,23103,20980,778,3.71,2123,284,13.38,10,0.04
"3212","72135",2010,72756,72530,68095,1833,2.69,4435,739,16.66,226,0.31
"3213","72137",2010,90867,90654,81356,2765,3.4,9298,1185,12.74,213,0.23
"3214","72139",2010,75464,74680,66851,1966,2.94,7829,1372,17.52,784,1.04
"3215","72141",2010,33741,33741,31111,1128,3.63,2630,288,10.95,0,0
"3216","72143",2010,39807,39313,36334,965,2.66,2979,296,9.94,494,1.24
"3217","72145",2010,60436,60334,56229,1286,2.29,4105,447,10.89,102,0.17
"3218","72147",2010,9313,9313,7880,174,2.21,1433,220,15.35,0,0
"3219","72149",2010,26565,26429,24951,872,3.49,1478,250,16.91,136,0.51
"3220","72151",2010,38387,38204,35195,948,2.69,3009,424,14.09,183,0.48
"3221","72153",2010,43082,43069,39539,830,2.1,3530,470,13.31,13,0.03
