IntSub,IntNoSub,noInt,total,IntSubPct,IntNoSubPct,NoIntPct,year,ZCTA
174,9,111,294,59.18,3.06,37.76,2019,25245
279,10,65,354,78.81,2.82,18.36,2019,25268
452,10,151,613,73.74,1.63,24.63,2019,25286
2649,44,277,2970,89.19,1.48,9.33,2019,25303
3857,94,1137,5088,75.81,1.85,22.35,2019,25311
3599,61,528,4188,85.94,1.46,12.61,2019,25419
703,58,191,952,73.84,6.09,20.06,2019,25434
487,0,20,507,96.06,0.0,3.94,2019,25446
235,1,41,277,84.84,0.36,14.8,2019,25106
322,0,167,489,65.85,0.0,34.15,2019,25501
244,12,66,322,75.78,3.73,20.5,2019,25507
638,29,196,863,73.93,3.36,22.71,2019,25515
186,73,255,514,36.19,14.2,49.61,2019,25520
647,43,157,847,76.39,5.08,18.54,2019,25535
345,36,55,436,79.13,8.26,12.61,2019,25564
1901,20,419,2340,81.24,0.85,17.91,2019,25601
542,0,0,542,100.0,0.0,0.0,2019,25606
349,8,126,483,72.26,1.66,26.09,2019,25608
218,24,69,311,70.1,7.72,22.19,2019,25617
486,35,224,745,65.23,4.7,30.07,2019,25621
99,15,0,114,86.84,13.16,0.0,2019,25628
138,0,81,219,63.01,0.0,36.99,2019,25632
97,0,16,113,85.84,0.0,14.16,2019,25644
392,24,129,545,71.93,4.4,23.67,2019,25671
180,40,44,264,68.18,15.15,16.67,2019,25817
226,12,0,238,94.96,5.04,0.0,2019,25818
133,0,0,133,100.0,0.0,0.0,2019,25836
323,21,85,429,75.29,4.9,19.81,2019,25843
139,0,84,223,62.33,0.0,37.67,2019,25666
82,0,29,111,73.87,0.0,26.13,2019,25650
849,0,147,996,85.24,0.0,14.76,2019,26541
270,0,0,270,100.0,0.0,0.0,2019,26576
114,0,37,151,75.5,0.0,24.5,2019,26627
48,0,98,146,32.88,0.0,67.12,2019,26629
107,0,31,138,77.54,0.0,22.46,2019,26676
106,0,0,106,100.0,0.0,0.0,2019,26680
70,0,106,176,39.77,0.0,60.23,2019,26714
4017,176,880,5073,79.18,3.47,17.35,2019,26726
117,0,57,174,67.24,0.0,32.76,2019,26731
1951,26,449,2426,80.42,1.07,18.51,2019,26753
1817,74,868,2759,65.86,2.68,31.46,2019,26757
140,62,63,265,52.83,23.4,23.77,2019,26804
76,0,51,127,59.84,0.0,40.16,2019,26823
173,0,116,289,59.86,0.0,40.14,2019,26855
12330,843,3783,16956,72.72,4.97,22.31,2019,26003
445,18,215,678,65.63,2.65,31.71,2019,26031
2142,42,275,2459,87.11,1.71,11.18,2019,26150
36,0,0,36,100.0,0.0,0.0,2019,26152
971,31,221,1223,79.39,2.53,18.07,2019,26159
678,0,279,957,70.85,0.0,29.15,2019,26180
790,0,139,929,85.04,0.0,14.96,2019,26184
65,0,71,136,47.79,0.0,52.21,2019,26217
81,26,14,121,66.94,21.49,11.57,2019,26224
0,0,13,13,0.0,0.0,100.0,2019,26259
299,0,89,388,77.06,0.0,22.94,2019,26269
147,10,105,262,56.11,3.82,40.08,2019,26278
233,53,154,440,52.95,12.05,35.0,2019,26294
17,0,0,17,100.0,0.0,0.0,2019,26327
740,20,334,1094,67.64,1.83,30.53,2019,28119
1633,38,447,2118,77.1,1.79,21.1,2019,26034
2168,165,500,2833,76.53,5.82,17.65,2019,26037
7055,207,1586,8848,79.74,2.34,17.92,2019,26062
1288,70,514,1872,68.8,3.74,27.46,2019,26143
560,30,175,765,73.2,3.92,22.88,2019,26149
5881,283,1610,7774,75.65,3.64,20.71,2019,26201
22,0,21,43,51.16,0.0,48.84,2019,26266
80,0,11,91,87.91,0.0,12.09,2019,26267
174,18,79,271,64.21,6.64,29.15,2019,26292
135,0,146,281,48.04,0.0,51.96,2019,26320
678,3,139,820,82.68,0.37,16.95,2019,26347
1143,95,271,1509,75.75,6.3,17.96,2019,26385
168,38,70,276,60.87,13.77,25.36,2019,26411
300,0,118,418,71.77,0.0,28.23,2019,26419
80,2,55,137,58.39,1.46,40.15,2019,26430
419,0,105,524,79.96,0.0,20.04,2019,26440
311,6,219,536,58.02,1.12,40.86,2019,26447
550,19,204,773,71.15,2.46,26.39,2019,26519
14135,359,2534,17028,83.01,2.11,14.88,2019,26554
929,71,297,1297,71.63,5.47,22.9,2019,26570
132,0,26,158,83.54,0.0,16.46,2019,26587
59,0,43,102,57.84,0.0,42.16,2019,26611
284,10,176,470,60.43,2.13,37.45,2019,26623
943,52,242,1237,76.23,4.2,19.56,2019,26624
56,0,54,110,50.91,0.0,49.09,2019,26443
160,8,10,178,89.89,4.49,5.62,2019,26562
228,0,95,323,70.59,0.0,29.41,2019,26621
535,0,211,746,71.72,0.0,28.28,2019,26833
184,8,52,244,75.41,3.28,21.31,2019,26169
55,0,0,55,100.0,0.0,0.0,2019,26291
993,0,142,1135,87.49,0.0,12.51,2019,26408
178,0,45,223,79.82,0.0,20.18,2019,26705
88,0,19,107,82.24,0.0,17.76,2019,26707
1020,0,245,1265,80.63,0.0,19.37,2019,26719
230,0,136,366,62.84,0.0,37.16,2019,26801
229,0,150,379,60.42,0.0,39.58,2019,26808
120,0,47,167,71.86,0.0,28.14,2019,26814
2367,93,541,3001,78.87,3.1,18.03,2019,26836
205,16,89,310,66.13,5.16,28.71,2019,26852
391,19,99,509,76.82,3.73,19.45,2019,26374
1645,22,521,2188,75.18,1.01,23.81,2019,26537
685,0,127,812,84.36,0.0,15.64,2019,26710
217,0,64,281,77.22,0.0,22.78,2019,26716
226,5,88,319,70.85,1.57,27.59,2019,26717
459,0,143,602,76.25,0.0,23.75,2019,26743
243,8,79,330,73.64,2.42,23.94,2019,26750
49,0,17,66,74.24,0.0,25.76,2019,26560
502,6,142,650,77.23,0.92,21.85,2019,26335
43,34,28,105,40.95,32.38,26.67,2019,26254
193,0,9,202,95.54,0.0,4.46,2019,26563
486,0,66,552,88.04,0.0,11.96,2019,26591
77,0,28,105,73.33,0.0,26.67,2019,26178
253,0,199,452,55.97,0.0,44.03,2019,26425
444,6,52,502,88.45,1.2,10.36,2019,26559
23,0,85,108,21.3,0.0,78.7,2019,26631
161,26,38,225,71.56,11.56,16.89,2019,26030
1755,83,461,2299,76.34,3.61,20.05,2019,26170
7,0,10,17,41.18,0.0,58.82,2019,26268
128,5,61,194,65.98,2.58,31.44,2019,17953
103,9,48,160,64.38,5.62,30.0,2019,26321
86,0,84,170,50.59,0.0,49.41,2019,26412
548,61,433,1042,52.59,5.85,41.55,2019,27890
3700,140,395,4235,87.37,3.31,9.33,2019,27958
5901,458,2272,8631,68.37,5.31,26.32,2019,27101
956,69,180,1205,79.34,5.73,14.94,2019,27283
18022,1257,3993,23272,77.44,5.4,17.16,2019,27834
122,1,38,161,75.78,0.62,23.6,2019,27873
983,37,498,1518,64.76,2.44,32.81,2019,27925
461,35,121,617,74.72,5.67,19.61,2019,27973
0,0,0,0,,,,2019,27110
11,0,19,30,36.67,0.0,63.33,2019,27201
9977,415,2734,13126,76.01,3.16,20.83,2019,27205
8630,598,1435,10663,80.93,5.61,13.46,2019,27332
37,0,0,37,100.0,0.0,0.0,2019,27340
10627,663,366,11656,91.17,5.69,3.14,2019,27517
7958,133,176,8267,96.26,1.61,2.13,2019,27518
18878,391,438,19707,95.79,1.98,2.22,2019,27519
4132,113,181,4426,93.36,2.55,4.09,2019,27523
7768,65,454,8287,93.74,0.78,5.48,2019,27527
0,0,0,0,,,,2019,27531
6595,168,1980,8743,75.43,1.92,22.65,2019,27537
7578,68,504,8150,92.98,0.83,6.18,2019,27539
43,1,70,114,37.72,0.88,61.4,2019,27556
4419,99,1259,5777,76.49,1.71,21.79,2019,27574
8625,376,311,9312,92.62,4.04,3.34,2019,27617
403,0,19,422,95.5,0.0,4.5,2019,27709
12,3,13,28,42.86,10.71,46.43,2019,27825
9,0,8,17,52.94,0.0,47.06,2019,27861
88,2,38,128,68.75,1.56,29.69,2019,27879
26,0,8,34,76.47,0.0,23.53,2019,27881
42,0,39,81,51.85,0.0,48.15,2019,27978
6952,255,2388,9595,72.45,2.66,24.89,2019,27577
416,12,131,559,74.42,2.15,23.43,2019,27016
942,32,375,1349,69.83,2.37,27.8,2019,27326
834,27,182,1043,79.96,2.59,17.45,2019,27356
6840,484,790,8114,84.3,5.96,9.74,2019,27408
3870,310,1252,5432,71.24,5.71,23.05,2019,27504
17356,170,585,18111,95.83,0.94,3.23,2019,27513
12416,653,1968,15037,82.57,4.34,13.09,2019,27520
4414,128,1328,5870,75.2,2.18,22.62,2019,27525
12443,326,2953,15722,79.14,2.07,18.78,2019,27530
11305,292,1690,13287,85.08,2.2,12.72,2019,27534
4115,208,1985,6308,65.23,3.3,31.47,2019,27536
12122,161,563,12846,94.36,1.25,4.38,2019,27540
13094,215,470,13779,95.03,1.56,3.41,2019,27560
22641,401,1180,24222,93.47,1.66,4.87,2019,27587
203,19,108,330,61.52,5.76,32.73,2019,27866
3955,390,1429,5774,68.5,6.75,24.75,2019,27892
798,42,688,1528,52.23,2.75,45.03,2019,27924
478,19,302,799,59.82,2.38,37.8,2019,27928
580,0,132,712,81.46,0.0,18.54,2019,27935
1270,89,316,1675,75.82,5.31,18.87,2019,27937
2123,79,919,3121,68.02,2.53,29.45,2019,27962
455,0,254,709,64.17,0.0,35.83,2019,26234
2099,235,968,3302,63.57,7.12,29.32,2019,27850
1136,105,523,1764,64.4,5.95,29.65,2019,27871
796,134,814,1744,45.64,7.68,46.67,2019,27874
6255,70,966,7291,85.79,0.96,13.25,2019,17025
6924,359,1993,9276,74.64,3.87,21.49,2019,28144
6659,788,3117,10564,63.03,7.46,29.51,2019,28150
3026,120,808,3954,76.53,3.03,20.44,2019,28168
17413,243,583,18239,95.47,1.33,3.2,2019,28173
16639,448,3007,20094,82.81,2.23,14.96,2019,28205
12553,232,1474,14259,88.04,1.63,10.34,2019,28214
4509,74,116,4699,95.96,1.57,2.47,2019,28307
4029,49,880,4958,81.26,0.99,17.75,2019,28315
1341,22,337,1700,78.88,1.29,19.82,2019,28318
2709,144,1007,3860,70.18,3.73,26.09,2019,28320
3016,61,929,4006,75.29,1.52,23.19,2019,28333
3043,50,480,3573,85.17,1.4,13.43,2019,28730
1070,39,67,1176,90.99,3.32,5.7,2019,28480
8226,480,1632,10338,79.57,4.64,15.79,2019,28715
5112,440,1779,7331,69.73,6.0,24.27,2019,28716
1209,62,182,1453,83.21,4.27,12.53,2019,28729
6349,142,975,7466,85.04,1.9,13.06,2019,28732
15,0,0,15,100.0,0.0,0.0,2019,28733
8382,230,1781,10393,80.65,2.21,17.14,2019,28001
205,3,53,261,78.54,1.15,20.31,2019,28007
1272,124,726,2122,59.94,5.84,34.21,2019,28018
541,45,206,792,68.31,5.68,26.01,2019,28020
17355,349,2242,19946,87.01,1.75,11.24,2019,28025
496,6,52,554,89.53,1.08,9.39,2019,28072
339,12,229,580,58.45,2.07,39.48,2019,28432
1934,18,207,2159,89.58,0.83,9.59,2019,28394
607,3,168,778,78.02,0.39,21.59,2019,28395
13690,343,941,14974,91.43,2.29,6.28,2019,28411
424,0,312,736,57.61,0.0,42.39,2019,28436
840,20,245,1105,76.02,1.81,22.17,2019,28441
7571,109,778,8458,89.51,1.29,9.2,2019,28443
153,0,171,324,47.22,0.0,52.78,2019,28452
1428,142,861,2431,58.74,5.84,35.42,2019,28458
1914,105,1016,3035,63.06,3.46,33.48,2019,28463
2185,0,478,2663,82.05,0.0,17.95,2019,28479
526,30,179,735,71.56,4.08,24.35,2019,28510
1372,53,188,1613,85.06,3.29,11.66,2019,28512
607,4,318,929,65.34,0.43,34.23,2019,28515
354,7,121,482,73.44,1.45,25.1,2019,28421
2567,174,444,3185,80.6,5.46,13.94,2019,28422
653,45,221,919,71.06,4.9,24.05,2019,28423
534,12,263,809,66.01,1.48,32.51,2019,28430
2587,83,261,2931,88.26,2.83,8.9,2019,28445
406,0,57,463,87.69,0.0,12.31,2019,28448
736,20,39,795,92.58,2.52,4.91,2019,28449
2141,47,331,2519,84.99,1.87,13.14,2019,28468
187,31,0,218,85.78,14.22,0.0,2019,28745
1369,124,264,1757,77.92,7.06,15.03,2019,28751
9183,313,2594,12090,75.96,2.59,21.46,2019,28752
2534,74,516,3124,81.11,2.37,16.52,2019,28768
7599,167,1505,9271,81.97,1.8,16.23,2019,28805
6796,313,1811,8920,76.19,3.51,20.3,2019,28906
132,5,78,215,61.4,2.33,36.28,2019,28077
2132,33,297,2462,86.6,1.34,12.06,2019,28097
3420,36,496,3952,86.54,0.91,12.55,2019,28103
16157,339,1031,17527,92.18,1.93,5.88,2019,28105
15970,371,1866,18207,87.71,2.04,10.25,2019,28110
1939,51,259,2249,86.22,2.27,11.52,2019,28124
11057,1166,6588,18811,58.78,6.2,35.02,2019,19140
706,16,139,861,82.0,1.86,16.14,2019,17009
77,0,0,77,100.0,0.0,0.0,2019,17010
5603,326,563,6492,86.31,5.02,8.67,2019,17033
6724,227,2151,9102,73.87,2.49,23.63,2019,17044
59,3,17,79,74.68,3.8,21.52,2019,17829
251,5,62,318,78.93,1.57,19.5,2019,17832
101,0,19,120,84.17,0.0,15.83,2019,17835
480,21,184,685,70.07,3.07,26.86,2019,17845
46,0,18,64,71.88,0.0,28.12,2019,17861
2333,72,1019,3424,68.14,2.1,29.76,2019,17866
530,6,102,638,83.07,0.94,15.99,2019,17929
92,10,139,241,38.17,4.15,57.68,2019,17002
108,0,27,135,80.0,0.0,20.0,2019,17005
240,4,114,358,67.04,1.12,31.84,2019,17006
2928,68,614,3610,81.11,1.88,17.01,2019,17020
278,4,95,377,73.74,1.06,25.2,2019,17035
632,36,242,910,69.45,3.96,26.59,2019,17047
2269,95,657,3021,75.11,3.14,21.75,2019,17061
1360,57,237,1654,82.22,3.45,14.33,2019,17065
744,19,183,946,78.65,2.01,19.34,2019,17087
5718,417,1476,7611,75.13,5.48,19.39,2019,17104
175,5,61,241,72.61,2.07,25.31,2019,17213
241,0,150,391,61.64,0.0,38.36,2019,17214
71,0,16,87,81.61,0.0,18.39,2019,17215
3921,97,854,4872,80.48,1.99,17.53,2019,17222
6352,142,939,7433,85.46,1.91,12.63,2019,17225
718,46,259,1023,70.19,4.5,25.32,2019,17302
3598,62,616,4276,84.14,1.45,14.41,2019,17340
118,1,6,125,94.4,0.8,4.8,2019,17355
11712,638,2541,14891,78.65,4.28,17.06,2019,17403
1538,43,304,1885,81.59,2.28,16.13,2019,17516
2062,111,295,2468,83.55,4.5,11.95,2019,17538
2440,266,330,3036,80.37,8.76,10.87,2019,17554
3881,299,1048,5228,74.23,5.72,20.05,2019,17557
761,32,133,926,82.18,3.46,14.36,2019,17565
1480,128,344,1952,75.82,6.56,17.62,2019,17569
17771,1206,2021,20998,84.63,5.74,9.62,2019,17601
15270,953,2786,19009,80.33,5.01,14.66,2019,17602
526,23,121,670,78.51,3.43,18.06,2019,17721
15,0,2,17,88.24,0.0,11.76,2019,17739
322,31,71,424,75.94,7.31,16.75,2019,17758
517,21,187,725,71.31,2.9,25.79,2019,17810
379,17,91,487,77.82,3.49,18.69,2019,17823
75,0,64,139,53.96,0.0,46.04,2019,17887
2183,18,490,2691,81.12,0.67,18.21,2019,17921
132,0,47,179,73.74,0.0,26.26,2019,17923
46,0,0,46,100.0,0.0,0.0,2019,17933
544,3,146,693,78.5,0.43,21.07,2019,17935
400,11,186,597,67.0,1.84,31.16,2019,17959
1471,5,235,1711,85.97,0.29,13.73,2019,17960
3792,126,816,4734,80.1,2.66,17.24,2019,17972
698,31,166,895,77.99,3.46,18.55,2019,17965
89,2,24,115,77.39,1.74,20.87,2019,17978
1796,56,444,2296,78.22,2.44,19.34,2019,17820
101,3,37,141,71.63,2.13,26.24,2019,17776
398,13,98,509,78.19,2.55,19.25,2019,17812
52,0,51,103,50.49,0.0,49.51,2019,17311
1657,93,313,2063,80.32,4.51,15.17,2019,17314
5284,130,856,6270,84.27,2.07,13.65,2019,20012
2059,28,321,2408,85.51,1.16,13.33,2019,17090
230,3,37,270,85.19,1.11,13.7,2019,17265
1297,4,249,1550,83.68,0.26,16.06,2019,17028
4510,179,1093,5782,78.0,3.1,18.9,2019,17067
330,15,77,422,78.2,3.55,18.25,2019,17228
266,0,313,579,45.94,0.0,54.06,2019,17886
220,8,88,316,69.62,2.53,27.85,2019,17964
24,0,0,24,100.0,0.0,0.0,2019,17083
132,41,69,242,54.55,16.94,28.51,2019,17221
2350,69,413,2832,82.98,2.44,14.58,2019,17327
826,50,428,1304,63.34,3.83,32.82,2019,17509
154,0,22,176,87.5,0.0,12.5,2019,17762
820,5,170,995,82.41,0.5,17.09,2019,17860
695,44,191,930,74.73,4.73,20.54,2019,17764
1531,13,376,1920,79.74,0.68,19.58,2019,17814
589,8,197,794,74.18,1.01,24.81,2019,17830
734,2,187,923,79.52,0.22,20.26,2019,17938
415,30,100,545,76.15,5.5,18.35,2019,17985
931,31,276,1238,75.2,2.5,22.29,2019,17744
474,0,63,537,88.27,0.0,11.73,2019,17868
1029,19,223,1271,80.96,1.49,17.55,2019,17980
7196,131,952,8279,86.92,1.58,11.5,2019,17015
199,5,106,310,64.19,1.61,34.19,2019,17030
9,29,0,38,23.68,76.32,0.0,2019,17039
13774,505,1082,15361,89.67,3.29,7.04,2019,17050
13,0,10,23,56.52,0.0,43.48,2019,17056
40,0,12,52,76.92,0.0,23.08,2019,17071
0,0,0,0,,,,2019,17120
9385,280,1369,11034,85.06,2.54,12.41,2019,17202
85,0,0,85,100.0,0.0,0.0,2019,17210
69,0,15,84,82.14,0.0,17.86,2019,17217
39,0,55,94,41.49,0.0,58.51,2019,17246
101,0,132,233,43.35,0.0,56.65,2019,17247
0,0,34,34,0.0,0.0,100.0,2019,17250
40,0,2,42,95.24,0.0,4.76,2019,17251
49,0,0,49,100.0,0.0,0.0,2019,17256
0,0,0,0,,,,2019,17261
213,0,0,213,100.0,0.0,0.0,2019,17263
178,0,35,213,83.57,0.0,16.43,2019,17272
54,5,30,89,60.67,5.62,33.71,2019,17371
7662,307,1670,9639,79.49,3.18,17.33,2019,17408
51,0,14,65,78.46,0.0,21.54,2019,17507
163,0,144,307,53.09,0.0,46.91,2019,17550
31,110,80,221,14.03,49.77,36.2,2019,17606
17,0,6,23,73.91,0.0,26.09,2019,17723
38,0,5,43,88.37,0.0,11.63,2019,17727
97,0,14,111,87.39,0.0,12.61,2019,17779
0,0,0,0,,,,2019,17822
621,20,204,845,73.49,2.37,24.14,2019,17876
38,0,7,45,84.44,0.0,15.56,2019,17880
10039,222,1678,11939,84.09,1.86,14.05,2019,17268
85,0,14,99,85.86,0.0,14.14,2019,17271
718,33,283,1034,69.44,3.19,27.37,2019,17094
3107,292,675,4074,76.26,7.17,16.57,2019,17102
83,0,35,118,70.34,0.0,29.66,2019,17223
474,51,103,628,75.48,8.12,16.4,2019,17224
2590,100,567,3257,79.52,3.07,17.41,2019,17236
919,27,315,1261,72.88,2.14,24.98,2019,17240
0,0,0,0,,,,2019,20427
2485,113,233,2831,87.78,3.99,8.23,2019,19333
6551,96,356,7003,93.55,1.37,5.08,2019,19341
3094,190,1003,4287,72.17,4.43,23.4,2019,19344
3953,19,149,4121,95.92,0.46,3.62,2019,19350
16288,206,1496,17990,90.54,1.15,8.32,2019,19403
47,0,0,47,100.0,0.0,0.0,2019,19435
22,23,0,45,48.89,51.11,0.0,2019,19457
2544,98,449,3091,82.3,3.17,14.53,2019,19137
6410,201,663,7274,88.12,2.76,9.11,2019,19046
11456,286,1084,12826,89.32,2.23,8.45,2019,19047
13332,176,1509,15017,88.78,1.17,10.05,2019,19063
2556,16,206,2778,92.01,0.58,7.42,2019,19075
2245,9,434,2688,83.52,0.33,16.15,2019,19076
5698,52,746,6496,87.72,0.8,11.48,2019,19015
3908,98,673,4679,83.52,2.09,14.38,2019,19030
10335,201,711,11247,91.89,1.79,6.32,2019,19038
283,0,18,301,94.02,0.0,5.98,2019,19730
26,0,0,26,100.0,0.0,0.0,2019,19732
4572,146,474,5192,88.06,2.81,9.13,2019,19806
494,2,54,550,89.82,0.36,9.82,2019,19954
1856,58,602,2516,73.77,2.31,23.93,2019,19960
10134,94,2083,12311,82.32,0.76,16.92,2019,19966
9825,275,2232,12332,79.67,2.23,18.1,2019,19136
3110,104,162,3376,92.12,3.08,4.8,2019,19081
3984,44,192,4220,94.41,1.04,4.55,2019,19086
6535,43,158,6736,97.02,0.64,2.35,2019,19106
8549,659,3315,12523,68.27,5.26,26.47,2019,19141
13596,638,4145,18379,73.98,3.47,22.55,2019,19145
17,0,0,17,100.0,0.0,0.0,2019,19367
296,0,84,380,77.89,0.0,22.11,2019,19374
376,14,0,390,96.41,3.59,0.0,2019,19437
3940,66,307,4313,91.35,1.53,7.12,2019,19444
19673,606,1933,22212,88.57,2.73,8.7,2019,19446
787,0,29,816,96.45,0.0,3.55,2019,19453
5915,83,625,6623,89.31,1.25,9.44,2019,19465
67,0,0,67,100.0,0.0,0.0,2019,19519
5414,72,846,6332,85.5,1.14,13.36,2019,19610
18182,343,1055,19580,92.86,1.75,5.39,2019,19702
4915,239,893,6047,81.28,3.95,14.77,2019,19703
3512,76,428,4016,87.45,1.89,10.66,2019,19609
10279,357,786,11422,89.99,3.13,6.88,2019,19454
5483,167,426,6076,90.24,2.75,7.01,2019,19462
14977,402,2819,18198,82.3,2.21,15.49,2019,19464
17968,689,1026,19683,91.29,3.5,5.21,2019,19711
17933,992,2522,21447,83.62,4.63,11.76,2019,19720
11136,201,845,12182,91.41,1.65,6.94,2019,19002
2977,0,298,3275,90.9,0.0,9.1,2019,19510
2296,44,431,2771,82.86,1.59,15.55,2019,19506
912,4,176,1092,83.52,0.37,16.12,2019,19507
4578,152,613,5343,85.68,2.84,11.47,2019,19522
3612,102,891,4605,78.44,2.21,19.35,2019,19526
1567,34,262,1863,84.11,1.83,14.06,2019,19551
136,0,36,172,79.07,0.0,20.93,2019,19554
6467,144,1627,8238,78.5,1.75,19.75,2019,19604
15331,451,1608,17390,88.16,2.59,9.25,2019,19147
13049,305,1056,14410,90.56,2.12,7.33,2019,19701
0,0,0,0,,,,2019,19710
10216,402,1011,11629,87.85,3.46,8.69,2019,19713
109,6,86,201,54.23,2.99,42.79,2019,24292
5785,53,545,6383,90.63,0.83,8.54,2019,20015
12888,263,1286,14437,89.27,1.82,8.91,2019,20110
9119,70,372,9561,95.38,0.73,3.89,2019,20121
4805,26,65,4896,98.14,0.53,1.33,2019,20124
2572,6,195,2773,92.75,0.22,7.03,2019,20181
218,0,98,316,68.99,0.0,31.01,2019,20184
8946,71,1149,10166,88.0,0.7,11.3,2019,20602
10586,207,467,11260,94.01,1.84,4.15,2019,20603
96,7,34,137,70.07,5.11,24.82,2019,20606
3690,61,131,3882,95.05,1.57,3.37,2019,20607
156,25,98,279,55.91,8.96,35.13,2019,20608
265,0,115,380,69.74,0.0,30.26,2019,20621
844,43,8,895,94.3,4.8,0.89,2019,20623
469,0,50,519,90.37,0.0,9.63,2019,20624
8054,463,1174,9691,83.11,4.78,12.11,2019,20653
6735,119,1077,7931,84.92,1.5,13.58,2019,20659
268,11,137,416,64.42,2.64,32.93,2019,20684
174,0,45,219,79.45,0.0,20.55,2019,20687
557,21,66,644,86.49,3.26,10.25,2019,20689
395,20,47,462,85.5,4.33,10.17,2019,20144
8406,146,251,8803,95.49,1.66,2.85,2019,20832
1058,45,148,1251,84.57,3.6,11.83,2019,20135
11122,255,942,12319,90.28,2.07,7.65,2019,20164
2346,36,151,2533,92.62,1.42,5.96,2019,20180
258,43,126,427,60.42,10.07,29.51,2019,20609
254,7,35,296,85.81,2.36,11.82,2019,20617
147,10,34,191,76.96,5.24,17.8,2019,20618
3270,189,337,3796,86.14,4.98,8.88,2019,20636
1783,0,111,1894,94.14,0.0,5.86,2019,20637
248,0,52,300,82.67,0.0,17.33,2019,20645
257,12,39,308,83.44,3.9,12.66,2019,20674
2203,65,203,2471,89.15,2.63,8.22,2019,20754
173,0,0,173,100.0,0.0,0.0,2019,20758
173,10,57,240,72.08,4.17,23.75,2019,20625
2648,191,36,2875,92.1,6.64,1.25,2019,20755
809,0,79,888,91.1,0.0,8.9,2019,20860
1174,33,64,1271,92.37,2.6,5.04,2019,20676
1132,0,40,1172,96.59,0.0,3.41,2019,20777
2193,3,159,2355,93.12,0.13,6.75,2019,20833
8012,311,1038,9361,85.59,3.32,11.09,2019,20912
0,0,0,0,,,,2019,20045
0,0,0,0,,,,2019,20052
0,0,0,0,,,,2019,20053
0,0,0,0,,,,2019,20057
0,0,0,0,,,,2019,20064
0,0,0,0,,,,2019,20202
0,0,0,0,,,,2019,20204
0,0,0,0,,,,2019,20228
0,0,0,0,,,,2019,20230
0,0,0,0,,,,2019,20240
0,0,0,0,,,,2019,20245
0,0,0,0,,,,2019,20260
0,0,0,0,,,,2019,20307
25,7,294,326,7.67,2.15,90.18,2019,20317
0,0,0,0,,,,2019,20373
0,0,0,0,,,,2019,20390
0,0,0,0,,,,2019,20405
0,0,0,0,,,,2019,20418
7134,413,2639,10186,70.04,4.05,25.91,2019,24501
0,0,0,0,,,,2019,20506
0,0,0,0,,,,2019,20510
0,0,0,0,,,,2019,20520
0,0,0,0,,,,2019,20535
0,0,0,0,,,,2019,20540
0,0,0,0,,,,2019,20551
0,0,0,0,,,,2019,20553
0,0,0,0,,,,2019,20560
0,0,0,0,,,,2019,20565
0,0,0,0,,,,2019,20566
0,0,0,0,,,,2019,20593
0,0,0,0,,,,2019,20660
40,69,0,109,36.7,63.3,0.0,2019,20686
0,0,0,0,,,,2019,20742
118,0,72,190,62.11,0.0,37.89,2019,20899
76,0,62,138,55.07,0.0,44.93,2019,20612
11074,168,959,12201,90.76,1.38,7.86,2019,20707
15075,397,1258,16730,90.11,2.37,7.52,2019,20902
1994,65,380,2439,81.75,2.67,15.58,2019,20711
8898,194,725,9817,90.64,1.98,7.39,2019,20770
3882,175,167,4224,91.9,4.14,3.95,2019,20872
342,3,0,345,99.13,0.87,0.0,2019,20670
7316,91,150,7557,96.81,1.2,1.98,2019,20720
5593,56,252,5901,94.78,0.95,4.27,2019,20905
10789,138,736,11663,92.51,1.18,6.31,2019,21009
2665,50,62,2777,95.97,1.8,2.23,2019,21017
894,25,130,1049,85.22,2.38,12.39,2019,21028
2876,0,190,3066,93.8,0.0,6.2,2019,21032
654,0,55,709,92.24,0.0,7.76,2019,21036
16481,525,951,17957,91.78,2.92,5.3,2019,21044
3231,52,399,3682,87.75,1.41,10.84,2019,21048
52,0,0,52,100.0,0.0,0.0,2019,21130
8925,53,480,9458,94.36,0.56,5.08,2019,21146
1871,51,191,2113,88.55,2.41,9.04,2019,21154
682,55,223,960,71.04,5.73,23.23,2019,21160
10152,390,962,11504,88.25,3.39,8.36,2019,21209
10825,303,1265,12393,87.35,2.44,10.21,2019,21212
5760,1403,3446,10609,54.29,13.22,32.48,2019,21216
782,23,118,923,84.72,2.49,12.78,2019,21520
512,28,234,774,66.15,3.62,30.23,2019,21545
421,20,178,619,68.01,3.23,28.76,2019,21555
8185,220,1357,9762,83.85,2.25,13.9,2019,21001
1529,9,144,1682,90.9,0.54,8.56,2019,21013
3274,36,102,3412,95.96,1.06,2.99,2019,21029
14213,190,723,15126,93.96,1.26,4.78,2019,21045
1312,104,200,1616,81.19,6.44,12.38,2019,21057
11709,261,1468,13438,87.13,1.94,10.92,2019,21060
624,4,259,887,70.35,0.45,29.2,2019,21531
7342,141,241,7724,95.05,1.83,3.12,2019,21012
9132,96,813,10041,90.95,0.96,8.1,2019,21030
5905,96,209,6210,95.09,1.55,3.37,2019,21046
89,0,0,89,100.0,0.0,0.0,2019,21056
0,0,0,0,,,,2019,21105
1770,0,64,1834,96.51,0.0,3.49,2019,21111
20045,366,1554,21965,91.26,1.67,7.07,2019,21122
1842,10,69,1921,95.89,0.52,3.59,2019,21161
2240,85,201,2526,88.68,3.37,7.96,2019,21163
16317,372,2772,19461,83.84,1.91,14.24,2019,21206
117,0,9,126,92.86,0.0,7.14,2019,24432
290,0,80,370,78.38,0.0,21.62,2019,24473
213,28,147,388,54.9,7.22,37.89,2019,24237
217,0,54,271,80.07,0.0,19.93,2019,24483
140,0,21,161,86.96,0.0,13.04,2019,24485
6887,160,661,7708,89.35,2.08,8.58,2019,24503
576,9,281,866,66.51,1.04,32.45,2019,24555
1718,56,673,2447,70.21,2.29,27.5,2019,24563
217,5,180,402,53.98,1.24,44.78,2019,24565
289,0,81,370,78.11,0.0,21.89,2019,24569
1768,70,450,2288,77.27,3.06,19.67,2019,24586
504,13,88,605,83.31,2.15,14.55,2019,24465
6138,174,1116,7428,82.63,2.34,15.02,2019,24014
1524,9,340,1873,81.37,0.48,18.15,2019,24064
2181,73,501,2755,79.17,2.65,18.19,2019,24065
656,17,325,998,65.73,1.7,32.57,2019,24085
27,0,61,88,30.68,0.0,69.32,2019,24086
142,0,72,214,66.36,0.0,33.64,2019,24105
13964,243,2080,16287,85.74,1.49,12.77,2019,24018
325,25,43,393,82.7,6.36,10.94,2019,24059
319,17,77,413,77.24,4.12,18.64,2019,24072
10955,372,1440,12767,85.81,2.91,11.28,2019,24073
1115,60,544,1719,64.86,3.49,31.65,2019,24088
370,7,216,593,62.39,1.18,36.42,2019,24102
3492,210,901,4603,75.86,4.56,19.57,2019,24121
1295,14,493,1802,71.86,0.78,27.36,2019,24124
7,0,0,7,100.0,0.0,0.0,2019,24131
517,0,132,649,79.66,0.0,20.34,2019,24138
137,0,62,199,68.84,0.0,31.16,2019,24139
0,0,0,0,,,,2019,24142
780,52,214,1046,74.57,4.97,20.46,2019,24162
5940,222,1584,7746,76.68,2.87,20.45,2019,24179
2042,276,858,3176,64.29,8.69,27.02,2019,24230
747,39,448,1234,60.53,3.16,36.3,2019,24053
314,0,40,354,88.7,0.0,11.3,2019,24077
1530,35,304,1869,81.86,1.87,16.27,2019,24090
2500,88,751,3339,74.87,2.64,22.49,2019,24091
5729,255,2009,7993,71.68,3.19,25.13,2019,24523
2557,33,820,3410,74.99,0.97,24.05,2019,24531
2228,164,608,3000,74.27,5.47,20.27,2019,24550
2344,79,1103,3526,66.48,2.24,31.28,2019,24557
927,40,1065,2032,45.62,1.97,52.41,2019,24577
2292,37,775,3104,73.84,1.19,24.97,2019,24590
291,32,324,647,44.98,4.95,50.08,2019,24598
195,12,99,306,63.73,3.92,32.35,2019,24602
255,0,120,375,68.0,0.0,32.0,2019,24603
154,2,211,367,41.96,0.54,57.49,2019,24622
435,34,159,628,69.27,5.41,25.32,2019,24712
244,0,36,280,87.14,0.0,12.86,2019,24733
290,25,138,453,64.02,5.52,30.46,2019,24818
294,0,21,315,93.33,0.0,6.67,2019,24822
339,49,203,591,57.36,8.29,34.35,2019,24844
209,37,15,261,80.08,14.18,5.75,2019,24851
2766,151,946,3863,71.6,3.91,24.49,2019,24504
1534,77,485,2096,73.19,3.67,23.14,2019,24517
2637,168,1027,3832,68.82,4.38,26.8,2019,24522
346,10,410,766,45.17,1.31,53.52,2019,24529
1186,65,305,1556,76.22,4.18,19.6,2019,24549
380,7,265,652,58.28,1.07,40.64,2019,24553
5189,58,615,5862,88.52,0.99,10.49,2019,26330
2723,119,1129,3971,68.57,3.0,28.43,2019,24521
294,18,254,566,51.94,3.18,44.88,2019,24526
345,0,81,426,80.99,0.0,19.01,2019,24530
277,32,206,515,53.79,6.21,40.0,2019,24534
70,0,18,88,79.55,0.0,20.45,2019,24536
24,0,37,61,39.34,0.0,60.66,2019,24539
340,0,234,574,59.23,0.0,40.77,2019,24566
647,12,283,942,68.68,1.27,30.04,2019,24571
365,7,224,596,61.24,1.17,37.58,2019,24363
620,111,256,987,62.82,11.25,25.94,2019,24283
2081,158,616,2855,72.89,5.53,21.58,2019,24319
558,13,168,739,75.51,1.76,22.73,2019,24324
1932,42,739,2713,71.21,1.55,27.24,2019,24370
384,17,100,501,76.65,3.39,19.96,2019,24597
104,18,39,161,64.6,11.18,24.22,2019,24981
40,0,0,40,100.0,0.0,0.0,2019,24962
1290,48,322,1660,77.71,2.89,19.4,2019,24963
380,14,153,547,69.47,2.56,27.97,2019,24976
27,0,0,27,100.0,0.0,0.0,2019,24888
158,39,15,212,74.53,18.4,7.08,2019,24977
206,0,105,311,66.24,0.0,33.76,2019,24313
476,6,141,623,76.4,0.96,22.63,2019,24314
0,0,0,0,,,,2019,24316
1123,112,377,1612,69.67,6.95,23.39,2019,24317
149,0,112,261,57.09,0.0,42.91,2019,24318
206,0,208,414,49.76,0.0,50.24,2019,24352
137,0,82,219,62.56,0.0,37.44,2019,24366
9884,180,1193,11257,87.8,1.6,10.6,2019,24019
1693,57,767,2517,67.26,2.26,30.47,2019,24054
3565,205,1300,5070,70.32,4.04,25.64,2019,24055
524,92,190,806,65.01,11.41,23.57,2019,24069
603,8,78,689,87.52,1.16,11.32,2019,24070
1055,132,127,1314,80.29,10.05,9.67,2019,24087
681,10,429,1120,60.8,0.89,38.3,2019,24089
711,51,127,889,79.98,5.74,14.29,2019,24128
5884,250,2165,8299,70.9,3.01,26.09,2019,24151
54,0,48,102,52.94,0.0,47.06,2019,24167
2409,197,967,3573,67.42,5.51,27.06,2019,24171
3479,172,641,4292,81.06,4.01,14.93,2019,24211
58,0,78,136,42.65,0.0,57.35,2019,24217
3061,404,650,4115,74.39,9.82,15.8,2019,24219
345,57,186,588,58.67,9.69,31.63,2019,24250
1116,37,1077,2230,50.04,1.66,48.3,2019,24260
1085,483,875,2443,44.41,19.77,35.82,2019,24263
83,0,28,111,74.77,0.0,25.23,2019,24269
1330,101,375,1806,73.64,5.59,20.76,2019,24127
697,79,250,1026,67.93,7.7,24.37,2019,24133
361,18,12,391,92.33,4.6,3.07,2019,24011
1985,65,942,2992,66.34,2.17,31.48,2019,24013
951,44,236,1231,77.25,3.57,19.17,2019,24556
555,76,454,1085,51.15,7.0,41.84,2019,24520
731,85,492,1308,55.89,6.5,37.61,2019,24528
8748,207,559,9514,91.95,2.18,5.88,2019,24551
3262,352,1630,5244,62.2,6.71,31.08,2019,24592
2147,200,634,2981,72.02,6.71,21.27,2019,24609
757,32,287,1076,70.35,2.97,26.67,2019,24380
2509,116,810,3435,73.04,3.38,23.58,2019,24416
4430,231,1105,5766,76.83,4.01,19.16,2019,24426
193,9,40,242,79.75,3.72,16.53,2019,26161
2003,88,586,2677,74.82,3.29,21.89,2019,24441
165,0,116,281,58.72,0.0,41.28,2019,24459
724,30,98,852,84.98,3.52,11.5,2019,24467
1221,70,98,1389,87.9,5.04,7.06,2019,23696
4558,208,1128,5894,77.33,3.53,19.14,2019,23707
476,26,219,721,66.02,3.61,30.37,2019,23821
397,2,137,536,74.07,0.37,25.56,2019,23827
441,9,142,592,74.49,1.52,23.99,2019,23830
629,6,242,877,71.72,0.68,27.59,2019,23833
277,0,141,418,66.27,0.0,33.73,2019,23850
4080,213,1304,5597,72.9,3.81,23.3,2019,23851
1135,68,397,1600,70.94,4.25,24.81,2019,23890
64,0,17,81,79.01,0.0,20.99,2019,23302
142,23,94,259,54.83,8.88,36.29,2019,23307
1236,31,272,1539,80.31,2.01,17.67,2019,23336
4164,97,851,5112,81.46,1.9,16.65,2019,23150
10068,1180,1814,13062,77.08,9.03,13.89,2019,23220
6966,405,2792,10163,68.54,3.99,27.47,2019,23222
2552,140,543,3235,78.89,4.33,16.79,2019,23230
6843,69,783,7695,88.93,0.9,10.18,2019,23294
383,2,145,530,72.26,0.38,27.36,2019,23301
11516,173,1145,12834,89.73,1.35,8.92,2019,23321
255,0,60,315,80.95,0.0,19.05,2019,23347
30,6,20,56,53.57,10.71,35.71,2019,23409
1322,171,256,1749,75.59,9.78,14.64,2019,23417
408,0,229,637,64.05,0.0,35.95,2019,23960
248,0,46,294,84.35,0.0,15.65,2019,23962
24,0,40,64,37.5,0.0,62.5,2019,23963
108,0,43,151,71.52,0.0,28.48,2019,23079
559,0,144,703,79.52,0.0,20.48,2019,23084
140,19,117,276,50.72,6.88,42.39,2019,23092
46,0,0,46,100.0,0.0,0.0,2019,23108
21,0,0,21,100.0,0.0,0.0,2019,23115
411,7,127,545,75.41,1.28,23.3,2019,23038
1022,98,86,1206,84.74,8.13,7.13,2019,23146
244,0,170,414,58.94,0.0,41.06,2019,23022
2726,48,590,3364,81.03,1.43,17.54,2019,23024
73,0,48,121,60.33,0.0,39.67,2019,23091
2001,79,101,2181,91.75,3.62,4.63,2019,23103
728,0,215,943,77.2,0.0,22.8,2019,23109
88,0,101,189,46.56,0.0,53.44,2019,23110
8884,119,588,9591,92.63,1.24,6.13,2019,23113
164,65,14,243,67.49,26.75,5.76,2019,23129
15254,983,1293,17530,87.02,5.61,7.38,2019,23188
2240,26,404,2670,83.9,0.97,15.13,2019,23192
11925,110,598,12633,94.4,0.87,4.73,2019,23233
12432,456,2784,15672,79.33,2.91,17.76,2019,23234
7373,176,1071,8620,85.53,2.04,12.42,2019,23237
220,0,64,284,77.46,0.0,22.54,2019,23303
229,23,142,394,58.12,5.84,36.04,2019,23011
131,8,40,179,73.18,4.47,22.35,2019,23032
183,19,82,284,64.44,6.69,28.87,2019,23337
1435,111,334,1880,76.33,5.9,17.77,2019,23310
346,44,98,488,70.9,9.02,20.08,2019,23356
278,16,36,330,84.24,4.85,10.91,2019,23357
50,0,0,50,100.0,0.0,0.0,2019,23358
185,1,67,253,73.12,0.4,26.48,2019,23413
14346,536,3636,18518,77.47,2.89,19.63,2019,23434
1722,58,754,2534,67.96,2.29,29.76,2019,27020
41,0,17,58,70.69,0.0,29.31,2019,26348
28,0,0,28,100.0,0.0,0.0,2019,26349
3287,31,860,4178,78.67,0.74,20.58,2019,26354
175,0,111,286,61.19,0.0,38.81,2019,26384
282,0,135,417,67.63,0.0,32.37,2019,26405
30,11,24,65,46.15,16.92,36.92,2019,26438
417,0,121,538,77.51,0.0,22.49,2019,26448
136,6,41,183,74.32,3.28,22.4,2019,26585
380,0,63,443,85.78,0.0,14.22,2019,26662
281,18,49,348,80.75,5.17,14.08,2019,26678
87,0,0,87,100.0,0.0,0.0,2019,26036
9155,331,2678,12164,75.26,2.72,22.02,2019,26101
35,0,23,58,60.34,0.0,39.66,2019,26138
83,0,31,114,72.81,0.0,27.19,2019,26148
2156,66,793,3015,71.51,2.19,26.3,2019,26164
2191,72,218,2481,88.31,2.9,8.79,2019,26181
1103,52,112,1267,87.06,4.1,8.84,2019,26205
240,5,126,371,64.69,1.35,33.96,2019,26208
68,32,0,100,68.0,32.0,0.0,2019,26209
15,0,0,15,100.0,0.0,0.0,2019,26228
833,11,277,1121,74.31,0.98,24.71,2019,26261
326,23,128,477,68.34,4.82,26.83,2019,26337
85,0,0,85,100.0,0.0,0.0,2019,26339
53,0,55,108,49.07,0.0,50.93,2019,26342
103,0,117,220,46.82,0.0,53.18,2019,26376
110,0,94,204,53.92,0.0,46.08,2019,26377
99,0,104,203,48.77,0.0,51.23,2019,26404
142,9,18,169,84.02,5.33,10.65,2019,26075
5581,182,1300,7063,79.02,2.58,18.41,2019,26104
4297,194,605,5096,84.32,3.81,11.87,2019,26105
245,7,83,335,73.13,2.09,24.78,2019,26146
184,0,30,214,85.98,0.0,14.02,2019,26039
600,18,326,944,63.56,1.91,34.53,2019,26033
544,0,208,752,72.34,0.0,27.66,2019,26035
1097,28,124,1249,87.83,2.24,9.93,2019,26038
1912,137,545,2594,73.71,5.28,21.01,2019,26047
601,35,144,780,77.05,4.49,18.46,2019,26050
777,92,170,1039,74.78,8.85,16.36,2019,26059
309,1,66,376,82.18,0.27,17.55,2019,26134
179,0,77,256,69.92,0.0,30.08,2019,26151
303,6,104,413,73.37,1.45,25.18,2019,26160
2262,104,319,2685,84.25,3.87,11.88,2019,26187
181,0,23,204,88.73,0.0,11.27,2019,26222
18,0,0,18,100.0,0.0,0.0,2019,26236
88,0,120,208,42.31,0.0,57.69,2019,26237
242,0,62,304,79.61,0.0,20.39,2019,26238
4158,169,1300,5627,73.89,3.0,23.1,2019,26241
249,3,72,324,76.85,0.93,22.22,2019,26273
446,14,266,726,61.43,1.93,36.64,2019,26283
993,71,421,1485,66.87,4.78,28.35,2019,26288
37,0,17,54,68.52,0.0,31.48,2019,26298
61,0,25,86,70.93,0.0,29.07,2019,26361
1034,79,291,1404,73.65,5.63,20.73,2019,26362
304,7,50,361,84.21,1.94,13.85,2019,26372
870,48,282,1200,72.5,4.0,23.5,2019,26415
210,2,60,272,77.21,0.74,22.06,2019,26574
178,0,134,312,57.05,0.0,42.95,2019,26581
77,0,17,94,81.91,0.0,18.09,2019,26586
94,0,77,171,54.97,0.0,45.03,2019,17862
1155,113,596,1864,61.96,6.06,31.97,2019,27027
9894,1631,3654,15179,65.18,10.75,24.07,2019,27030
2358,122,714,3194,73.83,3.82,22.35,2019,27048
1094,114,222,1430,76.5,7.97,15.52,2019,27053
11314,300,1165,12779,88.54,2.35,9.12,2019,27104
16830,361,2554,19745,85.24,1.83,12.93,2019,27106
520,10,256,786,66.16,1.27,32.57,2019,27814
319,32,256,607,52.55,5.27,42.17,2019,27818
2447,21,746,3214,76.14,0.65,23.21,2019,27822
1855,146,388,2389,77.65,6.11,16.24,2019,27011
9850,96,846,10792,91.27,0.89,7.84,2019,27012
277,9,48,334,82.93,2.69,14.37,2019,27014
2189,469,770,3428,63.86,13.68,22.46,2019,27017
7340,647,2652,10639,68.99,6.08,24.93,2019,27870
274,22,116,412,66.5,5.34,28.16,2019,27885
501,0,145,646,77.55,0.0,22.45,2019,27926
329,30,108,467,70.45,6.42,23.13,2019,27947
1228,40,44,1312,93.6,3.05,3.35,2019,27959
115,77,0,192,59.9,40.1,0.0,2019,27965
420,0,65,485,86.6,0.0,13.4,2019,27974
122,18,40,180,67.78,10.0,22.22,2019,27985
105,13,185,303,34.65,4.29,61.06,2019,27922
346,19,61,426,81.22,4.46,14.32,2019,27936
1018,35,90,1143,89.06,3.06,7.87,2019,27939
660,4,201,865,76.3,0.46,23.24,2019,27950
2759,123,216,3098,89.06,3.97,6.97,2019,27954
527,73,479,1079,48.84,6.77,44.39,2019,27970
522,16,349,887,58.85,1.8,39.35,2019,27878
793,48,316,1157,68.54,4.15,27.31,2019,27883
11615,370,2731,14716,78.93,2.51,18.56,2019,27909
3621,273,1307,5201,69.62,5.25,25.13,2019,27932
120,61,11,192,62.5,31.77,5.73,2019,27941
232,0,85,317,73.19,0.0,26.81,2019,27960
30,18,45,93,32.26,19.35,48.39,2019,27967
43,0,0,43,100.0,0.0,0.0,2019,27972
1397,11,87,1495,93.44,0.74,5.82,2019,27976
2929,65,787,3781,77.47,1.72,20.81,2019,27045
895,8,127,1030,86.89,0.78,12.33,2019,27009
8140,179,1844,10163,80.09,1.76,18.14,2019,27028
841,39,115,995,84.52,3.92,11.56,2019,27054
13184,321,1958,15463,85.26,2.08,12.66,2019,27127
460,0,181,641,71.76,0.0,28.24,2019,27208
14656,792,2961,18409,79.61,4.3,16.08,2019,27215
9409,499,3796,13704,68.66,3.64,27.7,2019,27217
1523,105,186,1814,83.96,5.79,10.25,2019,27235
3032,261,708,4001,75.78,6.52,17.7,2019,27214
4243,117,711,5071,83.67,2.31,14.02,2019,27244
6766,326,1625,8717,77.62,3.74,18.64,2019,27263
9194,136,1166,10496,87.6,1.3,11.11,2019,27278
7030,454,2457,9941,70.72,4.57,24.72,2019,27288
462,0,130,592,78.04,0.0,21.96,2019,27291
2675,309,350,3334,80.23,9.27,10.5,2019,27301
9980,441,1464,11885,83.97,3.71,12.32,2019,27302
2237,48,359,2644,84.61,1.82,13.58,2019,27313
523,0,118,641,81.59,0.0,18.41,2019,27343
2048,71,457,2576,79.5,2.76,17.74,2019,27350
4501,207,969,5677,79.28,3.65,17.07,2019,27370
1233,54,829,2116,58.27,2.55,39.18,2019,27379
644,22,163,829,77.68,2.65,19.66,2019,17244
4513,97,978,5588,80.76,1.74,17.5,2019,17870
116,0,42,158,73.42,0.0,26.58,2019,17920
99,3,33,135,73.33,2.22,24.44,2019,17925
3578,376,370,4324,82.75,8.7,8.56,2019,17551
7284,241,842,8367,87.06,2.88,10.06,2019,17552
37,0,13,50,74.0,0.0,26.0,2019,17570
68,0,0,68,100.0,0.0,0.0,2019,17576
50,0,54,104,48.08,0.0,51.92,2019,17730
106,1,10,117,90.6,0.85,8.55,2019,17749
53,15,0,68,77.94,22.06,0.0,2019,17750
4135,95,637,4867,84.96,1.95,13.09,2019,17754
3331,193,773,4297,77.52,4.49,17.99,2019,17756
104,0,45,149,69.8,0.0,30.2,2019,17768
406,37,91,534,76.03,6.93,17.04,2019,17774
9228,348,1658,11234,82.14,3.1,14.76,2019,17815
201,13,51,265,75.85,4.91,19.25,2019,17827
5070,219,1303,6592,76.91,3.32,19.77,2019,17837
1243,31,272,1546,80.4,2.01,17.59,2019,17846
3696,84,932,4712,78.44,1.78,19.78,2019,17847
803,11,367,1181,67.99,0.93,31.08,2019,17853
420,19,87,526,79.85,3.61,16.54,2019,17878
66,0,21,87,75.86,0.0,24.14,2019,17884
90,6,33,129,69.77,4.65,25.58,2019,17888
74,2,15,91,81.32,2.2,16.48,2019,17945
2539,24,308,2871,88.44,0.84,10.73,2019,17339
7824,175,1171,9170,85.32,1.91,12.77,2019,17406
892,10,135,1037,86.02,0.96,13.02,2019,17502
934,10,173,1117,83.62,0.9,15.49,2019,17532
2543,227,838,3608,70.48,6.29,23.23,2019,17540
14776,665,2177,17618,83.87,3.77,12.36,2019,17543
3372,174,424,3970,84.94,4.38,10.68,2019,17584
13693,925,3077,17695,77.38,5.23,17.39,2019,17701
3495,191,682,4368,80.01,4.37,15.61,2019,17702
1404,62,440,1906,73.66,3.25,23.08,2019,17724
1639,50,380,2069,79.22,2.42,18.37,2019,17728
22,0,10,32,68.75,0.0,31.25,2019,17729
1006,34,244,1284,78.35,2.65,19.0,2019,17771
609,13,145,767,79.4,1.69,18.9,2019,17813
2522,46,737,3305,76.31,1.39,22.3,2019,17842
177,22,98,297,59.6,7.41,33.0,2019,17850
1033,52,93,1178,87.69,4.41,7.89,2019,17856
2357,86,639,3082,76.48,2.79,20.73,2019,17857
451,3,253,707,63.79,0.42,35.79,2019,17864
38,0,22,60,63.33,0.0,36.67,2019,17867
7164,320,2345,9829,72.89,3.26,23.86,2019,17901
132,2,46,180,73.33,1.11,25.56,2019,17930
67,0,18,85,78.82,0.0,21.18,2019,17949
1596,0,407,2003,79.68,0.0,20.32,2019,17954
1016,36,349,1401,72.52,2.57,24.91,2019,17970
224,4,76,304,73.68,1.32,25.0,2019,17936
43,0,4,47,91.49,0.0,8.51,2019,17944
80,0,50,130,61.54,0.0,38.46,2019,17952
165,3,54,222,74.32,1.35,24.32,2019,17982
554,0,90,644,86.02,0.0,13.98,2019,17983
26,0,31,57,45.61,0.0,54.39,2019,17946
80,0,52,132,60.61,0.0,39.39,2019,17957
61,0,30,91,67.03,0.0,32.97,2019,17968
3542,100,613,4255,83.24,2.35,14.41,2019,17003
2939,39,174,3152,93.24,1.24,5.52,2019,19807
0,0,39,39,0.0,0.0,100.0,2019,17254
345,12,90,447,77.18,2.68,20.13,2019,17255
8537,614,1939,11090,76.98,5.54,17.48,2019,17257
365,0,137,502,72.71,0.0,27.29,2019,17262
867,7,190,1064,81.48,0.66,17.86,2019,17304
1736,101,365,2202,78.84,4.59,16.58,2019,17307
178,3,50,231,77.06,1.3,21.65,2019,17317
8675,242,1771,10688,81.17,2.26,16.57,2019,17325
1087,65,400,1552,70.04,4.19,25.77,2019,17344
2676,110,688,3474,77.03,3.17,19.8,2019,17345
414,0,93,507,81.66,0.0,18.34,2019,17352
900,67,748,1715,52.48,3.91,43.62,2019,17004
88,3,27,118,74.58,2.54,22.88,2019,17080
1421,23,374,1818,78.16,1.27,20.57,2019,17084
2205,57,334,2596,84.94,2.2,12.87,2019,17360
2158,32,403,2593,83.22,1.23,15.54,2019,17361
1745,31,334,2110,82.7,1.47,15.83,2019,17366
1820,143,253,2216,82.13,6.45,11.42,2019,17370
6521,265,1377,8163,79.88,3.25,16.87,2019,17545
880,50,469,1399,62.9,3.57,33.52,2019,17562
3062,70,995,4127,74.19,1.7,24.11,2019,17566
20368,1488,3398,25254,80.65,5.89,13.46,2019,17603
2084,129,398,2611,79.82,4.94,15.24,2019,17737
310,0,45,355,87.32,0.0,12.68,2019,17016
5916,163,902,6981,84.74,2.33,12.92,2019,17019
565,32,108,705,80.14,4.54,15.32,2019,17024
113,0,0,113,100.0,0.0,0.0,2019,17027
810,48,246,1104,73.37,4.35,22.28,2019,17034
120,0,0,120,100.0,0.0,0.0,2019,17041
670,12,172,854,78.45,1.41,20.14,2019,17086
252,58,40,350,72.0,16.57,11.43,2019,17088
8417,217,2037,10671,78.88,2.03,19.09,2019,17109
8581,268,2131,10980,78.15,2.44,19.41,2019,17201
265,0,121,386,68.65,0.0,31.35,2019,17021
2520,83,518,3121,80.74,2.66,16.6,2019,17038
862,0,227,1089,79.16,0.0,20.84,2019,17049
7734,297,1694,9725,79.53,3.05,17.42,2019,17057
525,0,154,679,77.32,0.0,22.68,2019,17058
365,4,91,460,79.35,0.87,19.78,2019,17060
13,0,0,13,100.0,0.0,0.0,2019,17076
213,0,30,243,87.65,0.0,12.35,2019,17081
466,10,105,581,80.21,1.72,18.07,2019,18415
342,17,38,397,86.15,4.28,9.57,2019,18417
1710,49,230,1989,85.97,2.46,11.56,2019,18424
1016,17,598,1631,62.29,1.04,36.66,2019,18434
3952,40,895,4887,80.87,0.82,18.31,2019,18436
501,26,76,603,83.08,4.31,12.6,2019,18438
320,12,78,410,78.05,2.93,19.02,2019,18453
560,19,107,686,81.63,2.77,15.6,2019,18350
4228,94,907,5229,80.86,1.8,17.35,2019,18643
533,52,385,970,54.95,5.36,39.69,2019,18701
1959,38,498,2495,78.52,1.52,19.96,2019,18810
450,22,88,560,80.36,3.93,15.71,2019,18818
284,0,0,284,100.0,0.0,0.0,2019,18915
113,0,10,123,91.87,0.0,8.13,2019,18920
3102,15,95,3212,96.58,0.47,2.96,2019,18929
4052,111,532,4695,86.3,2.36,11.33,2019,18960
13114,130,1151,14395,91.1,0.9,8.0,2019,18966
13993,924,3442,18359,76.22,5.03,18.75,2019,21218
5191,365,474,6030,86.09,6.05,7.86,2019,19809
8713,418,649,9780,89.09,4.27,6.64,2019,19810
2652,55,416,3123,84.92,1.76,13.32,2019,19938
1660,30,516,2206,75.25,1.36,23.39,2019,19940
225,8,5,238,94.54,3.36,2.1,2019,20880
6370,304,837,7511,84.81,4.05,11.14,2019,20903
733,15,0,748,97.99,2.01,0.0,2019,20197
14411,376,1022,15809,91.16,2.38,6.46,2019,20008
25014,530,2164,27708,90.28,1.91,7.81,2019,20009
380,17,154,551,68.97,3.09,27.95,2019,20611
1945,13,387,2345,82.94,0.55,16.5,2019,20616
5073,90,323,5486,92.47,1.64,5.89,2019,20619
372,82,94,548,67.88,14.96,17.15,2019,20620
127,0,12,139,91.37,0.0,8.63,2019,20629
3084,73,531,3688,83.62,1.98,14.4,2019,20640
3694,69,518,4281,86.29,1.61,12.1,2019,20678
732,25,81,838,87.35,2.98,9.67,2019,20688
7996,346,924,9266,86.29,3.73,9.97,2019,20705
1745,79,159,1983,88.0,3.98,8.02,2019,20714
901,0,134,1035,87.05,0.0,12.95,2019,20733
2766,103,130,2999,92.23,3.43,4.33,2019,20736
16756,340,1254,18350,91.31,1.85,6.83,2019,20744
12253,603,2211,15067,81.32,4.0,14.67,2019,20747
14946,260,1042,16248,91.99,1.6,6.41,2019,20772
12611,172,756,13539,93.15,1.27,5.58,2019,20003
1157,41,66,1264,91.53,3.24,5.22,2019,20004
6481,233,873,7587,85.42,3.07,11.51,2019,20005
12388,164,468,13020,95.15,1.26,3.59,2019,20016
9366,246,592,10204,91.79,2.41,5.8,2019,20111
2258,76,172,2506,90.1,3.03,6.86,2019,20115
7749,86,77,7912,97.94,1.09,0.97,2019,20169
16310,452,609,17371,93.89,2.6,3.51,2019,20176
0,0,0,0,,,,2019,20319
1427,65,305,1797,79.41,3.62,16.97,2019,20622
2139,118,191,2448,87.38,4.82,7.8,2019,20634
216,15,66,297,72.73,5.05,22.22,2019,20658
2315,14,55,2384,97.11,0.59,2.31,2019,20685
62,0,0,62,100.0,0.0,0.0,2019,20701
6260,61,427,6748,92.77,0.9,6.33,2019,20724
8174,667,791,9632,84.86,6.92,8.21,2019,20740
12527,540,1681,14748,84.94,3.66,11.4,2019,20748
12648,175,417,13240,95.53,1.32,3.15,2019,20817
16159,163,333,16655,97.02,0.98,2.0,2019,20854
211,0,0,211,100.0,0.0,0.0,2019,20868
11372,104,890,12366,91.96,0.84,7.2,2019,20901
18757,399,1360,20516,91.43,1.94,6.63,2019,20910
15069,1901,7148,24118,62.48,7.88,29.64,2019,20019
6122,240,1348,7710,79.4,3.11,17.48,2019,20017
12116,302,1045,13463,89.99,2.24,7.76,2019,20109
496,5,21,522,95.02,0.96,4.02,2019,20137
83,17,0,100,83.0,17.0,0.0,2019,20139
2185,58,143,2386,91.58,2.43,5.99,2019,20141
21339,428,506,22273,95.81,1.92,2.27,2019,20147
1378,24,54,1456,94.64,1.65,3.71,2019,20158
5765,46,215,6026,95.67,0.76,3.57,2019,20187
11239,291,274,11804,95.21,2.47,2.32,2019,20007
6459,121,1492,8072,80.02,1.5,18.48,2019,20018
5663,240,241,6144,92.17,3.91,3.92,2019,20037
328,0,135,463,70.84,0.0,29.16,2019,24579
11638,377,1214,13229,87.97,2.85,9.18,2019,21403
151,0,9,160,94.38,0.0,5.62,2019,21405
1205,20,109,1334,90.33,1.5,8.17,2019,21162
4634,92,446,5172,89.6,1.78,8.62,2019,21128
839,22,103,964,87.03,2.28,10.68,2019,21155
11647,350,2002,13999,83.2,2.5,14.3,2019,21157
6956,183,718,7857,88.53,2.33,9.14,2019,21214
5644,263,2305,8212,68.73,3.2,28.07,2019,21223
15550,625,2872,19047,81.64,3.28,15.08,2019,21224
1881,50,386,2317,81.18,2.16,16.66,2019,21226
12839,243,1725,14807,86.71,1.64,11.65,2019,21230
9774,301,1351,11426,85.54,2.63,11.82,2019,21237
271,0,19,290,93.45,0.0,6.55,2019,21402
205,0,77,282,72.7,0.0,27.3,2019,21524
482,13,272,767,62.84,1.69,35.46,2019,21530
1192,57,360,1609,74.08,3.54,22.37,2019,21536
761,3,208,972,78.29,0.31,21.4,2019,21539
629,34,81,744,84.54,4.57,10.89,2019,21541
152,0,17,169,89.94,0.0,10.06,2019,21612
2333,20,229,2582,90.36,0.77,8.87,2019,21619
3900,177,1009,5086,76.68,3.48,19.84,2019,21620
85,0,33,118,72.03,0.0,27.97,2019,21634
687,22,144,853,80.54,2.58,16.88,2019,21635
57,0,24,81,70.37,0.0,29.63,2019,21648
79,0,9,88,89.77,0.0,10.23,2019,21650
935,16,220,1171,79.85,1.37,18.79,2019,21651
60,0,6,66,90.91,0.0,9.09,2019,21653
422,1,89,512,82.42,0.2,17.38,2019,21659
165,4,21,190,86.84,2.11,11.05,2019,21664
83,0,0,83,100.0,0.0,0.0,2019,21665
1160,35,217,1412,82.15,2.48,15.37,2019,21673
169,0,13,182,92.86,0.0,7.14,2019,21676
1565,34,267,1866,83.87,1.82,14.31,2019,21710
637,4,35,676,94.23,0.59,5.18,2019,21737
10834,326,1972,13132,82.5,2.48,15.02,2019,21742
707,7,36,750,94.27,0.93,4.8,2019,21005
9570,133,666,10369,92.29,1.28,6.42,2019,21015
15909,108,864,16881,94.24,0.64,5.12,2019,21043
994,16,98,1108,89.71,1.44,8.84,2019,21053
6595,173,171,6939,95.04,2.49,2.46,2019,21076
2435,28,183,2646,92.03,1.06,6.92,2019,21084
13100,150,594,13844,94.63,1.08,4.29,2019,21113
11717,171,1032,12920,90.69,1.32,7.99,2019,21136
10788,239,791,11818,91.28,2.02,6.69,2019,21144
2118,49,75,2242,94.47,2.19,3.35,2019,21152
4719,174,261,5154,91.56,3.38,5.06,2019,21210
9732,284,1949,11965,81.34,2.37,16.29,2019,21239
71,0,21,92,77.17,0.0,22.83,2019,21523
132,25,49,206,64.08,12.14,23.79,2019,21529
4373,99,768,5240,83.45,1.89,14.66,2019,21532
9118,137,1366,10621,85.85,1.29,12.86,2019,21601
5525,183,1491,7199,76.75,2.54,20.71,2019,21613
13472,507,1453,15432,87.3,3.29,9.42,2019,21701
14341,505,1195,16041,89.4,3.15,7.45,2019,21702
4874,52,395,5321,91.6,0.98,7.42,2019,21704
1651,59,154,1864,88.57,3.17,8.26,2019,21716
1490,37,525,2052,72.61,1.8,25.58,2019,21722
1500,22,370,1892,79.28,1.16,19.56,2019,21727
10067,385,931,11383,88.44,3.38,8.18,2019,23435
58,0,0,58,100.0,0.0,0.0,2019,24595
124,0,253,377,32.89,0.0,67.11,2019,24599
27,2,2,31,87.1,6.45,6.45,2019,24724
24,27,29,80,30.0,33.75,36.25,2019,24731
182,14,78,274,66.42,5.11,28.47,2019,24736
28,0,36,64,43.75,0.0,56.25,2019,24813
212,22,73,307,69.06,7.17,23.78,2019,24862
27,0,0,27,100.0,0.0,0.0,2019,24898
384,1,88,473,81.18,0.21,18.6,2019,24946
39,0,34,73,53.42,0.0,46.58,2019,24957
38,8,34,80,47.5,10.0,42.5,2019,24606
69,8,35,112,61.61,7.14,31.25,2019,24607
2095,133,646,2874,72.89,4.63,22.48,2019,24614
68,0,28,96,70.83,0.0,29.17,2019,24628
693,13,453,1159,59.79,1.12,39.09,2019,24656
111,6,59,176,63.07,3.41,33.52,2019,24715
171,0,107,278,61.51,0.0,38.49,2019,24726
15,0,0,15,100.0,0.0,0.0,2019,24846
60,0,32,92,65.22,0.0,34.78,2019,24849
134,12,144,290,46.21,4.14,49.66,2019,24850
23,0,64,87,26.44,0.0,73.56,2019,24854
85,0,43,128,66.41,0.0,33.59,2019,24882
10,0,0,10,100.0,0.0,0.0,2019,24887
133,0,47,180,73.89,0.0,26.11,2019,24924
122,0,101,223,54.71,0.0,45.29,2019,24935
260,14,74,348,74.71,4.02,21.26,2019,24941
531,0,82,613,86.62,0.0,13.38,2019,24951
66,0,93,159,41.51,0.0,58.49,2019,24974
535,40,465,1040,51.44,3.85,44.71,2019,24983
350,5,202,557,62.84,0.9,36.27,2019,24165
252,12,417,681,37.0,1.76,61.23,2019,24225
893,7,339,1239,72.07,0.56,27.36,2019,24236
228,23,98,349,65.33,6.59,28.08,2019,24245
2521,75,1006,3602,69.99,2.08,27.93,2019,24266
163,0,109,272,59.93,0.0,40.07,2019,24272
1195,257,908,2360,50.64,10.89,38.47,2019,24277
545,56,161,762,71.52,7.35,21.13,2019,24311
2793,35,959,3787,73.75,0.92,25.32,2019,24343
11696,786,2988,15470,75.6,5.08,19.31,2019,24401
74,8,27,109,67.89,7.34,24.77,2019,24448
642,0,101,743,86.41,0.0,13.59,2019,24471
98,0,48,146,67.12,0.0,32.88,2019,24168
621,41,525,1187,52.32,3.45,44.23,2019,24174
5268,292,1553,7113,74.06,4.11,21.83,2019,24210
134,0,105,239,56.07,0.0,43.93,2019,24221
341,52,197,590,57.8,8.81,33.39,2019,24226
525,64,114,703,74.68,9.1,16.22,2019,24243
1259,58,717,2034,61.9,2.85,35.25,2019,24244
2352,130,850,3332,70.59,3.9,25.51,2019,24251
0,0,0,0,,,,2019,24415
1745,67,780,2592,67.32,2.58,30.09,2019,24422
40,0,2,42,95.24,0.0,4.76,2019,24093
892,43,246,1181,75.53,3.64,20.83,2019,24137
2528,96,778,3402,74.31,2.82,22.87,2019,24148
3802,20,1088,4910,77.43,0.41,22.16,2019,24202
108,3,65,176,61.36,1.7,36.93,2019,24934
107,0,77,184,58.15,0.0,41.85,2019,24945
354,61,197,612,57.84,9.97,32.19,2019,24966
177,0,85,262,67.56,0.0,32.44,2019,26590
168,0,43,211,79.62,0.0,20.38,2019,23480
4277,235,772,5284,80.94,4.45,14.61,2019,23661
3979,108,494,4581,86.86,2.36,10.78,2019,23662
3626,44,348,4018,90.24,1.1,8.66,2019,23664
1357,15,35,1407,96.45,1.07,2.49,2019,23665
35,0,0,35,100.0,0.0,0.0,2019,23691
12009,414,1199,13622,88.16,3.04,8.8,2019,23503
3110,33,187,3330,93.39,0.99,5.62,2019,23507
5493,220,476,6189,88.75,3.55,7.69,2019,23508
10257,434,1305,11996,85.5,3.62,10.88,2019,23518
945,222,108,1275,74.12,17.41,8.47,2019,23603
707,114,13,834,84.77,13.67,1.56,2019,23604
3950,756,1370,6076,65.01,12.44,22.55,2019,23605
4090,230,770,5090,80.35,4.52,15.13,2019,23663
7229,219,1647,9095,79.48,2.41,18.11,2019,23701
5884,197,1421,7502,78.43,2.63,18.94,2019,23805
92,0,35,127,72.44,0.0,27.56,2019,23828
1327,62,387,1776,74.72,3.49,21.79,2019,23837
1852,46,499,2397,77.26,1.92,20.82,2019,23842
220,0,124,344,63.95,0.0,36.05,2019,23857
553,56,236,845,65.44,6.63,27.93,2019,23881
1212,91,951,2254,53.77,4.04,42.19,2019,23924
77,0,41,118,65.25,0.0,34.75,2019,23938
5198,157,1023,6378,81.5,2.46,16.04,2019,23005
39,0,47,86,45.35,0.0,54.65,2019,23025
267,0,293,560,47.68,0.0,52.32,2019,23027
350,6,64,420,83.33,1.43,15.24,2019,23039
6911,316,996,8223,84.04,3.84,12.11,2019,23061
2626,48,972,3646,72.02,1.32,26.66,2019,23075
591,112,263,966,61.18,11.59,27.23,2019,23867
351,0,134,485,72.37,0.0,27.63,2019,23878
124,0,95,219,56.62,0.0,43.38,2019,23879
687,9,184,880,78.07,1.02,20.91,2019,23885
100,0,15,115,86.96,0.0,13.04,2019,23887
169,0,85,254,66.54,0.0,33.46,2019,23915
443,20,114,577,76.78,3.47,19.76,2019,23942
324,17,149,490,66.12,3.47,30.41,2019,23959
314,47,199,560,56.07,8.39,35.54,2019,23964
229,9,215,453,50.55,1.99,47.46,2019,23967
22970,560,2386,25916,88.63,2.16,9.21,2019,23462
24676,692,2155,27523,89.66,2.51,7.83,2019,23464
9649,192,799,10640,90.69,1.8,7.51,2019,23116
460,88,265,813,56.58,10.82,32.6,2019,23123
2204,163,316,2683,82.15,6.08,11.78,2019,23141
318,30,81,429,74.13,6.99,18.88,2019,23169
148,26,9,183,80.87,14.21,4.92,2019,23176
181,0,90,271,66.79,0.0,33.21,2019,23177
15277,870,1537,17684,86.39,4.92,8.69,2019,23185
10254,666,3014,13934,73.59,4.78,21.63,2019,23224
8903,340,2534,11777,75.6,2.89,21.52,2019,23227
10968,349,2611,13928,78.75,2.51,18.75,2019,23231
12090,230,837,13157,91.89,1.75,6.36,2019,23235
18,0,0,18,100.0,0.0,0.0,2019,23304
282,19,57,358,78.77,5.31,15.92,2019,23306
116,7,77,200,58.0,3.5,38.5,2019,23316
20811,396,1813,23020,90.4,1.72,7.88,2019,23320
6760,200,1408,8368,80.78,2.39,16.83,2019,23324
63,0,27,90,70.0,0.0,30.0,2019,23354
80,0,37,117,68.38,0.0,31.62,2019,26656
949,48,144,1141,83.17,4.21,12.62,2019,26711
235,0,31,266,88.35,0.0,11.65,2019,26767
112,0,38,150,74.67,0.0,25.33,2019,26810
551,25,199,775,71.1,3.23,25.68,2019,26040
4350,274,1783,6407,67.89,4.28,27.83,2019,26041
525,95,102,722,72.71,13.16,14.13,2019,26060
2753,160,929,3842,71.66,4.16,24.18,2019,26070
152,27,34,213,71.36,12.68,15.96,2019,26074
154,17,58,229,67.25,7.42,25.33,2019,26422
1801,53,486,2340,76.97,2.26,20.77,2019,26431
50,0,13,63,79.37,0.0,20.63,2019,26436
7386,148,1068,8602,85.86,1.72,12.42,2019,26501
13420,645,1119,15184,88.38,4.25,7.37,2019,26505
675,26,119,820,82.32,3.17,14.51,2019,26534
912,7,136,1055,86.45,0.66,12.89,2019,26547
150,0,155,305,49.18,0.0,50.82,2019,26575
1195,21,499,1715,69.68,1.22,29.1,2019,26582
337,0,60,397,84.89,0.0,15.11,2019,26610
11,0,12,23,47.83,0.0,52.17,2019,26615
15,0,0,15,100.0,0.0,0.0,2019,26617
69,26,37,132,52.27,19.7,28.03,2019,26691
393,0,203,596,65.94,0.0,34.06,2019,26763
551,0,116,667,82.61,0.0,17.39,2019,26812
149,6,169,324,45.99,1.85,52.16,2019,26815
289,0,46,335,86.27,0.0,13.73,2019,26845
9078,347,2326,11751,77.25,2.95,19.79,2019,26301
266,0,12,278,95.68,0.0,4.32,2019,26369
695,21,260,976,71.21,2.15,26.64,2019,26386
339,9,46,394,86.04,2.28,11.68,2019,26410
34,1,18,53,64.15,1.89,33.96,2019,26421
1017,30,360,1407,72.28,2.13,25.59,2019,26444
241,6,25,272,88.6,2.21,9.19,2019,26451
952,91,379,1422,66.95,6.4,26.65,2019,26456
10625,461,1183,12269,86.6,3.76,9.64,2019,26508
803,17,178,998,80.46,1.7,17.84,2019,26542
85,23,0,108,78.7,21.3,0.0,2019,26543
197,0,92,289,68.17,0.0,31.83,2019,26568
695,0,148,843,82.44,0.0,17.56,2019,26571
59,13,0,72,81.94,18.06,0.0,2019,26572
123,0,54,177,69.49,0.0,30.51,2019,26761
1276,48,376,1700,75.06,2.82,22.12,2019,26764
86,0,62,148,58.11,0.0,41.89,2019,26817
78,0,26,104,75.0,0.0,25.0,2019,26865
164,0,27,191,85.86,0.0,14.14,2019,26636
12,0,39,51,23.53,0.0,76.47,2019,26638
137,0,24,161,85.09,0.0,14.91,2019,26660
30,0,6,36,83.33,0.0,16.67,2019,26720
256,10,95,361,70.91,2.77,26.32,2019,26755
251,30,191,472,53.18,6.36,40.47,2019,26802
1927,27,699,2653,72.63,1.02,26.35,2019,26847
296,27,125,448,66.07,6.03,27.9,2019,26055
463,3,92,558,82.97,0.54,16.49,2019,26133
197,0,76,273,72.16,0.0,27.84,2019,26137
898,14,80,992,90.52,1.41,8.06,2019,26142
591,27,215,833,70.95,3.24,25.81,2019,26147
939,43,310,1292,72.68,3.33,23.99,2019,26175
150,0,92,242,61.98,0.0,38.02,2019,26202
2147,99,134,2380,90.21,4.16,5.63,2019,17007
11768,237,1995,14000,84.06,1.69,14.25,2019,17013
1524,5,205,1734,87.89,0.29,11.82,2019,17018
1110,27,201,1338,82.96,2.02,15.02,2019,17023
1225,80,238,1543,79.39,5.18,15.42,2019,17026
214,10,126,350,61.14,2.86,36.0,2019,17037
973,24,268,1265,76.92,1.9,21.19,2019,17045
1747,88,500,2335,74.82,3.77,21.41,2019,17066
5989,211,787,6987,85.72,3.02,11.26,2019,17070
37,0,0,37,100.0,0.0,0.0,2019,17077
363,27,154,544,66.73,4.96,28.31,2019,17229
238,0,68,306,77.78,0.0,22.22,2019,17235
3615,116,955,4686,77.14,2.48,20.38,2019,17241
742,19,214,975,76.1,1.95,21.95,2019,17264
43,0,0,43,100.0,0.0,0.0,2019,17270
86,0,12,98,87.76,0.0,12.24,2019,17306
17098,518,3243,20859,81.97,2.48,15.55,2019,17331
4024,225,837,5086,79.12,4.42,16.46,2019,17350
4270,98,702,5070,84.22,1.93,13.85,2019,17362
3190,81,368,3639,87.66,2.23,10.11,2019,17363
2493,169,381,3043,81.93,5.55,12.52,2019,17368
11742,275,1754,13771,85.27,2.0,12.74,2019,17402
728,18,69,815,89.33,2.21,8.47,2019,17407
149,14,35,198,75.25,7.07,17.68,2019,17508
1235,83,527,1845,66.94,4.5,28.56,2019,17527
784,45,595,1424,55.06,3.16,41.78,2019,17529
1410,0,446,1856,75.97,0.0,24.03,2019,17560
2089,63,566,2718,76.86,2.32,20.82,2019,17578
214,26,25,265,80.75,9.81,9.43,2019,17581
103,4,14,121,85.12,3.31,11.57,2019,17731
701,45,334,1080,64.91,4.17,30.93,2019,17747
35,0,25,60,58.33,0.0,41.67,2019,17767
2319,30,615,2964,78.24,1.01,20.75,2019,17777
53,0,0,53,100.0,0.0,0.0,2019,17778
1248,68,434,1750,71.31,3.89,24.8,2019,17824
462,34,125,621,74.4,5.48,20.13,2019,17881
1553,35,503,2091,74.27,1.67,24.06,2019,17931
83,0,21,104,79.81,0.0,20.19,2019,17951
2946,53,629,3628,81.2,1.46,17.34,2019,17963
92,0,17,109,84.4,0.0,15.6,2019,17979
6998,125,1116,8239,84.94,1.52,13.55,2019,17356
1159,8,188,1355,85.54,0.59,13.87,2019,17364
1248,36,206,1490,83.76,2.42,13.83,2019,17372
4296,319,1669,6284,68.36,5.08,26.56,2019,17401
11429,402,2165,13996,81.66,2.87,15.47,2019,17404
527,23,316,866,60.85,2.66,36.49,2019,17536
2362,103,288,2753,85.8,3.74,10.46,2019,17547
284,3,50,337,84.27,0.89,14.84,2019,17097
390,55,66,511,76.32,10.76,12.92,2019,17099
12560,274,1425,14259,88.08,1.92,9.99,2019,17112
72,5,54,131,54.96,3.82,41.22,2019,17219
440,26,175,641,68.64,4.06,27.3,2019,17238
393,3,151,547,71.85,0.55,27.61,2019,17243
136,0,49,185,73.51,0.0,26.49,2019,17266
834,19,281,1134,73.54,1.68,24.78,2019,17267
2718,81,273,3072,88.48,2.64,8.89,2019,17316
170,18,0,188,90.43,9.57,0.0,2019,17318
2729,31,301,3061,89.15,1.01,9.83,2019,17320
1719,90,385,2194,78.35,4.1,17.55,2019,17322
0,0,1,1,0.0,0.0,100.0,2019,20118
1097,27,280,1404,78.13,1.92,19.94,2019,20119
106,7,25,138,76.81,5.07,18.12,2019,20130
5149,67,429,5645,91.21,1.19,7.6,2019,20132
10589,183,117,10889,97.24,1.68,1.07,2019,20152
10960,270,350,11580,94.65,2.33,3.02,2019,20155
198,0,0,198,100.0,0.0,0.0,2019,20615
6536,98,907,7541,86.67,1.3,12.03,2019,20646
6300,69,590,6959,90.53,0.99,8.48,2019,20657
887,0,353,1240,71.53,0.0,28.47,2019,20664
220,17,122,359,61.28,4.74,33.98,2019,20690
1501,50,253,1804,83.2,2.77,14.02,2019,20722
8701,318,1657,10676,81.5,2.98,15.52,2019,20745
782,0,68,850,92.0,0.0,8.0,2019,20751
632,29,82,743,85.06,3.9,11.04,2019,20763
1125,14,72,1211,92.9,1.16,5.95,2019,20776
700,9,42,751,93.21,1.2,5.59,2019,20778
97,0,4,101,96.04,0.0,3.96,2019,20812
5818,70,164,6052,96.13,1.16,2.71,2019,20816
19336,401,884,20621,93.77,1.94,4.29,2019,20852
491,0,47,538,91.26,0.0,8.74,2019,20861
5470,133,152,5755,95.05,2.31,2.64,2019,20871
17333,460,2354,20147,86.03,2.28,11.68,2019,20001
15017,1058,5405,21480,69.91,4.93,25.16,2019,20020
7180,61,272,7513,95.57,0.81,3.62,2019,20105
4198,63,48,4309,97.42,1.46,1.11,2019,20166
11336,186,512,12034,94.2,1.55,4.25,2019,20175
4997,94,460,5551,90.02,1.69,8.29,2019,20186
11047,176,384,11607,95.18,1.52,3.31,2019,20191
5334,52,60,5446,97.94,0.95,1.1,2019,20194
8118,173,633,8924,90.97,1.94,7.09,2019,20601
154,0,30,184,83.7,0.0,16.3,2019,20626
4366,132,835,5333,81.87,2.48,15.66,2019,20650
652,13,409,1074,60.71,1.21,38.08,2019,20662
151,0,70,221,68.33,0.0,31.67,2019,20667
271,20,32,323,83.9,6.19,9.91,2019,20680
281,0,41,322,87.27,0.0,12.73,2019,20692
8741,39,300,9080,96.27,0.43,3.3,2019,20715
8122,243,418,8783,92.47,2.77,4.76,2019,20716
9100,261,222,9583,94.96,2.72,2.32,2019,20721
3366,12,315,3693,91.15,0.32,8.53,2019,20732
11195,337,741,12273,91.22,2.75,6.04,2019,20735
11401,554,2494,14449,78.91,3.83,17.26,2019,20743
12118,216,610,12944,93.62,1.67,4.71,2019,20815
604,17,57,678,89.09,2.51,8.41,2019,20842
19406,425,805,20636,94.04,2.06,3.9,2019,20850
106,12,0,118,89.83,10.17,0.0,2019,20862
4571,104,190,4865,93.96,2.14,3.91,2019,20866
20417,324,928,21669,94.22,1.5,4.28,2019,20874
8978,187,408,9573,93.78,1.95,4.26,2019,20876
21408,251,745,22404,95.55,1.12,3.33,2019,20878
4258,64,200,4522,94.16,1.42,4.42,2019,20882
10683,594,3874,15151,70.51,3.92,25.57,2019,20032
3632,144,166,3942,92.14,3.65,4.21,2019,20036
878,60,125,1063,82.6,5.64,11.76,2019,20117
3974,13,324,4311,92.18,0.3,7.52,2019,20794
12645,270,478,13393,94.41,2.02,3.57,2019,20814
88,0,9,97,90.72,0.0,9.28,2019,20838
10704,446,1650,12800,83.62,3.48,12.89,2019,20877
174,0,101,275,63.27,0.0,36.73,2019,24991
35,12,72,119,29.41,10.08,60.5,2019,22476
16,0,73,89,17.98,0.0,82.02,2019,22529
444,123,180,747,59.44,16.47,24.1,2019,22542
809,69,153,1031,78.47,6.69,14.84,2019,22620
1277,0,55,1332,95.87,0.0,4.13,2019,22625
659,16,191,866,76.1,1.85,22.06,2019,22637
224,0,55,279,80.29,0.0,19.71,2019,22650
6752,384,669,7805,86.51,4.92,8.57,2019,22655
103,0,0,103,100.0,0.0,0.0,2019,22548
582,9,301,892,65.25,1.01,33.74,2019,22514
797,26,202,1025,77.76,2.54,19.71,2019,22534
131,8,75,214,61.21,3.74,35.05,2019,22535
132,0,67,199,66.33,0.0,33.67,2019,22640
1734,60,50,1844,94.03,3.25,2.71,2019,22642
503,40,92,635,79.21,6.3,14.49,2019,22652
490,41,193,724,67.68,5.66,26.66,2019,22660
842,30,162,1034,81.43,2.9,15.67,2019,22728
297,0,44,341,87.1,0.0,12.9,2019,22733
880,12,139,1031,85.35,1.16,13.48,2019,22737
194,9,76,279,69.53,3.23,27.24,2019,22811
1994,14,496,2504,79.63,0.56,19.81,2019,22824
309,0,75,384,80.47,0.0,19.53,2019,22831
1691,27,136,1854,91.21,1.46,7.34,2019,22840
1619,12,451,2082,77.76,0.58,21.66,2019,22842
0,0,9,9,0.0,0.0,100.0,2019,22845
1121,71,475,1667,67.25,4.26,28.49,2019,22853
9076,244,1330,10650,85.22,2.29,12.49,2019,22902
6444,184,663,7291,88.38,2.52,9.09,2019,22911
1983,72,312,2367,83.78,3.04,13.18,2019,22923
1527,44,219,1790,85.31,2.46,12.23,2019,22947
547,0,81,628,87.1,0.0,12.9,2019,22959
10202,428,2789,13419,76.03,3.19,20.78,2019,22980
5802,49,29,5880,98.67,0.83,0.49,2019,22039
2402,62,106,2570,93.46,2.41,4.12,2019,22060
6316,182,154,6652,94.95,2.74,2.32,2019,22124
1160,93,41,1294,89.64,7.19,3.17,2019,22134
19630,316,1494,21440,91.56,1.47,6.97,2019,22304
10838,63,515,11416,94.94,0.55,4.51,2019,22310
10279,95,352,10726,95.83,0.89,3.28,2019,22315
53,0,53,106,50.0,0.0,50.0,2019,22432
277,32,37,346,80.06,9.25,10.69,2019,22480
1759,12,737,2508,70.14,0.48,29.39,2019,22520
802,0,166,968,82.85,0.0,17.15,2019,22576
8851,387,1573,10811,81.87,3.58,14.55,2019,22602
13653,451,2289,16393,83.29,2.75,13.96,2019,24502
1559,112,974,2645,58.94,4.23,36.82,2019,24558
117,15,53,185,63.24,8.11,28.65,2019,24562
4615,215,1682,6512,70.87,3.3,25.83,2019,24572
168,21,47,236,71.19,8.9,19.92,2019,24580
0,0,27,27,0.0,0.0,100.0,2019,24581
655,27,392,1074,60.99,2.51,36.5,2019,24589
0,0,0,0,,,,2019,24601
78,0,36,114,68.42,0.0,31.58,2019,24604
2581,53,651,3285,78.57,1.61,19.82,2019,24605
45,0,32,77,58.44,0.0,41.56,2019,24612
528,0,270,798,66.17,0.0,33.83,2019,24631
145,0,70,215,67.44,0.0,32.56,2019,24634
1633,34,671,2338,69.85,1.45,28.7,2019,24641
905,39,445,1389,65.15,2.81,32.04,2019,25514
764,73,422,1259,60.68,5.8,33.52,2019,24639
96,0,75,171,56.14,0.0,43.86,2019,24657
36,0,17,53,67.92,0.0,32.08,2019,24737
259,32,0,291,89.0,11.0,0.0,2019,24811
212,3,125,340,62.35,0.88,36.76,2019,24817
150,0,52,202,74.26,0.0,25.74,2019,24823
529,0,146,675,78.37,0.0,21.63,2019,24839
136,0,30,166,81.93,0.0,18.07,2019,24867
54,4,9,67,80.6,5.97,13.43,2019,24871
230,0,121,351,65.53,0.0,34.47,2019,24872
133,0,29,162,82.1,0.0,17.9,2019,24881
36,0,76,112,32.14,0.0,67.86,2019,24884
375,77,176,628,59.71,12.26,28.03,2019,24892
19,0,41,60,31.67,0.0,68.33,2019,24894
1338,7,1083,2428,55.11,0.29,44.6,2019,24224
1639,107,749,2495,65.69,4.29,30.02,2019,24228
40,0,53,93,43.01,0.0,56.99,2019,24239
827,92,473,1392,59.41,6.61,33.98,2019,24256
1639,282,573,2494,65.72,11.31,22.98,2019,24273
3910,479,1636,6025,64.9,7.95,27.15,2019,24301
220,16,95,331,66.47,4.83,28.7,2019,24323
316,8,176,500,63.2,1.6,35.2,2019,24326
764,36,420,1220,62.62,2.95,34.43,2019,24330
503,20,191,714,70.45,2.8,26.75,2019,24347
1298,27,450,1775,73.13,1.52,25.35,2019,24348
1453,18,498,1969,73.79,0.91,25.29,2019,24361
1642,72,416,2130,77.09,3.38,19.53,2019,24368
107,0,50,157,68.15,0.0,31.85,2019,24377
135,12,42,189,71.43,6.35,22.22,2019,24944
443,48,270,761,58.21,6.31,35.48,2019,24312
13,0,0,13,100.0,0.0,0.0,2019,24412
443,72,188,703,63.02,10.24,26.74,2019,24258
277,0,157,434,63.82,0.0,36.18,2019,24325
8,0,0,8,100.0,0.0,0.0,2019,24130
10,176,56,242,4.13,72.73,23.14,2019,24246
0,0,27,27,0.0,0.0,100.0,2019,24411
97,0,13,110,88.18,0.0,11.82,2019,24476
0,0,0,0,,,,2019,24570
52,0,52,104,50.0,0.0,50.0,2019,24729
67,0,46,113,59.29,0.0,40.71,2019,24738
34,0,7,41,82.93,0.0,17.07,2019,24826
200,0,24,224,89.29,0.0,10.71,2019,24834
67,0,48,115,58.26,0.0,41.74,2019,24847
113,0,107,220,51.36,0.0,48.64,2019,24878
177,0,91,268,66.04,0.0,33.96,2019,24613
119,5,113,237,50.21,2.11,47.68,2019,24635
657,23,392,1072,61.29,2.15,36.57,2019,24649
49,0,51,100,49.0,0.0,51.0,2019,24714
145,0,23,168,86.31,0.0,13.69,2019,24716
686,27,317,1030,66.6,2.62,30.78,2019,24747
163,0,56,219,74.43,0.0,25.57,2019,24808
65,0,0,65,100.0,0.0,0.0,2019,24816
103,14,54,171,60.23,8.19,31.58,2019,24853
190,20,40,250,76.0,8.0,16.0,2019,24879
20,12,18,50,40.0,24.0,36.0,2019,24861
764,44,358,1166,65.52,3.77,30.7,2019,24870
133,0,93,226,58.85,0.0,41.15,2019,24873
5917,193,2413,8523,69.42,2.26,28.31,2019,24701
800,4,295,1099,72.79,0.36,26.84,2019,26218
274,0,119,393,69.72,0.0,30.28,2019,25979
282,9,116,407,69.29,2.21,28.5,2019,25009
82,0,78,160,51.25,0.0,48.75,2019,25028
329,0,40,369,89.16,0.0,10.84,2019,25035
65,0,15,80,81.25,0.0,18.75,2019,25036
110,0,32,142,77.46,0.0,22.54,2019,25162
6023,223,705,6951,86.65,3.21,10.14,2019,25414
251,0,22,273,91.94,0.0,8.06,2019,25565
2324,0,787,3111,74.7,0.0,25.3,2019,25840
10,25,0,35,28.57,71.43,0.0,2019,25989
610,51,84,745,81.88,6.85,11.28,2019,25082
227,0,49,276,82.25,0.0,17.75,2019,25061
29,4,52,85,34.12,4.71,61.18,2019,25062
40,9,60,109,36.7,8.26,55.05,2019,25093
0,0,0,0,,,,2019,25112
134,0,80,214,62.62,0.0,37.38,2019,25142
55,0,52,107,51.4,0.0,48.6,2019,25156
20,0,18,38,52.63,0.0,47.37,2019,25180
0,0,0,0,,,,2019,25185
18,0,0,18,100.0,0.0,0.0,2019,25201
8,0,0,8,100.0,0.0,0.0,2019,25203
0,0,0,0,,,,2019,25305
4578,162,440,5180,88.38,3.13,8.49,2019,25403
7375,194,813,8382,87.99,2.31,9.7,2019,25404
4178,166,482,4826,86.57,3.44,9.99,2019,25405
47,0,17,64,73.44,0.0,26.56,2019,25432
101,0,0,101,100.0,0.0,0.0,2019,25690
48,0,0,48,100.0,0.0,0.0,2019,25810
15,0,0,15,100.0,0.0,0.0,2019,25811
80,0,35,115,69.57,0.0,30.43,2019,25264
4573,165,871,5609,81.53,2.94,15.53,2019,25309
70,0,32,102,68.63,0.0,31.37,2019,25044
215,0,44,259,83.01,0.0,16.99,2019,25873
37,0,0,37,100.0,0.0,0.0,2019,25876
139,0,31,170,81.76,0.0,18.24,2019,25906
12,0,10,22,54.55,0.0,45.45,2019,25911
14,0,38,52,26.92,0.0,73.08,2019,25115
2632,59,418,3109,84.66,1.9,13.44,2019,25430
285,10,197,492,57.93,2.03,40.04,2019,25854
385,22,50,457,84.25,4.81,10.94,2019,25969
126,0,46,172,73.26,0.0,26.74,2019,25868
260,5,100,365,71.23,1.37,27.4,2019,25871
67,0,46,113,59.29,0.0,40.71,2019,25913
568,6,281,855,66.43,0.7,32.87,2019,25917
37,15,50,102,36.27,14.71,49.02,2019,25922
32,0,15,47,68.09,0.0,31.91,2019,25857
80,0,13,93,86.02,0.0,13.98,2019,25862
60,0,16,76,78.95,0.0,21.05,2019,25005
360,23,217,600,60.0,3.83,36.17,2019,25844
661,0,293,954,69.29,0.0,30.71,2019,25823
720,0,156,876,82.19,0.0,17.81,2019,25827
539,0,175,714,75.49,0.0,24.51,2019,25831
41,0,29,70,58.57,0.0,41.43,2019,25915
1394,74,460,1928,72.3,3.84,23.86,2019,25918
382,32,127,541,70.61,5.91,23.48,2019,25938
94,0,144,238,39.5,0.0,60.5,2019,25978
397,38,78,513,77.39,7.41,15.2,2019,25202
2102,85,192,2379,88.36,3.57,8.07,2019,25213
739,6,138,883,83.69,0.68,15.63,2019,28717
71,0,52,123,57.72,0.0,42.28,2019,26263
169,0,65,234,72.22,0.0,27.78,2019,26264
409,18,214,641,63.81,2.81,33.39,2019,26280
10,25,0,35,28.57,71.43,0.0,2019,26282
1073,40,286,1399,76.7,2.86,20.44,2019,26287
74,3,25,102,72.55,2.94,24.51,2019,26521
895,27,175,1097,81.59,2.46,15.95,2019,26588
2197,35,688,2920,75.24,1.2,23.56,2019,26155
247,15,93,355,69.58,4.23,26.2,2019,26167
1138,18,327,1483,76.74,1.21,22.05,2019,26253
569,26,127,722,78.81,3.6,17.59,2019,26260
133,0,37,170,78.24,0.0,21.76,2019,26271
151,25,56,232,65.09,10.78,24.14,2019,26275
76,0,54,130,58.46,0.0,41.54,2019,26276
141,4,13,158,89.24,2.53,8.23,2019,26323
199,31,119,349,57.02,8.88,34.1,2019,26884
56,7,49,112,50.0,6.25,43.75,2019,26343
1101,64,182,1347,81.74,4.75,13.51,2019,26351
15,0,0,15,100.0,0.0,0.0,2019,26366
32,0,66,98,32.65,0.0,67.35,2019,26424
140,0,19,159,88.05,0.0,11.95,2019,26437
555,17,65,637,87.13,2.67,10.2,2019,26851
54,0,0,54,100.0,0.0,0.0,2019,26296
57,0,12,69,82.61,0.0,17.39,2019,26203
964,3,434,1401,68.81,0.21,30.98,2019,26206
14,0,0,14,100.0,0.0,0.0,2019,26215
30,0,36,66,45.45,0.0,54.55,2019,26230
1343,23,499,1865,72.01,1.23,26.76,2019,26250
345,6,135,486,70.99,1.23,27.78,2019,26257
141,0,88,229,61.57,0.0,38.43,2019,26270
81,0,88,169,47.93,0.0,52.07,2019,26285
196,0,50,246,79.67,0.0,20.33,2019,26293
63,0,94,157,40.13,0.0,59.87,2019,26325
193,0,117,310,62.26,0.0,37.74,2019,26338
267,32,48,347,76.95,9.22,13.83,2019,26346
1254,46,317,1617,77.55,2.84,19.6,2019,26378
2111,181,900,3192,66.13,5.67,28.2,2019,26416
1794,125,645,2564,69.97,4.88,25.16,2019,26426
39,0,25,64,60.94,0.0,39.06,2019,26435
2594,116,953,3663,70.82,3.17,26.02,2019,26452
324,0,20,344,94.19,0.0,5.81,2019,26520
1580,66,379,2025,78.02,3.26,18.72,2019,26525
145,3,150,298,48.66,1.01,50.34,2019,26866
117,10,70,197,59.39,5.08,35.53,2019,26032
37,12,0,49,75.51,24.49,0.0,2019,26056
188,0,61,249,75.5,0.0,24.5,2019,26136
68,0,61,129,52.71,0.0,47.29,2019,26141
1263,72,414,1749,72.21,4.12,23.67,2019,26601
36,0,92,128,28.12,0.0,71.88,2019,26619
3117,94,808,4019,77.56,2.34,20.1,2019,26651
646,28,105,779,82.93,3.59,13.48,2019,26679
308,0,97,405,76.05,0.0,23.95,2019,26681
70,0,0,70,100.0,0.0,0.0,2019,26684
162,0,87,249,65.06,0.0,34.94,2019,26690
1658,37,385,2080,79.71,1.78,18.51,2019,26704
186,0,73,259,71.81,0.0,28.19,2019,26722
265,0,115,380,69.74,0.0,30.26,2019,26739
875,63,332,1270,68.9,4.96,26.14,2019,26807
2374,68,234,2676,88.71,2.54,8.74,2019,17349
1029,14,170,1213,84.83,1.15,14.01,2019,28742
842,16,79,937,89.86,1.71,8.43,2019,28747
3489,135,1314,4938,70.66,2.73,26.61,2019,28748
2731,131,809,3671,74.39,3.57,22.04,2019,28754
220,7,195,422,52.13,1.66,46.21,2019,28781
6988,331,2366,9685,72.15,3.42,24.43,2019,28786
3151,79,892,4122,76.44,1.92,21.64,2019,28904
902,124,248,1274,70.8,9.73,19.47,2019,28905
13156,211,1425,14792,88.94,1.43,9.63,2019,28273
6165,459,3315,9939,62.03,4.62,33.35,2019,28328
1730,79,1939,3748,46.16,2.11,51.73,2019,28340
3537,23,1485,5045,70.11,0.46,29.44,2019,28345
675,64,380,1119,60.32,5.72,33.96,2019,28349
56,0,19,75,74.67,0.0,25.33,2019,28350
4174,162,1622,5958,70.06,2.72,27.22,2019,28365
39,0,16,55,70.91,0.0,29.09,2019,28367
1840,143,944,2927,62.86,4.89,32.25,2019,28382
2583,41,1311,3935,65.64,1.04,33.32,2019,28384
5461,185,2085,7731,70.64,2.39,26.97,2019,28501
757,17,192,966,78.36,1.76,19.88,2019,28508
675,0,231,906,74.5,0.0,25.5,2019,28523
768,32,31,831,92.42,3.85,3.73,2019,28582
1609,40,119,1768,91.01,2.26,6.73,2019,28594
7399,183,1313,8895,83.18,2.06,14.76,2019,28613
736,35,290,1061,69.37,3.3,27.33,2019,28622
7701,138,694,8533,90.25,1.62,8.13,2019,28532
861,19,215,1095,78.63,1.74,19.63,2019,28618
126,3,12,141,89.36,2.13,8.51,2019,28646
402,77,102,581,69.19,13.25,17.56,2019,28683
1475,100,524,2099,70.27,4.76,24.96,2019,28901
4676,55,442,5173,90.39,1.06,8.54,2019,28584
2263,48,741,3052,74.15,1.57,24.28,2019,28586
17291,370,3203,20864,82.87,1.77,15.35,2019,28601
2552,33,455,3040,83.95,1.09,14.97,2019,28604
430,0,91,521,82.53,0.0,17.47,2019,28627
1341,69,680,2090,64.16,3.3,32.54,2019,28640
338,0,15,353,95.75,0.0,4.25,2019,28649
1379,20,258,1657,83.22,1.21,15.57,2019,28654
0,0,73,73,0.0,0.0,100.0,2019,28666
948,11,267,1226,77.32,0.9,21.78,2019,28670
530,0,59,589,89.98,0.0,10.02,2019,28682
2530,84,838,3452,73.29,2.43,24.28,2019,28694
4611,162,951,5724,80.56,2.83,16.61,2019,28711
5132,150,1834,7116,72.12,2.11,25.77,2019,28714
8424,183,1148,9755,86.36,1.88,11.77,2019,28739
942,13,139,1094,86.11,1.19,12.71,2019,28763
1535,37,279,1851,82.93,2.0,15.07,2019,28356
27494,488,2100,30082,91.4,1.62,6.98,2019,28269
14409,907,2613,17929,80.37,5.06,14.57,2019,28403
4039,123,940,5102,79.17,2.41,18.42,2019,28516
10950,624,1494,13068,83.79,4.78,11.43,2019,28607
1617,10,501,2128,75.99,0.47,23.54,2019,28678
1911,31,773,2715,70.39,1.14,28.47,2019,28114
955,33,135,1123,85.04,2.94,12.02,2019,28746
14540,480,2938,17958,80.97,2.67,16.36,2019,28806
3449,100,725,4274,80.7,2.34,16.96,2019,28134
6887,501,1509,8897,77.41,5.63,16.96,2019,28504
11215,447,3101,14763,75.97,3.03,21.01,2019,28792
2276,69,494,2839,80.17,2.43,17.4,2019,19945
1159,31,178,1368,84.72,2.27,13.01,2019,17353
1511,39,247,1797,84.08,2.17,13.75,2019,17501
4915,163,704,5782,85.01,2.82,12.18,2019,17517
9571,406,1496,11473,83.42,3.54,13.04,2019,17022
44,0,15,59,74.58,0.0,25.42,2019,17029
12323,323,2382,15028,82.0,2.15,15.85,2019,17042
1066,24,469,1559,68.38,1.54,30.08,2019,17048
2278,54,811,3143,72.48,1.72,25.8,2019,17059
52,0,99,151,34.44,0.0,65.56,2019,17072
997,12,230,1239,80.47,0.97,18.56,2019,17082
736,25,219,980,75.1,2.55,22.35,2019,17098
3544,302,896,4742,74.74,6.37,18.89,2019,17103
8412,192,1542,10146,82.91,1.89,15.2,2019,17110
10885,270,1701,12856,84.67,2.1,13.23,2019,17111
3167,49,686,3902,81.16,1.26,17.58,2019,17113
1298,15,387,1700,76.35,0.88,22.76,2019,17252
93,0,19,112,83.04,0.0,16.96,2019,17253
1435,22,211,1668,86.03,1.32,12.65,2019,17301
534,0,305,839,63.65,0.0,36.35,2019,17309
713,65,99,877,81.3,7.41,11.29,2019,17321
794,32,97,923,86.02,3.47,10.51,2019,17329
347,16,0,363,95.59,4.41,0.0,2019,17064
1240,25,291,1556,79.69,1.61,18.7,2019,17068
38,0,8,46,82.61,0.0,17.39,2019,17075
1471,60,586,2117,69.49,2.83,27.68,2019,17519
395,90,255,740,53.38,12.16,34.46,2019,17535
1397,17,739,2153,64.89,0.79,34.32,2019,17555
759,32,413,1204,63.04,2.66,34.3,2019,17563
712,117,628,1457,48.87,8.03,43.1,2019,17572
1791,76,322,2189,81.82,3.47,14.71,2019,17579
678,47,104,829,81.79,5.67,12.55,2019,17582
1980,77,520,2577,76.83,2.99,20.18,2019,17751
680,10,215,905,75.14,1.1,23.76,2019,17772
1588,60,589,2237,70.99,2.68,26.33,2019,17233
57,3,26,86,66.28,3.49,30.23,2019,17239
129,2,26,157,82.17,1.27,16.56,2019,17249
963,126,361,1450,66.41,8.69,24.9,2019,17101
190,16,55,261,72.8,6.13,21.07,2019,17212
93,8,89,190,48.95,4.21,46.84,2019,17220
558,19,86,663,84.16,2.87,12.97,2019,17237
330,2,94,426,77.46,0.47,22.07,2019,17260
3782,95,633,4510,83.86,2.11,14.04,2019,17313
8581,340,1755,10676,80.38,3.18,16.44,2019,17315
3913,44,456,4413,88.67,1.0,10.33,2019,17319
1299,19,452,1770,73.39,1.07,25.54,2019,17324
3854,202,879,4935,78.1,4.09,17.81,2019,17740
12,0,6,18,66.67,0.0,33.33,2019,17742
5723,219,1146,7088,80.74,3.09,16.17,2019,17745
70,5,29,104,67.31,4.81,27.88,2019,17748
190,2,64,256,74.22,0.78,25.0,2019,17760
5027,117,1773,6917,72.68,1.69,25.63,2019,17801
1164,22,351,1537,75.73,1.43,22.84,2019,17834
2675,34,1100,3809,70.23,0.89,28.88,2019,17844
30,2,5,37,81.08,5.41,13.51,2019,17865
709,26,183,918,77.23,2.83,19.93,2019,17889
1681,73,122,1876,89.61,3.89,6.5,2019,17922
57,0,15,72,79.17,0.0,20.83,2019,17943
1452,21,428,1901,76.38,1.1,22.51,2019,17948
6507,87,296,6890,94.44,1.26,4.3,2019,20895
512,8,11,531,96.42,1.51,2.07,2019,19967
6067,173,769,7009,86.56,2.47,10.97,2019,19971
258,8,33,299,86.29,2.68,11.04,2019,19979
702,11,93,806,87.1,1.36,11.54,2019,19534
3841,42,576,4459,86.14,0.94,12.92,2019,19540
11827,281,1272,13380,88.39,2.1,9.51,2019,19606
61,0,10,71,85.92,0.0,14.08,2019,19731
7716,764,1919,10399,74.2,7.35,18.45,2019,19802
1145,12,93,1250,91.6,0.96,7.44,2019,19930
105,3,17,125,84.0,2.4,13.6,2019,19931
4678,81,290,5049,92.65,1.6,5.74,2019,19934
1883,90,625,2598,72.48,3.46,24.06,2019,19950
10827,143,1158,12128,89.27,1.18,9.55,2019,19958
3839,81,252,4172,92.02,1.94,6.04,2019,19962
4069,91,343,4503,90.36,2.02,7.62,2019,19118
8015,943,3450,12408,64.6,7.6,27.8,2019,19121
14544,275,1517,16336,89.03,1.68,9.29,2019,19128
12461,802,4261,17524,71.11,4.58,24.32,2019,19131
9991,292,1787,12070,82.78,2.42,14.81,2019,19135
94,0,27,121,77.69,0.0,22.31,2019,19316
95,0,0,95,100.0,0.0,0.0,2019,19319
2657,14,207,2878,92.32,0.49,7.19,2019,19352
4367,44,1344,5755,75.88,0.76,23.35,2019,19363
12522,592,3295,16409,76.31,3.61,20.08,2019,19401
5,0,0,5,100.0,0.0,0.0,2019,19472
1224,0,245,1469,83.32,0.0,16.68,2019,19505
5124,64,435,5623,91.13,1.14,7.74,2019,19003
6739,106,504,7349,91.7,1.44,6.86,2019,19010
2066,44,169,2279,90.65,1.93,7.42,2019,19012
6744,175,788,7707,87.5,2.27,10.22,2019,19014
2777,56,323,3156,87.99,1.77,10.23,2019,19033
1825,90,105,2020,90.35,4.46,5.2,2019,19034
10567,159,1135,11861,89.09,1.34,9.57,2019,19026
1345,46,48,1439,93.47,3.2,3.34,2019,19035
6907,114,765,7786,88.71,1.46,9.83,2019,19040
8860,174,892,9926,89.26,1.75,8.99,2019,19053
7898,149,448,8495,92.97,1.75,5.27,2019,19064
2592,53,332,2977,87.07,1.78,11.15,2019,19095
2908,66,81,3055,95.19,2.16,2.65,2019,19102
35,4,11,50,70.0,8.0,22.0,2019,19113
4713,309,1641,6663,70.73,4.64,24.63,2019,19122
3683,132,856,4671,78.85,2.83,18.33,2019,19129
5482,316,3159,8957,61.2,3.53,35.27,2019,19133
13694,747,4089,18530,73.9,4.03,22.07,2019,19144
2310,67,214,2591,89.15,2.59,8.26,2019,19301
9256,104,757,10117,91.49,1.03,7.48,2019,19468
5422,102,377,5901,91.88,1.73,6.39,2019,19473
261,0,42,303,86.14,0.0,13.86,2019,19474
518,17,70,605,85.62,2.81,11.57,2019,19503
3860,179,842,4881,79.08,3.67,17.25,2019,19530
166,7,29,202,82.18,3.47,14.36,2019,19536
1568,14,234,1816,86.34,0.77,12.89,2019,19539
705,45,263,1013,69.6,4.44,25.96,2019,19562
6276,159,992,7427,84.5,2.14,13.36,2019,19605
8141,141,1372,9654,84.33,1.46,14.21,2019,19607
13763,304,483,14550,94.59,2.09,3.32,2019,19709
72,0,0,72,100.0,0.0,0.0,2019,19733
12620,181,875,13676,92.28,1.32,6.4,2019,19130
1600,94,423,2117,75.58,4.44,19.98,2019,24651
286,4,2,292,97.95,1.37,0.68,2019,20896
21676,770,2692,25138,86.23,3.06,10.71,2019,20906
18838,792,4299,23929,78.72,3.31,17.97,2019,20011
542,0,26,568,95.42,0.0,4.58,2019,20006
10696,363,1533,12592,84.94,2.88,12.17,2019,20010
7029,269,976,8274,84.95,3.25,11.8,2019,20024
1664,33,291,1988,83.7,1.66,14.64,2019,20106
7990,83,136,8209,97.33,1.01,1.66,2019,20112
13005,148,341,13494,96.38,1.1,2.53,2019,20120
179,0,0,179,100.0,0.0,0.0,2019,20129
8178,137,92,8407,97.28,1.63,1.09,2019,20136
270,9,8,287,94.08,3.14,2.79,2019,20143
15581,171,100,15852,98.29,1.08,0.63,2019,20148
6591,63,168,6822,96.61,0.92,2.46,2019,20151
10645,125,398,11168,95.32,1.12,3.56,2019,20165
12606,260,532,13398,94.09,1.94,3.97,2019,20170
16803,196,411,17410,96.51,1.13,2.36,2019,20171
8540,213,429,9182,93.01,2.32,4.67,2019,20190
698,10,167,875,79.77,1.14,19.09,2019,20198
3998,189,470,4657,85.85,4.06,10.09,2019,20613
99,0,89,188,52.66,0.0,47.34,2019,20628
72,0,45,117,61.54,0.0,38.46,2019,20630
90,0,19,109,82.57,0.0,17.43,2019,20632
4414,90,361,4865,90.73,1.85,7.42,2019,20639
703,0,57,760,92.5,0.0,7.5,2019,20675
651,16,124,791,82.3,2.02,15.68,2019,20677
306,11,0,317,96.53,3.47,0.0,2019,20693
8740,217,915,9872,88.53,2.2,9.27,2019,20708
3037,88,703,3828,79.34,2.3,18.36,2019,20710
8661,452,2235,11348,76.32,3.98,19.7,2019,20746
9965,204,1747,11916,83.63,1.71,14.66,2019,20783
23,0,0,23,100.0,0.0,0.0,2019,20839
3054,16,24,3094,98.71,0.52,0.78,2019,20841
7520,262,430,8212,91.57,3.19,5.24,2019,20879
17401,1068,1305,19774,88.0,5.4,6.6,2019,20904
1666,12,11,1689,98.64,0.71,0.65,2019,20759
765,21,43,829,92.28,2.53,5.19,2019,20762
161,0,0,161,100.0,0.0,0.0,2019,20765
16962,234,1154,18350,92.44,1.28,6.29,2019,20774
341,0,91,432,78.94,0.0,21.06,2019,20779
3357,86,439,3882,86.48,2.22,11.31,2019,20781
12107,255,1538,13900,87.1,1.83,11.06,2019,20785
1850,22,79,1951,94.82,1.13,4.05,2019,20837
8830,224,579,9633,91.66,2.33,6.01,2019,20853
10569,303,971,11843,89.24,2.56,8.2,2019,20886
2591,10,305,2906,89.16,0.34,10.5,2019,20695
11813,197,1169,13179,89.64,1.49,8.87,2019,20706
3162,79,736,3977,79.51,1.99,18.51,2019,20712
11091,110,432,11633,95.34,0.95,3.71,2019,20723
4694,206,1148,6048,77.61,3.41,18.98,2019,20737
1384,12,53,1449,95.51,0.83,3.66,2019,20764
1904,21,16,1941,98.09,1.08,0.82,2019,20769
9752,202,1238,11192,87.13,1.8,11.06,2019,20782
7712,383,1387,9482,81.33,4.04,14.63,2019,20784
768,0,29,797,96.36,0.0,3.64,2019,20818
4405,50,534,4989,88.29,1.0,10.7,2019,20851
4953,61,230,5244,94.45,1.16,4.39,2019,20855
24056,680,3813,28549,84.26,2.38,13.36,2019,20002
15,0,0,15,100.0,0.0,0.0,2019,24719
101,6,8,115,87.83,5.22,6.96,2019,24866
102,27,55,184,55.43,14.67,29.89,2019,24869
3643,98,746,4487,81.19,2.18,16.63,2019,24901
1579,63,572,2214,71.32,2.85,25.84,2019,24986
1391,20,440,1851,75.15,1.08,23.77,2019,24095
351,0,209,560,62.68,0.0,37.32,2019,24439
1545,127,467,2139,72.23,5.94,21.83,2019,24538
9909,463,3394,13766,71.98,3.36,24.65,2019,24540
9100,415,2614,12129,75.03,3.42,21.55,2019,24541
973,70,575,1618,60.14,4.33,35.54,2019,24554
1030,51,353,1434,71.83,3.56,24.62,2019,24574
2869,298,733,3900,73.56,7.64,18.79,2019,24588
519,0,196,715,72.59,0.0,27.41,2019,24593
327,51,294,672,48.66,7.59,43.75,2019,24594
814,0,296,1110,73.33,0.0,26.67,2019,24620
2019,28,636,2683,75.25,1.04,23.7,2019,24630
29,0,50,79,36.71,0.0,63.29,2019,24464
3352,133,969,4454,75.26,2.99,21.76,2019,24477
449,84,148,681,65.93,12.33,21.73,2019,24479
1441,41,449,1931,74.62,2.12,23.25,2019,24482
102,0,56,158,64.56,0.0,35.44,2019,24487
525,0,268,793,66.2,0.0,33.8,2019,24918
2760,257,1150,4167,66.23,6.17,27.6,2019,24016
6167,373,2764,9304,66.28,4.01,29.71,2019,24017
16793,420,1062,18275,91.89,2.3,5.81,2019,24060
2330,64,678,3072,75.85,2.08,22.07,2019,24078
1143,21,345,1509,75.75,1.39,22.86,2019,24104
1087,59,262,1408,77.2,4.19,18.61,2019,24136
1017,71,240,1328,76.58,5.35,18.07,2019,24149
11491,421,2678,14590,78.76,2.89,18.36,2019,24153
1562,69,203,1834,85.17,3.76,11.07,2019,24184
5453,280,1311,7044,77.41,3.98,18.61,2019,24201
204,21,104,329,62.01,6.38,31.61,2019,24220
522,98,386,1006,51.89,9.74,38.37,2019,24271
103,42,162,307,33.55,13.68,52.77,2019,24282
218,0,51,269,81.04,0.0,18.96,2019,24925
488,0,89,577,84.58,0.0,15.42,2019,24931
833,0,314,1147,72.62,0.0,27.38,2019,24315
423,215,335,973,43.47,22.1,34.43,2019,24281
43,0,6,49,87.76,0.0,12.24,2019,24322
1697,59,479,2235,75.93,2.64,21.43,2019,24340
239,0,227,466,51.29,0.0,48.71,2019,24350
126,40,89,255,49.41,15.69,34.9,2019,24351
1495,94,687,2276,65.69,4.13,30.18,2019,24360
847,58,192,1097,77.21,5.29,17.5,2019,24440
1474,32,480,1986,74.22,1.61,24.17,2019,24910
243,0,33,276,88.04,0.0,11.96,2019,24915
2491,521,832,3844,64.8,13.55,21.64,2019,24293
5146,362,1687,7195,71.52,5.03,23.45,2019,24333
4018,258,1562,5838,68.82,4.42,26.76,2019,24354
242,8,261,511,47.36,1.57,51.08,2019,24378
663,0,178,841,78.83,0.0,21.17,2019,24435
137,10,100,247,55.47,4.05,40.49,2019,24458
772,42,225,1039,74.3,4.04,21.66,2019,24431
74,0,30,104,71.15,0.0,28.85,2019,24927
1224,35,325,1584,77.27,2.21,20.52,2019,24381
1320,30,374,1724,76.57,1.74,21.69,2019,24421
34,0,20,54,62.96,0.0,37.04,2019,24442
372,0,88,460,80.87,0.0,19.13,2019,25235
169,0,153,322,52.48,0.0,47.52,2019,24815
461,15,21,497,92.76,3.02,4.23,2019,24827
241,16,69,326,73.93,4.91,21.17,2019,24828
34,2,38,74,45.95,2.7,51.35,2019,24830
162,35,57,254,63.78,13.78,22.44,2019,24836
48,8,22,78,61.54,10.26,28.21,2019,24848
908,55,296,1259,72.12,4.37,23.51,2019,24874
123,0,22,145,84.83,0.0,15.17,2019,24880
498,12,109,619,80.45,1.94,17.61,2019,24938
1490,58,421,1969,75.67,2.95,21.38,2019,24970
66,0,54,120,55.0,0.0,45.0,2019,24984
9374,369,2253,11996,78.14,3.08,18.78,2019,24012
74,0,6,80,92.5,0.0,7.5,2019,24831
135,0,138,273,49.45,0.0,50.55,2019,24646
9623,482,2858,12963,74.23,3.72,22.05,2019,24740
915,101,257,1273,71.88,7.93,20.19,2019,24801
123,0,11,134,91.79,0.0,8.21,2019,24845
250,0,48,298,83.89,0.0,16.11,2019,24857
56,0,57,113,49.56,0.0,50.44,2019,24860
333,14,134,481,69.23,2.91,27.86,2019,24868
65,0,65,130,50.0,0.0,50.0,2019,24920
1046,44,523,1613,64.85,2.73,32.42,2019,24954
5537,146,886,6569,84.29,2.22,13.49,2019,24015
32,0,0,32,100.0,0.0,0.0,2019,24020
682,0,475,1157,58.95,0.0,41.05,2019,24092
2099,100,373,2572,81.61,3.89,14.5,2019,24101
1568,73,451,2092,74.95,3.49,21.56,2019,24134
7369,442,1246,9057,81.36,4.88,13.76,2019,24141
154,0,38,192,80.21,0.0,19.79,2019,24161
1226,135,463,1824,67.21,7.4,25.38,2019,24279
583,26,188,797,73.15,3.26,23.59,2019,24079
1575,65,547,2187,72.02,2.97,25.01,2019,24066
590,33,311,934,63.17,3.53,33.3,2019,24067
383,17,133,533,71.86,3.19,24.95,2019,24076
199,0,36,235,84.68,0.0,15.32,2019,24082
456,12,189,657,69.41,1.83,28.77,2019,24120
454,35,182,671,67.66,5.22,27.12,2019,24122
46,0,105,151,30.46,0.0,69.54,2019,24132
437,8,67,512,85.35,1.56,13.09,2019,24147
246,0,131,377,65.25,0.0,34.75,2019,24150
530,0,57,587,90.29,0.0,9.71,2019,24176
581,175,353,1109,52.39,15.78,31.83,2019,24216
486,100,468,1054,46.11,9.49,44.4,2019,24248
142,31,111,284,50.0,10.92,39.08,2019,24265
217,0,80,297,73.06,0.0,26.94,2019,24270
444,42,282,768,57.81,5.47,36.72,2019,24290
482,59,313,854,56.44,6.91,36.65,2019,24328
237,0,108,345,68.7,0.0,31.3,2019,24374
567,21,133,721,78.64,2.91,18.45,2019,24375
365,3,216,584,62.5,0.51,36.99,2019,24430
20,0,7,27,74.07,0.0,25.93,2019,24433
270,11,54,335,80.6,3.28,16.12,2019,24437
787,6,372,1165,67.55,0.52,31.93,2019,24445
4838,134,1215,6187,78.2,2.17,19.64,2019,24450
16,0,112,128,12.5,0.0,87.5,2019,24457
993,54,185,1232,80.6,4.38,15.02,2019,24486
498,29,273,800,62.25,3.62,34.12,2019,24472
204,0,46,250,81.6,0.0,18.4,2019,24484
316,0,56,372,84.95,0.0,15.05,2019,26818
593,56,259,908,65.31,6.17,28.52,2019,42087
625,42,248,915,68.31,4.59,27.1,2019,42120
14374,328,1498,16200,88.73,2.02,9.25,2019,44720
547,34,100,681,80.32,4.99,14.68,2019,44064
19150,379,2774,22303,85.86,1.7,12.44,2019,44077
298,5,120,423,70.45,1.18,28.37,2019,44093
326,72,328,726,44.9,9.92,45.18,2019,44099
7659,357,1744,9760,78.47,3.66,17.87,2019,44113
2674,309,855,3838,69.67,8.05,22.28,2019,44114
5002,172,1176,6350,78.77,2.71,18.52,2019,44132
9297,336,2260,11893,78.17,2.83,19.0,2019,44135
9116,157,1126,10399,87.66,1.51,10.83,2019,44136
698,31,162,891,78.34,3.48,18.18,2019,44215
5667,75,279,6021,94.12,1.25,4.63,2019,44140
5074,97,446,5617,90.33,1.73,7.94,2019,44141
15082,708,1463,17253,87.42,4.1,8.48,2019,44212
6513,209,904,7626,85.41,2.74,11.85,2019,44223
2657,214,137,3008,88.33,7.11,4.55,2019,44233
0,0,0,0,,,,2019,44243
21947,655,1883,24485,89.63,2.68,7.69,2019,44256
1754,155,473,2382,73.64,6.51,19.86,2019,44302
7042,511,2734,10287,68.46,4.97,26.58,2019,44310
1397,48,318,1763,79.24,2.72,18.04,2019,44403
1073,25,126,1224,87.66,2.04,10.29,2019,44429
1217,89,190,1496,81.35,5.95,12.7,2019,44445
5021,88,475,5584,89.92,1.58,8.51,2019,44721
95,0,41,136,69.85,0.0,30.15,2019,44809
1425,19,145,1589,89.68,1.2,9.13,2019,44824
1205,40,187,1432,84.15,2.79,13.06,2019,44847
806,0,152,958,84.13,0.0,15.87,2019,44849
583,23,78,684,85.23,3.36,11.4,2019,44854
735,29,238,1002,73.35,2.89,23.75,2019,44880
2340,83,395,2818,83.04,2.95,14.02,2019,44889
7425,250,1822,9497,78.18,2.63,19.19,2019,44903
5399,351,1588,7338,73.58,4.78,21.64,2019,44906
5655,247,617,6519,86.75,3.79,9.46,2019,44241
960,118,289,1367,70.23,8.63,21.14,2019,44288
1109,109,168,1386,80.01,7.86,12.12,2019,44304
6276,437,2041,8754,71.69,4.99,23.32,2019,44320
5453,170,508,6131,88.94,2.77,8.29,2019,44321
7855,97,710,8662,90.68,1.12,8.2,2019,44406
3348,143,831,4322,77.46,3.31,19.23,2019,44432
540,29,89,658,82.07,4.41,13.53,2019,44441
484,119,41,644,75.16,18.48,6.37,2019,44443
3363,88,821,4272,78.72,2.06,19.22,2019,44444
8360,380,2081,10821,77.26,3.51,19.23,2019,44483
98,80,270,448,21.88,17.86,60.27,2019,44503
673,18,247,938,71.75,1.92,26.33,2019,44510
4740,0,311,5051,93.84,0.0,6.16,2019,44614
6914,189,961,8064,85.74,2.34,11.92,2019,44641
179,8,56,243,73.66,3.29,23.05,2019,44653
2868,72,657,3597,79.73,2.0,18.27,2019,44662
61,0,0,61,100.0,0.0,0.0,2019,44670
79,0,0,79,100.0,0.0,0.0,2019,44671
1392,31,334,1757,79.23,1.76,19.01,2019,44676
2837,103,867,3807,74.52,2.71,22.77,2019,44707
338,3,56,397,85.14,0.76,14.11,2019,44804
726,31,129,886,81.94,3.5,14.56,2019,44807
4169,210,649,5028,82.92,4.18,12.91,2019,44811
3021,165,1517,4703,64.24,3.51,32.26,2019,42642
1704,25,848,2577,66.12,0.97,32.91,2019,42717
965,72,286,1323,72.94,5.44,21.62,2019,42721
155,0,57,212,73.11,0.0,26.89,2019,42722
399,0,231,630,63.33,0.0,36.67,2019,42729
23,0,38,61,37.7,0.0,62.3,2019,42731
526,24,84,634,82.97,3.79,13.25,2019,42027
142,0,98,240,59.17,0.0,40.83,2019,42028
1313,64,529,1906,68.89,3.36,27.75,2019,42041
601,10,163,774,77.65,1.29,21.06,2019,42048
632,32,368,1032,61.24,3.1,35.66,2019,42050
448,18,123,589,76.06,3.06,20.88,2019,42079
1403,113,241,1757,79.85,6.43,13.72,2019,42086
4347,155,1699,6201,70.1,2.5,27.4,2019,42164
10175,481,1672,12328,82.54,3.9,13.56,2019,42071
1571,90,240,1901,82.64,4.73,12.62,2019,42122
471,1,128,600,78.5,0.17,21.33,2019,42159
489,6,129,624,78.37,0.96,20.67,2019,42160
757,15,177,949,79.77,1.58,18.65,2019,42166
1368,115,596,2079,65.8,5.53,28.67,2019,42206
1486,118,943,2547,58.34,4.63,37.02,2019,42220
298,10,105,413,72.15,2.42,25.42,2019,42259
2897,51,1213,4161,69.62,1.23,29.15,2019,42261
706,0,185,891,79.24,0.0,20.76,2019,42274
14,0,0,14,100.0,0.0,0.0,2019,42338
1810,36,532,2378,76.11,1.51,22.37,2019,42347
1622,35,375,2032,79.82,1.72,18.45,2019,42366
386,34,122,542,71.22,6.27,22.51,2019,42410
8109,378,2156,10643,76.19,3.55,20.26,2019,42431
9875,248,2151,12274,80.45,2.02,17.52,2019,42141
563,23,344,930,60.54,2.47,36.99,2019,42202
170,0,93,263,64.64,0.0,35.36,2019,42236
1337,18,510,1865,71.69,0.97,27.35,2019,42256
3042,115,110,3267,93.11,3.52,3.37,2019,42262
530,10,235,775,68.39,1.29,30.32,2019,42266
321,19,115,455,70.55,4.18,25.27,2019,42333
594,13,180,787,75.48,1.65,22.87,2019,42337
421,18,194,633,66.51,2.84,30.65,2019,42343
1406,41,362,1809,77.72,2.27,20.01,2019,42348
1845,91,915,2851,64.71,3.19,32.09,2019,42408
217,3,159,379,57.26,0.79,41.95,2019,42440
452,49,159,660,68.48,7.42,24.09,2019,42456
1276,134,355,1765,72.29,7.59,20.11,2019,42459
348,17,69,434,80.18,3.92,15.9,2019,42462
2658,90,958,3706,71.72,2.43,25.85,2019,42539
1581,153,659,2393,66.07,6.39,27.54,2019,42567
2329,69,1585,3983,58.47,1.73,39.79,2019,42602
9,0,4,13,69.23,0.0,30.77,2019,42603
1597,39,571,2207,72.36,1.77,25.87,2019,42629
798,30,487,1315,60.68,2.28,37.03,2019,42635
695,73,614,1382,50.29,5.28,44.43,2019,42647
513,87,259,859,59.72,10.13,30.15,2019,42649
7563,184,2115,9862,76.69,1.87,21.45,2019,42718
400,12,100,512,78.12,2.34,19.53,2019,42733
4040,591,1420,6051,66.77,9.77,23.47,2019,42754
56,0,12,68,82.35,0.0,17.65,2019,42354
652,32,128,812,80.3,3.94,15.76,2019,42355
333,0,125,458,72.71,0.0,27.29,2019,42368
6,0,0,6,100.0,0.0,0.0,2019,42370
489,4,89,582,84.02,0.69,15.29,2019,42049
56,5,16,77,72.73,6.49,20.78,2019,42032
1284,43,555,1882,68.23,2.28,29.49,2019,42038
695,16,220,931,74.65,1.72,23.63,2019,42045
1044,5,274,1323,78.91,0.38,20.71,2019,42055
865,0,75,940,92.02,0.0,7.98,2019,42058
16,0,39,55,29.09,0.0,70.91,2019,42061
2166,104,930,3200,67.69,3.25,29.06,2019,42064
166,0,51,217,76.5,0.0,23.5,2019,42069
17899,479,3029,21407,83.61,2.24,14.15,2019,42101
270,7,142,419,64.44,1.67,33.89,2019,42140
26,0,25,51,50.98,0.0,49.02,2019,42151
405,30,159,594,68.18,5.05,26.77,2019,42170
2235,69,385,2689,83.12,2.57,14.32,2019,42171
1360,28,451,1839,73.95,1.52,24.52,2019,42210
4153,147,220,4520,91.88,3.25,4.87,2019,42223
2212,112,1056,3380,65.44,3.31,31.24,2019,42320
1183,26,314,1523,77.68,1.71,20.62,2019,42327
380,4,146,530,71.7,0.75,27.55,2019,42328
683,18,163,864,79.05,2.08,18.87,2019,42352
1834,66,354,2254,81.37,2.93,15.71,2019,42376
926,23,258,1207,76.72,1.91,21.38,2019,42378
327,35,77,439,74.49,7.97,17.54,2019,42436
453,5,144,602,75.25,0.83,23.92,2019,42528
157,0,85,242,64.88,0.0,35.12,2019,42541
1456,137,583,2176,66.91,6.3,26.79,2019,42553
25,0,0,25,100.0,0.0,0.0,2019,42638
68,0,48,116,58.62,0.0,41.38,2019,42715
471,74,116,661,71.26,11.2,17.55,2019,42716
587,19,122,728,80.63,2.61,16.76,2019,42746
178,5,25,208,85.58,2.4,12.02,2019,42154
531,18,481,1030,51.55,1.75,46.7,2019,42234
12212,785,3584,16581,73.65,4.73,21.62,2019,42240
143,4,41,188,76.06,2.13,21.81,2019,42273
3775,95,1836,5706,66.16,1.66,32.18,2019,42276
116,0,30,146,79.45,0.0,20.55,2019,42285
7,0,40,47,14.89,0.0,85.11,2019,42321
183,0,91,274,66.79,0.0,33.21,2019,42323
2459,106,655,3220,76.37,3.29,20.34,2019,42330
449,42,219,710,63.24,5.92,30.85,2019,42372
577,54,281,912,63.27,5.92,30.81,2019,42409
11642,570,3224,15436,75.42,3.69,20.89,2019,42420
468,6,167,641,73.01,0.94,26.05,2019,42441
430,0,96,526,81.75,0.0,18.25,2019,42458
4859,423,1658,6940,70.01,6.1,23.89,2019,42501
834,82,420,1336,62.43,6.14,31.44,2019,42519
90,26,48,164,54.88,15.85,29.27,2019,42566
76,0,0,76,100.0,0.0,0.0,2019,42631
998,98,720,1816,54.96,5.4,39.65,2019,42653
1138,208,483,1829,62.22,11.37,26.41,2019,42726
4213,95,1692,6000,70.22,1.58,28.2,2019,42728
157,14,26,197,79.7,7.11,13.2,2019,42741
224,8,84,316,70.89,2.53,26.58,2019,42753
699,23,179,901,77.58,2.55,19.87,2019,42023
502,0,115,617,81.36,0.0,18.64,2019,42056
495,25,138,658,75.23,3.8,20.97,2019,42021
523,40,294,857,61.03,4.67,34.31,2019,42081
92,0,62,154,59.74,0.0,40.26,2019,42371
15205,371,2854,18430,82.5,2.01,15.49,2019,42301
13630,206,2173,16009,85.14,1.29,13.57,2019,42303
1374,31,242,1647,83.42,1.88,14.69,2019,42351
863,47,341,1251,68.98,3.76,27.26,2019,42442
3276,85,996,4357,75.19,1.95,22.86,2019,42445
213,0,142,355,60.0,0.0,40.0,2019,42451
167,0,109,276,60.51,0.0,39.49,2019,42565
4942,130,2740,7812,63.26,1.66,35.07,2019,42633
16116,1227,3081,20424,78.91,6.01,15.09,2019,42701
370,9,198,577,64.12,1.56,34.32,2019,42712
1421,53,778,2252,63.1,2.35,34.55,2019,42765
127,0,88,215,59.07,0.0,40.93,2019,42204
50,0,16,66,75.76,0.0,24.24,2019,42254
315,46,117,478,65.9,9.62,24.48,2019,42324
133,8,0,141,94.33,5.67,0.0,2019,42326
10593,268,2013,12874,82.28,2.08,15.64,2019,42001
459,30,139,628,73.09,4.78,22.13,2019,42133
640,48,261,949,67.44,5.06,27.5,2019,42784
112,0,22,134,83.58,0.0,16.42,2019,42788
180,7,143,330,54.55,2.12,43.33,2019,42265
1371,32,231,1634,83.9,1.96,14.14,2019,42044
7741,300,752,8793,88.04,3.41,8.55,2019,42103
659,20,279,958,68.79,2.09,29.12,2019,42088
3849,222,1406,5477,70.28,4.05,25.67,2019,42211
83,0,48,131,63.36,0.0,36.64,2019,42374
17,0,13,30,56.67,0.0,43.33,2019,42037
84,0,22,106,79.25,0.0,20.75,2019,42102
14,0,0,14,100.0,0.0,0.0,2019,42124
103,0,0,103,100.0,0.0,0.0,2019,42130
114,0,30,144,79.17,0.0,20.83,2019,42156
49,0,0,49,100.0,0.0,0.0,2019,42163
0,0,36,36,0.0,0.0,100.0,2019,42322
0,0,0,0,,,,2019,42356
208,2,80,290,71.72,0.69,27.59,2019,42367
22,0,12,34,64.71,0.0,35.29,2019,42758
183,6,123,312,58.65,1.92,39.42,2019,42764
523,52,201,776,67.4,6.7,25.9,2019,42078
71,0,31,102,69.61,0.0,30.39,2019,42083
19,0,4,23,82.61,0.0,17.39,2019,42084
321,3,46,370,86.76,0.81,12.43,2019,42085
18,0,85,103,17.48,0.0,82.52,2019,42332
243,0,29,272,89.34,0.0,10.66,2019,42344
327,13,123,463,70.63,2.81,26.57,2019,42349
469,26,114,609,77.01,4.27,18.72,2019,42350
83,7,101,191,43.46,3.66,52.88,2019,42361
698,15,202,915,76.28,1.64,22.08,2019,42404
1024,27,309,1360,75.29,1.99,22.72,2019,42406
985,16,202,1203,81.88,1.33,16.79,2019,42413
1059,72,434,1565,67.67,4.6,27.73,2019,42450
706,26,141,873,80.87,2.98,16.15,2019,42452
339,34,127,500,67.8,6.8,25.4,2019,42461
775,37,310,1122,69.07,3.3,27.63,2019,42518
200,12,95,307,65.15,3.91,30.94,2019,42533
2535,81,901,3517,72.08,2.3,25.62,2019,42743
2459,362,631,3452,71.23,10.49,18.28,2019,42748
1589,134,502,2225,71.42,6.02,22.56,2019,42749
30,0,14,44,68.18,0.0,31.82,2019,42762
9313,272,2330,11915,78.16,2.28,19.56,2019,42003
2057,60,452,2569,80.07,2.34,17.59,2019,42029
750,46,295,1091,68.74,4.22,27.04,2019,42031
393,12,62,467,84.15,2.57,13.28,2019,42036
280,12,75,367,76.29,3.27,20.44,2019,42040
835,0,385,1220,68.44,0.0,31.56,2019,42051
416,9,98,523,79.54,1.72,18.74,2019,42076
464,27,141,632,73.42,4.27,22.31,2019,42082
12149,652,1125,13926,87.24,4.68,8.08,2019,42104
553,75,61,689,80.26,10.89,8.85,2019,42732
693,42,88,823,84.2,5.1,10.69,2019,42740
862,26,270,1158,74.44,2.25,23.32,2019,42757
714,42,133,889,80.31,4.72,14.96,2019,42776
262,20,135,417,62.83,4.8,32.37,2019,42782
326,0,50,376,86.7,0.0,13.3,2019,42035
259,0,20,279,92.83,0.0,7.17,2019,42123
133,7,11,151,88.08,4.64,7.28,2019,42153
2600,112,776,3488,74.54,3.21,22.25,2019,42167
287,13,47,347,82.71,3.75,13.54,2019,42232
98,0,43,141,69.5,0.0,30.5,2019,42280
256,8,179,443,57.79,1.81,40.41,2019,42286
608,12,232,852,71.36,1.41,27.23,2019,42325
258,0,63,321,80.37,0.0,19.63,2019,42339
3154,85,962,4201,75.08,2.02,22.9,2019,42345
71,6,25,102,69.61,5.88,24.51,2019,42369
447,33,189,669,66.82,4.93,28.25,2019,42411
2081,75,652,2808,74.11,2.67,23.22,2019,42437
191,1,40,232,82.33,0.43,17.24,2019,42453
801,66,299,1166,68.7,5.66,25.64,2019,42455
519,10,156,685,75.77,1.46,22.77,2019,42464
7235,328,1735,9298,77.81,3.53,18.66,2019,42503
130,0,71,201,64.68,0.0,35.32,2019,42516
1649,177,550,2376,69.4,7.45,23.15,2019,42544
569,22,208,799,71.21,2.75,26.03,2019,42713
255,0,68,323,78.95,0.0,21.05,2019,42054
0,0,0,0,,,,2019,42060
6728,331,2086,9145,73.57,3.62,22.81,2019,42066
1910,123,501,2534,75.37,4.85,19.77,2019,42127
6363,220,1463,8046,79.08,2.73,18.18,2019,42025
522,78,97,697,74.89,11.19,13.92,2019,42039
1647,47,369,2063,79.84,2.28,17.89,2019,42053
338,27,164,529,63.89,5.1,31.0,2019,42634
55,4,13,72,76.39,5.56,18.06,2019,47982
1367,40,315,1722,79.38,2.32,18.29,2019,47987
592,34,102,728,81.32,4.67,14.01,2019,47990
36,3,13,52,69.23,5.77,25.0,2019,47997
864,69,247,1180,73.22,5.85,20.93,2019,47368
48,1,9,58,82.76,1.72,15.52,2019,47381
346,6,121,473,73.15,1.27,25.58,2019,47451
3491,92,1165,4748,73.53,1.94,24.54,2019,47460
1525,0,241,1766,86.35,0.0,13.65,2019,47462
319,4,109,432,73.84,0.93,25.23,2019,47516
1836,71,283,2190,83.84,3.24,12.92,2019,47610
225,2,82,309,72.82,0.65,26.54,2019,47612
522,33,170,725,72.0,4.55,23.45,2019,47619
621,29,93,743,83.58,3.9,12.52,2019,47970
337,9,29,375,89.87,2.4,7.73,2019,47981
89,27,0,116,76.72,23.28,0.0,2019,47983
1522,87,340,1949,78.09,4.46,17.44,2019,47243
214,21,36,271,78.97,7.75,13.28,2019,47280
41,1,15,57,71.93,1.75,26.32,2019,47337
168,0,39,207,81.16,0.0,18.84,2019,47846
44,3,6,53,83.02,5.66,11.32,2019,47853
177,25,52,254,69.69,9.84,20.47,2019,47854
922,33,338,1293,71.31,2.55,26.14,2019,47868
1569,173,388,2130,73.66,8.12,18.22,2019,47901
20794,2308,1203,24305,85.55,9.5,4.95,2019,47906
301,9,69,379,79.42,2.37,18.21,2019,47921
1812,78,290,2180,83.12,3.58,13.3,2019,47932
575,15,65,655,87.79,2.29,9.92,2019,47940
7432,174,1232,8838,84.09,1.97,13.94,2019,47546
7381,112,1059,8552,86.31,1.31,12.38,2019,47025
426,0,108,534,79.78,0.0,20.22,2019,47141
970,56,157,1183,81.99,4.73,13.27,2019,47232
3239,84,246,3569,90.75,2.35,6.89,2019,47429
412,12,109,533,77.3,2.25,20.45,2019,47611
521,0,7,528,98.67,0.0,1.33,2019,47992
1648,113,514,2275,72.44,4.97,22.59,2019,47040
891,0,304,1195,74.56,0.0,25.44,2019,47161
14338,420,4139,18897,75.87,2.22,21.9,2019,47150
6889,477,1783,9149,75.3,5.21,19.49,2019,47250
10921,315,1854,13090,83.43,2.41,14.16,2019,47711
6020,136,365,6521,92.32,2.09,5.6,2019,47725
11211,364,1885,13460,83.29,2.7,14.0,2019,47802
281,20,162,463,60.69,4.32,34.99,2019,47837
162,0,90,252,64.29,0.0,35.71,2019,47858
18,0,0,18,100.0,0.0,0.0,2019,47865
136,2,24,162,83.95,1.23,14.81,2019,47917
53,0,8,61,86.89,0.0,13.11,2019,47925
704,21,114,839,83.91,2.5,13.59,2019,47963
228,8,48,284,80.28,2.82,16.9,2019,47967
395,9,116,520,75.96,1.73,22.31,2019,47974
3442,77,724,4243,81.12,1.81,17.06,2019,47978
886,29,312,1227,72.21,2.36,25.43,2019,47283
8408,546,2175,11129,75.55,4.91,19.54,2019,47362
1456,30,326,1812,80.35,1.66,17.99,2019,47106
4027,84,810,4921,81.83,1.71,16.46,2019,47670
415,7,72,494,84.01,1.42,14.57,2019,47930
1204,6,193,1403,85.82,0.43,13.76,2019,47665
1880,49,970,2899,64.85,1.69,33.46,2019,47872
25,0,17,42,59.52,0.0,40.48,2019,47123
195,0,59,254,76.77,0.0,23.23,2019,68407
91,8,13,112,81.25,7.14,11.61,2019,68437
146,1,98,245,59.59,0.41,40.0,2019,68447
251,11,27,289,86.85,3.81,9.34,2019,68460
660,3,207,870,75.86,0.34,23.79,2019,68465
9496,299,1355,11150,85.17,2.68,12.15,2019,68502
490,0,7,497,98.59,0.0,1.41,2019,68523
224,0,0,224,100.0,0.0,0.0,2019,68532
119,15,69,203,58.62,7.39,33.99,2019,68621
32,0,26,58,55.17,0.0,44.83,2019,58353
79,9,25,113,69.91,7.96,22.12,2019,58361
34,4,5,43,79.07,9.3,11.63,2019,58372
44,5,8,57,77.19,8.77,14.04,2019,58386
6018,251,1360,7629,78.88,3.29,17.83,2019,58401
47,2,6,55,85.45,3.64,10.91,2019,58431
335,18,129,482,69.5,3.73,26.76,2019,58433
93,11,34,138,67.39,7.97,24.64,2019,58454
95,0,19,114,83.33,0.0,16.67,2019,58532
68,4,43,115,59.13,3.48,37.39,2019,58542
154,0,66,220,70.0,0.0,30.0,2019,58568
296,22,83,401,73.82,5.49,20.7,2019,58576
103,7,12,122,84.43,5.74,9.84,2019,58581
83,0,3,86,96.51,0.0,3.49,2019,58634
313,21,29,363,86.23,5.79,7.99,2019,58636
411,26,87,524,78.44,4.96,16.6,2019,58638
194,2,58,254,76.38,0.79,22.83,2019,58651
37,1,25,63,58.73,1.59,39.68,2019,58716
92,0,5,97,94.85,0.0,5.15,2019,58756
222,50,62,334,66.47,14.97,18.56,2019,58759
337,4,33,374,90.11,1.07,8.82,2019,58761
99,0,16,115,86.09,0.0,13.91,2019,58768
32,4,9,45,71.11,8.89,20.0,2019,58778
431,18,77,526,81.94,3.42,14.64,2019,58785
41,21,18,80,51.25,26.25,22.5,2019,58795
29,0,6,35,82.86,0.0,17.14,2019,58844
186,16,40,242,76.86,6.61,16.53,2019,58571
191,5,75,271,70.48,1.85,27.68,2019,58573
52,0,6,58,89.66,0.0,10.34,2019,58620
193,6,28,227,85.02,2.64,12.33,2019,58655
455,38,161,654,69.57,5.81,24.62,2019,58621
127,5,32,164,77.44,3.05,19.51,2019,58626
289,8,24,321,90.03,2.49,7.48,2019,58653
1445,35,14,1494,96.72,2.34,0.94,2019,58704
40,6,10,56,71.43,10.71,17.86,2019,58744
116,6,3,125,92.8,4.8,2.4,2019,58752
55,0,37,92,59.78,0.0,40.22,2019,58776
596,19,116,731,81.53,2.6,15.87,2019,58790
209,5,45,259,80.69,1.93,17.37,2019,58030
124,0,17,141,87.94,0.0,12.06,2019,58038
473,8,152,633,74.72,1.26,24.01,2019,58041
152,10,34,196,77.55,5.1,17.35,2019,58064
147,0,16,163,90.18,0.0,9.82,2019,58079
284,9,50,343,82.8,2.62,14.58,2019,58081
116,4,27,147,78.91,2.72,18.37,2019,58214
227,7,38,272,83.46,2.57,13.97,2019,58230
213,5,82,300,71.0,1.67,27.33,2019,58243
335,94,194,623,53.77,15.09,31.14,2019,58730
117,7,5,129,90.7,5.43,3.88,2019,58733
196,6,42,244,80.33,2.46,17.21,2019,58736
2305,50,258,2613,88.21,1.91,9.87,2019,44081
7619,127,920,8666,87.92,1.47,10.62,2019,44087
6611,189,1030,7830,84.43,2.41,13.15,2019,44092
4710,527,3740,8977,52.47,5.87,41.66,2019,44104
5469,455,3392,9316,58.71,4.88,36.41,2019,44108
11577,486,4033,16096,71.92,3.02,25.06,2019,44120
11341,289,2193,13823,82.04,2.09,15.86,2019,44121
6315,104,680,7099,88.96,1.46,9.58,2019,44126
11223,236,1400,12859,87.28,1.84,10.89,2019,44133
12432,198,1179,13809,90.03,1.43,8.54,2019,44145
7146,45,484,7675,93.11,0.59,6.31,2019,44147
6888,126,706,7720,89.22,1.63,9.15,2019,44202
1695,76,366,2137,79.32,3.56,17.13,2019,44254
2188,218,703,3109,70.38,7.01,22.61,2019,44255
1549,45,134,1728,89.64,2.6,7.75,2019,44280
2093,29,187,2309,90.65,1.26,8.1,2019,44286
5515,224,1208,6947,79.39,3.22,17.39,2019,44833
10123,255,2283,12661,79.95,2.01,18.03,2019,44805
864,34,96,994,86.92,3.42,9.66,2019,44814
5995,257,1254,7506,79.87,3.42,16.71,2019,44820
34,0,0,34,100.0,0.0,0.0,2019,44828
1019,123,474,1616,63.06,7.61,29.33,2019,44837
78,0,19,97,80.41,0.0,19.59,2019,44838
798,50,214,1062,75.14,4.71,20.15,2019,44865
684,8,311,1003,68.2,0.8,31.01,2019,44878
219,31,86,336,65.18,9.23,25.6,2019,44887
4704,109,921,5734,82.04,1.9,16.06,2019,44904
6353,114,273,6740,94.26,1.69,4.05,2019,44022
3781,69,529,4379,86.34,1.58,12.08,2019,44026
44,0,57,101,43.56,0.0,56.44,2019,44080
655,5,233,893,73.35,0.56,26.09,2019,44836
1484,58,325,1867,79.49,3.11,17.41,2019,44851
62,0,63,125,49.6,0.0,50.4,2019,44856
587,63,155,805,72.92,7.83,19.25,2019,44866
1223,85,644,1952,62.65,4.35,32.99,2019,44902
6026,160,518,6704,89.89,2.39,7.73,2019,44023
3207,222,414,3843,83.45,5.78,10.77,2019,44074
967,30,148,1145,84.45,2.62,12.93,2019,44084
9984,424,5019,15427,64.72,2.75,32.53,2019,44105
7818,783,2553,11154,70.09,7.02,22.89,2019,44106
21217,647,2917,24781,85.62,2.61,11.77,2019,44107
12521,804,3954,17279,72.46,4.65,22.88,2019,44109
2368,331,1352,4051,58.45,8.17,33.37,2019,44115
2976,305,1742,5023,59.25,6.07,34.68,2019,44117
881,58,64,1003,87.84,5.78,6.38,2019,44666
3174,94,598,3866,82.1,2.43,15.47,2019,44710
8157,201,909,9267,88.02,2.17,9.81,2019,44138
1147,11,204,1362,84.21,0.81,14.98,2019,44217
14771,446,2072,17289,85.44,2.58,11.98,2019,44124
9030,279,1445,10754,83.97,2.59,13.44,2019,44143
622,71,184,877,70.92,8.1,20.98,2019,47227
29,0,17,46,63.04,0.0,36.96,2019,47467
87,13,54,154,56.49,8.44,35.06,2019,47525
383,2,141,526,72.81,0.38,26.81,2019,47637
1916,24,597,2537,75.52,0.95,23.53,2019,47918
1288,19,315,1622,79.41,1.17,19.42,2019,47433
208,0,32,240,86.67,0.0,13.33,2019,47535
1601,66,506,2173,73.68,3.04,23.29,2019,47635
312,3,161,476,65.55,0.63,33.82,2019,47989
440,29,134,603,72.97,4.81,22.22,2019,47369
898,22,229,1149,78.15,1.91,19.93,2019,47952
0,0,0,0,,,,2019,47104
102,0,13,115,88.7,0.0,11.3,2019,47110
0,0,4,4,0.0,0.0,100.0,2019,47306
42,13,11,66,63.64,19.7,16.67,2019,47324
225,27,71,323,69.66,8.36,21.98,2019,47335
33,0,11,44,75.0,0.0,25.0,2019,47367
94,10,21,125,75.2,8.0,16.8,2019,47388
0,0,0,0,,,,2019,47405
0,0,0,0,,,,2019,47434
59,0,28,87,67.82,0.0,32.18,2019,47437
60,0,0,60,100.0,0.0,0.0,2019,47457
19,0,0,19,100.0,0.0,0.0,2019,47458
0,0,0,0,,,,2019,47809
104,0,31,135,77.04,0.0,22.96,2019,47857
77,0,0,77,100.0,0.0,0.0,2019,47869
97,3,25,125,77.6,2.4,20.0,2019,47871
20,0,20,40,50.0,0.0,50.0,2019,47880
0,0,0,0,,,,2019,47907
70,6,22,98,71.43,6.12,22.45,2019,47382
75,0,29,104,72.12,0.0,27.88,2019,47522
75,0,0,75,100.0,0.0,0.0,2019,47574
12560,129,1347,14036,89.48,0.92,9.6,2019,47630
4352,159,629,5140,84.67,3.09,12.24,2019,47805
0,0,0,0,,,,2019,47536
262,14,74,350,74.86,4.0,21.14,2019,47537
175,2,112,289,60.55,0.69,38.75,2019,47568
117,0,22,139,84.17,0.0,15.83,2019,47576
204,4,59,267,76.4,1.5,22.1,2019,47588
187,0,77,264,70.83,0.0,29.17,2019,47590
28,0,7,35,80.0,0.0,20.0,2019,47596
77,0,9,86,89.53,0.0,10.47,2019,47616
1368,46,285,1699,80.52,2.71,16.77,2019,47648
85,2,2,89,95.51,2.25,2.25,2019,47683
156,6,26,188,82.98,3.19,13.83,2019,47708
266,13,143,422,63.03,3.08,33.89,2019,47443
2303,81,408,2792,82.49,2.9,14.61,2019,47396
11932,646,1544,14122,84.49,4.57,10.93,2019,47403
1407,22,507,1936,72.68,1.14,26.19,2019,47432
1392,53,548,1993,69.84,2.66,27.5,2019,47452
66,5,16,87,75.86,5.75,18.39,2019,47464
419,18,234,671,62.44,2.68,34.87,2019,47470
185,37,90,312,59.29,11.86,28.85,2019,47036
2020,76,219,2315,87.26,3.28,9.46,2019,47060
167,0,117,284,58.8,0.0,41.2,2019,47120
1140,18,428,1586,71.88,1.13,26.99,2019,47136
856,5,204,1065,80.38,0.47,19.15,2019,47959
34,0,12,46,73.91,0.0,26.09,2019,47964
363,11,30,404,89.85,2.72,7.43,2019,47968
123,5,17,145,84.83,3.45,11.72,2019,58063
10687,1122,1557,13366,79.96,8.39,11.65,2019,58102
656,26,36,718,91.36,3.62,5.01,2019,58204
148,34,82,264,56.06,12.88,31.06,2019,58212
657,8,257,922,71.26,0.87,27.87,2019,58220
27,2,9,38,71.05,5.26,23.68,2019,58229
68,0,38,106,64.15,0.0,35.85,2019,58250
412,5,151,568,72.54,0.88,26.58,2019,58267
191,0,87,278,68.71,0.0,31.29,2019,58271
50,0,8,58,86.21,0.0,13.79,2019,57475
170,0,17,187,90.91,0.0,9.09,2019,57476
82,6,19,107,76.64,5.61,17.76,2019,57534
41,0,23,64,64.06,0.0,35.94,2019,57547
525,57,207,789,66.54,7.22,26.24,2019,57551
312,9,86,407,76.66,2.21,21.13,2019,57564
367,37,183,587,62.52,6.3,31.18,2019,57567
40,0,0,40,100.0,0.0,0.0,2019,57574
289,3,82,374,77.27,0.8,21.93,2019,57319
193,24,199,416,46.39,5.77,47.84,2019,57339
84,1,33,118,71.19,0.85,27.97,2019,57340
410,11,91,512,80.08,2.15,17.77,2019,57345
37,3,9,49,75.51,6.12,18.37,2019,57337
44,0,12,56,78.57,0.0,21.43,2019,57341
4536,242,1567,6345,71.49,3.81,24.7,2019,57350
215,11,33,259,83.01,4.25,12.74,2019,57365
670,44,217,931,71.97,4.73,23.31,2019,57366
666,55,287,1008,66.07,5.46,28.47,2019,57369
53,0,18,71,74.65,0.0,25.35,2019,57371
192,0,54,246,78.05,0.0,21.95,2019,57373
180,1,15,196,91.84,0.51,7.65,2019,57434
368,14,126,508,72.44,2.76,24.8,2019,57438
118,2,55,175,67.43,1.14,31.43,2019,57440
171,6,40,217,78.8,2.76,18.43,2019,57450
220,9,36,265,83.02,3.4,13.58,2019,57454
150,1,13,164,91.46,0.61,7.93,2019,57461
37,16,33,86,43.02,18.6,38.37,2019,57473
58,0,7,65,89.23,0.0,10.77,2019,57474
47,0,3,50,94.0,0.0,6.0,2019,57477
13,9,42,64,20.31,14.06,65.62,2019,57521
116,2,21,139,83.45,1.44,15.11,2019,57529
195,10,285,490,39.8,2.04,58.16,2019,57572
44,2,19,65,67.69,3.08,29.23,2019,57585
632,9,528,1169,54.06,0.77,45.17,2019,57625
16,0,31,47,34.04,0.0,65.96,2019,57636
2197,75,355,2627,83.63,2.85,13.51,2019,57747
727,34,207,968,75.1,3.51,21.38,2019,57430
170,9,19,198,85.86,4.55,9.6,2019,57433
162,22,43,227,71.37,9.69,18.94,2019,57471
214,3,15,232,92.24,1.29,6.47,2019,57479
48,0,2,50,96.0,0.0,4.0,2019,57531
99,4,33,136,72.79,2.94,24.26,2019,57536
24,0,0,24,100.0,0.0,0.0,2019,57540
227,15,157,399,56.89,3.76,39.35,2019,57548
52,0,0,52,100.0,0.0,0.0,2019,57553
562,77,584,1223,45.95,6.3,47.75,2019,57555
25,0,0,25,100.0,0.0,0.0,2019,57562
5,0,0,5,100.0,0.0,0.0,2019,57571
170,2,35,207,82.13,0.97,16.91,2019,57620
36,3,32,71,50.7,4.23,45.07,2019,57621
7389,335,1872,9596,77.0,3.49,19.51,2019,44144
11247,170,1909,13326,84.4,1.28,14.33,2019,44221
3070,67,381,3518,87.27,1.9,10.83,2019,44230
420,40,138,598,70.23,6.69,23.08,2019,44235
8339,311,517,9167,90.97,3.39,5.64,2019,44236
13244,1420,1670,16334,81.08,8.69,10.22,2019,44240
1697,106,248,2051,82.74,5.17,12.09,2019,44262
2877,137,479,3493,82.36,3.92,13.71,2019,44270
3137,54,413,3604,87.04,1.5,11.46,2019,44303
5602,299,1287,7188,77.94,4.16,17.9,2019,44622
490,34,1113,1637,29.93,2.08,67.99,2019,44627
204,12,127,343,59.48,3.5,37.03,2019,44628
767,23,182,972,78.91,2.37,18.72,2019,44629
3181,75,391,3647,87.22,2.06,10.72,2019,44632
16646,371,2369,19386,85.87,1.91,12.22,2019,44646
3349,62,556,3967,84.42,1.56,14.02,2019,44657
1470,69,407,1946,75.54,3.55,20.91,2019,44672
430,48,147,625,68.8,7.68,23.52,2019,44695
339,17,49,405,83.7,4.2,12.1,2019,44802
199,14,72,285,69.82,4.91,25.26,2019,44815
743,11,164,918,80.94,1.2,17.86,2019,44818
4308,290,641,5239,82.23,5.54,12.24,2019,44839
810,38,103,951,85.17,4.0,10.83,2019,44840
462,17,80,559,82.65,3.04,14.31,2019,44853
7883,224,1369,9476,83.19,2.36,14.45,2019,44857
4506,303,1078,5887,76.54,5.15,18.31,2019,44875
7597,199,312,8108,93.7,2.45,3.85,2019,44011
1596,0,700,2296,69.51,0.0,30.49,2019,44021
2861,110,333,3304,86.59,3.33,10.08,2019,44028
6207,451,1504,8162,76.05,5.53,18.43,2019,44053
4107,94,409,4610,89.09,2.04,8.87,2019,44056
6380,104,1027,7511,84.94,1.38,13.67,2019,44057
1835,19,1999,3853,47.63,0.49,51.88,2019,44062
2430,109,766,3305,73.52,3.3,23.18,2019,44405
6393,200,972,7565,84.51,2.64,12.85,2019,44410
2309,142,424,2875,80.31,4.94,14.75,2019,44413
5039,540,1103,6682,75.41,8.08,16.51,2019,44420
1318,125,346,1789,73.67,6.99,19.34,2019,44437
1182,53,216,1451,81.46,3.65,14.89,2019,44473
2684,176,919,3779,71.02,4.66,24.32,2019,44502
511,34,184,729,70.1,4.66,25.24,2019,44611
635,24,139,798,79.57,3.01,17.42,2019,44613
1453,29,279,1761,82.51,1.65,15.84,2019,44621
940,35,133,1108,84.84,3.16,12.0,2019,44626
879,41,210,1130,77.79,3.63,18.58,2019,44656
8157,303,2218,10678,76.39,2.84,20.77,2019,44663
1431,27,297,1755,81.54,1.54,16.92,2019,44680
1587,112,866,2565,61.87,4.37,33.76,2019,44681
5643,232,1201,7076,79.75,3.28,16.97,2019,44706
7009,253,1139,8401,83.43,3.01,13.56,2019,44709
1183,28,249,1460,81.03,1.92,17.05,2019,47993
914,7,113,1034,88.39,0.68,10.93,2019,47143
1097,30,646,1773,61.87,1.69,36.44,2019,47164
4082,194,1736,6012,67.9,3.23,28.88,2019,47167
307,0,142,449,68.37,0.0,31.63,2019,47223
917,7,261,1185,77.38,0.59,22.03,2019,47229
468,9,103,580,80.69,1.55,17.76,2019,47234
1138,45,450,1633,69.69,2.76,27.56,2019,47246
345,0,172,517,66.73,0.0,33.27,2019,47264
1690,73,519,2282,74.06,3.2,22.74,2019,48726
2806,58,456,3320,84.52,1.75,13.73,2019,48734
632,10,155,797,79.3,1.25,19.45,2019,48741
1149,137,479,1765,65.1,7.76,27.14,2019,48744
213,31,117,361,59.0,8.59,32.41,2019,48754
1217,95,247,1559,78.06,6.09,15.84,2019,48757
3795,267,1030,5092,74.53,5.24,20.23,2019,48801
441,31,174,646,68.27,4.8,26.93,2019,48806
752,38,113,903,83.28,4.21,12.51,2019,48815
764,39,219,1022,74.76,3.82,21.43,2019,48818
487,5,97,589,82.68,0.85,16.47,2019,48832
1155,45,496,1696,68.1,2.65,29.25,2019,48850
194,30,159,383,50.65,7.83,41.51,2019,48856
505,10,57,572,88.29,1.75,9.97,2019,48861
1478,65,302,1845,80.11,3.52,16.37,2019,48866
3912,164,435,4511,86.72,3.64,9.64,2019,48895
54,0,28,82,65.85,0.0,34.15,2019,48896
1110,3,348,1461,75.98,0.21,23.82,2019,48933
13995,318,2396,16709,83.76,1.9,14.34,2019,48706
3959,138,592,4689,84.43,2.94,12.63,2019,48653
423,67,160,650,65.08,10.31,24.62,2019,48662
1115,53,317,1485,75.08,3.57,21.35,2019,48703
2224,98,330,2652,83.86,3.7,12.44,2019,48872
7034,242,928,8204,85.74,2.95,11.31,2019,48837
5194,173,473,5840,88.94,2.96,8.1,2019,48840
1705,67,520,2292,74.39,2.92,22.69,2019,48847
3384,133,391,3908,86.59,3.4,10.01,2019,48875
1810,79,634,2523,71.74,3.13,25.13,2019,48880
1771,20,352,2143,82.64,0.93,16.43,2019,48881
11983,852,5364,18199,65.84,4.68,29.47,2019,48235
10121,268,897,11286,89.68,2.37,7.95,2019,48236
5106,92,303,5501,92.82,1.67,5.51,2019,48301
5821,106,285,6212,93.71,1.71,4.59,2019,48302
11797,246,1241,13284,88.81,1.85,9.34,2019,48313
7164,212,920,8296,86.35,2.56,11.09,2019,48314
8486,250,913,9649,87.95,2.59,9.46,2019,48326
9632,363,1266,11261,85.53,3.22,11.24,2019,48328
4678,166,1717,6561,71.3,2.53,26.17,2019,48342
2216,73,259,2548,86.97,2.86,10.16,2019,48353
1358,74,457,1889,71.89,3.92,24.19,2019,48416
8532,168,1346,10046,84.93,1.67,13.4,2019,48433
390,22,87,499,78.16,4.41,17.43,2019,48454
2652,103,322,3077,86.19,3.35,10.46,2019,48455
5692,438,1725,7855,72.46,5.58,21.96,2019,48458
447,33,147,627,71.29,5.26,23.44,2019,48466
393,17,133,543,72.38,3.13,24.49,2019,48468
3172,42,571,3785,83.8,1.11,15.09,2019,48509
2303,27,609,2939,78.36,0.92,20.72,2019,48519
9437,268,2587,12292,76.77,2.18,21.05,2019,48602
409,13,300,722,56.65,1.8,41.55,2019,48607
51,0,11,62,82.26,0.0,17.74,2019,57645
58,0,18,76,76.32,0.0,23.68,2019,57657
96,0,22,118,81.36,0.0,18.64,2019,57725
393,28,156,577,68.11,4.85,27.04,2019,57735
66,0,33,99,66.67,0.0,33.33,2019,57748
105,29,36,170,61.76,17.06,21.18,2019,57788
0,0,0,0,,,,2019,57799
317,40,64,421,75.3,9.5,15.2,2019,57790
45,0,6,51,88.24,0.0,11.76,2019,57766
480,47,132,659,72.84,7.13,20.03,2019,66968
307,23,73,403,76.18,5.71,18.11,2019,66770
32,3,23,58,55.17,5.17,39.66,2019,66870
339,23,149,511,66.34,4.5,29.16,2019,66956
2946,57,61,3064,96.15,1.86,1.99,2019,66085
8446,223,552,9221,91.6,2.42,5.99,2019,66216
200,0,139,339,59.0,0.0,41.0,2019,66010
0,0,0,0,,,,2019,66031
0,0,0,0,,,,2019,66045
0,0,0,0,,,,2019,66621
0,0,0,0,,,,2019,66622
17,0,8,25,68.0,0.0,32.0,2019,66728
80,7,28,115,69.57,6.09,24.35,2019,66873
216,19,42,277,77.98,6.86,15.16,2019,65580
58,0,21,79,73.42,0.0,26.58,2019,65618
493,99,261,853,57.8,11.61,30.6,2019,65647
470,107,550,1127,41.7,9.49,48.8,2019,65745
455,14,202,671,67.81,2.09,30.1,2019,65789
129,3,40,172,75.0,1.74,23.26,2019,65321
441,11,63,515,85.63,2.14,12.23,2019,65612
41,0,10,51,80.39,0.0,19.61,2019,65664
125,0,109,234,53.42,0.0,46.58,2019,65755
152,0,81,233,65.24,0.0,34.76,2019,65634
1053,14,320,1387,75.92,1.01,23.07,2019,65704
0,0,0,0,,,,2019,65215
3455,212,336,4003,86.31,5.3,8.39,2019,65584
0,0,45,45,0.0,0.0,100.0,2019,65586
56,2,32,90,62.22,2.22,35.56,2019,65654
2638,171,210,3019,87.38,5.66,6.96,2019,66043
7407,343,708,8458,87.57,4.06,8.37,2019,66047
10629,495,2063,13187,80.6,3.75,15.64,2019,66048
2271,159,312,2742,82.82,5.8,11.38,2019,66053
847,12,120,979,86.52,1.23,12.26,2019,66054
370,10,117,497,74.45,2.01,23.54,2019,66060
4732,419,914,6065,78.02,6.91,15.07,2019,66103
4187,219,755,5161,81.13,4.24,14.63,2019,66112
8579,134,421,9134,93.92,1.47,4.61,2019,66208
4600,47,44,4691,98.06,1.0,0.94,2019,66224
414,4,105,523,79.16,0.76,20.08,2019,66411
44,0,40,84,52.38,0.0,47.62,2019,66412
74,13,47,134,55.22,9.7,35.07,2019,66432
50,5,0,55,90.91,9.09,0.0,2019,66438
537,16,103,656,81.86,2.44,15.7,2019,66451
48,0,1,49,97.96,0.0,2.04,2019,66522
146,18,46,210,69.52,8.57,21.9,2019,66540
278,66,75,419,66.35,15.75,17.9,2019,66546
7008,1174,1681,9863,71.05,11.9,17.04,2019,66604
10531,1474,1922,13927,75.62,10.58,13.8,2019,66614
545,22,199,766,71.15,2.87,25.98,2019,66712
368,21,79,468,78.63,4.49,16.88,2019,66753
3169,226,689,4084,77.6,5.53,16.87,2019,44714
279,21,129,429,65.03,4.9,30.07,2019,45711
744,41,330,1115,66.73,3.68,29.6,2019,45744
332,15,147,494,67.21,3.04,29.76,2019,45766
965,15,299,1279,75.45,1.17,23.38,2019,45786
250,0,192,442,56.56,0.0,43.44,2019,45788
109,0,17,126,86.51,0.0,13.49,2019,45819
911,39,217,1167,78.06,3.34,18.59,2019,45832
20621,586,2585,23792,86.67,2.46,10.86,2019,45840
963,4,148,1115,86.37,0.36,13.27,2019,45845
441,9,66,516,85.47,1.74,12.79,2019,45863
494,14,93,601,82.2,2.33,15.47,2019,45729
1380,25,340,1745,79.08,1.43,19.48,2019,45347
1633,56,402,2091,78.1,2.68,19.23,2019,45381
7344,203,1432,8979,81.79,2.26,15.95,2019,45414
7786,446,3796,12028,64.73,3.71,31.56,2019,45417
5252,206,1347,6805,77.18,3.03,19.79,2019,45426
5574,135,911,6620,84.2,2.04,13.76,2019,45504
4305,142,748,5195,82.87,2.73,14.4,2019,45309
1076,66,230,1372,78.43,4.81,16.76,2019,45369
200,8,117,325,61.54,2.46,36.0,2019,45620
1219,6,315,1540,79.16,0.39,20.45,2019,45653
2166,107,1180,3453,62.73,3.1,34.17,2019,45693
182,5,92,279,65.23,1.79,32.97,2019,45770
585,38,122,745,78.52,5.1,16.38,2019,45873
2199,148,720,3067,71.7,4.83,23.48,2019,45619
1082,82,554,1718,62.98,4.77,32.25,2019,45732
2206,67,278,2551,86.48,2.63,10.9,2019,45817
72,0,0,72,100.0,0.0,0.0,2019,45870
416,18,113,547,76.05,3.29,20.66,2019,45836
111,0,0,111,100.0,0.0,0.0,2019,45384
21610,435,2530,24575,87.93,1.77,10.3,2019,45011
113,4,20,137,82.48,2.92,14.6,2019,45032
59,2,19,80,73.75,2.5,23.75,2019,45070
717,7,297,1021,70.23,0.69,29.09,2019,45101
2389,102,948,3439,69.47,2.97,27.57,2019,45123
1229,35,294,1558,78.88,2.25,18.87,2019,45130
19054,457,1173,20684,92.12,2.21,5.67,2019,45140
891,18,78,987,90.27,1.82,7.9,2019,45162
7406,274,1322,9002,82.27,3.04,14.69,2019,45177
5920,254,1176,7350,80.54,3.46,16.0,2019,45205
4161,200,1577,5938,70.07,3.37,26.56,2019,45206
8198,291,1654,10143,80.82,2.87,16.31,2019,45212
2675,195,993,3863,69.25,5.05,25.71,2019,45216
5462,358,649,6469,84.43,5.53,10.03,2019,45219
3070,164,750,3984,77.06,4.12,18.83,2019,45225
9224,142,704,10070,91.6,1.41,6.99,2019,45241
9084,131,759,9974,91.08,1.31,7.61,2019,45248
0,0,0,0,,,,2019,45051
10,0,0,10,100.0,0.0,0.0,2019,45145
4346,260,607,5213,83.37,4.99,11.64,2019,48609
1426,3,285,1714,83.2,0.18,16.63,2019,48631
1506,53,582,2141,70.34,2.48,27.18,2019,48632
949,40,264,1253,75.74,3.19,21.07,2019,48637
124,0,106,230,53.91,0.0,46.09,2019,48724
424,31,106,561,75.58,5.53,18.89,2019,48738
1457,50,457,1964,74.19,2.55,23.27,2019,48739
629,21,162,812,77.46,2.59,19.95,2019,48748
325,9,127,461,70.5,1.95,27.55,2019,48749
884,100,330,1314,67.28,7.61,25.11,2019,47359
3375,426,995,4796,70.37,8.88,20.75,2019,47371
61,0,13,74,82.43,0.0,17.57,2019,47247
71,4,31,106,66.98,3.77,29.25,2019,47263
8369,486,1633,10488,79.8,4.63,15.57,2019,47303
1203,82,440,1725,69.74,4.75,25.51,2019,47305
1107,35,169,1311,84.44,2.67,12.89,2019,47334
382,16,113,511,74.76,3.13,22.11,2019,47345
220,30,53,303,72.61,9.9,17.49,2019,47352
2652,50,894,3596,73.75,1.39,24.86,2019,47885
9209,281,1801,11291,81.56,2.49,15.95,2019,47933
735,21,180,936,78.53,2.24,19.23,2019,47951
5255,107,1058,6420,81.85,1.67,16.48,2019,47960
208,3,26,237,87.76,1.27,10.97,2019,47965
141,0,23,164,85.98,0.0,14.02,2019,47966
517,58,163,738,70.05,7.86,22.09,2019,47971
846,8,395,1249,67.73,0.64,31.63,2019,47118
3212,60,529,3801,84.5,1.58,13.92,2019,47122
294,1,32,327,89.91,0.31,9.79,2019,47135
3906,303,1466,5675,68.83,5.34,25.83,2019,47170
4977,109,1064,6150,80.93,1.77,17.3,2019,47172
351,9,128,488,71.93,1.84,26.23,2019,47177
8838,177,1327,10342,85.46,1.71,12.83,2019,47203
888,113,317,1318,67.37,8.57,24.05,2019,47336
96,13,94,203,47.29,6.4,46.31,2019,47339
1775,39,405,2219,79.99,1.76,18.25,2019,47356
727,89,223,1039,69.97,8.57,21.46,2019,47373
499,54,172,725,68.83,7.45,23.72,2019,47384
214,4,56,274,78.1,1.46,20.44,2019,47387
15869,778,1099,17746,89.42,4.38,6.19,2019,47401
8179,741,1147,10067,81.25,7.36,11.39,2019,47404
73,0,80,153,47.71,0.0,52.29,2019,47420
1135,55,539,1729,65.64,3.18,31.17,2019,47438
144,3,56,203,70.94,1.48,27.59,2019,47465
554,4,166,724,76.52,0.55,22.93,2019,47469
5124,112,1584,6820,75.13,1.64,23.23,2019,47501
588,15,168,771,76.26,1.95,21.79,2019,47527
80,0,14,94,85.11,0.0,14.89,2019,47552
434,3,261,698,62.18,0.43,37.39,2019,47561
1096,47,458,1601,68.46,2.94,28.61,2019,47562
62,0,73,135,45.93,0.0,54.07,2019,47580
1036,13,531,1580,65.57,0.82,33.61,2019,47581
3653,112,993,4758,76.78,2.35,20.87,2019,47586
8,0,4,12,66.67,0.0,33.33,2019,47916
781,21,46,848,92.1,2.48,5.42,2019,47920
234,25,22,281,83.27,8.9,7.83,2019,47929
1209,35,248,1492,81.03,2.35,16.62,2019,47944
321,9,251,581,55.25,1.55,43.2,2019,47137
4307,171,1412,5890,73.12,2.9,23.97,2019,47112
1305,9,346,1660,78.61,0.54,20.84,2019,47126
0,0,0,0,,,,2019,66760
77,0,21,98,78.57,0.0,21.43,2019,66761
7637,367,1862,9866,77.41,3.72,18.87,2019,66762
249,21,72,342,72.81,6.14,21.05,2019,66771
257,43,187,487,52.77,8.83,38.4,2019,66781
718,21,238,977,73.49,2.15,24.36,2019,66783
77,0,8,85,90.59,0.0,9.41,2019,66830
329,9,91,429,76.69,2.1,21.21,2019,66845
291,15,25,331,87.92,4.53,7.55,2019,66868
284,20,72,376,75.53,5.32,19.15,2019,68624
220,2,50,272,80.88,0.74,18.38,2019,68647
98,9,16,123,79.67,7.32,13.01,2019,68648
640,42,115,797,80.3,5.27,14.43,2019,68649
484,5,67,556,87.05,0.9,12.05,2019,68651
1749,11,494,2254,77.6,0.49,21.92,2019,68661
107,9,19,135,79.26,6.67,14.07,2019,68664
184,4,32,220,83.64,1.82,14.55,2019,68669
394,44,108,546,72.16,8.06,19.78,2019,68714
53,1,4,58,91.38,1.72,6.9,2019,68326
200,1,58,259,77.22,0.39,22.39,2019,68464
452,23,130,605,74.71,3.8,21.49,2019,68636
3423,126,789,4338,78.91,2.9,18.19,2019,68850
18,5,1,24,75.0,20.83,4.17,2019,68001
1501,154,201,1856,80.87,8.3,10.83,2019,68003
7910,293,1089,9292,85.13,3.15,11.72,2019,68005
586,12,163,761,77.0,1.58,21.42,2019,68017
846,36,123,1005,84.18,3.58,12.24,2019,68023
4455,161,286,4902,90.88,3.28,5.83,2019,68028
115,3,20,138,83.33,2.17,14.49,2019,68033
385,10,33,428,89.95,2.34,7.71,2019,68041
596,15,115,726,82.09,2.07,15.84,2019,68920
35,7,1,43,81.4,16.28,2.33,2019,68975
72,15,18,105,68.57,14.29,17.14,2019,68943
103,0,6,109,94.5,0.0,5.5,2019,68945
132,2,17,151,87.42,1.32,11.26,2019,68950
704,7,59,770,91.43,0.91,7.66,2019,68955
232,16,61,309,75.08,5.18,19.74,2019,68966
337,10,109,456,73.9,2.19,23.9,2019,68967
131,13,10,154,85.06,8.44,6.49,2019,68976
127,28,10,165,76.97,16.97,6.06,2019,68981
696,10,102,808,86.14,1.24,12.62,2019,68937
437,17,94,548,79.74,3.1,17.15,2019,68956
257,6,17,280,91.79,2.14,6.07,2019,68958
1259,25,280,1564,80.5,1.6,17.9,2019,68959
59,0,22,81,72.84,0.0,27.16,2019,68972
757,17,264,1038,72.93,1.64,25.43,2019,68978
614,14,118,746,82.31,1.88,15.82,2019,68979
187,12,35,234,79.91,5.13,14.96,2019,68982
60,0,17,77,77.92,0.0,22.08,2019,68834
931,23,213,1167,79.78,1.97,18.25,2019,68840
340,1,70,411,82.73,0.24,17.03,2019,68866
274,30,82,386,70.98,7.77,21.24,2019,68874
761,17,137,915,83.17,1.86,14.97,2019,68883
111,7,29,147,75.51,4.76,19.73,2019,68948
32,0,9,41,78.05,0.0,21.95,2019,68952
200,8,44,252,79.37,3.17,17.46,2019,68957
25,1,6,32,78.12,3.12,18.75,2019,68964
115,15,61,191,60.21,7.85,31.94,2019,68971
84,0,28,112,75.0,0.0,25.0,2019,68977
83,0,0,83,100.0,0.0,0.0,2019,45147
105,5,27,137,76.64,3.65,19.71,2019,45158
26,0,20,46,56.52,0.0,43.48,2019,45166
111,2,17,130,85.38,1.54,13.08,2019,45319
22,0,1,23,95.65,0.0,4.35,2019,45350
101,4,6,111,90.99,3.6,5.41,2019,45361
121,0,20,141,85.82,0.0,14.18,2019,45372
0,0,0,0,,,,2019,45428
209,2,19,230,90.87,0.87,8.26,2019,45868
106,0,0,106,100.0,0.0,0.0,2019,45617
3,2,0,5,60.0,40.0,0.0,2019,45618
45,0,0,45,100.0,0.0,0.0,2019,45630
50,0,0,50,100.0,0.0,0.0,2019,45636
20,0,0,20,100.0,0.0,0.0,2019,45721
12,0,20,32,37.5,0.0,62.5,2019,45787
127,14,26,167,76.05,8.38,15.57,2019,45826
135,1,30,166,81.33,0.6,18.07,2019,45854
68,0,6,74,91.89,0.0,8.11,2019,45864
22,0,0,22,100.0,0.0,0.0,2019,45884
10208,333,2045,12586,81.11,2.65,16.25,2019,45215
767,8,91,866,88.57,0.92,10.51,2019,45877
1335,38,227,1600,83.44,2.38,14.19,2019,45887
4833,230,1195,6258,77.23,3.68,19.1,2019,45891
0,0,0,0,,,,2019,45897
16720,515,2688,19923,83.92,2.58,13.49,2019,45044
3016,17,278,3311,91.09,0.51,8.4,2019,45050
194,11,49,254,76.38,4.33,19.29,2019,45062
885,16,241,1142,77.5,1.4,21.1,2019,45064
4660,101,425,5186,89.86,1.95,8.2,2019,45067
2530,118,1000,3648,69.35,3.23,27.41,2019,45121
1447,66,342,1855,78.01,3.56,18.44,2019,45135
1075,53,590,1718,62.57,3.08,34.34,2019,45144
10341,327,1271,11939,86.62,2.74,10.65,2019,45239
4898,309,979,6186,79.18,5.0,15.83,2019,45246
4293,31,142,4466,96.13,0.69,3.18,2019,45305
92,6,6,104,88.46,5.77,5.77,2019,45310
14371,771,1847,16989,84.59,4.54,10.87,2019,45324
303,11,41,355,85.35,3.1,11.55,2019,45326
128,3,136,267,47.94,1.12,50.94,2019,45332
265,16,139,420,63.1,3.81,33.1,2019,45333
357,26,114,497,71.83,5.23,22.94,2019,45339
194,4,55,253,76.68,1.58,21.74,2019,45340
2290,41,199,2530,90.51,1.62,7.87,2019,45345
688,22,126,836,82.3,2.63,15.07,2019,45346
75,0,23,98,76.53,0.0,23.47,2019,45352
284,29,88,401,70.82,7.23,21.95,2019,45362
6867,200,936,8003,85.81,2.5,11.7,2019,45371
12963,613,2104,15680,82.67,3.91,13.42,2019,45385
613,25,264,902,67.96,2.77,29.27,2019,45874
6580,113,882,7575,86.86,1.49,11.64,2019,45895
1058,32,602,1692,62.53,1.89,35.58,2019,47138
242,4,176,422,57.35,0.95,41.71,2019,47142
488,11,156,655,74.5,1.68,23.82,2019,47145
186,18,187,391,47.57,4.6,47.83,2019,47147
494,45,69,608,81.25,7.4,11.35,2019,47166
151,0,56,207,72.95,0.0,27.05,2019,47224
186,9,71,266,69.92,3.38,26.69,2019,47244
9302,364,2439,12105,76.84,3.01,20.15,2019,47274
375,0,123,498,75.3,0.0,24.7,2019,47020
46,5,4,55,83.64,9.09,7.27,2019,47034
95,2,46,143,66.43,1.4,32.17,2019,47994
2876,121,1293,4290,67.04,2.82,30.14,2019,47713
575,4,84,663,86.73,0.6,12.67,2019,47840
131,2,82,215,60.93,0.93,38.14,2019,47855
442,0,137,579,76.34,0.0,23.66,2019,47862
966,9,241,1216,79.44,0.74,19.82,2019,47874
373,17,151,541,68.95,3.14,27.91,2019,47926
2530,141,667,3338,75.79,4.22,19.98,2019,47394
441,35,159,635,69.45,5.51,25.04,2019,47380
382,19,179,580,65.86,3.28,30.86,2019,47385
479,17,306,802,59.73,2.12,38.15,2019,47615
647,46,384,1077,60.07,4.27,35.65,2019,47471
919,72,277,1268,72.48,5.68,21.85,2019,47520
2255,20,818,3093,72.91,0.65,26.45,2019,47553
138,1,71,210,65.71,0.48,33.81,2019,47528
3114,93,618,3825,81.41,2.43,16.16,2019,47542
169,9,61,239,70.71,3.77,25.52,2019,47550
214,15,79,308,69.48,4.87,25.65,2019,47578
41,0,35,76,53.95,0.0,46.05,2019,47584
884,29,272,1185,74.6,2.45,22.95,2019,47598
4633,171,940,5744,80.66,2.98,16.36,2019,47601
1069,50,244,1363,78.43,3.67,17.9,2019,47638
8434,405,1500,10339,81.57,3.92,14.51,2019,47712
0,0,0,0,,,,2019,47836
660,40,288,988,66.8,4.05,29.15,2019,47841
340,24,84,448,75.89,5.36,18.75,2019,47847
466,13,122,601,77.54,2.16,20.3,2019,47848
166,0,30,196,84.69,0.0,15.31,2019,47849
108,0,66,174,62.07,0.0,37.93,2019,47860
157,20,57,234,67.09,8.55,24.36,2019,47861
135,0,98,233,57.94,0.0,42.06,2019,47866
105,6,26,137,76.64,4.38,18.98,2019,47881
5262,340,1446,7048,74.66,4.82,20.52,2019,47904
14177,645,2188,17010,83.35,3.79,12.86,2019,47905
1988,107,199,2294,86.66,4.66,8.67,2019,48003
2869,0,593,3462,82.87,0.0,17.13,2019,48015
800,1,160,961,83.25,0.1,16.65,2019,48022
5445,78,290,5813,93.67,1.34,4.99,2019,48025
5133,160,725,6018,85.29,2.66,12.05,2019,48026
5535,321,1232,7088,78.09,4.53,17.38,2019,48030
5997,220,1136,7353,81.56,2.99,15.45,2019,48034
17659,509,2066,20234,87.27,2.52,10.21,2019,48038
2613,49,586,3248,80.45,1.51,18.04,2019,48039
1446,40,270,1756,82.35,2.28,15.38,2019,48041
3717,64,511,4292,86.6,1.49,11.91,2019,48065
11284,330,1572,13186,85.58,2.5,11.92,2019,48071
649,18,150,817,79.44,2.2,18.36,2019,48890
13156,464,2612,16232,81.05,2.86,16.09,2019,48911
2910,112,795,3817,76.24,2.93,20.83,2019,48915
229,2,109,340,67.35,0.59,32.06,2019,68030
951,45,156,1152,82.55,3.91,13.54,2019,68069
296,11,54,361,81.99,3.05,14.96,2019,68343
304,21,98,423,71.87,4.96,23.17,2019,68354
421,2,50,473,89.01,0.42,10.57,2019,68402
165,2,49,216,76.39,0.93,22.69,2019,68436
166,6,19,191,86.91,3.14,9.95,2019,68016
65,0,38,103,63.11,0.0,36.89,2019,68844
694,28,160,882,78.68,3.17,18.14,2019,68869
25,1,3,29,86.21,3.45,10.34,2019,58321
13,0,0,13,100.0,0.0,0.0,2019,58323
147,66,184,397,37.03,16.62,46.35,2019,58335
976,57,192,1225,79.67,4.65,15.67,2019,58341
38,9,10,57,66.67,15.79,17.54,2019,58345
81,0,4,85,95.29,0.0,4.71,2019,58382
377,12,114,503,74.95,2.39,22.66,2019,58413
964,38,232,1234,78.12,3.08,18.8,2019,58421
10,0,18,28,35.71,0.0,64.29,2019,58423
45,31,21,97,46.39,31.96,21.65,2019,58428
167,0,33,200,83.5,0.0,16.5,2019,58429
26,11,15,52,50.0,21.15,28.85,2019,58440
62,1,12,75,82.67,1.33,16.0,2019,58443
969,42,156,1167,83.03,3.6,13.37,2019,58474
193,0,19,212,91.04,0.0,8.96,2019,58492
72,0,11,83,86.75,0.0,13.25,2019,58496
514,30,284,828,62.08,3.62,34.3,2019,58552
9545,381,1421,11347,84.12,3.36,12.52,2019,58554
61,24,18,103,59.22,23.3,17.48,2019,58559
142,10,17,169,84.02,5.92,10.06,2019,58231
4,3,0,7,57.14,42.86,0.0,2019,58239
87,2,34,123,70.73,1.63,27.64,2019,58258
680,14,81,775,87.74,1.81,10.45,2019,58278
10,0,16,26,38.46,0.0,61.54,2019,58355
120,5,18,143,83.92,3.5,12.59,2019,58845
56,35,29,120,46.67,29.17,24.17,2019,58853
95,19,21,135,70.37,14.07,15.56,2019,58004
710,29,138,877,80.96,3.31,15.74,2019,58257
449,14,79,542,82.84,2.58,14.58,2019,58240
39,0,5,44,88.64,0.0,11.36,2019,58244
234,8,64,306,76.47,2.61,20.92,2019,58256
71,0,18,89,79.78,0.0,20.22,2019,58260
324,2,150,476,68.07,0.42,31.51,2019,58261
23,0,15,38,60.53,0.0,39.47,2019,58311
393,18,235,646,60.84,2.79,36.38,2019,58324
140,10,34,184,76.09,5.43,18.48,2019,58351
44,0,0,44,100.0,0.0,0.0,2019,58363
157,2,18,177,88.7,1.13,10.17,2019,58033
456,16,67,539,84.6,2.97,12.43,2019,58040
454,14,26,494,91.9,2.83,5.26,2019,58042
39,0,3,42,92.86,0.0,7.14,2019,58057
12858,245,926,14029,91.65,1.75,6.6,2019,58078
192,0,54,246,78.05,0.0,21.95,2019,58227
312,12,82,406,76.85,2.96,20.2,2019,58228
144,2,24,170,84.71,1.18,14.12,2019,58011
63,0,26,89,70.79,0.0,29.21,2019,58013
23,1,5,29,79.31,3.45,17.24,2019,58029
156,5,26,187,83.42,2.67,13.9,2019,58031
92,5,28,125,73.6,4.0,22.4,2019,58035
56,0,12,68,82.35,0.0,17.65,2019,58043
44,3,9,56,78.57,5.36,16.07,2019,45899
1003,23,301,1327,75.58,1.73,22.68,2019,45831
2195,107,253,2555,85.91,4.19,9.9,2019,45387
274,0,13,287,95.47,0.0,4.53,2019,45388
136,9,35,180,75.56,5.0,19.44,2019,45389
10128,241,1139,11508,88.01,2.09,9.9,2019,45429
5645,166,677,6488,87.01,2.56,10.43,2019,45432
11853,122,929,12904,91.86,0.95,7.2,2019,45458
6259,175,1483,7917,79.06,2.21,18.73,2019,45505
505,14,215,734,68.8,1.91,29.29,2019,45634
0,0,0,0,,,,2019,45642
131,0,60,191,68.59,0.0,31.41,2019,45646
8954,435,2941,12330,72.62,3.53,23.85,2019,45662
616,0,202,818,75.31,0.0,24.69,2019,45684
330,10,129,469,70.36,2.13,27.51,2019,45685
317,9,122,448,70.76,2.01,27.23,2019,45719
52,49,82,183,28.42,26.78,44.81,2019,45727
75,10,122,207,36.23,4.83,58.94,2019,45741
2157,118,296,2571,83.9,4.59,11.51,2019,45810
3453,114,609,4176,82.69,2.73,14.58,2019,44408
581,43,83,707,82.18,6.08,11.74,2019,44411
1199,31,264,1494,80.25,2.07,17.67,2019,44436
474,10,165,649,73.04,1.54,25.42,2019,44450
1062,35,115,1212,87.62,2.89,9.49,2019,44451
3535,118,735,4388,80.56,2.69,16.75,2019,44471
7413,428,1447,9288,79.81,4.61,15.58,2019,44484
4706,241,2014,6961,67.61,3.46,28.93,2019,44485
298,20,55,373,79.89,5.36,14.75,2019,44490
62,0,0,62,100.0,0.0,0.0,2019,44610
7000,334,1094,8428,83.06,3.96,12.98,2019,44001
4524,250,1215,5989,75.54,4.17,20.29,2019,44030
319,0,142,461,69.2,0.0,30.8,2019,44032
1060,9,78,1147,92.41,0.78,6.8,2019,44040
4712,228,1054,5994,78.61,3.8,17.58,2019,44041
2061,81,205,2347,87.81,3.45,8.73,2019,44050
1186,105,424,1715,69.15,6.12,24.72,2019,44076
14627,608,4198,19433,75.27,3.13,21.6,2019,44102
5619,284,3102,9005,62.4,3.15,34.45,2019,44110
14143,557,3114,17814,79.39,3.13,17.48,2019,44111
9061,326,2102,11489,78.87,2.84,18.3,2019,44125
7514,217,1680,9411,79.84,2.31,17.85,2019,44137
6332,136,1106,7574,83.6,1.8,14.6,2019,44142
2106,29,332,2467,85.37,1.18,13.46,2019,44201
723,2,128,853,84.76,0.23,15.01,2019,44214
2519,231,636,3386,74.39,6.82,18.78,2019,44231
4165,74,726,4965,83.89,1.49,14.62,2019,44260
10954,756,1888,13598,80.56,5.56,13.88,2019,44266
1700,115,195,2010,84.58,5.72,9.7,2019,44272
2589,57,306,2952,87.7,1.93,10.37,2019,44273
559,17,73,649,86.13,2.62,11.25,2019,44276
2155,25,291,2471,87.21,1.01,11.78,2019,48808
1040,35,275,1350,77.04,2.59,20.37,2019,48831
2584,36,270,2890,89.41,1.25,9.34,2019,48848
502,30,221,753,66.67,3.98,29.35,2019,48865
7016,315,921,8252,85.02,3.82,11.16,2019,48442
2666,184,749,3599,74.08,5.11,20.81,2019,48444
397,13,91,501,79.24,2.59,18.16,2019,48445
4862,83,510,5455,89.13,1.52,9.35,2019,48451
210,32,28,270,77.78,11.85,10.37,2019,48465
169,0,23,192,88.02,0.0,11.98,2019,48476
118,0,9,127,92.91,0.0,7.09,2019,48502
7094,934,3088,11116,63.82,8.4,27.78,2019,48504
20,0,0,20,100.0,0.0,0.0,2019,48630
3338,277,856,4471,74.66,6.2,19.15,2019,48661
401,26,141,568,70.6,4.58,24.82,2019,48701
470,41,160,671,70.04,6.11,23.85,2019,48731
319,8,101,428,74.53,1.87,23.6,2019,48761
395,26,87,508,77.76,5.12,17.13,2019,48762
188,12,111,311,60.45,3.86,35.69,2019,48765
833,62,342,1237,67.34,5.01,27.65,2019,48811
1899,51,451,2401,79.09,2.12,18.78,2019,48817
5149,162,980,6291,81.85,2.58,15.58,2019,48827
665,44,132,841,79.07,5.23,15.7,2019,48834
14698,914,1550,17162,85.64,5.33,9.03,2019,48843
5316,178,1088,6582,80.77,2.7,16.53,2019,48846
56,2,17,75,74.67,2.67,22.67,2019,48852
166,7,52,225,73.78,3.11,23.11,2019,48853
11957,102,926,12985,92.08,0.79,7.13,2019,48178
8420,472,1830,10722,78.53,4.4,17.07,2019,48161
8297,150,560,9007,92.12,1.67,6.22,2019,48167
15106,335,1584,17025,88.73,1.97,9.3,2019,48170
1325,14,142,1481,89.47,0.95,9.59,2019,48179
5324,197,1112,6633,80.27,2.97,16.76,2019,48184
16974,257,1162,18393,92.29,1.4,6.32,2019,48187
5794,1140,2879,9813,59.04,11.62,29.34,2019,48209
11792,933,3008,15733,74.95,5.93,19.12,2019,48221
2227,282,1194,3703,60.14,7.62,32.24,2019,48229
6987,719,5246,12952,53.95,5.55,40.5,2019,48234
5524,267,985,6776,81.52,3.94,14.54,2019,48240
5952,104,316,6372,93.41,1.63,4.96,2019,48304
10489,270,843,11602,90.41,2.33,7.27,2019,48317
2143,13,144,2300,93.17,0.57,6.26,2019,48320
11342,104,888,12334,91.96,0.84,7.2,2019,48322
8867,164,898,9929,89.3,1.65,9.04,2019,48329
9217,166,1404,10787,85.45,1.54,13.02,2019,48336
1475,0,228,1703,86.61,0.0,13.39,2019,48367
8047,145,338,8530,94.34,1.7,3.96,2019,48375
1744,70,170,1984,87.9,3.53,8.57,2019,48428
1283,66,395,1744,73.57,3.78,22.65,2019,48441
805,40,251,1096,73.45,3.65,22.9,2019,48449
2615,54,507,3176,82.34,1.7,15.96,2019,48461
1524,133,674,2331,65.38,5.71,28.91,2019,48471
3472,133,510,4115,84.37,3.23,12.39,2019,48604
2389,111,520,3020,79.11,3.68,17.22,2019,48616
3847,138,1352,5337,72.08,2.59,25.33,2019,48625
2705,90,694,3489,77.53,2.58,19.89,2019,48629
1615,26,276,1917,84.25,1.36,14.4,2019,48634
247,62,107,416,59.38,14.9,25.72,2019,48636
11858,449,1277,13584,87.29,3.31,9.4,2019,48642
222,6,36,264,84.09,2.27,13.64,2019,58052
36,5,22,63,57.14,7.94,34.92,2019,58056
463,5,67,535,86.54,0.93,12.52,2019,58059
465,26,83,574,81.01,4.53,14.46,2019,58425
63,4,10,77,81.82,5.19,12.99,2019,58426
162,5,30,197,82.23,2.54,15.23,2019,58442
63,0,13,76,82.89,0.0,17.11,2019,58445
53,1,8,62,85.48,1.61,12.9,2019,58451
183,7,64,254,72.05,2.76,25.2,2019,58456
17,0,3,20,85.0,0.0,15.0,2019,57780
3146,172,741,4059,77.51,4.24,18.26,2019,57785
43,0,11,54,79.63,0.0,20.37,2019,57792
29,0,13,42,69.05,0.0,30.95,2019,57584
17,0,72,89,19.1,0.0,80.9,2019,57622
265,3,84,352,75.28,0.85,23.86,2019,57626
332,11,230,573,57.94,1.92,40.14,2019,57642
108,3,20,131,82.44,2.29,15.27,2019,57644
61,6,46,113,53.98,5.31,40.71,2019,57652
2577,33,472,3082,83.61,1.07,15.31,2019,57719
2076,92,422,2590,80.15,3.55,16.29,2019,57730
47,1,23,71,66.2,1.41,32.39,2019,57738
337,7,55,399,84.46,1.75,13.78,2019,57751
31,17,75,123,25.2,13.82,60.98,2019,57756
408,15,47,470,86.81,3.19,10.0,2019,57761
6013,174,623,6810,88.3,2.56,9.15,2019,57783
793,38,118,949,83.56,4.0,12.43,2019,57212
21,0,4,25,84.0,0.0,16.0,2019,57214
639,33,204,876,72.95,3.77,23.29,2019,57225
92,11,9,112,82.14,9.82,8.04,2019,57239
289,11,98,398,72.61,2.76,24.62,2019,57249
1780,45,244,2069,86.03,2.17,11.79,2019,57252
113,0,59,172,65.7,0.0,34.3,2019,57255
37,5,10,52,71.15,9.62,19.23,2019,57258
151,4,39,194,77.84,2.06,20.1,2019,57259
55,0,21,76,72.37,0.0,27.63,2019,57265
802,6,181,989,81.09,0.61,18.3,2019,57362
355,5,106,466,76.18,1.07,22.75,2019,57368
32,0,4,36,88.89,0.0,11.11,2019,57379
745,71,294,1110,67.12,6.4,26.49,2019,57380
305,9,107,421,72.45,2.14,25.42,2019,57384
64,4,21,89,71.91,4.49,23.6,2019,57386
19,9,20,48,39.58,18.75,41.67,2019,57420
613,35,128,776,78.99,4.51,16.49,2019,57442
299,10,7,316,94.62,3.16,2.22,2019,59057
5,0,4,9,55.56,0.0,44.44,2019,59062
42,0,10,52,80.77,0.0,19.23,2019,59085
6453,265,585,7303,88.36,3.63,8.01,2019,59106
338,6,122,466,72.53,1.29,26.18,2019,59215
151,0,81,232,65.09,0.0,34.91,2019,59231
819,25,137,981,83.49,2.55,13.97,2019,59254
42,0,12,54,77.78,0.0,22.22,2019,59258
71,4,14,89,79.78,4.49,15.73,2019,59311
62,3,14,79,78.48,3.8,17.72,2019,59332
1319,64,306,1689,78.09,3.79,18.12,2019,59427
35,3,16,54,64.81,5.56,29.63,2019,59432
153,0,33,186,82.26,0.0,17.74,2019,59443
26,0,11,37,70.27,0.0,29.73,2019,59530
756,18,127,901,83.91,2.0,14.1,2019,59730
397,22,170,589,67.4,3.74,28.86,2019,59632
2501,20,452,2973,84.12,0.67,15.2,2019,44287
10665,350,2965,13980,76.29,2.5,21.21,2019,44146
384,0,105,489,78.53,0.0,21.47,2019,44250
913,57,114,1084,84.23,5.26,10.52,2019,44253
183,0,91,274,66.79,0.0,33.21,2019,44308
1946,268,656,2870,67.8,9.34,22.86,2019,44311
1105,18,202,1325,83.4,1.36,15.25,2019,44402
358,40,86,484,73.97,8.26,17.77,2019,44427
1058,54,434,1546,68.43,3.49,28.07,2019,44003
8478,472,589,9539,88.88,4.95,6.17,2019,44012
20767,1346,4885,26998,76.92,4.99,18.09,2019,44035
708,118,77,903,78.41,13.07,8.53,2019,44048
22714,315,2196,25225,90.05,1.25,8.71,2019,44060
7103,185,891,8179,86.84,2.26,10.89,2019,44067
11352,395,1334,13081,86.78,3.02,10.2,2019,44070
467,0,190,657,71.08,0.0,28.92,2019,44082
924,20,319,1263,73.16,1.58,25.26,2019,44085
795,10,127,932,85.3,1.07,13.63,2019,44086
14019,399,1793,16211,86.48,2.46,11.06,2019,44094
11583,264,1761,13608,85.12,1.94,12.94,2019,44122
1066,61,684,1811,58.86,3.37,37.77,2019,44127
9206,429,3230,12865,71.56,3.33,25.11,2019,44128
18590,524,3138,22252,83.54,2.35,14.1,2019,44130
7261,147,901,8309,87.39,1.77,10.84,2019,44131
12848,344,2422,15614,82.29,2.2,15.51,2019,44134
680,50,91,821,82.83,6.09,11.08,2019,44634
339,15,130,484,70.04,3.1,26.86,2019,44638
6338,263,1047,7648,82.87,3.44,13.69,2019,44647
45,1,14,60,75.0,1.67,23.33,2019,44661
2379,84,692,3155,75.4,2.66,21.93,2019,44683
9424,148,820,10392,90.69,1.42,7.89,2019,44685
166,0,81,247,67.21,0.0,32.79,2019,44689
66,1,20,87,75.86,1.15,22.99,2019,44697
2741,130,947,3818,71.79,3.4,24.8,2019,44703
5727,177,1434,7338,78.05,2.41,19.54,2019,44705
9289,458,1253,11000,84.45,4.16,11.39,2019,44708
2285,72,584,2941,77.69,2.45,19.86,2019,44827
1538,77,427,2042,75.32,3.77,20.91,2019,44842
24,0,12,36,66.67,0.0,33.33,2019,44861
746,12,152,910,81.98,1.32,16.7,2019,44867
12961,867,2909,16737,77.44,5.18,17.38,2019,44870
988,15,174,1177,83.94,1.27,14.78,2019,44882
3747,191,842,4780,78.39,4.0,17.62,2019,44905
745,34,221,1000,74.5,3.4,22.1,2019,44412
580,0,119,699,82.98,0.0,17.02,2019,44417
6182,233,1506,7921,78.05,2.94,19.01,2019,44123
10039,250,1606,11895,84.4,2.1,13.5,2019,44129
520,24,93,637,81.63,3.77,14.6,2019,44826
123,0,19,142,86.62,0.0,13.38,2019,44678
15023,440,2836,18299,82.1,2.4,15.5,2019,44691
1878,75,441,2394,78.45,3.13,18.42,2019,48655
105,0,39,144,72.92,0.0,27.08,2019,48728
323,12,123,458,70.52,2.62,26.86,2019,48735
544,17,198,759,71.67,2.24,26.09,2019,48742
402,0,164,566,71.02,0.0,28.98,2019,48745
237,26,80,343,69.1,7.58,23.32,2019,48807
3376,156,542,4074,82.87,3.83,13.3,2019,48809
16767,1694,1485,19946,84.06,8.49,7.45,2019,48823
6566,291,701,7558,86.87,3.85,9.27,2019,48854
897,8,161,1066,84.15,0.75,15.1,2019,48857
571,13,199,783,72.92,1.66,25.42,2019,48871
47,0,7,54,87.04,0.0,12.96,2019,48874
4600,108,631,5339,86.16,2.02,11.82,2019,48001
2410,25,284,2719,88.64,0.92,10.45,2019,48048
433,25,48,506,85.57,4.94,9.49,2019,48050
5724,98,649,6471,88.46,1.51,10.03,2019,48051
6357,94,796,7247,87.72,1.3,10.98,2019,48082
8320,176,741,9237,90.07,1.91,8.02,2019,48083
8618,203,1423,10244,84.13,1.98,13.89,2019,48093
1932,16,166,2114,91.39,0.76,7.85,2019,48095
12343,444,1949,14736,83.76,3.01,13.23,2019,48917
1328,39,227,1594,83.31,2.45,14.24,2019,48014
660,22,83,765,86.27,2.88,10.85,2019,48032
2536,45,385,2966,85.5,1.52,12.98,2019,48054
16431,732,3013,20176,81.44,3.63,14.93,2019,48066
2275,16,60,2351,96.77,0.68,2.55,2019,48070
6090,147,446,6683,91.13,2.2,6.67,2019,48072
14816,307,1345,16468,89.97,1.86,8.17,2019,48073
1228,64,350,1642,74.79,3.9,21.32,2019,48096
13130,894,644,14668,89.51,6.09,4.39,2019,48105
7067,162,584,7813,90.45,2.07,7.47,2019,48114
3663,72,411,4146,88.35,1.74,9.91,2019,48138
1081,11,183,1275,84.78,0.86,14.35,2019,48140
4024,78,548,4650,86.54,1.68,11.78,2019,48160
2609,42,201,2852,91.48,1.47,7.05,2019,48165
7421,314,1121,8856,83.8,3.55,12.66,2019,48182
4991,396,2226,7613,65.56,5.2,29.24,2019,48202
3374,484,1168,5026,67.13,9.63,23.24,2019,48215
1575,385,940,2900,54.31,13.28,32.41,2019,48217
10027,242,1028,11297,88.76,2.14,9.1,2019,48220
8962,1293,5558,15813,56.67,8.18,35.15,2019,48227
0,0,0,0,,,,2019,48242
13315,201,1329,14845,89.69,1.35,8.95,2019,48310
11869,208,1580,13657,86.91,1.52,11.57,2019,48312
547,24,190,761,71.88,3.15,24.97,2019,48770
601,18,233,852,70.54,2.11,27.35,2019,48851
9055,863,1915,11833,76.52,7.29,16.18,2019,48174
10126,277,1704,12107,83.64,2.29,14.07,2019,48237
2016,82,329,2427,83.07,3.38,13.56,2019,48421
2526,156,326,3008,83.98,5.19,10.84,2019,48457
358,11,190,559,64.04,1.97,33.99,2019,48889
870,42,250,1162,74.87,3.61,21.51,2019,48891
512,14,128,654,78.29,2.14,19.57,2019,48894
1205,30,209,1444,83.45,2.08,14.47,2019,48436
251,21,50,322,77.95,6.52,15.53,2019,48456
7938,138,907,8983,88.37,1.54,10.1,2019,48473
8425,605,2623,11653,72.3,5.19,22.51,2019,48506
1182,30,247,1459,81.01,2.06,16.93,2019,48006
7739,138,1296,9173,84.37,1.5,14.13,2019,48036
236,32,48,316,74.68,10.13,15.19,2019,66415
183,7,40,230,79.57,3.04,17.39,2019,66416
123,2,20,145,84.83,1.38,13.79,2019,66428
202,0,32,234,86.32,0.0,13.68,2019,66431
6121,141,212,6474,94.55,2.18,3.27,2019,66503
0,12,0,12,0.0,100.0,0.0,2019,66506
1547,51,314,1912,80.91,2.67,16.42,2019,66508
802,11,278,1091,73.51,1.01,25.48,2019,66509
942,11,171,1124,83.81,0.98,15.21,2019,66512
228,9,56,293,77.82,3.07,19.11,2019,68627
561,13,20,594,94.44,2.19,3.37,2019,68358
364,2,48,414,87.92,0.48,11.59,2019,68418
68,0,0,68,100.0,0.0,0.0,2019,68445
1935,75,100,2110,91.71,3.55,4.74,2019,68524
252,10,66,328,76.83,3.05,20.12,2019,68727
208,5,38,251,82.87,1.99,15.14,2019,68947
66,2,7,75,88.0,2.67,9.33,2019,68974
458,34,50,542,84.5,6.27,9.23,2019,68301
198,12,87,297,66.67,4.04,29.29,2019,68652
631,36,85,752,83.91,4.79,11.3,2019,68769
50,1,8,59,84.75,1.69,13.56,2019,68837
6,0,12,18,33.33,0.0,66.67,2019,68954
234,8,58,300,78.0,2.67,19.33,2019,68752
199,23,53,275,72.36,8.36,19.27,2019,68835
436,37,81,554,78.7,6.68,14.62,2019,68927
69,11,34,114,60.53,9.65,29.82,2019,68055
9259,234,888,10381,89.19,2.25,8.55,2019,68137
23,6,1,30,76.67,20.0,3.33,2019,68072
0,0,0,0,,,,2019,68178
26,0,7,33,78.79,0.0,21.21,2019,68379
7,0,2,9,77.78,0.0,22.22,2019,68382
38,1,7,46,82.61,2.17,15.22,2019,68438
26,0,0,26,100.0,0.0,0.0,2019,68514
231,0,16,247,93.52,0.0,6.48,2019,68531
19,0,9,28,67.86,0.0,32.14,2019,68749
24,0,2,26,92.31,0.0,7.69,2019,68751
0,0,0,0,,,,2019,68849
8,0,1,9,88.89,0.0,11.11,2019,68969
182,9,20,211,86.26,4.27,9.48,2019,68743
296,5,94,395,74.94,1.27,23.8,2019,69034
46,0,5,51,90.2,0.0,9.8,2019,69132
222,13,57,292,76.03,4.45,19.52,2019,69156
40,0,3,43,93.02,0.0,6.98,2019,69157
130,2,70,202,64.36,0.99,34.65,2019,69217
2312,76,315,2703,85.53,2.81,11.65,2019,69337
72,0,4,76,94.74,0.0,5.26,2019,69355
364,26,162,552,65.94,4.71,29.35,2019,69360
78,5,6,89,87.64,5.62,6.74,2019,69366
487,19,135,641,75.98,2.96,21.06,2019,69339
156,2,17,175,89.14,1.14,9.71,2019,69345
127,5,43,175,72.57,2.86,24.57,2019,69350
86,24,2,112,76.79,21.43,1.79,2019,69351
3023,48,718,3789,79.78,1.27,18.95,2019,69001
164,0,30,194,84.54,0.0,15.46,2019,69020
171,2,42,215,79.53,0.93,19.53,2019,69043
309,6,43,358,86.31,1.68,12.01,2019,69123
330,0,47,377,87.53,0.0,12.47,2019,69127
1275,55,266,1596,79.89,3.45,16.67,2019,69138
633,7,127,767,82.53,0.91,16.56,2019,69140
0,0,24,24,0.0,0.0,100.0,2019,44816
218,36,40,294,74.15,12.24,13.61,2019,44841
1029,31,67,1127,91.3,2.75,5.94,2019,44846
26,0,0,26,100.0,0.0,0.0,2019,44850
365,3,97,465,78.49,0.65,20.86,2019,44855
508,14,76,598,84.95,2.34,12.71,2019,44859
3260,150,844,4254,76.63,3.53,19.84,2019,44890
5059,191,948,6198,81.62,3.08,15.3,2019,44425
1216,36,220,1472,82.61,2.45,14.95,2019,44430
1374,32,255,1661,82.72,1.93,15.35,2019,44442
723,86,248,1057,68.4,8.14,23.46,2019,44506
1770,32,320,2122,83.41,1.51,15.08,2019,44612
2959,112,802,3873,76.4,2.89,20.71,2019,44615
1497,39,407,1943,77.05,2.01,20.95,2019,44438
1323,83,641,2047,64.63,4.05,31.31,2019,44507
8346,98,1203,9647,86.51,1.02,12.47,2019,44514
475,29,91,595,79.83,4.87,15.29,2019,44625
4210,56,830,5096,82.61,1.1,16.29,2019,44667
421,47,85,553,76.13,8.5,15.37,2019,44669
873,54,382,1309,66.69,4.13,29.18,2019,44688
33,0,16,49,67.35,0.0,32.65,2019,44690
10,6,4,20,50.0,30.0,20.0,2019,44693
1001,80,467,1548,64.66,5.17,30.17,2019,44704
4842,87,495,5424,89.27,1.6,9.13,2019,44718
1855,59,384,2298,80.72,2.57,16.71,2019,44730
2585,44,634,3263,79.22,1.35,19.43,2019,44813
485,12,51,548,88.5,2.19,9.31,2019,44817
1593,12,268,1873,85.05,0.64,14.31,2019,44072
13222,300,2123,15645,84.51,1.92,13.57,2019,44118
12508,638,3458,16604,75.33,3.84,20.83,2019,44203
1022,57,87,1166,87.65,4.89,7.46,2019,44264
1545,53,243,1841,83.92,2.88,13.2,2019,44431
1671,29,254,1954,85.52,1.48,13.0,2019,44440
12429,402,1827,14658,84.79,2.74,12.46,2019,44512
8035,142,657,8834,90.96,1.61,7.44,2019,44139
3096,115,282,3493,88.63,3.29,8.07,2019,44216
6405,84,734,7223,88.68,1.16,10.16,2019,44278
10833,257,1298,12388,87.45,2.07,10.48,2019,44313
6222,379,1661,8262,75.31,4.59,20.1,2019,44314
390,12,56,458,85.15,2.62,12.23,2019,44418
972,134,239,1345,72.27,9.96,17.77,2019,44428
6669,374,2031,9074,73.5,4.12,22.38,2019,44446
481,26,53,560,85.89,4.64,9.46,2019,44449
1123,74,114,1311,85.66,5.64,8.7,2019,44452
387,0,25,412,93.93,0.0,6.07,2019,44454
591,85,61,737,80.19,11.53,8.28,2019,44455
3114,167,658,3939,79.06,4.24,16.7,2019,44481
626,33,355,1014,61.74,3.25,35.01,2019,44491
1484,149,415,2048,72.46,7.28,20.26,2019,44504
4966,350,2168,7484,66.35,4.68,28.97,2019,44505
5406,179,1285,6870,78.69,2.61,18.7,2019,48043
10102,161,1368,11631,86.85,1.38,11.76,2019,48045
14351,390,1209,15950,89.97,2.45,7.58,2019,48047
1416,23,118,1557,90.94,1.48,7.58,2019,48063
1026,9,36,1071,95.8,0.84,3.36,2019,48069
2985,27,482,3494,85.43,0.77,13.8,2019,48074
8729,63,899,9691,90.07,0.65,9.28,2019,48076
7767,186,1051,9004,86.26,2.07,11.67,2019,48081
9755,435,4111,14301,68.21,3.04,28.75,2019,48601
10046,340,1440,11826,84.95,2.88,12.18,2019,48603
2510,76,827,3413,73.54,2.23,24.23,2019,48617
9538,331,2421,12290,77.61,2.69,19.7,2019,48089
8944,209,1596,10749,83.21,1.94,14.85,2019,48135
1928,59,386,2373,81.25,2.49,16.27,2019,48626
47,0,0,47,100.0,0.0,0.0,2019,48627
2294,49,703,3046,75.31,1.61,23.08,2019,48650
528,18,113,659,80.12,2.73,17.15,2019,48652
755,66,230,1051,71.84,6.28,21.88,2019,48659
173,12,88,273,63.37,4.4,32.23,2019,48705
8546,207,2324,11077,77.15,1.87,20.98,2019,48708
326,18,122,466,69.96,3.86,26.18,2019,48720
4316,103,591,5010,86.15,2.06,11.8,2019,48732
549,19,126,694,79.11,2.74,18.16,2019,48733
777,29,296,1102,70.51,2.63,26.86,2019,48740
430,7,108,545,78.9,1.28,19.82,2019,48747
1019,107,276,1402,72.68,7.63,19.69,2019,48755
2981,122,840,3943,75.6,3.09,21.3,2019,48768
6008,117,601,6726,89.33,1.74,8.94,2019,48820
2069,55,359,2483,83.33,2.22,14.46,2019,48821
993,38,295,1326,74.89,2.87,22.25,2019,48829
217,10,60,287,75.61,3.48,20.91,2019,48841
1899,64,489,2452,77.45,2.61,19.94,2019,48888
564,18,104,686,82.22,2.62,15.16,2019,48897
8209,246,1076,9531,86.13,2.58,11.29,2019,48327
8477,208,1557,10242,82.77,2.03,15.2,2019,48092
11291,350,1806,13447,83.97,2.6,13.43,2019,48186
988,58,190,1236,79.94,4.69,15.37,2019,48002
438,6,108,552,79.35,1.09,19.57,2019,48028
4864,189,996,6049,80.41,3.12,16.47,2019,48059
1434,146,503,2083,68.84,7.01,24.15,2019,48453
11266,307,1619,13192,85.4,2.33,12.27,2019,48640
565,0,42,607,93.08,0.0,6.92,2019,48370
768,19,146,933,82.32,2.04,15.65,2019,48460
6718,344,1320,8382,80.15,4.1,15.75,2019,48532
545,29,146,720,75.69,4.03,20.28,2019,48635
6086,258,1260,7604,80.04,3.39,16.57,2019,48033
8434,39,355,8828,95.54,0.44,4.02,2019,48085
7863,111,1118,9092,86.48,1.22,12.3,2019,48088
8005,44,290,8339,95.99,0.53,3.48,2019,48168
36,31,9,76,47.37,40.79,11.84,2019,48177
5004,321,913,6238,80.22,5.15,14.64,2019,48193
0,0,0,0,,,,2019,48233
0,0,0,0,,,,2019,48243
0,0,0,0,,,,2019,48397
33,0,0,33,100.0,0.0,0.0,2019,48411
0,0,0,0,,,,2019,48551
0,0,0,0,,,,2019,48553
0,0,0,0,,,,2019,48554
4531,133,1027,5691,79.62,2.34,18.05,2019,48638
708,86,52,846,83.69,10.17,6.15,2019,58577
393,15,134,542,72.51,2.77,24.72,2019,58579
122,33,26,181,67.4,18.23,14.36,2019,58656
168,6,56,230,73.04,2.61,24.35,2019,58710
8,0,2,10,80.0,0.0,20.0,2019,58713
339,30,56,425,79.76,7.06,13.18,2019,58718
168,12,40,220,76.36,5.45,18.18,2019,58721
48,5,9,62,77.42,8.06,14.52,2019,58737
247,19,19,285,86.67,6.67,6.67,2019,58740
189,1,35,225,84.0,0.44,15.56,2019,59028
4829,266,809,5904,81.79,4.51,13.7,2019,59047
12,0,0,12,100.0,0.0,0.0,2019,59058
19,0,4,23,82.61,0.0,17.39,2019,59537
402,49,173,624,64.42,7.85,27.72,2019,59645
12715,743,976,14434,88.09,5.15,6.76,2019,59715
14537,384,787,15708,92.55,2.44,5.01,2019,59718
108,8,9,125,86.4,6.4,7.2,2019,59061
1423,6,225,1654,86.03,0.36,13.6,2019,59068
170,8,57,235,72.34,3.4,24.26,2019,59069
69,0,11,80,86.25,0.0,13.75,2019,59078
106,7,36,149,71.14,4.7,24.16,2019,59447
174,14,40,228,76.32,6.14,17.54,2019,59450
104,2,20,126,82.54,1.59,15.87,2019,59453
41,6,0,47,87.23,12.77,0.0,2019,59466
170,0,85,255,66.67,0.0,33.33,2019,59472
306,14,110,430,71.16,3.26,25.58,2019,59486
63,0,0,63,100.0,0.0,0.0,2019,59217
78,18,5,101,77.23,17.82,4.95,2019,59219
528,30,114,672,78.57,4.46,16.96,2019,59221
1683,70,251,2004,83.98,3.49,12.52,2019,59230
134,20,34,188,71.28,10.64,18.09,2019,59241
7,0,2,9,77.78,0.0,22.22,2019,59244
318,3,77,398,79.9,0.75,19.35,2019,59853
105,69,71,245,42.86,28.16,28.98,2019,59930
1797,68,336,2201,81.64,3.09,15.27,2019,59828
292,40,75,407,71.74,9.83,18.43,2019,59754
1216,41,323,1580,76.96,2.59,20.44,2019,59759
113,11,11,135,83.7,8.15,8.15,2019,59761
520,25,159,704,73.86,3.55,22.59,2019,59820
166,3,19,188,88.3,1.6,10.11,2019,59841
463,0,55,518,89.38,0.0,10.62,2019,59006
166,11,25,202,82.18,5.45,12.38,2019,59015
38,0,3,41,92.68,0.0,7.32,2019,59020
475,48,161,684,69.44,7.02,23.54,2019,59030
9,2,7,18,50.0,11.11,38.89,2019,59039
464,4,246,714,64.99,0.56,34.45,2019,59043
45,10,23,78,57.69,12.82,29.49,2019,59053
27,0,5,32,84.38,0.0,15.62,2019,59055
51,10,21,82,62.2,12.2,25.61,2019,59059
619,35,105,759,81.55,4.61,13.83,2019,59063
152,0,14,166,91.57,0.0,8.43,2019,59212
50,0,4,54,92.59,0.0,7.41,2019,59214
284,21,31,336,84.52,6.25,9.23,2019,59218
194,0,43,237,81.86,0.0,18.14,2019,59485
91,2,48,141,64.54,1.42,34.04,2019,59448
39,13,9,61,63.93,21.31,14.75,2019,59451
85,1,11,97,87.63,1.03,11.34,2019,59454
489,22,479,990,49.39,2.22,48.38,2019,59521
2366,32,755,3153,75.04,1.01,23.95,2019,60970
3915,320,1227,5462,71.68,5.86,22.46,2019,44509
1196,33,933,2162,55.32,1.53,43.15,2019,44606
615,3,168,786,78.24,0.38,21.37,2019,44608
1729,85,500,2314,74.72,3.67,21.61,2019,44618
779,21,547,1347,57.83,1.56,40.61,2019,44624
9052,434,1748,11234,80.58,3.86,15.56,2019,44883
1118,15,347,1480,75.54,1.01,23.45,2019,44643
3482,238,2222,5942,58.6,4.01,37.39,2019,44654
586,11,339,936,62.61,1.18,36.22,2019,44675
884,21,154,1059,83.47,1.98,14.54,2019,44677
352,6,40,398,88.44,1.51,10.05,2019,44251
764,128,100,992,77.02,12.9,10.08,2019,44423
1145,79,132,1356,84.44,5.83,9.73,2019,44234
11047,313,1401,12761,86.57,2.45,10.98,2019,44281
482,51,37,570,84.56,8.95,6.49,2019,44010
6307,129,766,7202,87.57,1.79,10.64,2019,44017
11572,379,984,12935,89.46,2.93,7.61,2019,44039
7944,881,2655,11480,69.2,7.67,23.13,2019,44052
1556,19,214,1789,86.98,1.06,11.96,2019,44065
5702,244,662,6608,86.29,3.69,10.02,2019,44089
3958,113,823,4894,80.87,2.31,16.82,2019,44090
3633,301,3241,7175,50.63,4.2,45.17,2019,44103
4409,104,1260,5773,76.37,1.8,21.83,2019,44119
5267,87,815,6169,85.38,1.41,13.21,2019,44301
7546,331,1711,9588,78.7,3.45,17.85,2019,44305
7206,366,1561,9133,78.9,4.01,17.09,2019,44306
2012,213,748,2973,67.68,7.16,25.16,2019,44307
11426,282,1800,13508,84.59,2.09,13.33,2019,44312
7969,334,1423,9726,81.94,3.43,14.63,2019,44319
6501,173,717,7391,87.96,2.34,9.7,2019,44333
557,4,59,620,89.84,0.65,9.52,2019,44404
1731,13,390,2134,81.12,0.61,18.28,2019,44644
396,3,20,419,94.51,0.72,4.77,2019,44682
868,11,264,1143,75.94,0.96,23.1,2019,44822
11934,245,2193,14372,83.04,1.7,15.26,2019,44095
7843,225,1030,9098,86.21,2.47,11.32,2019,44116
232,7,63,302,76.82,2.32,20.86,2019,44651
218,6,157,381,57.22,1.57,41.21,2019,44699
1030,36,114,1180,87.29,3.05,9.66,2019,44401
1134,106,227,1467,77.3,7.23,15.47,2019,44470
6986,303,1851,9140,76.43,3.32,20.25,2019,44511
809,24,115,948,85.34,2.53,12.13,2019,44645
100,88,330,518,19.31,16.99,63.71,2019,44702
756,19,142,917,82.44,2.07,15.49,2019,44843
5387,149,1310,6846,78.69,2.18,19.14,2019,44907
151,10,36,197,76.65,5.08,18.27,2019,44844
978,88,199,1265,77.31,6.96,15.73,2019,44864
101,3,13,117,86.32,2.56,11.11,2019,44874
175,1,23,199,87.94,0.5,11.56,2019,44045
0,0,0,0,,,,2019,44101
6864,107,525,7496,91.57,1.43,7.0,2019,44149
0,0,0,0,,,,2019,44265
46,0,0,46,100.0,0.0,0.0,2019,44274
5,0,5,10,50.0,0.0,50.0,2019,44285
66,14,9,89,74.16,15.73,10.11,2019,44439
29,0,0,29,100.0,0.0,0.0,2019,44493
30,0,18,48,62.5,0.0,37.5,2019,44607
0,0,0,0,,,,2019,44652
8,0,19,27,29.63,0.0,70.37,2019,44687
0,0,0,0,,,,2019,48667
0,0,0,0,,,,2019,48710
12,0,0,12,100.0,0.0,0.0,2019,48816
0,0,0,0,,,,2019,48825
4928,203,705,5836,84.44,3.48,12.08,2019,48855
55,0,2,57,96.49,0.0,3.51,2019,48870
0,0,0,0,,,,2019,48921
5667,212,897,6776,83.63,3.13,13.24,2019,48879
5185,775,3519,9479,54.7,8.18,37.12,2019,48204
9076,87,394,9557,94.97,0.91,4.12,2019,48306
1264,19,179,1462,86.46,1.3,12.24,2019,48418
7978,92,327,8397,95.01,1.1,3.89,2019,48331
4951,9,521,5481,90.33,0.16,9.51,2019,48381
158,51,103,312,50.64,16.35,33.01,2019,48470
10324,100,726,11150,92.59,0.9,6.51,2019,48108
3157,142,553,3852,81.96,3.69,14.36,2019,48117
10122,376,2083,12581,80.45,2.99,16.56,2019,48127
7074,400,715,8189,86.38,4.88,8.73,2019,48134
4034,226,432,4692,85.98,4.82,9.21,2019,48173
1615,439,1001,3055,52.86,14.37,32.77,2019,48218
13284,544,2185,16013,82.96,3.4,13.65,2019,48198
7904,759,2891,11554,68.41,6.57,25.02,2019,48207
5659,184,2915,8758,64.62,2.1,33.28,2019,48210
12889,1152,5330,19371,66.54,5.95,27.52,2019,48219
8266,187,705,9158,90.26,2.04,7.7,2019,48346
2978,78,260,3316,89.81,2.35,7.84,2019,48356
4483,25,151,4659,96.22,0.54,3.24,2019,48360
5460,81,445,5986,91.21,1.35,7.43,2019,48362
843,51,264,1158,72.8,4.4,22.8,2019,48427
203,0,107,310,65.48,0.0,34.52,2019,48437
2296,20,136,2452,93.64,0.82,5.55,2019,48438
17805,534,1417,19756,90.12,2.7,7.17,2019,48439
22,0,30,52,42.31,0.0,57.69,2019,48440
10186,160,516,10862,93.78,1.47,4.75,2019,48042
1806,32,219,2057,87.8,1.56,10.65,2019,48005
1030,40,162,1232,83.6,3.25,13.15,2019,48027
13279,542,2593,16414,80.9,3.3,15.8,2019,48060
1245,22,214,1481,84.06,1.49,14.45,2019,48064
11268,253,791,12312,91.52,2.05,6.42,2019,48067
7766,196,1261,9223,84.2,2.13,13.67,2019,48075
1505,98,441,2044,73.63,4.79,21.58,2019,48097
6680,70,285,7035,94.95,1.0,4.05,2019,48098
14822,859,705,16386,90.46,5.24,4.3,2019,48104
1462,59,278,1799,81.27,3.28,15.45,2019,48892
6308,339,1154,7801,80.86,4.35,14.79,2019,48912
9800,399,1841,12040,81.4,3.31,15.29,2019,48446
4506,78,290,4874,92.45,1.6,5.95,2019,48462
1437,23,275,1735,82.82,1.33,15.85,2019,48463
652,13,135,800,81.5,1.62,16.88,2019,48464
836,67,230,1133,73.79,5.91,20.3,2019,48467
461,11,101,573,80.45,1.92,17.63,2019,48469
3972,722,3616,8310,47.8,8.69,43.51,2019,48505
2382,25,218,2625,90.74,0.95,8.3,2019,48611
2793,151,986,3930,71.07,3.84,25.09,2019,48612
270,6,150,426,63.38,1.41,35.21,2019,48613
914,51,201,1166,78.39,4.37,17.24,2019,48615
1505,77,478,2060,73.06,3.74,23.2,2019,48618
171,4,82,257,66.54,1.56,31.91,2019,48619
3663,212,1090,4965,73.78,4.27,21.95,2019,48723
137,0,45,182,75.27,0.0,24.73,2019,59740
61,4,13,78,78.21,5.13,16.67,2019,59747
504,31,171,706,71.39,4.39,24.22,2019,59758
6226,39,307,6572,94.74,0.59,4.67,2019,59803
136,1,52,189,71.96,0.53,27.51,2019,59831
2169,70,137,2376,91.29,2.95,5.77,2019,59847
63,3,11,77,81.82,3.9,14.29,2019,59854
3579,181,645,4405,81.25,4.11,14.64,2019,59860
289,9,135,433,66.74,2.08,31.18,2019,59003
274,7,106,387,70.8,1.81,27.39,2019,66872
875,20,87,982,89.1,2.04,8.86,2019,66021
192,26,68,286,67.13,9.09,23.78,2019,66035
26964,537,939,28440,94.81,1.89,3.3,2019,66062
736,28,178,942,78.13,2.97,18.9,2019,66076
550,24,220,794,69.27,3.02,27.71,2019,66087
912,5,274,1191,76.57,0.42,23.01,2019,66090
9487,444,886,10817,87.7,4.1,8.19,2019,66215
179,1,29,209,85.65,0.48,13.88,2019,66093
95,3,42,140,67.86,2.14,30.0,2019,66094
7332,383,2585,10300,71.18,3.72,25.1,2019,66102
150,9,35,194,77.32,4.64,18.04,2019,66424
365,7,91,463,78.83,1.51,19.65,2019,66427
224,0,26,250,89.6,0.0,10.4,2019,66429
768,19,251,1038,73.99,1.83,24.18,2019,66439
637,53,60,750,84.93,7.07,8.0,2019,66531
393,26,73,492,79.88,5.28,14.84,2019,66543
153,2,34,189,80.95,1.06,17.99,2019,66552
331,146,301,778,42.54,18.77,38.69,2019,66603
1500,118,1459,3077,48.75,3.83,47.42,2019,66607
1266,139,789,2194,57.7,6.34,35.96,2019,66608
3663,226,804,4693,78.05,4.82,17.13,2019,66611
679,32,164,875,77.6,3.66,18.74,2019,66733
86,2,84,172,50.0,1.16,48.84,2019,66754
1073,28,179,1280,83.83,2.19,13.98,2019,66763
307,40,163,510,60.2,7.84,31.96,2019,66776
30,8,17,55,54.55,14.55,30.91,2019,66838
128,8,40,176,72.73,4.55,22.73,2019,66864
411,6,117,534,76.97,1.12,21.91,2019,66871
84,4,68,156,53.85,2.56,43.59,2019,66933
380,9,77,466,81.55,1.93,16.52,2019,66938
43,0,33,76,56.58,0.0,43.42,2019,66941
297,4,121,422,70.38,0.95,28.67,2019,66945
2008,52,372,2432,82.57,2.14,15.3,2019,66007
3610,105,581,4296,84.03,2.44,13.52,2019,66012
565,69,125,759,74.44,9.09,16.47,2019,66013
140,21,55,216,64.81,9.72,25.46,2019,66026
1430,106,15,1551,92.2,6.83,0.97,2019,66027
176,11,81,268,65.67,4.1,30.22,2019,66033
4784,65,390,5239,91.32,1.24,7.44,2019,66214
1948,72,382,2402,81.1,3.0,15.9,2019,66217
494,27,326,847,58.32,3.19,38.49,2019,66056
20587,313,1341,22241,92.56,1.41,6.03,2019,66061
4403,268,1580,6251,70.44,4.29,25.28,2019,66067
364,24,59,447,81.43,5.37,13.2,2019,66072
293,3,115,411,71.29,0.73,27.98,2019,66078
740,8,151,899,82.31,0.89,16.8,2019,66088
5288,120,92,5500,96.15,2.18,1.67,2019,66219
2228,7,137,2372,93.93,0.3,5.78,2019,66227
553,18,143,714,77.45,2.52,20.03,2019,66401
12,0,0,12,100.0,0.0,0.0,2019,44881
0,0,0,0,,,,2019,44901
3748,235,392,4375,85.67,5.37,8.96,2019,44044
5450,567,3772,9789,55.67,5.79,38.53,2019,44112
14426,205,1601,16232,88.87,1.26,9.86,2019,44224
1055,87,131,1273,82.88,6.83,10.29,2019,44275
66,14,9,89,74.16,15.73,10.11,2019,44049
695,40,219,954,72.85,4.19,22.96,2019,45629
543,15,198,756,71.83,1.98,26.19,2019,45153
1083,9,397,1489,72.73,0.6,26.66,2019,45167
1504,40,288,1832,82.1,2.18,15.72,2019,45169
1547,82,652,2281,67.82,3.59,28.58,2019,45207
2492,17,493,3002,83.01,0.57,16.42,2019,45217
5222,82,545,5849,89.28,1.4,9.32,2019,45233
16735,1059,3172,20966,79.82,5.05,15.13,2019,45601
3440,95,1079,4614,74.56,2.06,23.39,2019,45648
493,8,415,916,53.82,0.87,45.31,2019,45658
414,0,76,490,84.49,0.0,15.51,2019,45672
738,12,275,1025,72.0,1.17,26.83,2019,45679
3708,82,876,4666,79.47,1.76,18.77,2019,45694
97,1,62,160,60.62,0.62,38.75,2019,45698
661,26,342,1029,64.24,2.53,33.24,2019,45715
123,4,56,183,67.21,2.19,30.6,2019,45734
593,21,204,818,72.49,2.57,24.94,2019,45761
911,64,345,1320,69.02,4.85,26.14,2019,45771
187,6,40,233,80.26,2.58,17.17,2019,45776
882,173,372,1427,61.81,12.12,26.07,2019,45780
977,30,352,1359,71.89,2.21,25.9,2019,45784
1101,62,339,1502,73.3,4.13,22.57,2019,45813
6892,234,1021,8147,84.6,2.87,12.53,2019,45822
2079,25,240,2344,88.69,1.07,10.24,2019,45828
160,5,49,214,74.77,2.34,22.9,2019,45835
263,27,78,368,71.47,7.34,21.2,2019,45841
1041,56,133,1230,84.63,4.55,10.81,2019,45844
1232,38,237,1507,81.75,2.52,15.73,2019,45846
453,13,58,524,86.45,2.48,11.07,2019,45853
59,1,6,66,89.39,1.52,9.09,2019,45855
1420,60,425,1905,74.54,3.15,22.31,2019,45856
139,0,52,191,72.77,0.0,27.23,2019,45859
1690,12,201,1903,88.81,0.63,10.56,2019,45869
1923,92,482,2497,77.01,3.68,19.3,2019,45879
834,22,243,1099,75.89,2.0,22.11,2019,45880
1148,37,161,1346,85.29,2.75,11.96,2019,45883
256,1,55,312,82.05,0.32,17.63,2019,45894
11070,198,932,12200,90.74,1.62,7.64,2019,45036
19266,127,796,20189,95.43,0.63,3.94,2019,45040
918,0,145,1063,86.36,0.0,13.64,2019,45054
7580,458,619,8657,87.56,5.29,7.15,2019,45056
17,0,3,20,85.0,0.0,15.0,2019,45112
7,0,31,38,18.42,0.0,81.58,2019,45115
401,11,125,537,74.67,2.05,23.28,2019,45148
11274,411,1412,13097,86.08,3.14,10.78,2019,45150
415,6,195,616,67.37,0.97,31.66,2019,45168
2773,179,703,3655,75.87,4.9,19.23,2019,45176
5259,84,627,5970,88.09,1.41,10.5,2019,45209
8716,378,1662,10756,81.03,3.51,15.45,2019,45042
8093,208,306,8607,94.03,2.42,3.56,2019,45066
7522,108,861,8491,88.59,1.27,10.14,2019,45102
3862,128,655,4645,83.14,2.76,14.1,2019,45106
766,30,115,911,84.08,3.29,12.62,2019,48628
2612,87,658,3357,77.81,2.59,19.6,2019,48657
326,19,88,433,75.29,4.39,20.32,2019,48727
405,31,163,599,67.61,5.18,27.21,2019,48729
1835,28,365,2228,82.36,1.26,16.38,2019,48730
37,0,0,37,100.0,0.0,0.0,2019,48743
3362,177,543,4082,82.36,4.34,13.3,2019,48750
330,27,167,524,62.98,5.15,31.87,2019,48766
6675,139,1068,7882,84.69,1.76,13.55,2019,48813
4015,201,770,4986,80.53,4.03,15.44,2019,48836
5714,201,1576,7491,76.28,2.68,21.04,2019,48838
1864,42,402,2308,80.76,1.82,17.42,2019,48849
8166,541,455,9162,89.13,5.9,4.97,2019,48864
420,3,66,489,85.89,0.61,13.5,2019,48873
8497,209,1869,10575,80.35,1.98,17.67,2019,48906
1788,109,292,2189,81.68,4.98,13.34,2019,48120
474,0,129,603,78.61,0.0,21.39,2019,48157
7525,226,568,8319,90.46,2.72,6.83,2019,48176
5026,187,444,5657,88.85,3.31,7.85,2019,48189
1404,23,159,1586,88.52,1.45,10.03,2019,48191
5278,677,1913,7868,67.08,8.6,24.31,2019,48213
1741,116,605,2462,70.71,4.71,24.57,2019,48216
7674,595,1830,10099,75.99,5.89,18.12,2019,48223
4385,165,912,5462,80.28,3.02,16.7,2019,48225
10007,279,888,11174,89.56,2.5,7.95,2019,48309
2942,86,362,3390,86.78,2.54,10.68,2019,48062
4119,131,605,4855,84.84,2.7,12.46,2019,48079
3573,103,560,4236,84.35,2.43,13.22,2019,48040
2454,0,139,2593,94.64,0.0,5.36,2019,48380
9577,148,1150,10875,88.06,1.36,10.57,2019,48315
6098,82,206,6386,95.49,1.28,3.23,2019,48324
5009,215,1576,6800,73.66,3.16,23.18,2019,48341
4191,23,442,4656,90.01,0.49,9.49,2019,48383
1718,112,516,2346,73.23,4.77,21.99,2019,48450
454,31,177,662,68.58,4.68,26.74,2019,48472
772,53,266,1091,70.76,4.86,24.38,2019,48475
9270,504,3446,13220,70.12,3.81,26.07,2019,48507
2631,148,878,3657,71.94,4.05,24.01,2019,48529
4403,74,315,4792,91.88,1.54,6.57,2019,48623
59,0,9,68,86.76,0.0,13.24,2019,48633
1234,29,642,1905,64.78,1.52,33.7,2019,48647
1930,48,226,2204,87.57,2.18,10.25,2019,48049
8878,196,2710,11784,75.34,1.66,23.0,2019,48091
9895,1258,1786,12939,76.47,9.72,13.8,2019,48126
3441,110,285,3836,89.7,2.87,7.43,2019,48128
6373,394,2235,9002,70.8,4.38,24.83,2019,48141
3372,78,394,3844,87.72,2.03,10.25,2019,48144
6409,125,519,7053,90.87,1.77,7.36,2019,48386
6864,250,830,7944,86.4,3.15,10.45,2019,48334
8332,131,631,9094,91.62,1.44,6.94,2019,48371
7907,114,394,8415,93.96,1.35,4.68,2019,48382
9473,127,823,10423,90.89,1.22,7.9,2019,48390
6566,110,580,7256,90.49,1.52,7.99,2019,48393
1611,97,279,1987,81.08,4.88,14.04,2019,48412
6309,62,289,6660,94.73,0.93,4.34,2019,48084
6053,475,1096,7624,79.39,6.23,14.38,2019,48125
0,0,0,0,,,,2019,48143
9431,118,842,10391,90.76,1.14,8.1,2019,48150
18549,2282,3199,24030,77.19,9.5,13.31,2019,48180
44,0,33,77,57.14,0.0,42.86,2019,69144
233,15,69,317,73.5,4.73,21.77,2019,69149
414,31,101,546,75.82,5.68,18.5,2019,69154
174,11,33,218,79.82,5.05,15.14,2019,69169
65,0,11,76,85.53,0.0,14.47,2019,69219
27,0,0,27,100.0,0.0,0.0,2019,69331
625,21,140,786,79.52,2.67,17.81,2019,69022
42,0,39,81,51.85,0.0,48.15,2019,69026
33,3,3,39,84.62,7.69,7.69,2019,69036
85,5,10,100,85.0,5.0,10.0,2019,58476
58,9,40,107,54.21,8.41,37.38,2019,58357
87,2,30,119,73.11,1.68,25.21,2019,58365
1280,25,336,1641,78.0,1.52,20.48,2019,58368
64,4,39,107,59.81,3.74,36.45,2019,58379
60,0,11,71,84.51,0.0,15.49,2019,58385
48,1,10,59,81.36,1.69,16.95,2019,58415
79,2,26,107,73.83,1.87,24.3,2019,58420
52,0,26,78,66.67,0.0,33.33,2019,58422
71,18,27,116,61.21,15.52,23.28,2019,58444
124,1,38,163,76.07,0.61,23.31,2019,58448
64,9,24,97,65.98,9.28,24.74,2019,58464
39,0,24,63,61.9,0.0,38.1,2019,58478
75,0,12,87,86.21,0.0,13.79,2019,58479
84,13,54,151,55.63,8.61,35.76,2019,58480
75,0,23,98,76.53,0.0,23.47,2019,62323
626,29,113,768,81.51,3.78,14.71,2019,58251
231,9,73,313,73.8,2.88,23.32,2019,58741
171,7,19,197,86.8,3.55,9.64,2019,58750
739,202,232,1173,63.0,17.22,19.78,2019,58763
32,42,25,99,32.32,42.42,25.25,2019,58769
238,2,39,279,85.3,0.72,13.98,2019,58781
891,114,195,1200,74.25,9.5,16.25,2019,58784
54,5,14,73,73.97,6.85,19.18,2019,58787
66,11,28,105,62.86,10.48,26.67,2019,58830
53,23,3,79,67.09,29.11,3.8,2019,58833
55,8,29,92,59.78,8.7,31.52,2019,58835
276,43,77,396,69.7,10.86,19.44,2019,58575
157,1,16,174,90.23,0.57,9.2,2019,58580
629,13,161,803,78.33,1.62,20.05,2019,58639
518,41,81,640,80.94,6.41,12.66,2019,58640
395,9,96,500,79.0,1.8,19.2,2019,58646
349,25,92,466,74.89,5.36,19.74,2019,58652
35,1,13,49,71.43,2.04,26.53,2019,58712
560,40,37,637,87.91,6.28,5.81,2019,58722
78,17,27,122,63.93,13.93,22.13,2019,58727
93,0,37,130,71.54,0.0,28.46,2019,58760
160,2,20,182,87.91,1.1,10.99,2019,58783
9909,1594,1154,12657,78.29,12.59,9.12,2019,58801
68,2,11,81,83.95,2.47,13.58,2019,58838
337,16,80,433,77.83,3.7,18.48,2019,58366
433,26,193,652,66.41,3.99,29.6,2019,58367
311,24,97,432,71.99,5.56,22.45,2019,58369
150,0,47,197,76.14,0.0,23.86,2019,58418
427,10,81,518,82.43,1.93,15.64,2019,58458
235,28,109,372,63.17,7.53,29.3,2019,58463
383,33,57,473,80.97,6.98,12.05,2019,58482
83,10,4,97,85.57,10.31,4.12,2019,58486
138,25,97,260,53.08,9.62,37.31,2019,58544
84,12,13,109,77.06,11.01,11.93,2019,58565
83,0,26,109,76.15,0.0,23.85,2019,45131
1060,104,335,1499,70.71,6.94,22.35,2019,45142
248,11,128,387,64.08,2.84,33.07,2019,45160
1958,54,396,2408,81.31,2.24,16.45,2019,45171
744,0,28,772,96.37,0.0,3.63,2019,45174
10515,280,1051,11846,88.76,2.36,8.87,2019,45230
5448,501,710,6659,81.81,7.52,10.66,2019,45220
2403,45,149,2597,92.53,1.73,5.74,2019,45226
7118,230,1297,8645,82.34,2.66,15.0,2019,45227
9235,151,1610,10996,83.99,1.37,14.64,2019,45236
6977,325,2117,9419,74.07,3.45,22.48,2019,45237
8173,137,568,8878,92.06,1.54,6.4,2019,45255
18,0,0,18,100.0,0.0,0.0,2019,45301
358,0,71,429,83.45,0.0,16.55,2019,45312
1398,53,124,1575,88.76,3.37,7.87,2019,45315
835,3,191,1029,81.15,0.29,18.56,2019,45325
5360,125,966,6451,83.09,1.94,14.97,2019,45344
235,12,74,321,73.21,3.74,23.05,2019,45348
622,14,74,710,87.61,1.97,10.42,2019,45359
548,7,86,641,85.49,1.09,13.42,2019,45363
3267,61,1138,4466,73.15,1.37,25.48,2019,45402
2705,143,144,2992,90.41,4.78,4.81,2019,45409
1817,25,388,2230,81.48,1.12,17.4,2019,45416
518,0,99,617,83.95,0.0,16.05,2019,45418
2793,32,228,3053,91.48,1.05,7.47,2019,45430
8100,137,742,8979,90.21,1.53,8.26,2019,45440
11191,257,1059,12507,89.48,2.05,8.47,2019,45459
812,9,242,1063,76.39,0.85,22.77,2019,45613
1486,58,339,1883,78.92,3.08,18.0,2019,45644
67,0,27,94,71.28,0.0,28.72,2019,45671
3814,144,853,4811,79.28,2.99,17.73,2019,45680
627,23,365,1015,61.77,2.27,35.96,2019,45682
190,28,61,279,68.1,10.04,21.86,2019,45695
1288,63,466,1817,70.89,3.47,25.65,2019,45697
1179,37,265,1481,79.61,2.5,17.89,2019,45723
982,63,188,1233,79.64,5.11,15.25,2019,45742
8464,500,2261,11225,75.4,4.45,20.14,2019,45750
2559,134,427,3120,82.02,4.29,13.69,2019,45764
238,31,96,365,65.21,8.49,26.3,2019,45778
277,8,35,320,86.56,2.5,10.94,2019,45779
4733,265,1205,6203,76.3,4.27,19.43,2019,45804
4027,175,605,4807,83.77,3.64,12.59,2019,45807
98,8,22,128,76.56,6.25,17.19,2019,45808
6283,228,1832,8343,75.31,2.73,21.96,2019,45638
4243,288,620,5151,82.37,5.59,12.04,2019,45002
8631,1016,1070,10717,80.54,9.48,9.98,2019,45701
5197,127,1005,6329,82.11,2.01,15.88,2019,46774
853,68,180,1101,77.48,6.18,16.35,2019,46788
303,0,26,329,92.1,0.0,7.9,2019,46791
487,2,98,587,82.96,0.34,16.7,2019,46798
12971,305,1159,14435,89.86,2.11,8.03,2019,46835
12689,640,3114,16443,77.17,3.89,18.94,2019,46901
12513,682,2428,15623,80.09,4.37,15.54,2019,46902
40,0,3,43,93.02,0.0,6.98,2019,46930
988,91,163,1242,79.55,7.33,13.12,2019,46938
8100,392,2176,10668,75.93,3.67,20.4,2019,46947
157,0,78,235,66.81,0.0,33.19,2019,46950
587,32,116,735,79.86,4.35,15.78,2019,46951
6789,341,1774,8904,76.25,3.83,19.92,2019,46970
1138,0,106,1244,91.48,0.0,8.52,2019,46349
12403,285,2881,15569,79.66,1.83,18.5,2019,46368
264,16,22,302,87.42,5.3,7.28,2019,46374
109,0,45,154,70.78,0.0,29.22,2019,46377
12926,247,1322,14495,89.18,1.7,9.12,2019,46385
4715,147,1574,6436,73.26,2.28,24.46,2019,46408
29,0,0,29,100.0,0.0,0.0,2019,46502
1062,103,355,1520,69.87,6.78,23.36,2019,46510
10324,198,331,10853,95.13,1.82,3.05,2019,46530
472,17,123,612,77.12,2.78,20.1,2019,46532
860,54,143,1057,81.36,5.11,13.53,2019,46940
1081,121,222,1424,75.91,8.5,15.59,2019,46989
3544,189,520,4253,83.33,4.44,12.23,2019,46819
7751,60,486,8297,93.42,0.72,5.86,2019,46845
159,3,43,205,77.56,1.46,20.98,2019,46110
892,45,122,1059,84.23,4.25,11.52,2019,46130
18779,528,1928,21235,88.43,2.49,9.08,2019,46143
1403,120,542,2065,67.94,5.81,26.25,2019,46148
9399,285,1849,11533,81.5,2.47,16.03,2019,46151
249,14,208,471,52.87,2.97,44.16,2019,46156
7456,164,1178,8798,84.75,1.86,13.39,2019,46158
7866,495,1447,9808,80.2,5.05,14.75,2019,46202
9053,434,2110,11597,78.06,3.74,18.19,2019,46205
4326,196,997,5519,78.38,3.55,18.06,2019,46975
4490,228,2343,7061,63.59,3.23,33.18,2019,46404
11114,467,698,12279,90.51,3.8,5.68,2019,46217
10016,260,1311,11587,86.44,2.24,11.31,2019,46342
338,14,82,434,77.88,3.23,18.89,2019,46035
569,17,347,933,60.99,1.82,37.19,2019,46543
1201,66,254,1521,78.96,4.34,16.7,2019,46792
767,27,150,944,81.25,2.86,15.89,2019,46702
1031,48,333,1412,73.02,3.4,23.58,2019,46787
918,34,228,1180,77.8,2.88,19.32,2019,46065
1673,48,285,2006,83.4,2.39,14.21,2019,46121
331,13,85,429,77.16,3.03,19.81,2019,46180
3508,40,92,3640,96.37,1.1,2.53,2019,46259
14242,95,328,14665,97.12,0.65,2.24,2019,46037
12258,188,764,13210,92.79,1.42,5.78,2019,46062
107,0,10,117,91.45,0.0,8.55,2019,46146
15,0,0,15,100.0,0.0,0.0,2019,46183
9,0,8,17,52.94,0.0,47.06,2019,46704
34,0,0,34,100.0,0.0,0.0,2019,46771
26,0,0,26,100.0,0.0,0.0,2019,46786
248,12,64,324,76.54,3.7,19.75,2019,46915
0,10,0,10,0.0,100.0,0.0,2019,46922
33,3,9,45,73.33,6.67,20.0,2019,46967
91,0,15,106,85.85,0.0,14.15,2019,46984
1541,69,282,1892,81.45,3.65,14.9,2019,46126
101,0,0,101,100.0,0.0,0.0,2019,46998
3046,157,918,4121,73.91,3.81,22.28,2019,46001
6780,173,1266,8219,82.49,2.1,15.4,2019,46012
931,31,243,1205,77.26,2.57,20.17,2019,46030
95,17,0,112,84.82,15.18,0.0,2019,46290
6237,668,3460,10365,60.17,6.44,33.38,2019,46312
75,1,4,80,93.75,1.25,5.0,2019,46376
13705,416,2185,16306,84.05,2.55,13.4,2019,46383
3634,198,1084,4916,73.92,4.03,22.05,2019,46394
1365,44,1281,2690,50.74,1.64,47.62,2019,46402
2519,164,1816,4499,55.99,3.65,40.36,2019,46407
17991,556,3189,21736,82.77,2.56,14.67,2019,48185
22507,1078,1932,25517,88.2,4.22,7.57,2019,48197
3478,640,2525,6643,52.36,9.63,38.01,2019,48206
5397,832,3765,9994,54.0,8.32,37.67,2019,48238
428,10,74,512,83.59,1.95,14.45,2019,48649
1799,57,474,2330,77.21,2.45,20.34,2019,48651
716,27,265,1008,71.03,2.68,26.29,2019,48654
1353,51,388,1792,75.5,2.85,21.65,2019,48656
808,48,197,1053,76.73,4.56,18.71,2019,48725
577,5,121,703,82.08,0.71,17.21,2019,65254
1340,15,282,1637,81.86,0.92,17.23,2019,65255
131,0,24,155,84.52,0.0,15.48,2019,65260
402,40,235,677,59.38,5.91,34.71,2019,65263
395,33,338,766,51.57,4.31,44.13,2019,65786
905,31,343,1279,70.76,2.42,26.82,2019,65770
174,51,42,267,65.17,19.1,15.73,2019,65054
508,0,95,603,84.25,0.0,15.75,2019,65624
110,0,0,110,100.0,0.0,0.0,2019,65729
3609,233,830,4672,77.25,4.99,17.77,2019,65708
29,0,0,29,100.0,0.0,0.0,2019,65715
431,63,150,644,66.93,9.78,23.29,2019,65724
222,0,72,294,75.51,0.0,24.49,2019,65760
108,12,47,167,64.67,7.19,28.14,2019,65762
3,0,4,7,42.86,0.0,57.14,2019,65784
19845,2685,3305,25835,76.81,10.39,12.79,2019,65807
910,60,326,1296,70.22,4.63,25.15,2019,65231
187,26,82,295,63.39,8.81,27.8,2019,65262
55,0,11,66,83.33,0.0,16.67,2019,65282
90,7,18,115,78.26,6.09,15.65,2019,65001
2268,318,853,3439,65.95,9.25,24.8,2019,65608
62,0,13,75,82.67,0.0,17.33,2019,65690
250,0,25,275,90.91,0.0,9.09,2019,65247
10616,314,1534,12464,85.17,2.52,12.31,2019,65714
142,11,58,211,67.3,5.21,27.49,2019,66833
210,8,19,237,88.61,3.38,8.02,2019,66840
72,2,42,116,62.07,1.72,36.21,2019,66758
141,2,69,212,66.51,0.94,32.55,2019,66767
32,1,24,57,56.14,1.75,42.11,2019,66782
107,3,77,187,57.22,1.6,41.18,2019,66842
75,1,19,95,78.95,1.05,20.0,2019,66850
233,6,46,285,81.75,2.11,16.14,2019,66852
142,4,46,192,73.96,2.08,23.96,2019,66853
123,5,40,168,73.21,2.98,23.81,2019,66858
433,18,159,610,70.98,2.95,26.07,2019,66860
86,2,20,108,79.63,1.85,18.52,2019,66930
134,29,72,235,57.02,12.34,30.64,2019,66939
45,2,30,77,58.44,2.6,38.96,2019,66944
26,0,35,61,42.62,0.0,57.38,2019,66946
29,0,10,39,74.36,0.0,25.64,2019,66955
882,79,364,1325,66.57,5.96,27.47,2019,66757
189,4,50,243,77.78,1.65,20.58,2019,66779
284,0,74,358,79.33,0.0,20.67,2019,66834
147,0,28,175,84.0,0.0,16.0,2019,66849
143,25,64,232,61.64,10.78,27.59,2019,66717
174,0,16,190,91.58,0.0,8.42,2019,66735
74,0,7,81,91.36,0.0,8.64,2019,66772
0,0,0,0,,,,2019,66778
68,0,36,104,65.38,0.0,34.62,2019,66859
190,3,111,304,62.5,0.99,36.51,2019,66869
33,1,6,40,82.5,2.5,15.0,2019,44825
5969,418,1364,7751,77.01,5.39,17.6,2019,44830
637,35,160,832,76.56,4.21,19.23,2019,43148
615,26,172,813,75.65,3.2,21.16,2019,43150
13242,583,2692,16517,80.17,3.53,16.3,2019,43204
10555,400,691,11646,90.63,3.43,5.93,2019,43212
11191,202,1035,12428,90.05,1.63,8.33,2019,43214
8376,272,1018,9666,86.65,2.81,10.53,2019,43215
5993,406,2434,8833,67.85,4.6,27.56,2019,43223
18310,264,2387,20961,87.35,1.26,11.39,2019,43229
7264,156,696,8116,89.5,1.92,8.58,2019,43231
15209,432,3303,18944,80.28,2.28,17.44,2019,43232
17344,343,713,18400,94.26,1.86,3.88,2019,43235
16098,487,3840,20425,78.82,2.38,18.8,2019,43302
5570,378,1343,7291,76.4,5.18,18.42,2019,43138
111,2,44,157,70.7,1.27,28.03,2019,43144
1927,36,85,2048,94.09,1.76,4.15,2019,43240
911,4,176,1091,83.5,0.37,16.13,2019,43310
1071,65,175,1311,81.69,4.96,13.35,2019,43324
934,0,153,1087,85.92,0.0,14.08,2019,43342
263,5,79,347,75.79,1.44,22.77,2019,43345
458,14,80,552,82.97,2.54,14.49,2019,43347
254,5,33,292,86.99,1.71,11.3,2019,43359
87,5,18,110,79.09,4.55,16.36,2019,43408
1240,25,181,1446,85.75,1.73,12.52,2019,43450
388,1,54,443,87.58,0.23,12.19,2019,43451
2445,75,161,2681,91.2,2.8,6.01,2019,43460
401,0,106,507,79.09,0.0,20.91,2019,43464
5032,87,1064,6183,81.38,1.41,17.21,2019,43506
417,16,72,505,82.57,3.17,14.26,2019,43511
1046,33,191,1270,82.36,2.6,15.04,2019,43469
9315,309,1903,11527,80.81,2.68,16.51,2019,43512
1832,70,366,2268,80.78,3.09,16.14,2019,43526
5464,201,699,6364,85.86,3.16,10.98,2019,43528
560,19,70,649,86.29,2.93,10.79,2019,43533
236,4,21,261,90.42,1.53,8.05,2019,43535
142,0,50,192,73.96,0.0,26.04,2019,43842
28,0,0,28,100.0,0.0,0.0,2019,43902
1756,14,512,2282,76.95,0.61,22.44,2019,43907
1136,46,255,1437,79.05,3.2,17.75,2019,43917
54,0,0,54,100.0,0.0,0.0,2019,43925
0,0,0,0,,,,2019,43967
25,0,0,25,100.0,0.0,0.0,2019,43972
21,0,16,37,56.76,0.0,43.24,2019,43974
10,0,0,10,100.0,0.0,0.0,2019,43032
112,0,26,138,81.16,0.0,18.84,2019,43036
7645,236,1083,8964,85.29,2.63,12.08,2019,43623
538,23,212,773,69.6,2.98,27.43,2019,43730
459,0,125,584,78.6,0.0,21.4,2019,43734
263,12,57,332,79.22,3.61,17.17,2019,43767
137,0,17,154,88.96,0.0,11.04,2019,43768
285,2,192,479,59.5,0.42,40.08,2019,43778
1372,48,661,2081,65.93,2.31,31.76,2019,43793
5822,282,1769,7873,73.95,3.58,22.47,2019,43812
647,4,598,1249,51.8,0.32,47.88,2019,43824
1888,100,1074,3062,61.66,3.27,35.08,2019,43832
1087,21,371,1479,73.5,1.42,25.08,2019,43844
1469,26,375,1870,78.56,1.39,20.05,2019,43845
1075,0,217,1292,83.2,0.0,16.8,2019,43910
13822,317,2342,16481,83.87,1.92,14.21,2019,46514
4270,236,647,5153,82.86,4.58,12.56,2019,46582
1374,45,334,1753,78.38,2.57,19.05,2019,46721
1541,27,102,1670,92.28,1.62,6.11,2019,46748
403,10,144,557,72.35,1.8,25.85,2019,46760
2498,85,1432,4015,62.22,2.12,35.67,2019,46761
531,36,131,698,76.07,5.16,18.77,2019,46776
1485,76,218,1779,83.47,4.27,12.25,2019,46793
1178,32,187,1397,84.32,2.29,13.39,2019,46797
1767,45,173,1985,89.02,2.27,8.72,2019,46391
20,0,0,20,100.0,0.0,0.0,2019,46045
650,47,141,838,77.57,5.61,16.83,2019,46056
443,20,54,517,85.69,3.87,10.44,2019,46057
404,0,156,560,72.14,0.0,27.86,2019,46531
1060,85,355,1500,70.67,5.67,23.67,2019,46542
8645,314,2462,11421,75.69,2.75,21.56,2019,46545
2881,181,1132,4194,68.69,4.32,26.99,2019,46550
124,94,5,223,55.61,42.15,2.24,2019,46556
1051,28,1322,2401,43.77,1.17,55.06,2019,46565
239,5,81,325,73.54,1.54,24.92,2019,46570
1206,245,781,2232,54.03,10.98,34.99,2019,46601
5706,164,581,6451,88.45,2.54,9.01,2019,46356
1608,70,453,2131,75.46,3.28,21.26,2019,46366
5341,161,204,5706,93.6,2.82,3.58,2019,46373
49,0,71,120,40.83,0.0,59.17,2019,46393
2067,49,718,2834,72.94,1.73,25.34,2019,46409
13583,64,261,13908,97.66,0.46,1.88,2019,46033
3600,169,968,4737,76.0,3.57,20.43,2019,46036
3055,65,680,3800,80.39,1.71,17.89,2019,46540
3044,191,579,3814,79.81,5.01,15.18,2019,46567
2482,198,961,3641,68.17,5.44,26.39,2019,46613
1599,114,401,2114,75.64,5.39,18.97,2019,46616
5255,386,1845,7486,70.2,5.16,24.65,2019,46619
2741,61,419,3221,85.1,1.89,13.01,2019,46701
1870,156,687,2713,68.93,5.75,25.32,2019,46711
626,45,506,1177,53.19,3.82,42.99,2019,46740
824,5,192,1021,80.71,0.49,18.81,2019,46747
8316,207,1273,9796,84.89,2.11,13.0,2019,46240
4184,131,919,5234,79.94,2.5,17.56,2019,46310
2608,64,539,3211,81.22,1.99,16.79,2019,46923
1827,118,233,2178,83.88,5.42,10.7,2019,46936
6012,734,1534,8280,72.61,8.86,18.53,2019,46952
174,26,57,257,67.7,10.12,22.18,2019,46957
36,0,0,36,100.0,0.0,0.0,2019,46968
859,16,163,1038,82.76,1.54,15.7,2019,46982
565,52,85,702,80.48,7.41,12.11,2019,46986
401,11,65,477,84.07,2.31,13.63,2019,45821
294,2,52,348,84.48,0.57,14.94,2019,45876
706,15,99,820,86.1,1.83,12.07,2019,45860
59,2,35,96,61.46,2.08,36.46,2019,45861
720,13,57,790,91.14,1.65,7.22,2019,45871
119,0,1,120,99.17,0.0,0.83,2019,45888
4578,158,721,5457,83.89,2.9,13.21,2019,45213
4559,164,832,5555,82.07,2.95,14.98,2019,45223
7565,267,1569,9401,80.47,2.84,16.69,2019,45224
5071,97,216,5384,94.19,1.8,4.01,2019,45243
9284,195,926,10405,89.23,1.87,8.9,2019,45244
7770,221,944,8935,86.96,2.47,10.57,2019,45251
1757,52,113,1922,91.42,2.71,5.88,2019,45252
1244,76,415,1735,71.7,4.38,23.92,2019,46511
9502,274,2061,11837,80.27,2.31,17.41,2019,46526
6502,155,1507,8164,79.64,1.9,18.46,2019,46528
10357,400,2093,12850,80.6,3.11,16.29,2019,46544
900,26,137,1063,84.67,2.45,12.89,2019,46553
568,9,824,1401,40.54,0.64,58.82,2019,46571
29,10,6,45,64.44,22.22,13.33,2019,46595
6141,331,1028,7500,81.88,4.41,13.71,2019,46703
477,64,163,704,67.76,9.09,23.15,2019,46705
4667,295,913,5875,79.44,5.02,15.54,2019,46714
219,0,40,259,84.56,0.0,15.44,2019,46731
246,7,40,293,83.96,2.39,13.65,2019,46766
2189,45,521,2755,79.46,1.63,18.91,2019,46767
5743,236,818,6797,84.49,3.47,12.03,2019,46011
6263,158,1506,7927,79.01,1.99,19.0,2019,46013
6282,330,1759,8371,75.04,3.94,21.01,2019,46041
1001,28,154,1183,84.62,2.37,13.02,2019,46044
2366,33,0,2399,98.62,1.38,0.0,2019,46075
67,3,16,86,77.91,3.49,18.6,2019,46111
579,67,132,778,74.42,8.61,16.97,2019,46115
25,0,0,25,100.0,0.0,0.0,2019,46125
89,0,29,118,75.42,0.0,24.58,2019,46127
633,26,60,719,88.04,3.62,8.34,2019,46149
1203,26,158,1387,86.73,1.87,11.39,2019,46157
515,25,99,639,80.59,3.91,15.49,2019,46171
6346,206,2011,8563,74.11,2.41,23.48,2019,46806
5948,226,467,6641,89.56,3.4,7.03,2019,46807
899,44,220,1163,77.3,3.78,18.92,2019,46910
727,38,221,986,73.73,3.85,22.41,2019,46919
43,7,39,89,48.31,7.87,43.82,2019,46931
5555,844,2107,8506,65.31,9.92,24.77,2019,46953
3821,151,596,4568,83.65,3.31,13.05,2019,46040
660,24,67,751,87.88,3.2,8.92,2019,46048
4218,16,173,4407,95.71,0.36,3.93,2019,46055
626,75,121,822,76.16,9.12,14.72,2019,46070
1098,58,183,1339,82.0,4.33,13.67,2019,46071
9879,168,349,10396,95.03,1.62,3.36,2019,46077
2011,0,378,2389,84.18,0.0,15.82,2019,46106
193,0,51,244,79.1,0.0,20.9,2019,46117
714,20,86,820,87.07,2.44,10.49,2019,46128
9935,361,1682,11978,82.94,3.01,14.04,2019,46131
255,29,53,337,75.67,8.61,15.73,2019,46133
1929,131,481,2541,75.91,5.16,18.93,2019,46160
4039,36,427,4502,89.72,0.8,9.48,2019,46163
416,36,152,604,68.87,5.96,25.17,2019,46165
1617,67,234,1918,84.31,3.49,12.2,2019,46181
526,0,131,657,80.06,0.0,19.94,2019,46182
540,54,102,696,77.59,7.76,14.66,2019,46186
6347,250,1775,8372,75.81,2.99,21.2,2019,46208
11011,477,4397,15885,69.32,3.0,27.68,2019,46219
8930,305,793,10028,89.05,3.04,7.91,2019,46239
8100,388,2150,10638,76.14,3.65,20.21,2019,46241
3096,23,155,3274,94.56,0.7,4.73,2019,46280
9403,156,1270,10829,86.83,1.44,11.73,2019,46815
2565,80,876,3521,72.85,2.27,24.88,2019,46803
10854,251,884,11989,90.53,2.09,7.37,2019,46804
6753,295,1331,8379,80.59,3.52,15.88,2019,46808
529,6,201,736,71.88,0.82,27.31,2019,46917
344,7,37,388,88.66,1.8,9.54,2019,46920
141,0,22,163,86.5,0.0,13.5,2019,66936
215,2,107,324,66.36,0.62,33.02,2019,66937
89,5,50,144,61.81,3.47,34.72,2019,66940
103,8,13,124,83.06,6.45,10.48,2019,66942
159,6,66,231,68.83,2.6,28.57,2019,66943
72,0,22,94,76.6,0.0,23.4,2019,66959
38,0,14,52,73.08,0.0,26.92,2019,66970
221,11,56,288,76.74,3.82,19.44,2019,66510
747,117,584,1448,51.59,8.08,40.33,2019,66612
67,0,18,85,78.82,0.0,21.18,2019,68960
119,11,62,192,61.98,5.73,32.29,2019,68360
824,25,181,1030,80.0,2.43,17.57,2019,68361
304,16,49,369,82.38,4.34,13.28,2019,68366
157,0,32,189,83.07,0.0,16.93,2019,68368
147,2,40,189,77.78,1.06,21.16,2019,68377
27,5,16,48,56.25,10.42,33.33,2019,68380
473,16,90,579,81.69,2.76,15.54,2019,68640
40,0,6,46,86.96,0.0,13.04,2019,68655
63,0,20,83,75.9,0.0,24.1,2019,68659
455,10,29,494,92.11,2.02,5.87,2019,68662
645,10,114,769,83.88,1.3,14.82,2019,68718
99,2,34,135,73.33,1.48,25.19,2019,68720
804,12,153,969,82.97,1.24,15.79,2019,68731
26,0,5,31,83.87,0.0,16.13,2019,68734
106,0,33,139,76.26,0.0,23.74,2019,68755
432,12,103,547,78.98,2.19,18.83,2019,68765
373,16,30,419,89.02,3.82,7.16,2019,68790
635,89,270,994,63.88,8.95,27.16,2019,68823
7063,237,875,8175,86.4,2.9,10.7,2019,68845
200,2,41,243,82.3,0.82,16.87,2019,68852
334,3,36,373,89.54,0.8,9.65,2019,68854
188,14,54,256,73.44,5.47,21.09,2019,68859
100,10,59,169,59.17,5.92,34.91,2019,68860
79,0,27,106,74.53,0.0,25.47,2019,68871
244,10,63,317,76.97,3.15,19.87,2019,68872
125,17,39,181,69.06,9.39,21.55,2019,68882
203,16,50,269,75.46,5.95,18.59,2019,68768
52,0,14,66,78.79,0.0,21.21,2019,68773
67,3,18,88,76.14,3.41,20.45,2019,68774
270,27,120,417,64.75,6.47,28.78,2019,68783
319,15,34,368,86.68,4.08,9.24,2019,68786
40,0,20,60,66.67,0.0,33.33,2019,68789
8820,275,1758,10853,81.27,2.53,16.2,2019,68801
8198,415,1300,9913,82.7,4.19,13.11,2019,68803
317,40,59,416,76.2,9.62,14.18,2019,68810
183,0,85,268,68.28,0.0,31.72,2019,68815
190,6,61,257,73.93,2.33,23.74,2019,68827
515,8,166,689,74.75,1.16,24.09,2019,68853
37,0,0,37,100.0,0.0,0.0,2019,68861
1006,47,277,1330,75.64,3.53,20.83,2019,68862
365,3,64,432,84.49,0.69,14.81,2019,68863
238,7,51,296,80.41,2.36,17.23,2019,68935
251,49,85,385,65.19,12.73,22.08,2019,68004
268,1,87,356,75.28,0.28,24.44,2019,68029
94,8,10,112,83.93,7.14,8.93,2019,68036
136,1,34,171,79.53,0.58,19.88,2019,68040
504,21,131,656,76.83,3.2,19.97,2019,68057
11550,259,2464,14273,80.92,1.81,17.26,2019,68104
10776,134,537,11447,94.14,1.17,4.69,2019,68116
531,11,211,753,70.52,1.46,28.02,2019,43933
19,0,0,19,100.0,0.0,0.0,2019,43951
2323,147,888,3358,69.18,4.38,26.44,2019,43906
18,0,29,47,38.3,0.0,61.7,2019,43928
85,0,96,181,46.96,0.0,53.04,2019,43934
2643,131,798,3572,73.99,3.67,22.34,2019,43935
789,28,440,1257,62.77,2.23,35.0,2019,43945
746,7,183,936,79.7,0.75,19.55,2019,43946
1958,150,651,2759,70.97,5.44,23.6,2019,43968
563,62,235,860,65.47,7.21,27.33,2019,43977
36,6,9,51,70.59,11.76,17.65,2019,43541
122,0,10,132,92.42,0.0,7.58,2019,43547
807,31,171,1009,79.98,3.07,16.95,2019,43554
6639,258,1839,8736,76.0,2.95,21.05,2019,43609
1813,132,531,2476,73.22,5.33,21.45,2019,43620
18054,635,4155,22844,79.03,2.78,18.19,2019,43701
593,32,99,724,81.91,4.42,13.67,2019,43739
1955,109,553,2617,74.7,4.17,21.13,2019,43713
933,48,217,1198,77.88,4.01,18.11,2019,43718
103,0,17,120,85.83,0.0,14.17,2019,43722
699,46,303,1048,66.7,4.39,28.91,2019,43748
937,39,261,1237,75.75,3.15,21.1,2019,43758
2402,155,625,3182,75.49,4.87,19.64,2019,43764
931,44,291,1266,73.54,3.48,22.99,2019,43773
232,10,85,327,70.95,3.06,25.99,2019,43811
270,10,142,422,63.98,2.37,33.65,2019,43843
308,3,225,536,57.46,0.56,41.98,2019,43915
810,58,228,1096,73.91,5.29,20.8,2019,43942
140,30,59,229,61.14,13.1,25.76,2019,43983
606,4,256,866,69.98,0.46,29.56,2019,43986
1859,72,365,2296,80.97,3.14,15.9,2019,43344
1367,51,164,1582,86.41,3.22,10.37,2019,43412
400,12,60,472,84.75,2.54,12.71,2019,43413
1027,20,294,1341,76.58,1.49,21.92,2019,43416
1354,28,404,1786,75.81,1.57,22.62,2019,43431
171,2,32,205,83.41,0.98,15.61,2019,43437
102,4,14,120,85.0,3.33,11.67,2019,43438
138,20,11,169,81.66,11.83,6.51,2019,43456
1164,27,165,1356,85.84,1.99,12.17,2019,43522
252,3,43,298,84.56,1.01,14.43,2019,43548
13994,417,1385,15796,88.59,2.64,8.77,2019,43551
7650,589,2225,10464,73.11,5.63,21.26,2019,43605
7148,229,1235,8612,83.0,2.66,14.34,2019,43616
336,4,181,521,64.49,0.77,34.74,2019,43720
454,8,174,636,71.38,1.26,27.36,2019,43732
147,0,0,147,100.0,0.0,0.0,2019,43735
307,15,158,480,63.96,3.12,32.92,2019,43754
408,21,132,561,72.73,3.74,23.53,2019,43760
1382,41,210,1633,84.63,2.51,12.86,2019,43762
1906,45,288,2239,85.13,2.01,12.86,2019,43830
475,50,151,676,70.27,7.4,22.34,2019,43837
614,14,152,780,78.72,1.79,19.49,2019,43901
406,0,172,578,70.24,0.0,29.76,2019,43908
491,9,142,642,76.48,1.4,22.12,2019,43913
51,0,16,67,76.12,0.0,23.88,2019,43914
814,25,90,929,87.62,2.69,9.69,2019,45303
2300,113,376,2789,82.47,4.05,13.48,2019,45304
4903,127,1028,6058,80.93,2.1,16.97,2019,45320
54,2,5,61,88.52,3.28,8.2,2019,45336
1266,94,248,1608,78.73,5.85,15.42,2019,45341
13849,323,1649,15821,87.54,2.04,10.42,2019,45342
53,0,11,64,82.81,0.0,17.19,2019,45353
9416,302,1903,11621,81.03,2.6,16.38,2019,45365
362,31,60,453,79.91,6.84,13.25,2019,45382
4500,158,1061,5719,78.69,2.76,18.55,2019,45403
4927,107,649,5683,86.7,1.88,11.42,2019,45415
17224,524,1546,19294,89.27,2.72,8.01,2019,45424
10781,248,1100,12129,88.89,2.04,9.07,2019,45431
565,0,17,582,97.08,0.0,2.92,2019,45433
4240,157,283,4680,90.6,3.35,6.05,2019,45434
3065,117,908,4090,74.94,2.86,22.2,2019,45439
5539,75,747,6361,87.08,1.18,11.74,2019,45502
11999,361,1942,14302,83.9,2.52,13.58,2019,45503
817,26,297,1140,71.67,2.28,26.05,2019,45623
344,3,42,389,88.43,0.77,10.8,2019,45867
1214,63,262,1539,78.88,4.09,17.02,2019,45872
514,20,50,584,88.01,3.42,8.56,2019,45889
2421,96,383,2900,83.48,3.31,13.21,2019,45383
7647,200,953,8800,86.9,2.27,10.83,2019,45322
308,0,32,340,90.59,0.0,9.41,2019,45330
179,0,71,250,71.6,0.0,28.4,2019,45354
3381,83,903,4367,77.42,1.9,20.68,2019,45404
6351,125,1621,8097,78.44,1.54,20.02,2019,45405
91,0,32,123,73.98,0.0,26.02,2019,45621
0,0,57,57,0.0,0.0,100.0,2019,45622
0,0,0,0,,,,2019,45624
1670,143,192,2005,83.29,7.13,9.58,2019,45628
482,0,155,637,75.67,0.0,24.33,2019,45681
4615,315,1219,6149,75.05,5.12,19.82,2019,45631
350,89,81,520,67.31,17.12,15.58,2019,45654
1925,102,717,2744,70.15,3.72,26.13,2019,45661
2577,73,756,3406,75.66,2.14,22.2,2019,45692
484,0,278,762,63.52,0.0,36.48,2019,45696
3077,139,807,4023,76.49,3.46,20.06,2019,45714
1749,69,784,2602,67.22,2.65,30.13,2019,45769
6605,100,1175,7880,83.82,1.27,14.91,2019,45030
0,0,0,0,,,,2019,45041
967,32,121,1120,86.34,2.86,10.8,2019,45053
17781,354,824,18959,93.79,1.87,4.35,2019,45069
1282,30,168,1480,86.62,2.03,11.35,2019,45118
86,0,58,144,59.72,0.0,40.28,2019,45132
3575,65,388,4028,88.75,1.61,9.63,2019,45152
86,4,19,109,78.9,3.67,17.43,2019,45164
12800,486,2093,15379,83.23,3.16,13.61,2019,45211
1674,15,356,2045,81.86,0.73,17.41,2019,45318
22,0,0,22,100.0,0.0,0.0,2019,45773
129,2,8,139,92.81,1.44,5.76,2019,45816
1087,48,310,1445,75.22,3.32,21.45,2019,45843
225,10,66,301,74.75,3.32,21.93,2019,45851
1044,12,114,1170,89.23,1.03,9.74,2019,45858
2997,143,661,3801,78.85,3.76,17.39,2019,45669
664,9,223,896,74.11,1.0,24.89,2019,45645
639,42,343,1024,62.4,4.1,33.5,2019,45647
1784,41,755,2580,69.15,1.59,29.26,2019,45656
1400,109,239,1748,80.09,6.24,13.67,2019,46928
1500,103,386,1989,75.41,5.18,19.41,2019,46554
1003,25,159,1187,84.5,2.11,13.4,2019,46555
2641,130,806,3577,73.83,3.63,22.53,2019,46574
1615,84,82,1781,90.68,4.72,4.6,2019,46590
6249,262,1195,7706,81.09,3.4,15.51,2019,46706
2685,38,419,3142,85.46,1.21,13.34,2019,46723
376,0,80,456,82.46,0.0,17.54,2019,46730
1027,39,171,1237,83.02,3.15,13.82,2019,46773
110,0,121,231,47.62,0.0,52.38,2019,47270
7448,462,938,8848,84.18,5.22,10.6,2019,47408
8782,327,2261,11370,77.24,2.88,19.89,2019,47421
2753,58,1073,3884,70.88,1.49,27.63,2019,47441
2602,198,501,3301,78.82,6.0,15.18,2019,47448
234,0,33,267,87.64,0.0,12.36,2019,47453
2023,177,680,2880,70.24,6.15,23.61,2019,47454
191,14,19,224,85.27,6.25,8.48,2019,47519
186,13,50,249,74.7,5.22,20.08,2019,47524
457,42,609,1108,41.25,3.79,54.96,2019,47558
586,16,186,788,74.37,2.03,23.6,2019,47272
85,14,29,128,66.41,10.94,22.66,2019,47282
6594,333,2335,9262,71.19,3.6,25.21,2019,47331
409,0,90,499,81.96,0.0,18.04,2019,47386
1617,77,491,2185,74.0,3.52,22.47,2019,47353
650,4,255,909,71.51,0.44,28.05,2019,47634
251,53,123,427,58.78,12.41,28.81,2019,47003
952,47,143,1142,83.36,4.12,12.52,2019,47022
519,16,138,673,77.12,2.38,20.51,2019,47030
883,50,181,1114,79.26,4.49,16.25,2019,47032
403,1,187,591,68.19,0.17,31.64,2019,47038
100,0,18,118,84.75,0.0,15.25,2019,47114
348,11,226,585,59.49,1.88,38.63,2019,47564
286,48,144,478,59.83,10.04,30.13,2019,47577
134,12,89,235,57.02,5.11,37.87,2019,47585
278,12,68,358,77.65,3.35,18.99,2019,47597
467,1,209,677,68.98,0.15,30.87,2019,47649
11427,347,2249,14023,81.49,2.47,16.04,2019,47714
10909,377,1767,13053,83.57,2.89,13.54,2019,47715
3657,43,1030,4730,77.32,0.91,21.78,2019,47804
573,3,171,747,76.71,0.4,22.89,2019,47838
3520,140,635,4295,81.96,3.26,14.78,2019,47842
0,0,0,0,,,,2019,47876
14679,686,1593,16958,86.56,4.05,9.39,2019,47909
456,19,110,585,77.95,3.25,18.8,2019,47922
95,0,0,95,100.0,0.0,0.0,2019,47924
631,8,145,784,80.48,1.02,18.49,2019,47928
497,9,51,557,89.23,1.62,9.16,2019,47941
225,37,54,316,71.2,11.71,17.09,2019,47943
743,17,102,862,86.19,1.97,11.83,2019,47946
485,5,107,597,81.24,0.84,17.92,2019,47948
405,2,61,468,86.54,0.43,13.03,2019,47949
446,3,283,732,60.93,0.41,38.66,2019,47957
1261,21,294,1576,80.01,1.33,18.65,2019,47018
2101,169,241,2511,83.67,6.73,9.6,2019,47041
1738,47,605,2390,72.72,1.97,25.31,2019,47043
1701,118,737,2556,66.55,4.62,28.83,2019,47102
179,0,86,265,67.55,0.0,32.45,2019,47116
3496,102,570,4168,83.88,2.45,13.68,2019,47119
1324,46,329,1699,77.93,2.71,19.36,2019,47124
506,14,77,597,84.76,2.35,12.9,2019,68715
256,32,143,431,59.4,7.42,33.18,2019,68716
608,21,209,838,72.55,2.51,24.94,2019,68729
3850,113,156,4119,93.47,2.74,3.79,2019,68007
10,3,0,13,76.92,23.08,0.0,2019,68010
139,10,14,163,85.28,6.13,8.59,2019,68019
10256,426,1997,12679,80.89,3.36,15.75,2019,68025
114,6,34,154,74.03,3.9,22.08,2019,67109
444,14,106,564,78.72,2.48,18.79,2019,67119
1117,44,321,1482,75.37,2.97,21.66,2019,71227
741,30,223,994,74.55,3.02,22.43,2019,71238
162,0,206,368,44.02,0.0,55.98,2019,71256
788,0,165,953,82.69,0.0,17.31,2019,71275
1226,144,318,1688,72.63,8.53,18.84,2019,71280
3359,180,1599,5138,65.38,3.5,31.12,2019,71302
238,15,85,338,70.41,4.44,25.15,2019,71323
2328,207,1355,3890,59.85,5.32,34.83,2019,71052
199,38,67,304,65.46,12.5,22.04,2019,71063
11461,2782,3172,17415,65.81,15.97,18.21,2019,71111
7813,148,1463,9424,82.91,1.57,15.52,2019,71118
852,29,389,1270,67.09,2.28,30.63,2019,71234
857,9,166,1032,83.04,0.87,16.09,2019,71268
256,0,280,536,47.76,0.0,52.24,2019,71277
6211,258,1669,8138,76.32,3.17,20.51,2019,71301
2328,14,349,2691,86.51,0.52,12.97,2019,71328
907,63,309,1279,70.91,4.93,24.16,2019,71341
156,48,105,309,50.49,15.53,33.98,2019,71356
32,0,11,43,74.42,0.0,25.58,2019,58262
74,0,16,90,82.22,0.0,17.78,2019,58266
318,31,72,421,75.53,7.36,17.1,2019,58274
1364,112,599,2075,65.73,5.4,28.87,2019,58316
644,80,274,998,64.53,8.02,27.45,2019,58329
45,0,21,66,68.18,0.0,31.82,2019,58331
134,12,31,177,75.71,6.78,17.51,2019,58332
319,43,67,429,74.36,10.02,15.62,2019,58344
291,3,24,318,91.51,0.94,7.55,2019,58005
118,5,18,141,83.69,3.55,12.77,2019,58017
463,12,164,639,72.46,1.88,25.67,2019,58027
586,23,58,667,87.86,3.45,8.7,2019,58051
469,4,113,586,80.03,0.68,19.28,2019,58060
145,3,15,163,88.96,1.84,9.2,2019,58068
41,0,10,51,80.39,0.0,19.61,2019,58069
3246,185,532,3963,81.91,4.67,13.42,2019,58075
0,0,0,0,,,,2019,58202
134,3,33,170,78.82,1.76,19.41,2019,58210
283,8,48,339,83.48,2.36,14.16,2019,58218
11,0,3,14,78.57,0.0,21.43,2019,58224
337,10,81,428,78.74,2.34,18.93,2019,58225
38,0,28,66,57.58,0.0,42.42,2019,58241
150,15,70,235,63.83,6.38,29.79,2019,58276
478,15,218,711,67.23,2.11,30.66,2019,58282
1406,35,277,1718,81.84,2.04,16.12,2019,58318
118,11,17,146,80.82,7.53,11.64,2019,58327
223,19,82,324,68.83,5.86,25.31,2019,58346
0,0,0,0,,,,2019,58362
164,58,169,391,41.94,14.83,43.22,2019,58370
101,0,15,116,87.07,0.0,12.93,2019,58424
267,21,54,342,78.07,6.14,15.79,2019,58438
65,7,25,97,67.01,7.22,25.77,2019,58460
136,6,29,171,79.53,3.51,16.96,2019,43961
27,0,6,33,81.82,0.0,18.18,2019,43962
602,0,412,1014,59.37,0.0,40.63,2019,43749
1938,78,776,2792,69.41,2.79,27.79,2019,43912
66,0,28,94,70.21,0.0,29.79,2019,43926
150,4,28,182,82.42,2.2,15.38,2019,43939
4204,174,711,5089,82.61,3.42,13.97,2019,43950
383,10,91,484,79.13,2.07,18.8,2019,43971
100,0,27,127,78.74,0.0,21.26,2019,43531
252,0,79,331,76.13,0.0,23.87,2019,43501
2116,67,346,2529,83.67,2.65,13.68,2019,43502
962,35,154,1151,83.58,3.04,13.38,2019,43516
491,12,70,573,85.69,2.09,12.22,2019,43540
996,16,245,1257,79.24,1.27,19.49,2019,43570
2506,26,232,2764,90.67,0.94,8.39,2019,43571
8315,538,1078,9931,83.73,5.42,10.85,2019,43606
6656,563,1810,9029,73.72,6.24,20.05,2019,43607
791,33,261,1085,72.9,3.04,24.06,2019,43719
0,18,29,47,0.0,38.3,61.7,2019,43721
39,0,28,67,58.21,0.0,41.79,2019,43005
18023,425,1536,19984,90.19,2.13,7.69,2019,43015
928,28,147,1103,84.13,2.54,13.33,2019,43022
9261,255,2213,11729,78.96,2.17,18.87,2019,43050
51,0,16,67,76.12,0.0,23.88,2019,43070
102,0,7,109,93.58,0.0,6.42,2019,43127
18938,835,3884,23657,80.05,3.53,16.42,2019,43130
856,6,185,1047,81.76,0.57,17.67,2019,43003
495,21,137,653,75.8,3.22,20.98,2019,43556
2601,30,120,2751,94.55,1.09,4.36,2019,43617
599,17,194,810,73.95,2.1,23.95,2019,43772
935,26,373,1334,70.09,1.95,27.96,2019,43943
52,0,0,52,100.0,0.0,0.0,2019,43030
35,26,0,61,57.38,42.62,0.0,2019,43117
30,0,11,41,73.17,0.0,26.83,2019,43330
0,0,5,5,0.0,0.0,100.0,2019,43403
25,0,16,41,60.98,0.0,39.02,2019,43433
20,0,4,24,83.33,0.0,16.67,2019,43434
28,2,9,39,71.79,5.13,23.08,2019,43446
0,9,26,35,0.0,25.71,74.29,2019,43463
30,0,11,41,73.17,0.0,26.83,2019,43505
67,0,28,95,70.53,0.0,29.47,2019,43519
10,0,0,10,100.0,0.0,0.0,2019,43523
17,0,8,25,68.0,0.0,32.0,2019,43711
8,0,0,8,100.0,0.0,0.0,2019,43733
13,2,14,29,44.83,6.9,48.28,2019,43736
19,0,21,40,47.5,0.0,52.5,2019,43750
14,3,7,24,58.33,12.5,29.17,2019,43759
24,0,0,24,100.0,0.0,0.0,2019,43761
7,0,5,12,58.33,0.0,41.67,2019,43786
0,0,42,42,0.0,0.0,100.0,2019,43805
103,0,101,204,50.49,0.0,49.51,2019,45673
80,0,12,92,86.96,0.0,13.04,2019,45674
99,6,106,211,46.92,2.84,50.24,2019,45688
4956,33,552,5541,89.44,0.6,9.96,2019,45249
803,10,115,928,86.53,1.08,12.39,2019,45306
1432,67,217,1716,83.45,3.9,12.65,2019,45308
1847,82,421,2350,78.6,3.49,17.91,2019,45311
271,12,70,353,76.77,3.4,19.83,2019,45321
3121,142,355,3618,86.26,3.92,9.81,2019,45327
7549,338,1875,9762,77.33,3.46,19.21,2019,45331
682,30,129,841,81.09,3.57,15.34,2019,45334
1653,101,284,2038,81.11,4.96,13.94,2019,45338
2146,56,504,2706,79.31,2.07,18.63,2019,45232
8112,125,481,8718,93.05,1.43,5.52,2019,45208
2310,182,1067,3559,64.91,5.11,29.98,2019,45214
1361,26,134,1521,89.48,1.71,8.81,2019,45218
15984,608,2466,19058,83.87,3.19,12.94,2019,45238
8707,207,1060,9974,87.3,2.08,10.63,2019,45240
7649,362,754,8765,87.27,4.13,8.6,2019,45245
1339,31,87,1457,91.9,2.13,5.97,2019,45302
1252,9,83,1344,93.15,0.67,6.18,2019,45314
292,0,55,347,84.15,0.0,15.85,2019,45317
1916,43,206,2165,88.5,1.99,9.52,2019,45323
529,29,47,605,87.44,4.79,7.77,2019,45337
147,2,9,158,93.04,1.27,5.7,2019,45349
7832,271,1780,9883,79.25,2.74,18.01,2019,45356
111,4,5,120,92.5,3.33,4.17,2019,45358
900,2,63,965,93.26,0.21,6.53,2019,45370
1021,19,251,1291,79.09,1.47,19.44,2019,45390
7227,198,1904,9329,77.47,2.12,20.41,2019,45406
5606,178,1318,7102,78.94,2.51,18.56,2019,45410
6560,201,1092,7853,83.53,2.56,13.91,2019,45449
4125,86,1010,5221,79.01,1.65,19.34,2019,45506
1066,131,602,1799,59.26,7.28,33.46,2019,45614
4896,229,1187,6312,77.57,3.63,18.81,2019,45640
1821,209,866,2896,62.88,7.22,29.9,2019,45660
220,16,162,398,55.28,4.02,40.7,2019,45678
1600,127,517,2244,71.3,5.66,23.04,2019,45710
108,9,70,187,57.75,4.81,37.43,2019,45716
126,13,35,174,72.41,7.47,20.11,2019,45740
106,0,46,152,69.74,0.0,30.26,2019,45746
522,19,206,747,69.88,2.54,27.58,2019,45772
49,0,50,99,49.49,0.0,50.51,2019,45789
7927,401,1224,9552,82.99,4.2,12.81,2019,45805
3383,79,795,4257,79.47,1.86,18.68,2019,45833
302,9,67,378,79.89,2.38,17.72,2019,45849
1654,37,218,1909,86.64,1.94,11.42,2019,45865
438,64,120,622,70.42,10.29,19.29,2019,45743
1108,26,453,1587,69.82,1.64,28.54,2019,45760
698,13,362,1073,65.05,1.21,33.74,2019,45767
392,15,253,660,59.39,2.27,38.33,2019,45768
6682,303,1694,8679,76.99,3.49,19.52,2019,45801
3854,101,500,4455,86.51,2.27,11.22,2019,45806
571,7,145,723,78.98,0.97,20.06,2019,45812
1027,31,158,1216,84.46,2.55,12.99,2019,45814
411,9,107,527,77.99,1.71,20.3,2019,47163
222,0,134,356,62.36,0.0,37.64,2019,47175
6704,293,1587,8584,78.1,3.41,18.49,2019,47240
395,27,281,703,56.19,3.84,39.97,2019,47260
331,0,201,532,62.22,0.0,37.78,2019,47281
8040,413,2472,10925,73.59,3.78,22.63,2019,47302
11214,658,1503,13375,83.84,4.92,11.24,2019,47304
119,0,99,218,54.59,0.0,45.41,2019,47325
353,84,189,626,56.39,13.42,30.19,2019,47326
934,102,138,1174,79.56,8.69,11.75,2019,47340
133,1,21,155,85.81,0.65,13.55,2019,47351
13861,1004,3771,18636,74.38,5.39,20.24,2019,47374
906,83,155,1144,79.2,7.26,13.55,2019,47383
384,24,98,506,75.89,4.74,19.37,2019,47393
0,0,0,0,,,,2019,47406
172,8,95,275,62.55,2.91,34.55,2019,47427
459,0,124,583,78.73,0.0,21.27,2019,47436
399,9,109,517,77.18,1.74,21.08,2019,47456
1029,18,351,1398,73.61,1.29,25.11,2019,47459
1290,24,366,1680,76.79,1.43,21.79,2019,47512
1403,24,292,1719,81.62,1.4,16.99,2019,47532
367,11,87,465,78.92,2.37,18.71,2019,47541
892,17,87,996,89.56,1.71,8.73,2019,47579
8480,129,1682,10291,82.4,1.25,16.34,2019,47591
895,50,177,1122,79.77,4.46,15.78,2019,47613
664,21,181,866,76.67,2.42,20.9,2019,47631
1224,7,276,1507,81.22,0.46,18.31,2019,47639
292,10,118,420,69.52,2.38,28.1,2019,47640
865,16,468,1349,64.12,1.19,34.69,2019,47879
2337,91,914,3342,69.93,2.72,27.35,2019,47882
63,0,23,86,73.26,0.0,26.74,2019,47884
1089,47,230,1366,79.72,3.44,16.84,2019,47923
273,7,37,317,86.12,2.21,11.67,2019,47942
235,0,64,299,78.6,0.0,21.4,2019,47950
813,16,100,929,87.51,1.72,10.76,2019,47954
35,0,25,60,58.33,0.0,41.67,2019,47958
296,23,112,431,68.68,5.34,25.99,2019,47354
267,22,97,386,69.17,5.7,25.13,2019,47358
262,6,51,319,82.13,1.88,15.99,2019,47975
728,0,195,923,78.87,0.0,21.13,2019,47977
346,9,31,386,89.64,2.33,8.03,2019,47991
29,0,10,39,74.36,0.0,25.64,2019,47969
517,4,67,588,87.93,0.68,11.39,2019,47995
3551,144,840,4535,78.3,3.18,18.52,2019,47006
1540,134,346,2020,76.24,6.63,17.13,2019,47031
1376,38,295,1709,80.51,2.22,17.26,2019,47037
1202,100,367,1669,72.02,5.99,21.99,2019,47042
611,7,297,915,66.78,0.77,32.46,2019,47108
4787,157,1082,6026,79.44,2.61,17.96,2019,47111
5569,210,2458,8237,67.61,2.55,29.84,2019,47129
12,0,19,31,38.71,0.0,61.29,2019,47160
484,13,112,609,79.47,2.13,18.39,2019,47230
6054,275,1928,8257,73.32,3.33,23.35,2019,47710
805,23,277,1105,72.85,2.08,25.07,2019,47633
29,3,6,38,76.32,7.89,15.79,2019,47654
482,23,211,716,67.32,3.21,29.47,2019,47666
300,7,37,344,87.21,2.03,10.76,2019,47833
6165,215,1378,7758,79.47,2.77,17.76,2019,47834
726,18,208,952,76.26,1.89,21.85,2019,47850
152,4,36,192,79.17,2.08,18.75,2019,58461
180,17,50,247,72.87,6.88,20.24,2019,58467
38,0,45,83,45.78,0.0,54.22,2019,58488
318,21,95,434,73.27,4.84,21.89,2019,58530
188,2,21,211,89.1,0.95,9.95,2019,58531
344,5,23,372,92.47,1.34,6.18,2019,58558
755,51,232,1038,72.74,4.91,22.35,2019,58563
36,4,16,56,64.29,7.14,28.57,2019,58566
265,10,62,337,78.64,2.97,18.4,2019,58348
505,25,79,609,82.92,4.11,12.97,2019,57014
74,0,28,102,72.55,0.0,27.45,2019,57021
188,50,33,271,69.37,18.45,12.18,2019,57073
85,5,42,132,64.39,3.79,31.82,2019,57218
192,7,61,260,73.85,2.69,23.46,2019,57237
315,12,48,375,84.0,3.2,12.8,2019,57241
93,0,22,115,80.87,0.0,19.13,2019,57217
45,0,0,45,100.0,0.0,0.0,2019,57541
1004,47,570,1621,61.94,2.9,35.16,2019,57601
1426,42,280,1748,81.58,2.4,16.02,2019,57754
90,0,12,102,88.24,0.0,11.76,2019,57646
32,0,5,37,86.49,0.0,13.51,2019,57755
151,0,13,164,92.07,0.0,7.93,2019,57242
38,1,13,52,73.08,1.92,25.0,2019,57245
87,4,11,102,85.29,3.92,10.78,2019,57246
102,8,16,126,80.95,6.35,12.7,2019,57264
193,9,48,250,77.2,3.6,19.2,2019,57278
112,12,26,150,74.67,8.0,17.33,2019,57322
484,24,98,606,79.87,3.96,16.17,2019,57349
208,14,49,271,76.75,5.17,18.08,2019,57370
23,0,10,33,69.7,0.0,30.3,2019,57455
172,0,33,205,83.9,0.0,16.1,2019,57544
84,0,7,91,92.31,0.0,7.69,2019,57649
69,6,3,78,88.46,7.69,3.85,2019,57724
14,9,49,72,19.44,12.5,68.06,2019,57794
3815,112,277,4204,90.75,2.66,6.59,2019,57005
252,8,64,324,77.78,2.47,19.75,2019,57359
256,0,7,263,97.34,0.0,2.66,2019,57427
128,17,46,191,67.02,8.9,24.08,2019,57448
159,4,48,211,75.36,1.9,22.75,2019,57522
81,0,52,133,60.9,0.0,39.1,2019,57269
0,0,0,0,,,,2019,57117
0,0,0,0,,,,2019,57197
32,0,14,46,69.57,0.0,30.43,2019,57429
8,0,33,41,19.51,0.0,80.49,2019,57439
16,0,0,16,100.0,0.0,0.0,2019,57630
27,0,57,84,32.14,0.0,67.86,2019,57639
20,0,0,20,100.0,0.0,0.0,2019,57741
0,0,0,0,,,,2019,57776
16,0,3,19,84.21,0.0,15.79,2019,57782
51,6,11,68,75.0,8.82,16.18,2019,57236
317,0,37,354,89.55,0.0,10.45,2019,57016
214,3,34,251,85.26,1.2,13.55,2019,57054
6264,195,827,7286,85.97,2.68,11.35,2019,57110
197,6,110,313,62.94,1.92,35.14,2019,57270
345,20,65,430,80.23,4.65,15.12,2019,57276
214,0,49,263,81.37,0.0,18.63,2019,57312
70,5,29,104,67.31,4.81,27.88,2019,57323
408,11,100,519,78.61,2.12,19.27,2019,57328
215,3,33,251,85.66,1.2,13.15,2019,57332
39,3,9,51,76.47,5.88,17.65,2019,43836
108,0,9,117,92.31,0.0,7.69,2019,43931
12,0,0,12,100.0,0.0,0.0,2019,43970
16,4,10,30,53.33,13.33,33.33,2019,43985
4284,75,420,4779,89.64,1.57,8.79,2019,43064
2467,44,389,2900,85.07,1.52,13.41,2019,43105
266,3,58,327,81.35,0.92,17.74,2019,43932
683,17,322,1022,66.83,1.66,31.51,2019,43988
961,12,196,1169,82.21,1.03,16.77,2019,43107
47,0,5,52,90.38,0.0,9.62,2019,43317
40,0,0,40,100.0,0.0,0.0,2019,43439
907,41,130,1078,84.14,3.8,12.06,2019,43569
11589,284,2430,14303,81.02,1.99,16.99,2019,43614
2387,86,353,2826,84.47,3.04,12.49,2019,43315
14107,530,3219,17856,79.0,2.97,18.03,2019,43207
612,11,104,727,84.18,1.51,14.31,2019,43217
6529,208,868,7605,85.85,2.74,11.41,2019,43311
1870,135,400,2405,77.75,5.61,16.63,2019,43316
405,13,74,492,82.32,2.64,15.04,2019,43343
340,3,67,410,82.93,0.73,16.34,2019,43442
411,19,134,564,72.87,3.37,23.76,2019,43457
9672,695,1722,12089,80.01,5.75,14.24,2019,43612
1664,45,454,2163,76.93,2.08,20.99,2019,43947
19984,815,3516,24315,82.19,3.35,14.46,2019,43055
1385,66,226,1677,82.59,3.94,13.48,2019,43061
466,24,31,521,89.44,4.61,5.95,2019,43066
6855,239,1199,8293,82.66,2.88,14.46,2019,43078
2474,0,0,2474,100.0,0.0,0.0,2019,43002
2622,69,251,2942,89.12,2.35,8.53,2019,43011
1033,0,300,1333,77.49,0.0,22.51,2019,43014
2432,56,599,3087,78.78,1.81,19.4,2019,43019
4392,51,564,5007,87.72,1.02,11.26,2019,43031
8791,131,83,9005,97.62,1.45,0.92,2019,43035
11077,201,1144,12422,89.17,1.62,9.21,2019,43040
6002,87,937,7026,85.43,1.24,13.34,2019,43056
9374,188,713,10275,91.23,1.83,6.94,2019,43062
14407,229,306,14942,96.42,1.53,2.05,2019,43065
1882,71,261,2214,85.0,3.21,11.79,2019,43072
23345,339,1269,24953,93.56,1.36,5.09,2019,43081
13422,430,1139,14991,89.53,2.87,7.6,2019,43110
4637,83,555,5275,87.91,1.57,10.52,2019,43125
272,0,62,334,81.44,0.0,18.56,2019,43136
864,42,50,956,90.38,4.39,5.23,2019,43137
476,11,141,628,75.8,1.75,22.45,2019,43963
835,35,123,993,84.09,3.52,12.39,2019,43001
853,62,179,1094,77.97,5.67,16.36,2019,43008
14946,331,462,15739,94.96,2.1,2.94,2019,43017
3908,47,159,4114,94.99,1.14,3.86,2019,43021
634,16,94,744,85.22,2.15,12.63,2019,43071
1545,60,309,1914,80.72,3.13,16.14,2019,43080
431,25,92,548,78.65,4.56,16.79,2019,45862
52,1,8,61,85.25,1.64,13.11,2019,45866
3748,103,517,4368,85.81,2.36,11.84,2019,45875
4348,135,780,5263,82.61,2.57,14.82,2019,45885
579,10,104,693,83.55,1.44,15.01,2019,45896
295,3,104,402,73.38,0.75,25.87,2019,45898
1403,67,692,2162,64.89,3.1,32.01,2019,45651
1011,14,246,1271,79.54,1.1,19.35,2019,45652
527,13,168,708,74.44,1.84,23.73,2019,45657
630,0,347,977,64.48,0.0,35.52,2019,45659
1872,124,468,2464,75.97,5.03,18.99,2019,45663
769,87,411,1267,60.69,6.87,32.44,2019,45686
721,88,175,984,73.27,8.94,17.78,2019,45724
461,56,90,607,75.95,9.23,14.83,2019,45735
332,2,154,488,68.03,0.41,31.56,2019,45745
309,0,116,425,72.71,0.0,27.29,2019,45775
52,4,0,56,92.86,7.14,0.0,2019,45809
157,10,31,198,79.29,5.05,15.66,2019,45820
190,5,43,238,79.83,2.1,18.07,2019,45003
10475,294,1731,12500,83.8,2.35,13.85,2019,45005
203,4,43,250,81.2,1.6,17.2,2019,45001
15012,428,1861,17301,86.77,2.47,10.76,2019,45014
1409,16,160,1585,88.9,1.01,10.09,2019,45052
1671,0,160,1831,91.26,0.0,8.74,2019,45065
3739,58,483,4280,87.36,1.36,11.29,2019,45068
2988,62,653,3703,80.69,1.67,17.63,2019,45107
913,13,310,1236,73.87,1.05,25.08,2019,45120
391,11,83,485,80.62,2.27,17.11,2019,45146
106,0,18,124,85.48,0.0,14.52,2019,45155
2823,95,621,3539,79.77,2.68,17.55,2019,45157
42,10,6,58,72.41,17.24,10.34,2019,45172
974,74,330,1378,70.68,5.37,23.95,2019,45203
3609,189,2299,6097,59.19,3.1,37.71,2019,45229
8060,171,605,8836,91.22,1.94,6.85,2019,45242
8671,67,750,9488,91.39,0.71,7.9,2019,45247
85,9,47,141,60.28,6.38,33.33,2019,45307
29,0,10,39,74.36,0.0,25.64,2019,45316
159,12,54,225,70.67,5.33,24.0,2019,45328
2264,79,374,2717,83.33,2.91,13.77,2019,45335
82,0,22,104,78.85,0.0,21.15,2019,45351
1576,70,280,1926,81.83,3.63,14.54,2019,45368
5664,195,1007,6866,82.49,2.84,14.67,2019,45377
120,2,15,137,87.59,1.46,10.95,2019,45378
1681,49,259,1989,84.51,2.46,13.02,2019,45380
5924,219,457,6600,89.76,3.32,6.92,2019,45419
1981,67,302,2350,84.3,2.85,12.85,2019,45830
17862,612,2615,21089,84.7,2.9,12.4,2019,45013
8,0,9,17,47.06,0.0,52.94,2019,45838
44,5,35,84,52.38,5.95,41.67,2019,45033
459,0,72,531,86.44,0.0,13.56,2019,45034
9099,112,290,9501,95.77,1.18,3.05,2019,45039
1510,11,136,1657,91.13,0.66,8.21,2019,45113
3252,140,585,3977,81.77,3.52,14.71,2019,45122
169,2,149,320,52.81,0.62,46.56,2019,47859
54,0,71,125,43.2,0.0,56.8,2019,47863
1262,64,282,1608,78.48,3.98,17.54,2019,47320
1249,44,525,1818,68.7,2.42,28.88,2019,47327
1592,105,337,2034,78.27,5.16,16.57,2019,47330
770,58,287,1115,69.06,5.2,25.74,2019,47342
1246,58,220,1524,81.76,3.81,14.44,2019,47346
828,64,262,1154,71.75,5.55,22.7,2019,47355
256,9,59,324,79.01,2.78,18.21,2019,47357
185,0,23,208,88.94,0.0,11.06,2019,46759
410,39,61,510,80.39,7.65,11.96,2019,46764
1933,69,449,2451,78.87,2.82,18.32,2019,46777
227,4,58,289,78.55,1.38,20.07,2019,46781
2211,13,221,2445,90.43,0.53,9.04,2019,46783
724,13,159,896,80.8,1.45,17.75,2019,46784
554,0,145,699,79.26,0.0,20.74,2019,46794
6777,205,658,7640,88.7,2.68,8.61,2019,46818
355,13,84,452,78.54,2.88,18.58,2019,46913
189,0,34,223,84.75,0.0,15.25,2019,46958
480,11,84,575,83.48,1.91,14.61,2019,46985
297,13,65,375,79.2,3.47,17.33,2019,46987
278,7,87,372,74.73,1.88,23.39,2019,46988
184,13,64,261,70.5,4.98,24.52,2019,46990
501,27,154,682,73.46,3.96,22.58,2019,46991
5235,455,1307,6997,74.82,6.5,18.68,2019,46992
2086,60,537,2683,77.75,2.24,20.01,2019,46996
7479,459,5110,13048,57.32,3.52,39.16,2019,46201
1607,82,439,2128,75.52,3.85,20.63,2019,46225
8877,210,555,9642,92.07,2.18,5.76,2019,46234
8001,277,854,9132,87.61,3.03,9.35,2019,46250
4868,50,511,5429,89.67,0.92,9.41,2019,46303
2880,164,952,3996,72.07,4.1,23.82,2019,46327
252,0,66,318,79.25,0.0,20.75,2019,46340
3132,62,527,3721,84.17,1.67,14.16,2019,46341
316,5,120,441,71.66,1.13,27.21,2019,46346
14117,390,3082,17589,80.26,2.22,17.52,2019,46350
13965,392,3596,17953,77.79,2.18,20.03,2019,46360
325,0,14,339,95.87,0.0,4.13,2019,46365
8715,200,2069,10984,79.34,1.82,18.84,2019,46229
8745,438,2947,12130,72.09,3.61,24.3,2019,46235
104,0,0,104,100.0,0.0,0.0,2019,46381
7469,127,548,8144,91.71,1.56,6.73,2019,46311
7755,42,838,8635,89.81,0.49,9.7,2019,46321
56,0,13,69,81.16,0.0,18.84,2019,46379
583,20,78,681,85.61,2.94,11.45,2019,46382
994,17,247,1258,79.01,1.35,19.63,2019,46390
2442,80,393,2915,83.77,2.74,13.48,2019,46392
2940,88,801,3829,76.78,2.3,20.92,2019,46405
34,0,18,52,65.38,0.0,34.62,2019,46508
612,8,243,863,70.92,0.93,28.16,2019,46524
3142,221,810,4173,75.29,5.3,19.41,2019,46534
1567,61,342,1970,79.54,3.1,17.36,2019,46562
6401,259,2097,8757,73.1,2.96,23.95,2019,46563
4363,297,1073,5733,76.1,5.18,18.72,2019,46615
2523,113,989,3625,69.6,3.12,27.28,2019,46506
2932,38,373,3343,87.71,1.14,11.16,2019,46507
7360,416,1235,9011,81.68,4.62,13.71,2019,46517
7238,527,2302,10067,71.9,5.23,22.87,2019,46628
1310,56,305,1671,78.4,3.35,18.25,2019,46710
96,6,37,139,69.06,4.32,26.62,2019,57335
161,1,46,208,77.4,0.48,22.12,2019,57342
36,0,11,47,76.6,0.0,23.4,2019,57344
209,1,14,224,93.3,0.45,6.25,2019,57348
11,0,6,17,64.71,0.0,35.29,2019,57358
16,0,24,40,40.0,0.0,60.0,2019,57361
435,16,67,518,83.98,3.09,12.93,2019,57385
82,15,16,113,72.57,13.27,14.16,2019,57422
153,7,19,179,85.47,3.91,10.61,2019,57468
67,0,68,135,49.63,0.0,50.37,2019,66019
390,13,127,530,73.58,2.45,23.96,2019,66097
5565,111,510,6186,89.96,1.79,8.24,2019,66207
2247,20,331,2598,86.49,0.77,12.74,2019,66436
104,17,27,148,70.27,11.49,18.24,2019,66544
29,3,41,73,39.73,4.11,56.16,2019,66714
1000,32,209,1241,80.58,2.58,16.84,2019,66414
117,2,29,148,79.05,1.35,19.59,2019,66417
148,9,11,168,88.1,5.36,6.55,2019,66419
252,8,89,349,72.21,2.29,25.5,2019,66423
179,2,48,229,78.17,0.87,20.96,2019,66425
175,10,99,284,61.62,3.52,34.86,2019,66024
2648,5,114,2767,95.7,0.18,4.12,2019,66218
473,7,28,508,93.11,1.38,5.51,2019,66514
599,24,100,723,82.85,3.32,13.83,2019,66549
253,9,140,402,62.94,2.24,34.83,2019,66095
1998,16,277,2291,87.21,0.7,12.09,2019,66018
2360,24,287,2671,88.36,0.9,10.75,2019,66006
89,7,20,116,76.72,6.03,17.24,2019,66008
147,1,33,181,81.22,0.55,18.23,2019,66017
6911,475,902,8288,83.39,5.73,10.88,2019,66046
5287,121,441,5849,90.39,2.07,7.54,2019,66205
11039,150,474,11663,94.65,1.29,4.06,2019,66213
2637,61,55,2753,95.79,2.22,2.0,2019,66220
4321,30,179,4530,95.39,0.66,3.95,2019,66226
237,0,59,296,80.07,0.0,19.93,2019,66403
119,0,16,135,88.15,0.0,11.85,2019,66422
1489,30,429,1948,76.44,1.54,22.02,2019,66434
78,0,19,97,80.41,0.0,19.59,2019,66732
69,0,19,88,78.41,0.0,21.59,2019,66734
747,29,166,942,79.3,3.08,17.62,2019,66052
648,45,412,1105,58.64,4.07,37.29,2019,66075
226,33,78,337,67.06,9.79,23.15,2019,66080
2970,101,278,3349,88.68,3.02,8.3,2019,66083
502,47,244,793,63.3,5.93,30.77,2019,66105
13206,152,1062,14420,91.58,1.05,7.36,2019,66212
612,9,121,742,82.48,1.21,16.31,2019,66440
85,6,37,128,66.41,4.69,28.91,2019,66501
15088,929,1498,17515,86.14,5.3,8.55,2019,66502
42,2,7,51,82.35,3.92,13.73,2019,66518
196,10,38,244,80.33,4.1,15.57,2019,66520
1078,29,312,1419,75.97,2.04,21.99,2019,66538
3097,99,270,3466,89.35,2.86,7.79,2019,66547
2646,164,485,3295,80.3,4.98,14.72,2019,66617
146,2,71,219,66.67,0.91,32.42,2019,66710
99,2,47,148,66.89,1.35,31.76,2019,66716
1398,18,175,1591,87.87,1.13,11.0,2019,66839
185,0,49,234,79.06,0.0,20.94,2019,66952
126,0,3,129,97.67,0.0,2.33,2019,66740
131,27,84,242,54.13,11.16,34.71,2019,66851
9610,57,540,10207,94.15,0.56,5.29,2019,43085
77,21,37,135,57.04,15.56,27.41,2019,43101
1410,89,171,1670,84.43,5.33,10.24,2019,43102
989,34,180,1203,82.21,2.83,14.96,2019,43154
43,2,24,69,62.32,2.9,34.78,2019,43156
187,3,45,235,79.57,1.28,19.15,2019,43157
8608,192,1617,10417,82.63,1.84,15.52,2019,43206
4163,89,775,5027,82.81,1.77,15.42,2019,43953
97,122,17,236,41.1,51.69,7.2,2019,43210
361,79,35,475,76.0,16.63,7.37,2019,43356
576,15,76,667,86.36,2.25,11.39,2019,43534
10507,229,754,11490,91.44,1.99,6.56,2019,43537
2609,65,536,3210,81.28,2.02,16.7,2019,43543
4928,203,639,5770,85.41,3.52,11.07,2019,43545
4292,112,929,5333,80.48,2.1,17.42,2019,43558
10773,240,1264,12277,87.75,1.95,10.3,2019,43560
3629,355,1185,5169,70.21,6.87,22.93,2019,43608
11467,691,1815,13973,82.07,4.95,12.99,2019,43613
14919,419,2636,17974,83.0,2.33,14.67,2019,43615
479,5,340,824,58.13,0.61,41.26,2019,43716
1564,85,409,2058,76.0,4.13,19.87,2019,43723
1958,86,853,2897,67.59,2.97,29.44,2019,43724
1555,68,545,2168,71.73,3.14,25.14,2019,43756
477,20,138,635,75.12,3.15,21.73,2019,43766
1302,88,258,1648,79.0,5.34,15.66,2019,43821
307,25,133,465,66.02,5.38,28.6,2019,43840
1799,64,372,2235,80.49,2.86,16.64,2019,43938
32,0,27,59,54.24,0.0,45.76,2019,43905
6919,341,1814,9074,76.25,3.76,19.99,2019,43920
289,29,26,344,84.01,8.43,7.56,2019,43930
86,0,22,108,79.63,0.0,20.37,2019,43940
1085,5,315,1405,77.22,0.36,22.42,2019,43318
290,0,95,385,75.32,0.0,24.68,2019,43319
91,5,37,133,68.42,3.76,27.82,2019,43322
648,91,174,913,70.97,9.97,19.06,2019,43348
964,27,128,1119,86.15,2.41,11.44,2019,43358
11659,965,1067,13691,85.16,7.05,7.79,2019,43402
450,0,72,522,86.21,0.0,13.79,2019,43432
134,0,27,161,83.23,0.0,16.77,2019,43458
421,26,68,515,81.75,5.05,13.2,2019,43524
66,5,17,88,75.0,5.68,19.32,2019,43529
40,0,0,40,100.0,0.0,0.0,2019,43536
470,0,55,525,89.52,0.0,10.48,2019,43549
2848,11,302,3161,90.1,0.35,9.55,2019,43566
2888,290,1245,4423,65.3,6.56,28.15,2019,43604
60,0,16,76,78.95,0.0,21.05,2019,43717
393,35,132,560,70.18,6.25,23.57,2019,43728
80,0,12,92,86.96,0.0,13.04,2019,43740
418,0,178,596,70.13,0.0,29.87,2019,43746
497,24,133,654,75.99,3.67,20.34,2019,43755
6674,250,2523,9447,70.65,2.65,26.71,2019,45133
2808,37,613,3458,81.2,1.07,17.73,2019,45154
18,0,4,22,81.82,0.0,18.18,2019,45156
1191,9,234,1434,83.05,0.63,16.32,2019,45159
1893,52,574,2519,75.15,2.06,22.79,2019,45204
1090,24,149,1263,86.3,1.9,11.8,2019,45850
159,3,67,229,69.43,1.31,29.26,2019,45886
201,5,30,236,85.17,2.12,12.71,2019,45890
3928,132,622,4682,83.9,2.82,13.28,2019,45015
94,19,49,162,58.02,11.73,30.25,2019,45782
449,4,86,539,83.3,0.74,15.96,2019,45881
676,11,108,795,85.03,1.38,13.58,2019,45827
884,54,196,1134,77.95,4.76,17.28,2019,45882
11121,357,1156,12634,88.02,2.83,9.15,2019,45103
6912,200,881,7993,86.48,2.5,11.02,2019,45202
12131,390,1461,13982,86.76,2.79,10.45,2019,45373
9747,231,1833,11811,82.52,1.96,15.52,2019,45420
1213,62,440,1715,70.73,3.62,25.66,2019,45612
4510,138,1160,5808,77.65,2.38,19.97,2019,45690
122,5,21,148,82.43,3.38,14.19,2019,45111
13889,483,2250,16622,83.56,2.91,13.54,2019,45231
96,2,74,172,55.81,1.16,43.02,2019,45360
466,0,210,676,68.93,0.0,31.07,2019,45616
112,0,52,164,68.29,0.0,31.71,2019,45650
1036,17,106,1159,89.39,1.47,9.15,2019,46051
4518,148,404,5070,89.11,2.92,7.97,2019,46064
11336,84,555,11975,94.66,0.7,4.63,2019,46074
2311,96,822,3229,71.57,2.97,25.46,2019,46124
0,31,32,63,0.0,49.21,50.79,2019,46155
821,63,144,1028,79.86,6.13,14.01,2019,46161
1448,48,144,1640,88.29,2.93,8.78,2019,46164
2281,122,155,2558,89.17,4.77,6.06,2019,46167
8382,94,827,9303,90.1,1.01,8.89,2019,46375
4314,150,1444,5908,73.02,2.54,24.44,2019,46403
905,86,341,1332,67.94,6.46,25.6,2019,46504
887,53,149,1089,81.45,4.87,13.68,2019,46539
2043,68,472,2583,79.09,2.63,18.27,2019,46552
3986,63,479,4528,88.03,1.39,10.58,2019,46561
57,0,19,76,75.0,0.0,25.0,2019,46345
2508,104,719,3331,75.29,3.12,21.59,2019,46738
661,0,176,837,78.97,0.0,21.03,2019,46745
4777,132,1119,6028,79.25,2.19,18.56,2019,46755
448,2,339,789,56.78,0.25,42.97,2019,46772
644,33,122,799,80.6,4.13,15.27,2019,46779
8088,336,1308,9732,83.11,3.45,13.44,2019,46725
6019,294,1363,7676,78.41,3.83,17.76,2019,46733
8398,439,1814,10651,78.85,4.12,17.03,2019,46750
680,13,78,771,88.2,1.69,10.12,2019,46763
905,34,218,1157,78.22,2.94,18.84,2019,46770
451,21,78,550,82.0,3.82,14.18,2019,46785
7438,328,1620,9386,79.25,3.49,17.26,2019,46805
772,11,105,888,86.94,1.24,11.82,2019,46058
164,7,29,200,82.0,3.5,14.5,2019,46063
866,44,191,1101,78.66,4.0,17.35,2019,46732
911,28,458,1397,65.21,2.0,32.78,2019,46741
986,57,264,1307,75.44,4.36,20.2,2019,46742
523,9,231,763,68.55,1.18,30.28,2019,46743
1608,64,238,1910,84.19,3.35,12.46,2019,46765
74,9,14,97,76.29,9.28,14.43,2019,46799
3997,54,207,4258,93.87,1.27,4.86,2019,46814
1582,49,159,1790,88.38,2.74,8.88,2019,46347
1004,0,199,1203,83.46,0.0,16.54,2019,46371
2360,13,463,2836,83.22,0.46,16.33,2019,46069
4657,294,2045,6996,66.57,4.2,29.23,2019,46016
20501,431,1894,22826,89.81,1.89,8.3,2019,46307
5348,242,1721,7311,73.15,3.31,23.54,2019,46816
10764,326,1310,12400,86.81,2.63,10.56,2019,46825
452,18,78,548,82.48,3.28,14.23,2019,46911
432,38,92,562,76.87,6.76,16.37,2019,46926
372,11,77,460,80.87,2.39,16.74,2019,46960
1915,63,333,2311,82.86,2.73,14.41,2019,46017
19153,289,771,20213,94.76,1.43,3.81,2019,46032
16309,124,476,16909,96.45,0.73,2.82,2019,46038
126,14,80,220,57.27,6.36,36.36,2019,46039
816,94,231,1141,71.52,8.24,20.25,2019,46068
2988,216,475,3679,81.22,5.87,12.91,2019,46072
40,0,8,48,83.33,0.0,16.67,2019,46103
363,0,56,419,86.63,0.0,13.37,2019,46104
556,0,119,675,82.37,0.0,17.63,2019,46105
1747,35,190,1972,88.59,1.77,9.63,2019,46118
4930,152,701,5783,85.25,2.63,12.12,2019,46122
11721,282,800,12803,91.55,2.2,6.25,2019,46123
13598,594,1783,15975,85.12,3.72,11.16,2019,46140
96,0,83,179,53.63,0.0,46.37,2019,46162
167,9,60,236,70.76,3.81,25.42,2019,46175
3593,29,474,4096,87.72,0.71,11.57,2019,46204
8411,445,1203,10059,83.62,4.42,11.96,2019,46214
1051,0,336,1387,75.78,0.0,24.22,2019,46216
13423,366,1270,15059,89.14,2.43,8.43,2019,46237
9382,161,841,10384,90.35,1.55,8.1,2019,46256
8293,124,1409,9826,84.4,1.26,14.34,2019,46304
7937,193,1244,9374,84.67,2.06,13.27,2019,46322
796,50,273,1119,71.13,4.47,24.4,2019,46929
1013,76,224,1313,77.15,5.79,17.06,2019,46932
45,0,29,74,60.81,0.0,39.19,2019,46943
576,40,164,780,73.85,5.13,21.03,2019,46974
1459,120,162,1741,83.8,6.89,9.3,2019,46979
236,6,33,275,85.82,2.18,12.0,2019,46301
6524,191,1373,8088,80.66,2.36,16.98,2019,46323
325,7,80,412,78.88,1.7,19.42,2019,46348
2405,299,1018,3722,64.62,8.03,27.35,2019,46406
13244,392,1841,15477,85.57,2.53,11.9,2019,46410
8887,357,2112,11356,78.26,3.14,18.6,2019,46516
78,9,86,173,45.09,5.2,49.71,2019,46537
1357,98,143,1598,84.92,6.13,8.95,2019,46538
1938,83,494,2515,77.06,3.3,19.64,2019,46795
3632,164,918,4714,77.05,3.48,19.47,2019,46802
3385,112,622,4119,82.18,2.72,15.1,2019,46809
2138,114,307,2559,83.55,4.45,12.0,2019,46933
584,38,205,827,70.62,4.59,24.79,2019,46939
317,15,32,364,87.09,4.12,8.79,2019,46941
17,0,9,26,65.38,0.0,34.62,2019,46946
142,0,36,178,79.78,0.0,20.22,2019,66780
9451,459,1557,11467,82.42,4.0,13.58,2019,66801
414,5,125,544,76.1,0.92,22.98,2019,66835
603,15,155,773,78.01,1.94,20.05,2019,66856
51,2,0,53,96.23,3.77,0.0,2019,66862
520,24,114,658,79.03,3.65,17.33,2019,66866
1826,154,507,2487,73.42,6.19,20.39,2019,66901
33,0,7,40,82.5,0.0,17.5,2019,66932
49,4,10,63,77.78,6.35,15.87,2019,66964
147,3,16,166,88.55,1.81,9.64,2019,67132
1392,75,187,1654,84.16,4.53,11.31,2019,67026
2978,167,549,3694,80.62,4.52,14.86,2019,67152
3684,85,1257,5026,73.3,1.69,25.01,2019,67337
46,11,33,90,51.11,12.22,36.67,2019,67458
65,2,12,79,82.28,2.53,15.19,2019,67519
393,40,91,524,75.0,7.63,17.37,2019,68733
234,24,71,329,71.12,7.29,21.58,2019,68735
63,3,8,74,85.14,4.05,10.81,2019,68742
41,2,3,46,89.13,4.35,6.52,2019,68747
232,6,72,310,74.84,1.94,23.23,2019,68757
123,3,38,164,75.0,1.83,23.17,2019,68761
303,15,56,374,81.02,4.01,14.97,2019,68764
459,26,164,649,70.72,4.01,25.27,2019,68770
155,3,42,200,77.5,1.5,21.0,2019,68812
179,7,44,230,77.83,3.04,19.13,2019,68813
282,23,74,379,74.41,6.07,19.53,2019,68814
112,6,34,152,73.68,3.95,22.37,2019,68817
22,1,2,25,88.0,4.0,8.0,2019,68821
514,13,59,586,87.71,2.22,10.07,2019,68824
238,14,38,290,82.07,4.83,13.1,2019,68034
184,8,117,309,59.55,2.59,37.86,2019,68039
585,56,174,815,71.78,6.87,21.35,2019,68045
882,24,279,1185,74.43,2.03,23.54,2019,68446
145,4,12,161,90.06,2.48,7.45,2019,68448
28,6,15,49,57.14,12.24,30.61,2019,68452
434,7,121,562,77.22,1.25,21.53,2019,68463
3255,117,448,3820,85.21,3.06,11.73,2019,68467
5892,158,755,6805,86.58,2.32,11.09,2019,68505
5533,91,826,6450,85.78,1.41,12.81,2019,68507
7874,242,1083,9199,85.6,2.63,11.77,2019,68510
267,0,18,285,93.68,0.0,6.32,2019,68527
87,1,23,111,78.38,0.9,20.72,2019,68622
4397,128,463,4988,88.15,2.57,9.28,2019,68008
222,4,60,286,77.62,1.4,20.98,2019,68626
577,3,136,716,80.59,0.42,18.99,2019,68466
6466,97,1206,7769,83.23,1.25,15.52,2019,68504
3992,373,819,5184,77.01,7.2,15.8,2019,68508
388,43,103,534,72.66,8.05,19.29,2019,68633
161,0,41,202,79.7,0.0,20.3,2019,68635
204,10,41,255,80.0,3.92,16.08,2019,68644
248,4,67,319,77.74,1.25,21.0,2019,68658
383,8,121,512,74.8,1.56,23.63,2019,68660
198,4,77,279,70.97,1.43,27.6,2019,68663
317,28,56,401,79.05,6.98,13.97,2019,68665
69,8,40,117,58.97,6.84,34.19,2019,68345
88,3,42,133,66.17,2.26,31.58,2019,68303
218,0,35,253,86.17,0.0,13.83,2019,68336
460,8,116,584,78.77,1.37,19.86,2019,68359
282,0,89,371,76.01,0.0,23.99,2019,68404
280,0,104,384,72.92,0.0,27.08,2019,43779
128,23,63,214,59.81,10.75,29.44,2019,43788
1394,52,499,1945,71.67,2.67,25.66,2019,43822
22128,472,1319,23919,92.51,1.97,5.51,2019,43026
62,0,45,107,57.94,0.0,42.06,2019,43037
782,8,37,827,94.56,0.97,4.47,2019,43045
462,9,46,517,89.36,1.74,8.9,2019,43067
68,6,14,88,77.27,6.82,15.91,2019,43077
93,0,32,125,74.4,0.0,25.6,2019,43111
390,9,146,545,71.56,1.65,26.79,2019,43115
1123,114,394,1631,68.85,6.99,24.16,2019,43135
716,12,117,845,84.73,1.42,13.85,2019,43145
275,0,86,361,76.18,0.0,23.82,2019,43152
784,58,148,990,79.19,5.86,14.95,2019,43155
158,0,0,158,100.0,0.0,0.0,2019,43158
2359,68,340,2767,85.25,2.46,12.29,2019,43162
612,37,136,785,77.96,4.71,17.32,2019,43164
4290,94,1093,5477,78.33,1.72,19.96,2019,43205
9094,318,2429,11841,76.8,2.69,20.51,2019,43219
14200,305,2845,17350,81.84,1.76,16.4,2019,43224
1507,68,473,2048,73.58,3.32,23.1,2019,43731
650,0,227,877,74.12,0.0,25.88,2019,43780
5276,268,1599,7143,73.86,3.75,22.39,2019,43952
18966,420,2741,22127,85.71,1.9,12.39,2019,43228
931,62,173,1166,79.85,5.32,14.84,2019,43521
1550,36,255,1841,84.19,1.96,13.85,2019,43044
13254,251,539,14044,94.37,1.79,3.84,2019,43147
13097,139,490,13726,95.42,1.01,3.57,2019,43221
1401,44,289,1734,80.8,2.54,16.67,2019,43430
627,9,133,769,81.53,1.17,17.3,2019,43527
186,20,71,277,67.15,7.22,25.63,2019,43013
2812,46,608,3466,81.13,1.33,17.54,2019,43076
99,5,15,119,83.19,4.2,12.61,2019,43151
8511,93,492,9096,93.57,1.02,5.41,2019,43202
354,4,128,486,72.84,0.82,26.34,2019,43337
8231,305,1873,10409,79.08,2.93,17.99,2019,44460
10231,400,1438,12069,84.77,3.31,11.91,2019,44515
11169,430,2542,14141,78.98,3.04,17.98,2019,44601
1211,95,196,1502,80.63,6.32,13.05,2019,44609
527,26,144,697,75.61,3.73,20.66,2019,44620
456,43,260,759,60.08,5.67,34.26,2019,44633
705,76,256,1037,67.98,7.33,24.69,2019,44637
76,0,4,80,95.0,0.0,5.0,2019,44640
43,1,11,55,78.18,1.82,20.0,2019,44659
10223,484,2669,13376,76.43,3.62,19.95,2019,44004
8041,139,1169,9349,86.01,1.49,12.5,2019,44024
541,44,253,838,64.56,5.25,30.19,2019,44046
2917,63,404,3384,86.2,1.86,11.94,2019,44047
4195,137,563,4895,85.7,2.8,11.5,2019,44054
4510,653,2264,7427,60.72,8.79,30.48,2019,44055
4210,179,651,5040,83.53,3.55,12.92,2019,46107
10131,199,1125,11455,88.44,1.74,9.82,2019,46142
33,0,49,82,40.24,0.0,59.76,2019,46144
313,8,155,476,65.76,1.68,32.56,2019,46150
11670,374,1351,13395,87.12,2.79,10.09,2019,46168
778,44,188,1010,77.03,4.36,18.61,2019,46172
10568,595,2927,14090,75.0,4.22,20.77,2019,46203
9213,349,2548,12110,76.08,2.88,21.04,2019,46222
10787,398,2454,13639,79.09,2.92,17.99,2019,46224
12685,727,4863,18275,69.41,3.98,26.61,2019,46226
5144,59,518,5721,89.91,1.03,9.05,2019,46228
2896,0,388,3284,88.19,0.0,11.81,2019,46231
12564,562,2645,15771,79.67,3.56,16.77,2019,46254
11459,426,1925,13810,82.98,3.08,13.94,2019,46260
2833,0,225,3058,92.64,0.0,7.36,2019,46278
821,82,54,957,85.79,8.57,5.64,2019,46031
2478,175,215,2868,86.4,6.1,7.5,2019,46034
18,0,0,18,100.0,0.0,0.0,2019,46047
632,19,113,764,82.72,2.49,14.79,2019,46050
486,7,140,633,76.78,1.11,22.12,2019,46076
12142,228,989,13359,90.89,1.71,7.4,2019,46112
4970,77,380,5427,91.58,1.42,7.0,2019,46113
1797,15,369,2181,82.39,0.69,16.92,2019,46120
492,2,269,763,64.48,0.26,35.26,2019,46166
2720,267,1050,4037,67.38,6.61,26.01,2019,46173
8567,438,2210,11215,76.39,3.91,19.71,2019,46176
4290,108,497,4895,87.64,2.21,10.15,2019,46184
5781,419,6259,12459,46.4,3.36,50.24,2019,46218
14822,215,1846,16883,87.79,1.27,10.93,2019,46220
9983,429,1968,12380,80.64,3.47,15.9,2019,46614
3172,95,553,3820,83.04,2.49,14.48,2019,46617
2158,96,374,2628,82.12,3.65,14.23,2019,46635
2559,193,512,3264,78.4,5.91,15.69,2019,46737
1079,22,228,1329,81.19,1.66,17.16,2019,46573
5541,415,463,6419,86.32,6.47,7.21,2019,46637
2954,369,1669,4992,59.17,7.39,33.43,2019,46320
875,100,243,1218,71.84,8.21,19.95,2019,46536
435,60,130,625,69.6,9.6,20.8,2019,46914
7607,361,1560,9528,79.84,3.79,16.37,2019,46052
994,54,213,1261,78.83,4.28,16.89,2019,46147
13472,85,1131,14688,91.72,0.58,7.7,2019,46060
6957,325,1256,8538,81.48,3.81,14.71,2019,46580
1044,12,232,1288,81.06,0.93,18.01,2019,46501
1198,65,355,1618,74.04,4.02,21.94,2019,46746
826,40,173,1039,79.5,3.85,16.65,2019,46994
364,29,85,478,76.15,6.07,17.78,2019,46049
5376,306,1326,7008,76.71,4.37,18.92,2019,46135
9298,112,1147,10557,88.07,1.06,10.86,2019,46236
6304,123,666,7093,88.88,1.73,9.39,2019,46319
7671,123,1532,9326,82.25,1.32,16.43,2019,46221
17773,1145,3280,22198,80.07,5.16,14.78,2019,46227
9184,324,1464,10972,83.7,2.95,13.34,2019,46268
6466,368,1534,8368,77.27,4.4,18.33,2019,46324
336,0,68,404,83.17,0.0,16.83,2019,46959
64,0,31,95,67.37,0.0,32.63,2019,46961
2675,236,567,3478,76.91,6.79,16.3,2019,46962
618,16,155,789,78.33,2.03,19.65,2019,46978
413,38,171,622,66.4,6.11,27.49,2019,47431
3015,83,1164,4262,70.74,1.95,27.31,2019,47446
29,0,0,29,100.0,0.0,0.0,2019,47455
598,32,194,824,72.57,3.88,23.54,2019,47513
350,2,64,416,84.13,0.48,15.38,2019,47529
238,0,167,405,58.77,0.0,41.23,2019,47531
5468,133,1365,6966,78.5,1.91,19.6,2019,47720
7674,228,937,8839,86.82,2.58,10.6,2019,47803
3585,324,885,4794,74.78,6.76,18.46,2019,47807
2831,86,654,3571,79.28,2.41,18.31,2019,47424
74,6,56,136,54.41,4.41,41.18,2019,47449
472,12,126,610,77.38,1.97,20.66,2019,47468
59,0,12,71,83.1,0.0,16.9,2019,47514
226,14,110,350,64.57,4.0,31.43,2019,47515
195,0,40,235,82.98,0.0,17.02,2019,47521
903,38,351,1292,69.89,2.94,27.17,2019,47523
263,11,52,326,80.67,3.37,15.95,2019,47551
512,30,106,648,79.01,4.63,16.36,2019,47557
1753,53,707,2513,69.76,2.11,28.13,2019,47567
337,17,64,418,80.62,4.07,15.31,2019,47575
4226,203,886,5315,79.51,3.82,16.67,2019,47620
1504,10,392,1906,78.91,0.52,20.57,2019,47660
139,12,91,242,57.44,4.96,37.6,2019,47017
869,26,379,1274,68.21,2.04,29.75,2019,47024
39,0,91,130,30.0,0.0,70.0,2019,47035
1141,30,359,1530,74.58,1.96,23.46,2019,47117
356,38,195,589,60.44,6.45,33.11,2019,47125
1789,61,519,2369,75.52,2.57,21.91,2019,47165
14037,557,2669,17263,81.31,3.23,15.46,2019,47201
3332,61,778,4171,79.88,1.46,18.65,2019,47001
46,13,45,104,44.23,12.5,43.27,2019,47010
226,17,44,287,78.75,5.92,15.33,2019,47011
3091,159,597,3847,80.35,4.13,15.52,2019,47012
306,7,31,344,88.95,2.03,9.01,2019,47016
402,5,180,587,68.48,0.85,30.66,2019,47023
640,10,399,1049,61.01,0.95,38.04,2019,47115
14519,522,3132,18173,79.89,2.87,17.23,2019,47130
676,12,330,1018,66.4,1.18,32.42,2019,47140
166,21,126,313,53.04,6.71,40.26,2019,47162
69,0,14,83,83.13,0.0,16.87,2019,47226
1393,43,544,1980,70.35,2.17,27.47,2019,47220
304,2,30,336,90.48,0.6,8.93,2019,47231
345,18,115,478,72.18,3.77,24.06,2019,47235
6108,232,1515,7855,77.76,2.95,19.29,2019,47265
660,26,116,802,82.29,3.24,14.46,2019,47273
31,0,9,40,77.5,0.0,22.5,2019,47344
70,5,6,81,86.42,6.17,7.41,2019,47361
1619,124,439,2182,74.2,5.68,20.12,2019,47390
335,4,88,427,78.45,0.94,20.61,2019,47955
370,3,74,447,82.77,0.67,16.55,2019,47980
827,32,259,1118,73.97,2.86,23.17,2019,47338
660,33,214,907,72.77,3.64,23.59,2019,47341
3012,266,671,3949,76.27,6.74,16.99,2019,47348
345,51,78,474,72.78,10.76,16.46,2019,47360
331,4,82,417,79.38,0.96,19.66,2019,47832
4505,159,883,5547,81.22,2.87,15.92,2019,60429
1548,75,176,1799,86.05,4.17,9.78,2019,60461
13602,326,1495,15423,88.19,2.11,9.69,2019,60462
7266,213,1225,8704,83.48,2.45,14.07,2019,60466
185,6,38,229,80.79,2.62,16.59,2019,60470
3867,128,764,4759,81.26,2.69,16.05,2019,60481
4048,148,741,4937,81.99,3.0,15.01,2019,60471
895,67,577,1539,58.15,4.35,37.49,2019,60472
323,5,46,374,86.36,1.34,12.3,2019,60479
983,32,262,1277,76.98,2.51,20.52,2019,63555
901,29,294,1224,73.61,2.37,24.02,2019,63556
446,46,89,581,76.76,7.92,15.32,2019,63559
23,0,15,38,60.53,0.0,39.47,2019,63566
957,55,195,1207,79.29,4.56,16.16,2019,63627
4382,201,556,5139,85.27,3.91,10.82,2019,63051
400,47,54,501,79.84,9.38,10.78,2019,67487
281,24,67,372,75.54,6.45,18.01,2019,67490
440,10,155,605,72.73,1.65,25.62,2019,67154
118,4,60,182,64.84,2.2,32.97,2019,67134
3261,3,610,3874,84.18,0.08,15.75,2019,67147
11,0,10,21,52.38,0.0,47.62,2019,67150
6254,235,679,7168,87.25,3.28,9.47,2019,67206
6111,501,2034,8646,70.68,5.79,23.53,2019,67213
826,11,354,1191,69.35,0.92,29.72,2019,67333
290,10,74,374,77.54,2.67,19.79,2019,67342
36,0,18,54,66.67,0.0,33.33,2019,67345
217,3,51,271,80.07,1.11,18.82,2019,67354
88,6,13,107,82.24,5.61,12.15,2019,67364
236,17,68,321,73.52,5.3,21.18,2019,67430
232,10,63,305,76.07,3.28,20.66,2019,67450
66,0,7,73,90.41,0.0,9.59,2019,67452
597,3,220,820,72.8,0.37,26.83,2019,67455
238,25,43,306,77.78,8.17,14.05,2019,67457
122,0,29,151,80.79,0.0,19.21,2019,67131
180,7,45,232,77.59,3.02,19.4,2019,67127
934,36,161,1131,82.58,3.18,14.24,2019,67135
697,14,91,802,86.91,1.75,11.35,2019,67146
4190,112,1114,5416,77.36,2.07,20.57,2019,67156
6767,380,1864,9011,75.1,4.22,20.69,2019,67216
262,29,129,420,62.38,6.9,30.71,2019,67349
16673,592,3288,20553,81.12,2.88,16.0,2019,67401
147,2,40,189,77.78,1.06,21.16,2019,67427
1362,11,244,1617,84.23,0.68,15.09,2019,68064
1815,48,364,2227,81.5,2.16,16.34,2019,68066
362,4,211,577,62.74,0.69,36.57,2019,68071
7338,105,432,7875,93.18,1.33,5.49,2019,68130
5757,94,162,6013,95.74,1.56,2.69,2019,68136
489,20,146,655,74.66,3.05,22.29,2019,68970
2386,10,265,2661,89.67,0.38,9.96,2019,68157
168,12,25,205,81.95,5.85,12.2,2019,68307
41,1,9,51,80.39,1.96,17.65,2019,68309
128,1,57,186,68.82,0.54,30.65,2019,68318
142,9,39,190,74.74,4.74,20.53,2019,68320
111,2,31,144,77.08,1.39,21.53,2019,68327
184,10,18,212,86.79,4.72,8.49,2019,68328
2375,39,469,2883,82.38,1.35,16.27,2019,68333
419,6,49,474,88.4,1.27,10.34,2019,68341
930,14,29,973,95.58,1.44,2.98,2019,68347
34,3,7,44,77.27,6.82,15.91,2019,68364
0,0,0,0,,,,2019,60539
4881,62,357,5300,92.09,1.17,6.74,2019,60026
8170,143,337,8650,94.45,1.65,3.9,2019,60051
7466,62,295,7823,95.44,0.79,3.77,2019,60124
10307,139,894,11340,90.89,1.23,7.88,2019,60133
23,5,0,28,82.14,17.86,0.0,2019,60144
9262,118,311,9691,95.57,1.22,3.21,2019,60156
10582,215,862,11659,90.76,1.84,7.39,2019,60169
10864,92,552,11508,94.4,0.8,4.8,2019,60189
6161,154,859,7174,85.88,2.15,11.97,2019,60403
6033,80,453,6566,91.88,1.22,6.9,2019,60404
3327,64,619,4010,82.97,1.6,15.44,2019,60428
1940,43,338,2321,83.58,1.85,14.56,2019,60484
8451,55,380,8886,95.1,0.62,4.28,2019,60487
70,7,6,83,84.34,8.43,7.23,2019,62419
115,8,34,157,73.25,5.1,21.66,2019,62446
1728,27,502,2257,76.56,1.2,22.24,2019,62448
308,8,63,379,81.27,2.11,16.62,2019,62465
190,0,11,201,94.53,0.0,5.47,2019,62469
2497,23,886,3406,73.31,0.68,26.01,2019,62471
255,5,41,301,84.72,1.66,13.62,2019,62477
135,5,24,164,82.32,3.05,14.63,2019,62478
120,13,46,179,67.04,7.26,25.7,2019,62481
309,0,119,428,72.2,0.0,27.8,2019,62515
174,0,38,212,82.08,0.0,17.92,2019,62538
1791,84,208,2083,85.98,4.03,9.99,2019,62563
558,10,76,644,86.65,1.55,11.8,2019,62573
345,6,99,450,76.67,1.33,22.0,2019,62611
1334,3,188,1525,87.48,0.2,12.33,2019,62613
126,8,32,166,75.9,4.82,19.28,2019,62630
383,0,155,538,71.19,0.0,28.81,2019,62047
135,2,61,198,68.18,1.01,30.81,2019,62053
231,10,116,357,64.71,2.8,32.49,2019,62058
598,11,55,664,90.06,1.66,8.28,2019,62061
3092,77,197,3366,91.86,2.29,5.85,2019,62062
6,0,0,6,100.0,0.0,0.0,2019,62070
749,28,219,996,75.2,2.81,21.99,2019,62082
495,31,104,630,78.57,4.92,16.51,2019,62084
44,0,17,61,72.13,0.0,27.87,2019,62085
461,0,101,562,82.03,0.0,17.97,2019,62086
191,3,41,235,81.28,1.28,17.45,2019,62633
264,6,51,321,82.24,1.87,15.89,2019,62634
102,0,18,120,85.0,0.0,15.0,2019,62639
400,21,127,548,72.99,3.83,23.18,2019,62665
137,1,37,175,78.29,0.57,21.14,2019,62673
478,6,136,620,77.1,0.97,21.94,2019,62674
182,15,32,229,79.48,6.55,13.97,2019,62689
10884,1126,3516,15526,70.1,7.25,22.65,2019,62702
2499,177,453,3129,79.87,5.66,14.48,2019,62707
167,8,52,227,73.57,3.52,22.91,2019,62817
843,40,340,1223,68.93,3.27,27.8,2019,62822
436,36,216,688,63.37,5.23,31.4,2019,62823
153,1,97,251,60.96,0.4,38.65,2019,62253
49,0,3,52,94.23,0.0,5.77,2019,67049
183,4,64,251,72.91,1.59,25.5,2019,67053
79,4,32,115,68.7,3.48,27.83,2019,67057
1256,90,403,1749,71.81,5.15,23.04,2019,67068
66,6,9,81,81.48,7.41,11.11,2019,67103
1033,93,320,1446,71.44,6.43,22.13,2019,67107
1039,18,209,1266,82.07,1.42,16.51,2019,68405
292,2,39,333,87.69,0.6,11.71,2019,68409
85,0,15,100,85.0,0.0,15.0,2019,68785
324,2,115,441,73.47,0.45,26.08,2019,68825
109,8,18,135,80.74,5.93,13.33,2019,68833
79,0,13,92,85.87,0.0,14.13,2019,68838
267,3,38,308,86.69,0.97,12.34,2019,68843
468,19,103,590,79.32,3.22,17.46,2019,68876
141,0,55,196,71.94,0.0,28.06,2019,68925
144,5,28,177,81.36,2.82,15.82,2019,69133
162,0,26,188,86.17,0.0,13.83,2019,69134
40,2,2,44,90.91,4.55,4.55,2019,69039
186,3,43,232,80.17,1.29,18.53,2019,69147
15,7,0,22,68.18,31.82,0.0,2019,69340
103,0,0,103,100.0,0.0,0.0,2019,69023
8,0,8,16,50.0,0.0,50.0,2019,69027
158,0,20,178,88.76,0.0,11.24,2019,69029
455,20,158,633,71.88,3.16,24.96,2019,69021
400,15,123,538,74.35,2.79,22.86,2019,69024
289,7,69,365,79.18,1.92,18.9,2019,69028
526,7,79,612,85.95,1.14,12.91,2019,69143
382,10,82,474,80.59,2.11,17.3,2019,69155
16,12,19,47,34.04,25.53,40.43,2019,69161
2745,103,544,3392,80.93,3.04,16.04,2019,69162
87,0,21,108,80.56,0.0,19.44,2019,69168
89,2,17,108,82.41,1.85,15.74,2019,69214
35,0,9,44,79.55,0.0,20.45,2019,69216
70,1,26,97,72.16,1.03,26.8,2019,69030
55,0,3,58,94.83,0.0,5.17,2019,69221
5,0,0,5,100.0,0.0,0.0,2019,69171
11,0,2,13,84.62,0.0,15.38,2019,69353
233,4,103,340,68.53,1.18,30.29,2019,71950
801,84,335,1220,65.66,6.89,27.46,2019,71957
1226,29,299,1554,78.89,1.87,19.24,2019,71968
1049,30,483,1562,67.16,1.92,30.92,2019,71068
393,30,252,675,58.22,4.44,37.33,2019,71070
25,0,61,86,29.07,0.0,70.93,2019,71079
4012,408,3141,7561,53.06,5.4,41.54,2019,71109
31,19,85,135,22.96,14.07,62.96,2019,71223
65,7,15,87,74.71,8.05,17.24,2019,71243
2190,0,894,3084,71.01,0.0,28.99,2019,71251
255,16,235,506,50.4,3.16,46.44,2019,71261
301,6,291,598,50.33,1.0,48.66,2019,71266
24,0,14,38,63.16,0.0,36.84,2019,71276
2630,371,1808,4809,54.69,7.71,37.6,2019,71295
1731,108,912,2751,62.92,3.93,33.15,2019,71343
887,123,546,1556,57.01,7.9,35.09,2019,71350
3108,107,1135,4350,71.45,2.46,26.09,2019,71351
58,9,0,67,86.57,13.43,0.0,2019,71401
37,0,7,44,84.09,0.0,15.91,2019,71410
47,0,0,47,100.0,0.0,0.0,2019,71425
67,0,31,98,68.37,0.0,31.63,2019,71426
3143,128,275,3546,88.64,3.61,7.76,2019,71459
132,0,175,307,43.0,0.0,57.0,2019,71642
57,0,14,71,80.28,0.0,19.72,2019,71651
4194,385,1216,5795,72.37,6.64,20.98,2019,71655
145,13,107,265,54.72,4.91,40.38,2019,71658
179,14,269,462,38.74,3.03,58.23,2019,71368
1432,38,874,2344,61.09,1.62,37.29,2019,71418
2879,81,314,3274,87.94,2.47,9.59,2019,67110
6776,267,1306,8349,81.16,3.2,15.64,2019,67114
261,19,114,394,66.24,4.82,28.93,2019,67120
2167,46,117,2330,93.0,1.97,5.02,2019,67133
140,1,78,219,63.93,0.46,35.62,2019,67137
124,3,12,139,89.21,2.16,8.63,2019,67138
10,4,5,19,52.63,21.05,26.32,2019,67143
6344,27,237,6608,96.0,0.41,3.59,2019,67205
287,8,98,393,73.03,2.04,24.94,2019,67024
135,8,25,168,80.36,4.76,14.88,2019,67066
599,11,41,651,92.01,1.69,6.3,2019,67067
174,14,31,219,79.45,6.39,14.16,2019,67123
124,0,35,159,77.99,0.0,22.01,2019,67142
308,0,34,342,90.06,0.0,9.94,2019,67149
2564,238,565,3367,76.15,7.07,16.78,2019,67210
3479,109,783,4371,79.59,2.49,17.91,2019,67219
4120,104,993,5217,78.97,1.99,19.03,2019,67301
37,3,2,42,88.1,7.14,4.76,2019,67332
38,0,25,63,60.32,0.0,39.68,2019,67355
3722,202,1048,4972,74.86,4.06,21.08,2019,67357
350,7,47,404,86.63,1.73,11.63,2019,67416
345,30,57,432,79.86,6.94,13.19,2019,67441
1006,32,283,1321,76.15,2.42,21.42,2019,67449
148,3,5,156,94.87,1.92,3.21,2019,67491
917,120,201,1238,74.07,9.69,16.24,2019,67505
231,14,101,346,66.76,4.05,29.19,2019,67514
20,0,2,22,90.91,0.0,9.09,2019,67515
641,25,51,717,89.4,3.49,7.11,2019,67522
332,13,86,431,77.03,3.02,19.95,2019,67525
384,18,104,506,75.89,3.56,20.55,2019,67561
73,9,20,102,71.57,8.82,19.61,2019,67568
954,65,178,1197,79.7,5.43,14.87,2019,67579
86,1,14,101,85.15,0.99,13.86,2019,67584
59,0,18,77,76.62,0.0,23.38,2019,67623
636,5,106,747,85.14,0.67,14.19,2019,67740
81,13,20,114,71.05,11.4,17.54,2019,67643
95,2,16,113,84.07,1.77,14.16,2019,67644
118,0,21,139,84.89,0.0,15.11,2019,67657
135,4,43,182,74.18,2.2,23.63,2019,67741
795,22,205,1022,77.79,2.15,20.06,2019,67748
130,0,39,169,76.92,0.0,23.08,2019,67753
371,2,101,474,78.27,0.42,21.31,2019,67758
344,8,72,424,81.13,1.89,16.98,2019,67831
835,18,165,1018,82.02,1.77,16.21,2019,67835
282,8,65,355,79.44,2.25,18.31,2019,67844
659,13,153,825,79.88,1.58,18.55,2019,67861
481,12,141,634,75.87,1.89,22.24,2019,67867
1644,57,282,1983,82.9,2.87,14.22,2019,67871
92,0,45,137,67.15,0.0,32.85,2019,67882
5838,79,1110,7027,83.08,1.12,15.8,2019,67901
529,45,154,728,72.66,6.18,21.15,2019,67950
4603,126,528,5257,87.56,2.4,10.04,2019,67002
743,62,197,1002,74.15,6.19,19.66,2019,67003
415,16,75,506,82.02,3.16,14.82,2019,70749
329,49,223,601,54.74,8.15,37.1,2019,70750
459,12,281,752,61.04,1.6,37.37,2019,70759
1149,20,270,1439,79.85,1.39,18.76,2019,70777
323,20,130,473,68.29,4.23,27.48,2019,70780
80,27,10,117,68.38,23.08,8.55,2019,70801
353,17,201,571,61.82,2.98,35.2,2019,71456
2919,297,2263,5479,53.28,5.42,41.3,2019,71601
85,62,61,208,40.87,29.81,29.33,2019,71724
275,10,330,615,44.72,1.63,53.66,2019,71726
393,44,413,850,46.24,5.18,48.59,2019,71765
504,68,274,846,59.57,8.04,32.39,2019,71845
422,8,336,766,55.09,1.04,43.86,2019,71861
16044,536,3387,19967,80.35,2.68,16.96,2019,71913
110,0,107,217,50.69,0.0,49.31,2019,71935
204,8,60,272,75.0,2.94,22.06,2019,59832
31,3,21,55,56.36,5.45,38.18,2019,59484
224,10,48,282,79.43,3.55,17.02,2019,59038
111,3,99,213,52.11,1.41,46.48,2019,59213
49,9,8,66,74.24,13.64,12.12,2019,59007
37,2,5,44,84.09,4.55,11.36,2019,59419
67,9,21,97,69.07,9.28,21.65,2019,59525
22,0,7,29,75.86,0.0,24.14,2019,59640
7,2,0,9,77.78,22.22,0.0,2019,59082
14,0,0,14,100.0,0.0,0.0,2019,59240
12,0,9,21,57.14,0.0,42.86,2019,59256
6,0,6,12,50.0,0.0,50.0,2019,59312
26,0,0,26,100.0,0.0,0.0,2019,59418
7,0,0,7,100.0,0.0,0.0,2019,59461
126,7,5,138,91.3,5.07,3.62,2019,59489
103,0,40,143,72.03,0.0,27.97,2019,59647
35,3,0,38,92.11,7.89,0.0,2019,59703
31,2,3,36,86.11,5.56,8.33,2019,59724
41,22,18,81,50.62,27.16,22.22,2019,59732
117,0,33,150,78.0,0.0,22.0,2019,59760
61,0,11,72,84.72,0.0,15.28,2019,59830
93,2,42,137,67.88,1.46,30.66,2019,59856
38,0,21,59,64.41,0.0,35.59,2019,59863
890,17,201,1108,80.32,1.53,18.14,2019,59313
1068,54,194,1316,81.16,4.1,14.74,2019,59474
277,11,249,537,51.58,2.05,46.37,2019,59639
1112,33,321,1466,75.85,2.25,21.9,2019,59752
76,2,41,119,63.87,1.68,34.45,2019,59827
115,0,14,129,89.15,0.0,10.85,2019,59540
151,3,18,172,87.79,1.74,10.47,2019,59247
20,0,10,30,66.67,0.0,33.33,2019,59252
22,0,8,30,73.33,0.0,26.67,2019,59253
3822,60,913,4795,79.71,1.25,19.04,2019,59301
59,4,26,89,66.29,4.49,29.21,2019,59326
55,9,10,74,74.32,12.16,13.51,2019,59336
245,8,73,326,75.15,2.45,22.39,2019,59337
108,0,34,142,76.06,0.0,23.94,2019,59347
60,0,30,90,66.67,0.0,33.33,2019,59411
448,28,192,668,67.07,4.19,28.74,2019,59412
1056,45,288,1389,76.03,3.24,20.73,2019,59425
8843,234,1181,10258,86.21,2.28,11.51,2019,59602
86,0,3,89,96.63,0.0,3.37,2019,59633
0,0,0,0,,,,2019,59636
188,29,52,269,69.89,10.78,19.33,2019,59638
6584,256,1225,8065,81.64,3.17,15.19,2019,59714
138,26,43,207,66.67,12.56,20.77,2019,59721
1465,68,406,1939,75.55,3.51,20.94,2019,59722
43,3,16,62,69.35,4.84,25.81,2019,59743
841,11,132,984,85.47,1.12,13.41,2019,59825
51,3,6,60,85.0,5.0,10.0,2019,59848
91,0,0,91,100.0,0.0,0.0,2019,70442
125,0,155,280,44.64,0.0,55.36,2019,70455
9368,304,779,10451,89.64,2.91,7.45,2019,70461
4341,144,720,5205,83.4,2.77,13.83,2019,70518
415,28,124,567,73.19,4.94,21.87,2019,70531
2065,47,610,2722,75.86,1.73,22.41,2019,70533
134,0,35,169,79.29,0.0,20.71,2019,70537
82,0,48,130,63.08,0.0,36.92,2019,70556
10648,402,3474,14524,73.31,2.77,23.92,2019,70560
8735,548,5305,14588,59.88,3.76,36.37,2019,70570
1008,88,366,1462,68.95,6.02,25.03,2019,70377
2498,113,602,3213,77.75,3.52,18.74,2019,70392
209,0,75,284,73.59,0.0,26.41,2019,70581
9118,466,4445,14029,64.99,3.32,31.68,2019,70601
12900,512,1698,15110,85.37,3.39,11.24,2019,70605
2121,0,542,2663,79.65,0.0,20.35,2019,70633
431,55,213,699,61.66,7.87,30.47,2019,70652
57,0,46,103,55.34,0.0,44.66,2019,70654
515,23,57,595,86.55,3.87,9.58,2019,70660
5470,298,888,6656,82.18,4.48,13.34,2019,70714
421,47,120,588,71.6,7.99,20.41,2019,70715
2485,32,73,2590,95.95,1.24,2.82,2019,70734
1103,83,474,1660,66.45,5.0,28.55,2019,70748
41,26,0,67,61.19,38.81,0.0,2019,70787
12325,268,779,13372,92.17,2.0,5.83,2019,70808
15359,606,1680,17645,87.04,3.43,9.52,2019,70816
2948,102,417,3467,85.03,2.94,12.03,2019,70774
72,0,86,158,45.57,0.0,54.43,2019,70756
356,0,44,400,89.0,0.0,11.0,2019,70762
63,0,29,92,68.48,0.0,31.52,2019,70773
2627,385,602,3614,72.69,10.65,16.66,2019,70775
896,14,354,1264,70.89,1.11,28.01,2019,70776
1037,19,307,1363,76.08,1.39,22.52,2019,70788
7932,157,1154,9243,85.82,1.7,12.49,2019,70791
5739,666,2680,9085,63.17,7.33,29.5,2019,70805
11871,148,473,12492,95.03,1.18,3.79,2019,70817
0,0,0,0,,,,2019,70836
114,11,60,185,61.62,5.95,32.43,2019,70465
7201,194,721,8116,88.73,2.39,8.88,2019,70471
7669,409,3377,11455,66.95,3.57,29.48,2019,70501
5482,151,779,6412,85.5,2.35,12.15,2019,70507
178,6,101,285,62.46,2.11,35.44,2019,70534
3874,80,1341,5295,73.16,1.51,25.33,2019,70538
869,35,353,1257,69.13,2.78,28.08,2019,70549
6209,219,825,7253,85.61,3.02,11.37,2019,70563
3377,52,786,4215,80.12,1.23,18.65,2019,70583
108,52,0,160,67.5,32.5,0.0,2019,70632
370,0,383,753,49.14,0.0,50.86,2019,70661
87,0,45,132,65.91,0.0,34.09,2019,70662
74,0,13,87,85.06,0.0,14.94,2019,70743
285,0,29,314,90.76,0.0,9.24,2019,70752
122,33,137,292,41.78,11.3,46.92,2019,70761
1208,23,269,1500,80.53,1.53,17.93,2019,70763
516,18,126,660,78.18,2.73,19.09,2019,59014
261,13,204,478,54.6,2.72,42.68,2019,59022
11,6,4,21,52.38,28.57,19.05,2019,59025
67,0,8,75,89.33,0.0,10.67,2019,59031
78,0,21,99,78.79,0.0,21.21,2019,59033
390,16,137,543,71.82,2.95,25.23,2019,59036
150,0,125,275,54.55,0.0,45.45,2019,59855
426,4,210,640,66.56,0.62,32.81,2019,59874
17808,419,2556,20783,85.69,2.02,12.3,2019,59901
3001,123,469,3593,83.52,3.42,13.05,2019,59911
205,8,57,270,75.93,2.96,21.11,2019,59913
89,11,26,126,70.63,8.73,20.63,2019,59914
360,19,100,479,75.16,3.97,20.88,2019,59925
139,0,58,197,70.56,0.0,29.44,2019,59926
111,4,21,136,81.62,2.94,15.44,2019,59931
9415,209,1047,10671,88.23,1.96,9.81,2019,60185
13605,316,901,14822,91.79,2.13,6.08,2019,60188
2555,29,456,3040,84.05,0.95,15.0,2019,60401
3394,96,191,3681,92.2,2.61,5.19,2019,60422
796,40,100,936,85.04,4.27,10.68,2019,60424
2595,56,307,2958,87.73,1.89,10.38,2019,60425
4076,117,838,5031,81.02,2.33,16.66,2019,59044
81,0,9,90,90.0,0.0,10.0,2019,59065
21,7,6,34,61.76,20.59,17.65,2019,57457
28,0,2,30,93.33,0.0,6.67,2019,57470
289,24,68,381,75.85,6.3,17.85,2019,57528
81,1,24,106,76.42,0.94,22.64,2019,57538
29,8,20,57,50.88,14.04,35.09,2019,57563
164,37,308,509,32.22,7.27,60.51,2019,57570
113,12,157,282,40.07,4.26,55.67,2019,57577
216,0,102,318,67.92,0.0,32.08,2019,57623
183,11,80,274,66.79,4.01,29.2,2019,57632
98,0,41,139,70.5,0.0,29.5,2019,57641
201,7,84,292,68.84,2.4,28.77,2019,57656
18,0,12,30,60.0,0.0,40.0,2019,57661
86,6,42,134,64.18,4.48,31.34,2019,57714
2473,47,301,2821,87.66,1.67,10.67,2019,57718
281,9,28,318,88.36,2.83,8.81,2019,57720
906,28,281,1215,74.57,2.3,23.13,2019,57732
675,16,259,950,71.05,1.68,27.26,2019,57745
41,17,0,58,70.69,29.31,0.0,2019,57758
402,40,108,550,73.09,7.27,19.64,2019,57760
167,0,0,167,100.0,0.0,0.0,2019,57779
33,0,1,34,97.06,0.0,2.94,2019,57027
169,15,73,257,65.76,5.84,28.4,2019,57219
43,0,23,66,65.15,0.0,34.85,2019,57233
274,15,61,350,78.29,4.29,17.43,2019,57235
135,25,55,215,62.79,11.63,25.58,2019,57238
96,0,6,102,94.12,0.0,5.88,2019,57247
46,2,9,57,80.7,3.51,15.79,2019,57251
43,0,11,54,79.63,0.0,20.37,2019,57346
396,45,95,536,73.88,8.4,17.72,2019,57279
417,5,55,477,87.42,1.05,11.53,2019,57311
155,7,88,250,62.0,2.8,35.2,2019,57317
115,2,28,145,79.31,1.38,19.31,2019,57324
388,71,128,587,66.1,12.1,21.81,2019,57355
131,7,24,162,80.86,4.32,14.81,2019,57374
199,36,76,311,63.99,11.58,24.44,2019,57375
177,3,45,225,78.67,1.33,20.0,2019,57381
9,0,0,9,100.0,0.0,0.0,2019,57426
85,4,57,146,58.22,2.74,39.04,2019,57432
470,36,236,742,63.34,4.85,31.81,2019,57437
64,0,36,100,64.0,0.0,36.0,2019,57449
65,5,22,92,70.65,5.43,23.91,2019,57467
5914,147,1157,7218,81.93,2.04,16.03,2019,57501
1041,45,212,1298,80.2,3.47,16.33,2019,57532
175,10,130,315,55.56,3.17,41.27,2019,57543
231,9,60,300,77.0,3.0,20.0,2019,57559
230,11,50,291,79.04,3.78,17.18,2019,57568
1359,60,349,1768,76.87,3.39,19.74,2019,57580
95,2,0,97,97.94,2.06,0.0,2019,57640
107,9,42,158,67.72,5.7,26.58,2019,57648
13166,265,1334,14765,89.17,1.79,9.03,2019,57702
34,0,18,52,65.38,0.0,34.62,2019,57750
62,4,45,111,55.86,3.6,40.54,2019,61416
401,32,137,570,70.35,5.61,24.04,2019,61421
249,19,46,314,79.3,6.05,14.65,2019,61430
471,24,81,576,81.77,4.17,14.06,2019,61747
60,0,16,76,78.95,0.0,21.05,2019,61743
595,16,98,709,83.92,2.26,13.82,2019,61744
4361,111,992,5464,79.81,2.03,18.16,2019,60433
11312,165,444,11921,94.89,1.38,3.72,2019,60451
1336,119,242,1697,78.73,7.01,14.26,2019,60456
6164,139,859,7162,86.07,1.94,11.99,2019,60473
889,21,173,1083,82.09,1.94,15.97,2019,60476
13203,340,1468,15011,87.96,2.27,9.78,2019,60477
11720,193,933,12846,91.23,1.5,7.26,2019,60517
1158,26,259,1443,80.25,1.8,17.95,2019,60518
3546,195,633,4374,81.07,4.46,14.47,2019,60523
629,11,88,728,86.4,1.51,12.09,2019,60531
6287,184,406,6877,91.42,2.68,5.9,2019,60542
4029,27,504,4560,88.36,0.59,11.05,2019,60545
1283,14,183,1480,86.69,0.95,12.36,2019,60551
13148,86,213,13447,97.78,0.64,1.58,2019,60564
460,41,0,501,91.82,8.18,0.0,2019,60604
9381,718,3137,13236,70.87,5.42,23.7,2019,60612
23972,1028,2072,27072,88.55,3.8,7.65,2019,60613
22560,525,5707,28792,78.36,1.82,19.82,2019,60617
29732,1043,4583,35358,84.09,2.95,12.96,2019,60618
7518,764,3666,11948,62.92,6.39,30.68,2019,60624
18147,953,3895,22995,78.92,4.14,16.94,2019,60626
17754,434,2684,20872,85.06,2.08,12.86,2019,60630
18859,1129,5025,25013,75.4,4.51,20.09,2019,60632
13070,728,2206,16004,81.67,4.55,13.78,2019,60645
11148,513,3326,14987,74.38,3.42,22.19,2019,60653
15464,382,2565,18411,83.99,2.07,13.93,2019,60506
512,20,102,634,80.76,3.15,16.09,2019,60511
17,0,0,17,100.0,0.0,0.0,2019,60519
982,22,67,1071,91.69,2.05,6.26,2019,60520
5792,87,203,6082,95.23,1.43,3.34,2019,60521
10231,257,1158,11646,87.85,2.21,9.94,2019,60525
44,1,4,49,89.8,2.04,8.16,2019,60536
997,24,140,1161,85.87,2.07,12.06,2019,60541
12459,238,597,13294,93.72,1.79,4.49,2019,60543
548,16,94,658,83.28,2.43,14.29,2019,60550
8723,241,1373,10337,84.39,2.33,13.28,2019,60559
11690,534,367,12591,92.84,4.24,2.91,2019,60654
34216,1054,1818,37088,92.26,2.84,4.9,2019,60657
11178,653,1654,13485,82.89,4.84,12.27,2019,60659
12091,454,2809,15354,78.75,2.96,18.29,2019,60707
8793,218,1939,10950,80.3,1.99,17.71,2019,60714
17125,1757,3480,22362,76.58,7.86,15.56,2019,60804
146,3,18,167,87.43,1.8,10.78,2019,60946
211,0,46,257,82.1,0.0,17.9,2019,60952
467,18,116,601,77.7,3.0,19.3,2019,60955
185,8,36,229,80.79,3.49,15.72,2019,60962
272,2,31,305,89.18,0.66,10.16,2019,60929
17754,356,2654,20764,85.5,1.71,12.78,2019,60056
13886,171,1104,15161,91.59,1.13,7.28,2019,60193
3132,233,474,3839,81.58,6.07,12.35,2019,60464
12603,141,1431,14175,88.91,0.99,10.1,2019,60030
11955,151,1074,13180,90.71,1.15,8.15,2019,60107
4096,110,253,4459,91.86,2.47,5.67,2019,60143
99,2,29,130,76.15,1.54,22.31,2019,68928
366,20,50,436,83.94,4.59,11.47,2019,68933
335,19,89,443,75.62,4.29,20.09,2019,68944
2174,167,448,2789,77.95,5.99,16.06,2019,68949
2879,78,636,3593,80.13,2.17,17.7,2019,68410
213,2,20,235,90.64,0.85,8.51,2019,68413
202,9,34,245,82.45,3.67,13.88,2019,61749
1382,25,284,1691,81.73,1.48,16.79,2019,61752
15282,2467,1734,19483,78.44,12.66,8.9,2019,61761
4157,233,775,5165,80.48,4.51,15.0,2019,61764
353,3,85,441,80.05,0.68,19.27,2019,61770
7257,594,1124,8975,80.86,6.62,12.52,2019,61802
194,3,59,256,75.78,1.17,23.05,2019,61811
426,29,72,527,80.83,5.5,13.66,2019,61841
938,58,199,1195,78.49,4.85,16.65,2019,61842
424,9,85,518,81.85,1.74,16.41,2019,61847
185,31,44,260,71.15,11.92,16.92,2019,61876
955,72,649,1676,56.98,4.3,38.72,2019,61911
7129,784,1196,9109,78.26,8.61,13.13,2019,61920
677,23,162,862,78.54,2.67,18.79,2019,61937
1967,78,569,2614,75.25,2.98,21.77,2019,61953
1643,230,425,2298,71.5,10.01,18.49,2019,61606
8230,212,1322,9764,84.29,2.17,13.54,2019,61615
375,0,113,488,76.84,0.0,23.16,2019,62338
1108,48,231,1387,79.88,3.46,16.65,2019,62341
118,1,52,171,69.01,0.58,30.41,2019,62345
511,23,135,669,76.38,3.44,20.18,2019,62351
76,6,35,117,64.96,5.13,29.91,2019,62352
1110,23,295,1428,77.73,1.61,20.66,2019,62353
204,0,27,231,88.31,0.0,11.69,2019,62358
187,0,131,318,58.81,0.0,41.19,2019,62990
76,0,68,144,52.78,0.0,47.22,2019,62976
229,6,50,285,80.35,2.11,17.54,2019,62977
255,3,69,327,77.98,0.92,21.1,2019,62982
138,1,133,272,50.74,0.37,48.9,2019,62992
1008,38,543,1589,63.44,2.39,34.17,2019,62995
2110,278,457,2845,74.17,9.77,16.06,2019,62441
1042,51,204,1297,80.34,3.93,15.73,2019,62447
242,0,93,335,72.24,0.0,27.76,2019,62462
815,1,276,1092,74.63,0.09,25.27,2019,62466
123,0,43,166,74.1,0.0,25.9,2019,62475
496,12,133,641,77.38,1.87,20.75,2019,62513
83,0,28,111,74.77,0.0,25.23,2019,62514
59,0,16,75,78.67,0.0,21.33,2019,62517
68,10,14,92,73.91,10.87,15.22,2019,62518
982,37,116,1135,86.52,3.26,10.22,2019,62535
534,14,107,655,81.53,2.14,16.34,2019,62544
330,11,48,389,84.83,2.83,12.34,2019,62547
912,33,159,1104,82.61,2.99,14.4,2019,62550
530,16,108,654,81.04,2.45,16.51,2019,62001
112,8,35,155,72.26,5.16,22.58,2019,62006
140,7,67,214,65.42,3.27,31.31,2019,62013
112,1,29,142,78.87,0.7,20.42,2019,62019
37,2,2,41,90.24,4.88,4.88,2019,62023
3384,158,745,4287,78.94,3.69,17.38,2019,62024
1630,29,339,1998,81.58,1.45,16.97,2019,62033
619,5,200,824,75.12,0.61,24.27,2019,62037
593,32,207,832,71.27,3.85,24.88,2019,62044
262,11,63,336,77.98,3.27,18.75,2019,62339
4,10,0,14,28.57,71.43,0.0,2019,67012
1061,23,149,1233,86.05,1.87,12.08,2019,67013
68,14,32,114,59.65,12.28,28.07,2019,67023
299,25,69,393,76.08,6.36,17.56,2019,67035
5100,188,1518,6806,74.93,2.76,22.3,2019,67042
1482,0,248,1730,85.66,0.0,14.34,2019,67101
225,0,40,265,84.91,0.0,15.09,2019,68415
74,0,7,81,91.36,0.0,8.64,2019,68419
312,13,50,375,83.2,3.47,13.33,2019,68443
684,32,250,966,70.81,3.31,25.88,2019,68450
105,0,70,175,60.0,0.0,40.0,2019,68453
181,0,14,195,92.82,0.0,7.18,2019,68455
472,7,33,512,92.19,1.37,6.45,2019,68456
796,26,117,939,84.77,2.77,12.46,2019,68002
92,0,25,117,78.63,0.0,21.37,2019,68014
180,18,92,290,62.07,6.21,31.72,2019,68020
8566,165,416,9147,93.65,1.8,4.55,2019,68022
152,0,74,226,67.26,0.0,32.74,2019,68044
4255,132,596,4983,85.39,2.65,11.96,2019,68048
207,0,0,207,100.0,0.0,0.0,2019,68517
397,25,124,546,72.71,4.58,22.71,2019,68629
571,13,164,748,76.34,1.74,21.93,2019,68638
367,1,84,452,81.19,0.22,18.58,2019,68643
488,8,82,578,84.43,1.38,14.19,2019,68666
186,12,48,246,75.61,4.88,19.51,2019,68736
1008,23,185,1216,82.89,1.89,15.21,2019,68739
332,10,58,400,83.0,2.5,14.5,2019,68740
219,4,66,289,75.78,1.38,22.84,2019,68741
46,0,13,59,77.97,0.0,22.03,2019,68753
232,12,53,297,78.11,4.04,17.85,2019,68777
794,31,194,1019,77.92,3.04,19.04,2019,68779
1391,86,433,1910,72.83,4.5,22.67,2019,68788
477,42,213,732,65.16,5.74,29.1,2019,68791
1663,73,438,2174,76.49,3.36,20.15,2019,68822
1294,59,342,1695,76.34,3.48,20.18,2019,68826
231,11,109,351,65.81,3.13,31.05,2019,68831
615,21,154,790,77.85,2.66,19.49,2019,68832
176,14,55,245,71.84,5.71,22.45,2019,68842
5871,271,855,6997,83.91,3.87,12.22,2019,68847
78,1,32,111,70.27,0.9,28.83,2019,68858
346,9,30,385,89.87,2.34,7.79,2019,68865
216,8,4,228,94.74,3.51,1.75,2019,68870
206,6,59,271,76.01,2.21,21.77,2019,68875
136,2,20,158,86.08,1.27,12.66,2019,68878
8354,274,2020,10648,78.46,2.57,18.97,2019,68901
30,0,5,35,85.71,0.0,14.29,2019,68923
185,4,43,232,79.74,1.72,18.53,2019,68938
379,10,144,533,71.11,1.88,27.02,2019,68939
185,11,104,300,61.67,3.67,34.67,2019,68961
150,2,20,172,87.21,1.16,11.63,2019,68973
415,35,113,563,73.71,6.22,20.07,2019,68038
563,22,132,717,78.52,3.07,18.41,2019,68047
1169,20,142,1331,87.83,1.5,10.67,2019,68059
729,26,246,1001,72.83,2.6,24.58,2019,68061
10792,209,466,11467,94.11,1.82,4.06,2019,68123
80,15,23,118,67.8,12.71,19.49,2019,68062
3712,272,432,4416,84.06,6.16,9.78,2019,68102
3893,23,296,4212,92.43,0.55,7.03,2019,68122
4544,8,298,4850,93.69,0.16,6.14,2019,68138
222,0,95,317,70.03,0.0,29.97,2019,71944
518,18,190,726,71.35,2.48,26.17,2019,71949
363,2,265,630,57.62,0.32,42.06,2019,71956
167,48,118,333,50.15,14.41,35.44,2019,71970
636,31,286,953,66.74,3.25,30.01,2019,71958
206,0,85,291,70.79,0.0,29.21,2019,71959
2493,88,116,2697,92.44,3.26,4.3,2019,57032
583,38,137,758,76.91,5.01,18.07,2019,57053
95,0,4,99,95.96,0.0,4.04,2019,57057
27,0,9,36,75.0,0.0,25.0,2019,57061
1966,11,145,2122,92.65,0.52,6.83,2019,57064
12186,353,1802,14341,84.97,2.46,12.57,2019,57103
17059,658,1520,19237,88.68,3.42,7.9,2019,57106
236,7,31,274,86.13,2.55,11.31,2019,57220
104,0,27,131,79.39,0.0,20.61,2019,57227
92,0,28,120,76.67,0.0,23.33,2019,57232
217,7,35,259,83.78,2.7,13.51,2019,57243
119,18,61,198,60.1,9.09,30.81,2019,57263
172,18,45,235,73.19,7.66,19.15,2019,57266
51,1,19,71,71.83,1.41,26.76,2019,57271
67,5,10,82,81.71,6.1,12.2,2019,57272
258,4,59,321,80.37,1.25,18.38,2019,57314
489,10,7,506,96.64,1.98,1.38,2019,57020
361,15,136,512,70.51,2.93,26.56,2019,57026
1088,45,179,1312,82.93,3.43,13.64,2019,57028
654,39,229,922,70.93,4.23,24.84,2019,57029
263,27,63,353,74.5,7.65,17.85,2019,57031
97,6,18,121,80.17,4.96,14.88,2019,57047
446,24,243,713,62.55,3.37,34.08,2019,57066
92,11,34,137,67.15,8.03,24.82,2019,57067
496,13,52,561,88.41,2.32,9.27,2019,57068
358,23,72,453,79.03,5.08,15.89,2019,57075
6397,304,1287,7988,80.08,3.81,16.11,2019,57078
9039,367,1670,11076,81.61,3.31,15.08,2019,57201
320,30,166,516,62.02,5.81,32.17,2019,57273
878,53,293,1224,71.73,4.33,23.94,2019,57274
339,21,159,519,65.32,4.05,30.64,2019,57313
140,2,21,163,85.89,1.23,12.88,2019,57321
135,0,61,196,68.88,0.0,31.12,2019,57330
149,7,11,167,89.22,4.19,6.59,2019,57331
275,7,69,351,78.35,1.99,19.66,2019,57334
264,10,78,352,75.0,2.84,22.16,2019,57353
349,26,204,579,60.28,4.49,35.23,2019,57356
303,14,67,384,78.91,3.65,17.45,2019,57363
0,0,0,0,,,,2019,57364
88,4,12,104,84.62,3.85,11.54,2019,57367
448,55,141,644,69.57,8.54,21.89,2019,57382
255,9,77,341,74.78,2.64,22.58,2019,57383
141,4,47,192,73.44,2.08,24.48,2019,57446
88,10,17,115,76.52,8.7,14.78,2019,57452
60,0,0,60,100.0,0.0,0.0,2019,57651
140,13,37,190,73.68,6.84,19.47,2019,57631
116,2,25,143,81.12,1.4,17.48,2019,57633
10,0,0,10,100.0,0.0,0.0,2019,57650
14461,791,3166,18418,78.52,4.29,17.19,2019,57701
56,2,59,117,47.86,1.71,50.43,2019,57716
62,0,22,84,73.81,0.0,26.19,2019,57722
164,25,216,405,40.49,6.17,53.33,2019,57752
183,9,62,254,72.05,3.54,24.41,2019,57762
9,0,5,14,64.29,0.0,35.71,2019,58065
0,0,0,0,,,,2019,58076
0,0,0,0,,,,2019,58105
0,0,0,0,,,,2019,58205
10,0,0,10,100.0,0.0,0.0,2019,58339
0,0,0,0,,,,2019,58402
190,0,130,320,59.38,0.0,40.62,2019,71962
1076,18,319,1413,76.15,1.27,22.58,2019,71964
327,6,105,438,74.66,1.37,23.97,2019,71325
2792,190,1447,4429,63.04,4.29,32.67,2019,71635
149,61,113,323,46.13,18.89,34.98,2019,71644
52,0,85,137,37.96,0.0,62.04,2019,71661
19,0,9,28,67.86,0.0,32.14,2019,71722
1447,95,827,2369,61.08,4.01,34.91,2019,71639
561,62,243,866,64.78,7.16,28.06,2019,71647
276,33,315,624,44.23,5.29,50.48,2019,71670
2320,132,896,3348,69.3,3.94,26.76,2019,71671
283,13,87,383,73.89,3.39,22.72,2019,71752
430,24,270,724,59.39,3.31,37.29,2019,71764
218,0,122,340,64.12,0.0,35.88,2019,71827
270,16,136,422,63.98,3.79,32.23,2019,71838
95,0,27,122,77.87,0.0,22.13,2019,71853
1075,100,557,1732,62.07,5.77,32.16,2019,71943
245,27,178,450,54.44,6.0,39.56,2019,71003
27,21,340,388,6.96,5.41,87.63,2019,71021
435,89,112,636,68.4,13.99,17.61,2019,71027
1177,93,173,1443,81.57,6.44,11.99,2019,71033
4099,362,1604,6065,67.58,5.97,26.45,2019,71602
687,52,540,1279,53.71,4.07,42.22,2019,71638
227,15,162,404,56.19,3.71,40.1,2019,71834
833,47,377,1257,66.27,3.74,29.99,2019,71836
1355,68,622,2045,66.26,3.33,30.42,2019,71837
218,0,58,276,78.99,0.0,21.01,2019,71847
469,18,419,906,51.77,1.99,46.25,2019,71858
568,25,293,886,64.11,2.82,33.07,2019,71860
188,8,37,233,80.69,3.43,15.88,2019,71866
291,7,111,409,71.15,1.71,27.14,2019,71961
478,9,197,684,69.88,1.32,28.8,2019,71354
160,27,150,337,47.48,8.01,44.51,2019,71358
1513,125,690,2328,64.99,5.37,29.64,2019,71373
370,114,429,913,40.53,12.49,46.99,2019,71378
172,0,166,338,50.89,0.0,49.11,2019,71404
220,0,105,325,67.69,0.0,32.31,2019,71407
555,17,112,684,81.14,2.49,16.37,2019,71422
191,2,14,207,92.27,0.97,6.76,2019,71427
2000,140,1325,3465,57.72,4.04,38.24,2019,71449
506,6,286,798,63.41,0.75,35.84,2019,71454
28,0,28,56,50.0,0.0,50.0,2019,71455
886,23,361,1270,69.76,1.81,28.43,2019,71921
330,82,284,696,47.41,11.78,40.8,2019,71336
79,0,7,86,91.86,0.0,8.14,2019,71339
1899,54,600,2553,74.38,2.12,23.5,2019,71342
10420,253,2105,12778,81.55,1.98,16.47,2019,71360
330,37,306,673,49.03,5.5,45.47,2019,71366
250,0,170,420,59.52,0.0,40.48,2019,71367
1311,38,293,1642,79.84,2.31,17.84,2019,71403
6,0,59,65,9.23,0.0,90.77,2019,71414
487,42,272,801,60.8,5.24,33.96,2019,71419
334,0,42,376,88.83,0.0,11.17,2019,71424
95,7,30,132,71.97,5.3,22.73,2019,59936
5159,109,562,5830,88.49,1.87,9.64,2019,59937
3148,156,827,4131,76.2,3.78,20.02,2019,59923
23,0,0,23,100.0,0.0,0.0,2019,59933
136,13,29,178,76.4,7.3,16.29,2019,59434
203,0,70,273,74.36,0.0,25.64,2019,59410
459,5,164,628,73.09,0.8,26.11,2019,68376
251,9,18,278,90.29,3.24,6.47,2019,68401
589,32,51,672,87.65,4.76,7.59,2019,68430
64,6,29,99,64.65,6.06,29.29,2019,68433
157,0,34,191,82.2,0.0,17.8,2019,68457
105,2,43,150,70.0,1.33,28.67,2019,68942
451,30,100,581,77.62,5.16,17.21,2019,68922
57,5,7,69,82.61,7.25,10.14,2019,68934
148,0,10,158,93.67,0.0,6.33,2019,68980
135,0,91,226,59.73,0.0,40.27,2019,68634
526,28,198,752,69.95,3.72,26.33,2019,68642
261,0,21,282,92.55,0.0,7.45,2019,68653
28,2,2,32,87.5,6.25,6.25,2019,68667
176,9,57,242,72.73,3.72,23.55,2019,68722
153,18,79,250,61.2,7.2,31.6,2019,68725
567,8,53,628,90.29,1.27,8.44,2019,68745
743,42,245,1030,72.14,4.08,23.79,2019,68748
621,38,165,824,75.36,4.61,20.02,2019,68756
60,3,31,94,63.83,3.19,32.98,2019,68759
1581,53,412,2046,77.27,2.59,20.14,2019,68763
30,6,15,51,58.82,11.76,29.41,2019,68332
435,3,43,481,90.44,0.62,8.94,2019,68339
110,1,11,122,90.16,0.82,9.02,2019,68348
33,6,39,78,42.31,7.69,50.0,2019,68381
85,11,29,125,68.0,8.8,23.2,2019,68414
281,29,23,333,84.38,8.71,6.91,2019,68421
166,3,53,222,74.77,1.35,23.87,2019,68346
385,7,65,457,84.25,1.53,14.22,2019,68349
103,7,33,143,72.03,4.9,23.08,2019,68367
563,30,78,671,83.9,4.47,11.62,2019,68371
42,0,15,57,73.68,0.0,26.32,2019,68375
141,2,65,208,67.79,0.96,31.25,2019,68406
105,0,33,138,76.09,0.0,23.91,2019,68417
351,7,106,464,75.65,1.51,22.84,2019,68423
229,3,34,266,86.09,1.13,12.78,2019,68439
29,0,20,49,59.18,0.0,40.82,2019,68440
82,0,5,87,94.25,0.0,5.75,2019,68441
122,2,48,172,70.93,1.16,27.91,2019,68442
233,1,44,278,83.81,0.36,15.83,2019,68454
45,5,21,71,63.38,7.04,29.58,2019,68458
1452,34,114,1600,90.75,2.12,7.12,2019,68462
16368,427,876,17671,92.63,2.42,4.96,2019,68516
896,19,33,948,94.51,2.0,3.48,2019,68520
2344,39,64,2447,95.79,1.59,2.62,2019,68526
131,0,45,176,74.43,0.0,25.57,2019,68623
258,10,44,312,82.69,3.21,14.1,2019,68710
770,88,140,998,77.15,8.82,14.03,2019,68713
85,0,19,104,81.73,0.0,18.27,2019,68717
606,13,165,784,77.3,1.66,21.05,2019,68730
410,8,127,545,75.23,1.47,23.3,2019,68758
126,4,28,158,79.75,2.53,17.72,2019,68338
147,0,46,193,76.17,0.0,23.83,2019,68322
181,4,39,224,80.8,1.79,17.41,2019,68335
1332,13,249,1594,83.56,0.82,15.62,2019,70819
1420,41,557,2018,70.37,2.03,27.6,2019,70431
3492,110,421,4023,86.8,2.73,10.46,2019,70445
4685,16,325,5026,93.22,0.32,6.47,2019,70447
0,0,0,0,,,,2019,70451
184,9,47,240,76.67,3.75,19.58,2019,70453
45,3,19,67,67.16,4.48,28.36,2019,59420
153,7,17,177,86.44,3.95,9.6,2019,59430
602,19,143,764,78.8,2.49,18.72,2019,59436
64,0,7,71,90.14,0.0,9.86,2019,59440
92,0,6,98,93.88,0.0,6.12,2019,59460
30,0,16,46,65.22,0.0,34.78,2019,59467
193,15,37,245,78.78,6.12,15.1,2019,59468
262,8,73,343,76.38,2.33,21.28,2019,59479
168,5,63,236,71.19,2.12,26.69,2019,59482
688,18,254,960,71.67,1.88,26.46,2019,59523
525,81,196,802,65.46,10.1,24.44,2019,59526
113,0,19,132,85.61,0.0,14.39,2019,59528
72,8,7,87,82.76,9.2,8.05,2019,59529
101,4,4,109,92.66,3.67,3.67,2019,59531
59,0,17,76,77.63,0.0,22.37,2019,59532
25,8,10,43,58.14,18.6,23.26,2019,59545
24,0,3,27,88.89,0.0,11.11,2019,59547
1255,89,315,1659,75.65,5.36,18.99,2019,59644
101,8,21,130,77.69,6.15,16.15,2019,59728
74,0,25,99,74.75,0.0,25.25,2019,59735
1542,60,241,1843,83.67,3.26,13.08,2019,59741
61,5,13,79,77.22,6.33,16.46,2019,59746
55,0,38,93,59.14,0.0,40.86,2019,59748
66,16,13,95,69.47,16.84,13.68,2019,59755
2644,186,400,3230,81.86,5.76,12.38,2019,59804
200,3,32,235,85.11,1.28,13.62,2019,59826
241,5,49,295,81.69,1.69,16.61,2019,59844
339,15,258,612,55.39,2.45,42.16,2019,59845
1873,113,601,2587,72.4,4.37,23.23,2019,59864
3553,230,619,4402,80.71,5.22,14.06,2019,59870
173,0,27,200,86.5,0.0,13.5,2019,59223
7,0,2,9,77.78,0.0,22.22,2019,59081
1022,59,465,1546,66.11,3.82,30.08,2019,59201
27,0,8,35,77.14,0.0,22.86,2019,59242
35,0,0,35,100.0,0.0,0.0,2019,59257
218,0,54,272,80.15,0.0,19.85,2019,59919
742,42,208,992,74.8,4.23,20.97,2019,59922
38,0,17,55,69.09,0.0,30.91,2019,59851
396,33,130,559,70.84,5.9,23.26,2019,59858
23,0,12,35,65.71,0.0,34.29,2019,59867
5019,166,763,5948,84.38,2.79,12.83,2019,59912
119,3,21,143,83.22,2.1,14.69,2019,59927
82,0,16,98,83.67,0.0,16.33,2019,59929
206,0,19,225,91.56,0.0,8.44,2019,59934
1031,72,355,1458,70.71,4.94,24.35,2019,59935
8928,195,1703,10826,82.47,1.8,15.73,2019,59404
457,39,412,908,50.33,4.3,45.37,2019,59255
11,0,0,11,100.0,0.0,0.0,2019,59276
12,0,6,18,66.67,0.0,33.33,2019,59322
20,0,3,23,86.96,0.0,13.04,2019,59343
548,26,223,797,68.76,3.26,27.98,2019,59421
5,0,0,5,100.0,0.0,0.0,2019,59424
656,18,158,832,78.85,2.16,18.99,2019,59442
5226,431,1162,6819,76.64,6.32,17.04,2019,62223
1296,63,25,1384,93.64,4.55,1.81,2019,62225
1581,16,427,2024,78.11,0.79,21.1,2019,62239
1906,17,382,2305,82.69,0.74,16.57,2019,62243
852,14,119,985,86.5,1.42,12.08,2019,62216
6067,198,1199,7464,81.28,2.65,16.06,2019,62220
48,4,14,66,72.73,6.06,21.21,2019,67105
109,15,13,137,79.56,10.95,9.49,2019,67106
1964,20,81,2065,95.11,0.97,3.92,2019,67215
123,0,71,194,63.4,0.0,36.6,2019,67340
152,0,22,174,87.36,0.0,12.64,2019,67347
81,2,65,148,54.73,1.35,43.92,2019,67351
158,16,18,192,82.29,8.33,9.38,2019,67732
101,0,16,117,86.32,0.0,13.68,2019,67734
1977,19,249,2245,88.06,0.85,11.09,2019,67735
835,25,193,1053,79.3,2.37,18.33,2019,67749
850,22,188,1060,80.19,2.08,17.74,2019,67663
198,0,20,218,90.83,0.0,9.17,2019,67737
4491,69,572,5132,87.51,1.34,11.15,2019,67209
15782,488,2324,18594,84.88,2.62,12.5,2019,67212
4583,311,514,5408,84.74,5.75,9.5,2019,67220
7345,218,359,7922,92.72,2.75,4.53,2019,67226
3820,89,130,4039,94.58,2.2,3.22,2019,67230
453,0,107,560,80.89,0.0,19.11,2019,67330
109,7,38,154,70.78,4.55,24.68,2019,67346
167,7,78,252,66.27,2.78,30.95,2019,67353
79,0,96,175,45.14,0.0,54.86,2019,67360
1451,58,339,1848,78.52,3.14,18.34,2019,67420
397,18,72,487,81.52,3.7,14.78,2019,67437
925,25,195,1145,80.79,2.18,17.03,2019,67439
166,13,96,275,60.36,4.73,34.91,2019,67444
120,2,51,173,69.36,1.16,29.48,2019,67447
40,0,0,40,100.0,0.0,0.0,2019,67482
45,0,28,73,61.64,0.0,38.36,2019,67545
751,19,153,923,81.37,2.06,16.58,2019,67546
159,0,50,209,76.08,0.0,23.92,2019,67557
112,2,24,138,81.16,1.45,17.39,2019,67563
65,0,22,87,74.71,0.0,25.29,2019,67564
159,12,40,211,75.36,5.69,18.96,2019,67565
59,1,13,73,80.82,1.37,17.81,2019,67574
74,1,17,92,80.43,1.09,18.48,2019,67626
9194,272,2046,11512,79.86,2.36,17.77,2019,67846
141,5,22,168,83.93,2.98,13.1,2019,67523
626,55,122,803,77.96,6.85,15.19,2019,67543
85,9,24,118,72.03,7.63,20.34,2019,67556
162,4,77,243,66.67,1.65,31.69,2019,67567
633,16,172,821,77.1,1.95,20.95,2019,67576
7904,356,1421,9681,81.64,3.68,14.68,2019,67601
30,0,19,49,61.22,0.0,38.78,2019,67635
97,2,20,119,81.51,1.68,16.81,2019,67649
7976,208,1445,9629,82.83,2.16,15.01,2019,68105
8268,137,1107,9512,86.92,1.44,11.64,2019,68106
2127,171,937,3235,65.75,5.29,28.96,2019,68110
5536,287,2312,8135,68.05,3.53,28.42,2019,68111
6914,130,1135,8179,84.53,1.59,13.88,2019,68114
2543,79,431,3053,83.3,2.59,14.12,2019,68117
10280,379,2011,12670,81.14,2.99,15.87,2019,68134
9421,128,270,9819,95.95,1.3,2.75,2019,68135
8868,285,678,9831,90.2,2.9,6.9,2019,68154
21,9,22,52,40.38,17.31,42.31,2019,70782
6346,640,973,7959,79.73,8.04,12.23,2019,70785
12924,271,2746,15941,81.07,1.7,17.23,2019,70003
4925,90,1004,6019,81.82,1.5,16.68,2019,70006
419,4,61,484,86.57,0.83,12.6,2019,70031
5965,193,1386,7544,79.07,2.56,18.37,2019,70043
2197,78,416,2691,81.64,2.9,15.46,2019,62230
733,29,263,1025,71.51,2.83,25.66,2019,62237
336,8,54,398,84.42,2.01,13.57,2019,62255
2799,171,400,3370,83.06,5.07,11.87,2019,62258
275,3,66,344,79.94,0.87,19.19,2019,62292
659,26,159,844,78.08,3.08,18.84,2019,62320
56,6,9,71,78.87,8.45,12.68,2019,62334
840,12,297,1149,73.11,1.04,25.85,2019,62257
26,0,11,37,70.27,0.0,29.73,2019,62261
10832,269,766,11867,91.28,2.27,6.45,2019,62269
541,2,129,672,80.51,0.3,19.2,2019,62272
66,0,5,71,92.96,0.0,7.04,2019,62273
1137,12,301,1450,78.41,0.83,20.76,2019,62275
389,16,123,528,73.67,3.03,23.3,2019,62277
338,9,135,482,70.12,1.87,28.01,2019,62324
717,18,287,1022,70.16,1.76,28.08,2019,62326
6950,224,510,7684,90.45,2.92,6.64,2019,60491
7522,59,184,7765,96.87,0.76,2.37,2019,60502
4918,169,144,5231,94.02,3.23,2.75,2019,60503
10697,119,674,11490,93.1,1.04,5.87,2019,60527
6877,66,181,7124,96.53,0.93,2.54,2019,60585
12855,241,480,13576,94.69,1.78,3.54,2019,60586
8464,336,691,9491,89.18,3.54,7.28,2019,60642
301,24,344,669,44.99,3.59,51.42,2019,60958
9614,323,2142,12079,79.59,2.67,17.73,2019,60656
64,3,2,69,92.75,4.35,2.9,2019,60920
2319,49,168,2536,91.44,1.93,6.62,2019,60096
101,0,0,101,100.0,0.0,0.0,2019,60141
3124,99,369,3592,86.97,2.76,10.27,2019,60416
5020,97,731,5848,85.84,1.66,12.5,2019,60546
16642,917,5305,22864,72.79,4.01,23.2,2019,60628
1834,61,175,2070,88.6,2.95,8.45,2019,60480
4015,228,171,4414,90.96,5.17,3.87,2019,60554
19674,845,4038,24557,80.12,3.44,16.44,2019,60641
1906,118,441,2465,77.32,4.79,17.89,2019,60942
7274,155,1220,8649,84.1,1.79,14.11,2019,60450
112,22,16,150,74.67,14.67,10.67,2019,61378
1134,89,319,1542,73.54,5.77,20.69,2019,61410
366,25,84,475,77.05,5.26,17.68,2019,61420
223,6,38,267,83.52,2.25,14.23,2019,61432
244,11,50,305,80.0,3.61,16.39,2019,61440
264,10,130,404,65.35,2.48,32.18,2019,61441
664,63,109,836,79.43,7.54,13.04,2019,61376
88,2,33,123,71.54,1.63,26.83,2019,61340
105,5,29,139,75.54,3.6,20.86,2019,61358
50,5,7,62,80.65,8.06,11.29,2019,61372
389,23,87,499,77.96,4.61,17.43,2019,61379
433,8,81,522,82.95,1.53,15.52,2019,61353
1871,72,439,2382,78.55,3.02,18.43,2019,61362
13,2,28,43,30.23,4.65,65.12,2019,61374
170,0,48,218,77.98,0.0,22.02,2019,61411
327,12,59,398,82.16,3.02,14.82,2019,61414
681,0,80,761,89.49,0.0,10.51,2019,61415
1992,94,363,2449,81.34,3.84,14.82,2019,68152
253,2,38,293,86.35,0.68,12.97,2019,68313
113,1,16,130,86.92,0.77,12.31,2019,68321
110,4,22,136,80.88,2.94,16.18,2019,68323
68,0,7,75,90.67,0.0,9.33,2019,68325
206,8,59,273,75.46,2.93,21.61,2019,68329
0,0,0,0,,,,2019,58405
7,12,0,19,36.84,63.16,0.0,2019,58452
12071,727,1156,13954,86.51,5.21,8.28,2019,58503
0,0,0,0,,,,2019,58702
0,0,0,0,,,,2019,58705
0,0,0,0,,,,2019,58707
156,4,26,186,83.87,2.15,13.98,2019,58006
12,0,2,14,85.71,0.0,14.29,2019,58001
89,3,6,98,90.82,3.06,6.12,2019,58008
14,0,0,14,100.0,0.0,0.0,2019,58009
969,51,90,1110,87.3,4.59,8.11,2019,58012
687,59,104,850,80.82,6.94,12.24,2019,58045
108,4,29,141,76.6,2.84,20.57,2019,58049
1025,28,264,1317,77.83,2.13,20.05,2019,58054
178,10,22,210,84.76,4.76,10.48,2019,58071
15486,1051,2175,18712,82.76,5.62,11.62,2019,58201
54,7,11,72,75.0,9.72,15.28,2019,58520
101,4,33,138,73.19,2.9,23.91,2019,58483
19,0,0,19,100.0,0.0,0.0,2019,58484
66,8,10,84,78.57,9.52,11.9,2019,58497
29,0,10,39,74.36,0.0,25.64,2019,58524
888,169,244,1301,68.26,12.99,18.75,2019,58540
1351,48,150,1549,87.22,3.1,9.68,2019,58545
79,7,18,104,75.96,6.73,17.31,2019,58549
115,8,48,171,67.25,4.68,28.07,2019,58562
8891,521,1476,10888,81.66,4.79,13.56,2019,58601
50,0,35,85,58.82,0.0,41.18,2019,58627
246,37,13,296,83.11,12.5,4.39,2019,58630
61,3,21,85,71.76,3.53,24.71,2019,58632
17,12,43,72,23.61,16.67,59.72,2019,58641
49,3,25,77,63.64,3.9,32.47,2019,58643
75,27,9,111,67.57,24.32,8.11,2019,58645
374,0,110,484,77.27,0.0,22.73,2019,58647
97,5,35,137,70.8,3.65,25.55,2019,58649
11640,436,1742,13818,84.24,3.16,12.61,2019,58701
8822,243,672,9737,90.6,2.5,6.9,2019,58703
93,23,42,158,58.86,14.56,26.58,2019,58765
45,5,13,63,71.43,7.94,20.63,2019,58775
113,5,21,139,81.29,3.6,15.11,2019,58789
82,10,35,127,64.57,7.87,27.56,2019,58792
180,4,48,232,77.59,1.72,20.69,2019,58793
62,0,6,68,91.18,0.0,8.82,2019,58794
110,0,26,136,80.88,0.0,19.12,2019,58847
41,14,6,61,67.21,22.95,9.84,2019,58430
178,3,14,195,91.28,1.54,7.18,2019,58472
1285,49,240,1574,81.64,3.11,15.25,2019,58523
3206,166,915,4287,74.78,3.87,21.34,2019,58301
6672,450,1604,8726,76.46,5.16,18.38,2019,60803
1569,87,384,2040,76.91,4.26,18.82,2019,60954
506,14,122,642,78.82,2.18,19.0,2019,60963
8930,334,619,9883,90.36,3.38,6.26,2019,60187
5229,212,1283,6724,77.77,3.15,19.08,2019,60164
5320,119,233,5672,93.79,2.1,4.11,2019,60173
10779,223,886,11888,90.67,1.88,7.45,2019,68164
49,0,7,56,87.5,0.0,12.5,2019,68315
228,0,20,248,91.94,0.0,8.06,2019,68316
183,7,25,215,85.12,3.26,11.63,2019,68319
42,0,7,49,85.71,0.0,14.29,2019,68324
1648,61,548,2257,73.02,2.7,24.28,2019,68352
200,5,47,252,79.37,1.98,18.65,2019,68342
10111,561,2022,12694,79.65,4.42,15.93,2019,68701
32,0,20,52,61.54,0.0,38.46,2019,68719
40,0,19,59,67.8,0.0,32.2,2019,68724
710,8,61,779,91.14,1.03,7.83,2019,68073
217,17,4,238,91.18,7.14,1.68,2019,68113
7053,126,574,7753,90.97,1.63,7.4,2019,68128
3533,81,149,3763,93.89,2.15,3.96,2019,68133
3292,198,425,3915,84.09,5.06,10.86,2019,68147
143,4,35,182,78.57,2.2,19.23,2019,68314
622,6,78,706,88.1,0.85,11.05,2019,68317
142,6,61,209,67.94,2.87,29.19,2019,68746
156,5,50,211,73.93,2.37,23.7,2019,68726
77,0,18,95,81.05,0.0,18.95,2019,68711
162,14,45,221,73.3,6.33,20.36,2019,68723
86,0,26,112,76.79,0.0,23.21,2019,68728
69,0,35,104,66.35,0.0,33.65,2019,68732
397,19,107,523,75.91,3.63,20.46,2019,68760
135,0,47,182,74.18,0.0,25.82,2019,68766
1162,30,218,1410,82.41,2.13,15.46,2019,68767
486,21,119,626,77.64,3.35,19.01,2019,68771
114,3,30,147,77.55,2.04,20.41,2019,68792
165,6,32,203,81.28,2.96,15.76,2019,68841
126,0,55,181,69.61,0.0,30.39,2019,68855
245,1,64,310,79.03,0.32,20.65,2019,68856
365,11,85,461,79.18,2.39,18.44,2019,68864
142,7,51,200,71.0,3.5,25.5,2019,68879
56,0,13,69,81.16,0.0,18.84,2019,68929
129,6,55,190,67.89,3.16,28.95,2019,68932
182,2,39,223,81.61,0.9,17.49,2019,68654
170,5,16,191,89.01,2.62,8.38,2019,68018
557,21,121,699,79.69,3.0,17.31,2019,68031
9318,222,585,10125,92.03,2.19,5.78,2019,68046
112,1,10,123,91.06,0.81,8.13,2019,68058
279,11,29,319,87.46,3.45,9.09,2019,68070
176,14,62,252,69.84,5.56,24.6,2019,67445
194,0,35,229,84.72,0.0,15.28,2019,67446
357,35,89,481,74.22,7.28,18.5,2019,67451
261,4,89,354,73.73,1.13,25.14,2019,67466
72,2,28,102,70.59,1.96,27.45,2019,67468
120,0,55,175,68.57,0.0,31.43,2019,67483
122,5,31,158,77.22,3.16,19.62,2019,67516
764,28,281,1073,71.2,2.61,26.19,2019,67526
62,0,13,75,82.67,0.0,17.33,2019,67553
391,9,66,466,83.91,1.93,14.16,2019,67001
4430,112,773,5315,83.35,2.11,14.54,2019,67010
479,22,72,573,83.6,3.84,12.57,2019,67020
96,0,33,129,74.42,0.0,25.58,2019,67028
748,10,79,837,89.37,1.19,9.44,2019,67030
23,0,3,26,88.46,0.0,11.54,2019,67036
584,14,89,687,85.01,2.04,12.95,2019,67050
126,2,65,193,65.28,1.04,33.68,2019,67051
394,11,124,529,74.48,2.08,23.44,2019,67054
789,72,379,1240,63.63,5.81,30.56,2019,71429
198,12,17,227,87.22,5.29,7.49,2019,71441
5676,447,1978,8101,70.07,5.52,24.42,2019,71446
275,26,238,539,51.02,4.82,44.16,2019,71447
23,0,38,61,37.7,0.0,62.3,2019,71452
665,48,189,902,73.73,5.32,20.95,2019,71461
14657,379,2089,17125,85.59,2.21,12.2,2019,70506
902,27,394,1323,68.18,2.04,29.78,2019,70515
5994,202,1029,7225,82.96,2.8,14.24,2019,70611
578,21,289,888,65.09,2.36,32.55,2019,70655
177,91,30,298,59.4,30.54,10.07,2019,70721
1447,200,716,2363,61.24,8.46,30.3,2019,70722
268,13,133,414,64.73,3.14,32.13,2019,70723
224,0,12,236,94.92,0.0,5.08,2019,70729
4324,8,353,4685,92.29,0.17,7.53,2019,70739
3422,399,631,4452,76.86,8.96,14.17,2019,70754
235,26,58,319,73.67,8.15,18.18,2019,70772
938,0,323,1261,74.39,0.0,25.61,2019,70052
79,0,3,82,96.34,0.0,3.66,2019,70091
1863,186,1486,3535,52.7,5.26,42.04,2019,70113
2796,226,1148,4170,67.05,5.42,27.53,2019,70346
319,11,97,427,74.71,2.58,22.72,2019,70355
6937,153,1418,8508,81.54,1.8,16.67,2019,70002
1132,40,140,1312,86.28,3.05,10.67,2019,70030
396,11,76,483,81.99,2.28,15.73,2019,70036
45,0,23,68,66.18,0.0,33.82,2019,70038
5403,28,639,6070,89.01,0.46,10.53,2019,70037
580,114,286,980,59.18,11.63,29.18,2019,70039
687,3,175,865,79.42,0.35,20.23,2019,70067
952,0,386,1338,71.15,0.0,28.85,2019,70071
15523,475,3773,19771,78.51,2.4,19.08,2019,70072
1416,62,312,1790,79.11,3.46,17.43,2019,70075
910,15,276,1201,75.77,1.25,22.98,2019,70079
665,0,324,989,67.24,0.0,32.76,2019,70083
2380,235,299,2914,81.67,8.06,10.26,2019,70087
5268,146,1713,7127,73.92,2.05,24.04,2019,70128
1775,60,678,2513,70.63,2.39,26.98,2019,70373
1989,41,678,2708,73.45,1.51,25.04,2019,70374
48,0,0,48,100.0,0.0,0.0,2019,70375
195,8,95,298,65.44,2.68,31.88,2019,70638
81,0,0,81,100.0,0.0,0.0,2019,70644
356,61,114,531,67.04,11.49,21.47,2019,70645
28,0,30,58,48.28,0.0,51.72,2019,70650
867,31,463,1361,63.7,2.28,34.02,2019,70656
3256,59,684,3999,81.42,1.48,17.1,2019,70665
1422,19,233,1674,84.95,1.14,13.92,2019,70711
1338,22,414,1774,75.42,1.24,23.34,2019,70719
529,28,59,616,85.88,4.55,9.58,2019,70740
1559,66,481,2106,74.03,3.13,22.84,2019,70744
22,0,30,52,42.31,0.0,57.69,2019,70651
1358,42,410,1810,75.03,2.32,22.65,2019,70657
119,30,141,290,41.03,10.34,48.62,2019,70753
980,31,239,1250,78.4,2.48,19.12,2019,70783
10123,249,756,11128,90.97,2.24,6.79,2019,70809
2725,102,715,3542,76.93,2.88,20.19,2019,70812
185,22,87,294,62.93,7.48,29.59,2019,70397
5344,101,2248,7693,69.47,1.31,29.22,2019,70427
2350,148,971,3469,67.74,4.27,27.99,2019,70443
1949,80,588,2617,74.47,3.06,22.47,2019,70446
28,0,17,45,62.22,0.0,37.78,2019,57256
2792,140,344,3276,85.23,4.27,10.5,2019,57042
314,26,69,409,76.77,6.36,16.87,2019,57035
327,10,53,390,83.85,2.56,13.59,2019,57037
22,0,19,41,53.66,0.0,46.34,2019,57041
199,51,84,334,59.58,15.27,25.15,2019,57046
2125,121,1020,3266,65.06,3.7,31.23,2019,71463
531,19,464,1014,52.37,1.87,45.76,2019,71469
1217,71,695,1983,61.37,3.58,35.05,2019,71486
111,19,79,209,53.11,9.09,37.8,2019,71631
765,37,459,1261,60.67,2.93,36.4,2019,71640
1098,38,584,1720,63.84,2.21,33.95,2019,71653
135,51,110,296,45.61,17.23,37.16,2019,71660
1438,51,775,2264,63.52,2.25,34.23,2019,71665
1013,37,820,1870,54.17,1.98,43.85,2019,71038
89,19,87,195,45.64,9.74,44.62,2019,71043
27,0,5,32,84.38,0.0,15.62,2019,71048
483,46,229,758,63.72,6.07,30.21,2019,71051
4,0,12,16,25.0,0.0,75.0,2019,71952
446,18,250,714,62.46,2.52,35.01,2019,71960
610,26,167,803,75.97,3.24,20.8,2019,71362
161,14,120,295,54.58,4.75,40.68,2019,71674
136,0,62,198,68.69,0.0,31.31,2019,71971
10,0,7,17,58.82,0.0,41.18,2019,71823
1101,39,519,1659,66.37,2.35,31.28,2019,71929
410,18,93,521,78.69,3.45,17.85,2019,71945
593,24,133,750,79.07,3.2,17.73,2019,71371
1125,31,330,1486,75.71,2.09,22.21,2019,71433
208,36,18,262,79.39,13.74,6.87,2019,71759
594,30,214,838,70.88,3.58,25.54,2019,71833
68,4,55,127,53.54,3.15,43.31,2019,71965
201,0,158,359,55.99,0.0,44.01,2019,71008
235,16,412,663,35.44,2.41,62.14,2019,71018
1210,118,664,1992,60.74,5.92,33.33,2019,71742
932,41,589,1562,59.67,2.62,37.71,2019,71743
147,120,161,428,34.35,28.04,37.62,2019,71747
371,67,237,675,54.96,9.93,35.11,2019,71462
1103,10,502,1615,68.3,0.62,31.08,2019,71467
122,0,1,123,99.19,0.0,0.81,2019,71472
2839,47,847,3733,76.05,1.26,22.69,2019,71483
845,8,72,925,91.35,0.86,7.78,2019,71485
232,39,243,514,45.14,7.59,47.28,2019,71643
1505,118,750,2373,63.42,4.97,31.61,2019,71646
1118,27,734,1879,59.5,1.44,39.06,2019,71654
170,0,81,251,67.73,0.0,32.27,2019,71663
24,0,12,36,66.67,0.0,33.33,2019,71666
532,24,267,823,64.64,2.92,32.44,2019,71675
37,5,37,79,46.84,6.33,46.84,2019,71677
5303,122,1884,7309,72.55,1.67,25.78,2019,71701
129,11,82,222,58.11,4.95,36.94,2019,71766
4508,154,1292,5954,75.71,2.59,21.7,2019,71801
547,33,281,861,63.53,3.83,32.64,2019,71937
114,4,35,153,74.51,2.61,22.88,2019,71969
4625,268,1794,6687,69.16,4.01,26.83,2019,71108
1919,146,1142,3207,59.84,4.55,35.61,2019,71241
270,24,178,472,57.2,5.08,37.71,2019,71652
87,3,139,229,37.99,1.31,60.7,2019,71069
1318,1,423,1742,75.66,0.06,24.28,2019,71235
605,10,241,856,70.68,1.17,28.15,2019,71016
1938,66,206,2210,87.69,2.99,9.32,2019,59833
635,0,191,826,76.88,0.0,23.12,2019,59834
38,0,0,38,100.0,0.0,0.0,2019,59842
98,3,19,120,81.67,2.5,15.83,2019,59843
540,0,127,667,80.96,0.0,19.04,2019,59846
658,13,150,821,80.15,1.58,18.27,2019,59868
3992,144,2114,6250,63.87,2.3,33.82,2019,70062
9543,528,1717,11788,80.96,4.48,14.57,2019,70068
4284,145,384,4813,89.01,3.01,7.98,2019,70070
5335,259,3943,9537,55.94,2.72,41.34,2019,70114
2335,31,573,2939,79.45,1.05,19.5,2019,70129
6188,222,1045,7455,83.0,2.98,14.02,2019,70130
9160,336,2499,11995,76.37,2.8,20.83,2019,70131
2851,78,842,3771,75.6,2.07,22.33,2019,70345
1135,128,507,1770,64.12,7.23,28.64,2019,70354
195,3,132,330,59.09,0.91,40.0,2019,70358
8887,256,1698,10841,81.98,2.36,15.66,2019,70360
6332,149,2199,8680,72.95,1.72,25.33,2019,70363
95,0,0,95,100.0,0.0,0.0,2019,70391
9488,171,1693,11352,83.58,1.51,14.91,2019,70403
5095,277,841,6213,82.01,4.46,13.54,2019,70435
2586,33,616,3235,79.94,1.02,19.04,2019,70437
1247,49,161,1457,85.59,3.36,11.05,2019,70449
130,0,0,130,100.0,0.0,0.0,2019,70513
636,18,196,850,74.82,2.12,23.06,2019,70514
168,0,34,202,83.17,0.0,16.83,2019,70516
4823,96,1378,6297,76.59,1.52,21.88,2019,70535
2969,72,614,3655,81.23,1.97,16.8,2019,70548
1697,54,601,2352,72.15,2.3,25.55,2019,70339
4362,226,1346,5934,73.51,3.81,22.68,2019,70116
9688,231,2572,12491,77.56,1.85,20.59,2019,70118
9975,312,1479,11766,84.78,2.65,12.57,2019,70123
298,0,223,521,57.2,0.0,42.8,2019,70353
697,27,366,1090,63.94,2.48,33.58,2019,70357
8221,151,2163,10535,78.04,1.43,20.53,2019,70364
1250,133,352,1735,72.05,7.67,20.29,2019,70395
3555,71,1312,4938,71.99,1.44,26.57,2019,70422
9359,140,1878,11377,82.26,1.23,16.51,2019,70005
4085,167,446,4698,86.95,3.55,9.49,2019,70047
438,0,328,766,57.18,0.0,42.82,2019,70356
1791,39,669,2499,71.67,1.56,26.77,2019,70390
10142,275,3519,13936,72.78,1.97,25.25,2019,70058
1374,205,778,2357,58.29,8.7,33.01,2019,70084
1299,0,389,1688,76.95,0.0,23.05,2019,70085
7898,260,2879,11037,71.56,2.36,26.08,2019,70094
16245,1101,2433,19779,82.13,5.57,12.3,2019,70726
882,105,426,1413,62.42,7.43,30.15,2019,70730
386,8,126,520,74.23,1.54,24.23,2019,70732
71,0,118,189,37.57,0.0,62.43,2019,70736
14099,302,1391,15792,89.28,1.91,8.81,2019,70737
528,12,180,720,73.33,1.67,25.0,2019,70755
1758,76,694,2528,69.54,3.01,27.45,2019,70760
4557,124,1233,5914,77.05,2.1,20.85,2019,70764
845,28,280,1153,73.29,2.43,24.28,2019,70770
995,58,188,1241,80.18,4.67,15.15,2019,70778
139,15,98,252,55.16,5.95,38.89,2019,70789
5783,819,2657,9259,62.46,8.85,28.7,2019,70802
3851,262,1344,5457,70.57,4.8,24.63,2019,70807
8650,269,1257,10176,85.0,2.64,12.35,2019,70815
86,7,28,121,71.07,5.79,23.14,2019,57763
34,13,5,52,65.38,25.0,9.62,2019,57767
1417,32,186,1635,86.67,1.96,11.38,2019,57769
604,42,516,1162,51.98,3.61,44.41,2019,57770
185,0,230,415,44.58,0.0,55.42,2019,57772
989,18,132,1139,86.83,1.58,11.59,2019,57030
1231,51,253,1535,80.2,3.32,16.48,2019,59875
165,0,29,194,85.05,0.0,14.95,2019,59910
254,0,15,269,94.42,0.0,5.58,2019,59918
505,8,94,607,83.2,1.32,15.49,2019,59920
36,0,10,46,78.26,0.0,21.74,2019,59745
816,23,72,911,89.57,2.52,7.9,2019,59716
2639,161,563,3363,78.47,4.79,16.74,2019,59725
73,2,23,98,74.49,2.04,23.47,2019,59733
568,61,104,733,77.49,8.32,14.19,2019,59823
149,10,31,190,78.42,5.26,16.32,2019,59837
3139,85,682,3906,80.36,2.18,17.46,2019,59457
130,12,56,198,65.66,6.06,28.28,2019,59464
114,4,5,123,92.68,3.25,4.07,2019,59477
64,0,3,67,95.52,0.0,4.48,2019,59542
32,0,21,53,60.38,0.0,39.62,2019,59546
89,6,11,106,83.96,5.66,10.38,2019,59631
60,20,33,113,53.1,17.7,29.2,2019,59710
90,10,17,117,76.92,8.55,14.53,2019,59720
576,27,136,739,77.94,3.65,18.4,2019,59749
17056,423,1459,18938,90.06,2.23,7.7,2019,60073
8717,222,1207,10146,85.92,2.19,11.9,2019,60077
14186,308,890,15384,92.21,2.0,5.79,2019,60089
9902,177,892,10971,90.26,1.61,8.13,2019,60110
14353,609,1465,16427,87.37,3.71,8.92,2019,60115
5898,73,487,6458,91.33,1.13,7.54,2019,60118
15664,202,907,16773,93.39,1.2,5.41,2019,60010
19450,583,2905,22938,84.79,2.54,12.66,2019,60016
2890,6,180,3076,93.95,0.2,5.85,2019,60022
10687,125,669,11481,93.08,1.09,5.83,2019,60035
333,14,28,375,88.8,3.73,7.47,2019,60072
3127,16,132,3275,95.48,0.49,4.03,2019,60081
8635,372,1277,10284,83.97,3.62,12.42,2019,60099
10969,272,550,11791,93.03,2.31,4.66,2019,60102
6221,119,935,7275,85.51,1.64,12.85,2019,60106
126,2,12,140,90.0,1.43,8.57,2019,60129
2418,32,136,2586,93.5,1.24,5.26,2019,60135
845,0,118,963,87.75,0.0,12.25,2019,60146
1432,78,68,1578,90.75,4.94,4.31,2019,60151
5662,114,702,6478,87.4,1.76,10.84,2019,60154
9070,612,3071,12753,71.12,4.8,24.08,2019,60901
131,24,26,181,72.38,13.26,14.36,2019,60917
501,15,100,616,81.33,2.44,16.23,2019,60921
7983,152,888,9023,88.47,1.68,9.84,2019,60002
16232,222,1006,17460,92.97,1.27,5.76,2019,60014
133,1,2,136,97.79,0.74,1.47,2019,60029
11128,102,1183,12413,89.65,0.82,9.53,2019,60050
12059,152,703,12914,93.38,1.18,5.44,2019,60060
4740,81,1194,6015,78.8,1.35,19.85,2019,60131
18321,327,1882,20530,89.24,1.59,9.17,2019,60148
993,78,210,1281,77.52,6.09,16.39,2019,60165
5201,72,96,5369,96.87,1.34,1.79,2019,60192
12018,385,904,13307,90.31,2.89,6.79,2019,60202
14823,575,4116,19514,75.96,2.95,21.09,2019,60411
5896,62,120,6078,97.01,1.02,1.97,2019,60490
3394,71,361,3826,88.71,1.86,9.44,2019,60514
205,0,16,221,92.76,0.0,7.24,2019,60537
14993,293,689,15975,93.85,1.83,4.31,2019,60540
7209,1462,270,8941,80.63,16.35,3.02,2019,60601
20429,1165,4327,25921,78.81,4.49,16.69,2019,60608
10396,254,1283,11933,87.12,2.13,10.75,2019,60441
10844,377,2622,13843,78.34,2.72,18.94,2019,60409
4571,273,812,5656,80.82,4.83,14.36,2019,60417
6993,376,2461,9830,71.14,3.83,25.04,2019,60426
10516,181,912,11609,90.58,1.56,7.86,2019,60446
4327,88,329,4744,91.21,1.85,6.94,2019,60447
3399,41,361,3801,89.42,1.08,9.5,2019,60449
8971,124,1211,10306,87.05,1.2,11.75,2019,60452
16734,902,3626,21262,78.7,4.24,17.05,2019,60453
571,15,121,707,80.76,2.12,17.11,2019,66517
65,12,17,94,69.15,12.77,18.09,2019,66527
260,8,77,345,75.36,2.32,22.32,2019,66528
895,23,148,1066,83.96,2.16,13.88,2019,66535
69,6,12,87,79.31,6.9,13.79,2019,66541
1025,19,72,1116,91.85,1.7,6.45,2019,66542
5330,216,1696,7242,73.6,2.98,23.42,2019,66605
3693,632,992,5317,69.46,11.89,18.66,2019,66606
1132,130,220,1482,76.38,8.77,14.84,2019,66615
2976,272,360,3608,82.48,7.54,9.98,2019,66618
1730,116,382,2228,77.65,5.21,17.15,2019,66725
71,0,17,88,80.68,0.0,19.32,2019,66746
314,2,78,394,79.7,0.51,19.8,2019,66756
12298,321,711,13330,92.26,2.41,5.33,2019,66049
251,18,66,335,74.93,5.37,19.7,2019,66015
2277,23,311,2611,87.21,0.88,11.91,2019,66025
7486,163,405,8054,92.95,2.02,5.03,2019,66030
871,10,187,1068,81.55,0.94,17.51,2019,66066
899,52,81,1032,87.11,5.04,7.85,2019,66073
987,129,307,1423,69.36,9.07,21.57,2019,66092
6485,456,1364,8305,78.09,5.49,16.42,2019,66106
8126,163,670,8959,90.7,1.82,7.48,2019,66204
7751,71,460,8282,93.59,0.86,5.55,2019,66209
1951,49,85,2085,93.57,2.35,4.08,2019,66211
525,29,236,790,66.46,3.67,29.87,2019,63363
5,0,4,9,55.56,0.0,44.44,2019,63370
603,46,250,899,67.07,5.12,27.81,2019,63377
1959,63,382,2404,81.49,2.62,15.89,2019,63389
1223,30,305,1558,78.5,1.93,19.58,2019,63435
182,3,107,292,62.33,1.03,36.64,2019,63954
260,0,151,411,63.26,0.0,36.74,2019,63956
367,20,100,487,75.36,4.11,20.53,2019,63829
1739,59,714,2512,69.23,2.35,28.42,2019,63863
256,8,118,382,67.02,2.09,30.89,2019,63868
725,14,385,1124,64.5,1.25,34.25,2019,63937
45,0,52,97,46.39,0.0,53.61,2019,63941
155,8,87,250,62.0,3.2,34.8,2019,63943
469,23,158,650,72.15,3.54,24.31,2019,63961
497,32,268,797,62.36,4.02,33.63,2019,63967
3511,97,370,3978,88.26,2.44,9.3,2019,63088
3917,163,946,5026,77.93,3.24,18.82,2019,63103
6018,338,2270,8626,69.77,3.92,26.32,2019,63111
8159,443,2875,11477,71.09,3.86,25.05,2019,63118
4016,220,458,4694,85.56,4.69,9.76,2019,63124
4843,72,487,5402,89.65,1.33,9.02,2019,63132
3991,215,1019,5225,76.38,4.11,19.5,2019,63134
6104,98,910,7112,85.83,1.38,12.8,2019,63138
790,31,92,913,86.53,3.4,10.08,2019,63347
2176,65,283,2524,86.21,2.58,11.21,2019,63362
26009,512,1966,28487,91.3,1.8,6.9,2019,63376
16178,1859,7286,25323,63.89,7.34,28.77,2019,60620
20413,802,4766,25981,78.57,3.09,18.34,2019,60634
14224,816,4419,19459,73.1,4.19,22.71,2019,60637
10133,742,5861,16736,60.55,4.43,35.02,2019,60644
159,5,47,211,75.36,2.37,22.27,2019,60910
450,7,47,504,89.29,1.39,9.33,2019,60911
460,18,133,611,75.29,2.95,21.77,2019,60913
251,7,42,300,83.67,2.33,14.0,2019,60928
226,8,49,283,79.86,2.83,17.31,2019,60961
13357,1095,490,14942,89.39,7.33,3.28,2019,60605
2097,104,0,2201,95.27,4.73,0.0,2019,60606
15764,1748,7484,24996,63.07,6.99,29.94,2019,60623
23478,1967,6482,31927,73.54,6.16,20.3,2019,60629
3722,183,815,4720,78.86,3.88,17.27,2019,60633
16029,926,3290,20245,79.18,4.57,16.25,2019,60638
28533,2070,4863,35466,80.45,5.84,13.71,2019,60640
15644,487,5329,21460,72.9,2.27,24.83,2019,60649
8872,164,1154,10190,87.07,1.61,11.32,2019,60655
5737,254,209,6200,92.53,4.1,3.37,2019,60661
8257,339,2282,10878,75.91,3.12,20.98,2019,60827
182,3,35,220,82.73,1.36,15.91,2019,60919
721,23,115,859,83.93,2.68,13.39,2019,60927
991,30,242,1263,78.46,2.38,19.16,2019,60940
9492,237,2314,12043,78.82,1.97,19.21,2019,60631
10537,437,1689,12663,83.21,3.45,13.34,2019,60005
9240,162,367,9769,94.58,1.66,3.76,2019,60015
7872,266,1854,9992,78.78,2.66,18.55,2019,60018
3807,57,112,3976,95.75,1.43,2.82,2019,60044
12838,206,1141,14185,90.5,1.45,8.04,2019,60068
1559,22,82,1663,93.75,1.32,4.93,2019,58047
10,5,0,15,66.67,33.33,0.0,2019,58219
98,1,20,119,82.35,0.84,16.81,2019,58269
347,37,149,533,65.1,6.94,27.95,2019,58631
264,29,47,340,77.65,8.53,13.82,2019,58773
109,4,12,125,87.2,3.2,9.6,2019,58015
38,4,11,53,71.7,7.55,20.75,2019,58216
153,2,24,179,85.47,1.12,13.41,2019,58021
5658,662,1086,7406,76.4,8.94,14.66,2019,58203
1607,55,631,2293,70.08,2.4,27.52,2019,58237
750,30,129,909,82.51,3.3,14.19,2019,58623
131,0,5,136,96.32,0.0,3.68,2019,58731
150,11,70,231,64.94,4.76,30.3,2019,58384
187,10,87,284,65.85,3.52,30.63,2019,58529
23,7,10,40,57.5,17.5,25.0,2019,58569
398,14,129,541,73.57,2.59,23.84,2019,58788
174,7,78,259,67.18,2.7,30.12,2019,58374
584,44,143,771,75.75,5.71,18.55,2019,58622
107,35,19,161,66.46,21.74,11.8,2019,58735
205,0,31,236,86.86,0.0,13.14,2019,58771
83,3,9,95,87.37,3.16,9.47,2019,58036
19192,932,3373,23497,81.68,3.97,14.36,2019,58103
51,13,0,64,79.69,20.31,0.0,2019,58277
6,0,5,11,54.55,0.0,45.45,2019,58002
1406,53,246,1705,82.46,3.11,14.43,2019,67062
257,11,35,303,84.82,3.63,11.55,2019,67118
65,0,13,78,83.33,0.0,16.67,2019,67122
2463,46,542,3051,80.73,1.51,17.76,2019,67124
8475,171,1431,10077,84.1,1.7,14.2,2019,67502
96,0,24,120,80.0,0.0,20.0,2019,67511
7158,200,1167,8525,83.96,2.35,13.69,2019,63379
4777,199,943,5919,80.71,3.36,15.93,2019,63383
155,31,113,299,51.84,10.37,37.79,2019,63388
0,0,0,0,,,,2019,63433
336,11,84,431,77.96,2.55,19.49,2019,63440
142,7,82,231,61.47,3.03,35.5,2019,63472
100,8,70,178,56.18,4.49,39.33,2019,63474
30,2,1,33,90.91,6.06,3.03,2019,63540
92,0,76,168,54.76,0.0,45.24,2019,63547
206,14,118,338,60.95,4.14,34.91,2019,69044
401,6,118,525,76.38,1.14,22.48,2019,69045
126,7,39,172,73.26,4.07,22.67,2019,69121
1614,113,374,2101,76.82,5.38,17.8,2019,69130
50,0,2,52,96.15,0.0,3.85,2019,69142
38,9,9,56,67.86,16.07,16.07,2019,69148
126,0,25,151,83.44,0.0,16.56,2019,69150
91,4,18,113,80.53,3.54,15.93,2019,69170
103,0,25,128,80.47,0.0,19.53,2019,69218
110,18,13,141,78.01,12.77,9.22,2019,69333
3395,131,716,4242,80.03,3.09,16.88,2019,69341
549,7,107,663,82.81,1.06,16.14,2019,69348
306,5,82,393,77.86,1.27,20.87,2019,69163
245,1,49,295,83.05,0.34,16.61,2019,69131
289,7,34,330,87.58,2.12,10.3,2019,69151
2269,72,402,2743,82.72,2.62,14.66,2019,69153
1373,23,346,1742,78.82,1.32,19.86,2019,69201
880,48,151,1079,81.56,4.45,13.99,2019,69210
12,0,2,14,85.71,0.0,14.29,2019,69220
4,0,8,12,33.33,0.0,66.67,2019,69335
182,16,63,261,69.73,6.13,24.14,2019,69346
204,13,36,253,80.63,5.14,14.23,2019,69352
1194,28,308,1530,78.04,1.83,20.13,2019,69357
789,27,250,1066,74.02,2.53,23.45,2019,69343
13,37,4,54,24.07,68.52,7.41,2019,69354
646,18,145,809,79.85,2.22,17.92,2019,69358
5534,286,1387,7207,76.79,3.97,19.25,2019,69361
189,2,29,220,85.91,0.91,13.18,2019,69032
944,22,165,1131,83.47,1.95,14.59,2019,69033
179,5,42,226,79.2,2.21,18.58,2019,69038
27,0,6,33,81.82,0.0,18.18,2019,69041
45,0,24,69,65.22,0.0,34.78,2019,69046
404,18,70,492,82.11,3.66,14.23,2019,69120
357,20,141,518,68.92,3.86,27.22,2019,69129
116,0,49,165,70.3,0.0,29.7,2019,69146
46,0,20,66,69.7,0.0,30.3,2019,69037
213,6,60,279,76.34,2.15,21.51,2019,69040
251,11,50,312,80.45,3.53,16.03,2019,69122
96,7,56,159,60.38,4.4,35.22,2019,69141
251,24,104,379,66.23,6.33,27.44,2019,69152
239,11,9,259,92.28,4.25,3.47,2019,69166
73,15,27,115,63.48,13.04,23.48,2019,69212
3380,112,656,4148,81.49,2.7,15.81,2019,69301
800,2,180,982,81.47,0.2,18.33,2019,69336
314,16,124,454,69.16,3.52,27.31,2019,69025
108,1,53,162,66.67,0.62,32.72,2019,69125
29,0,0,29,100.0,0.0,0.0,2019,69135
1036,17,325,1378,75.18,1.23,23.58,2019,69145
98,0,54,152,64.47,0.0,35.53,2019,69167
147,0,33,180,81.67,0.0,18.33,2019,69211
156,6,66,228,68.42,2.63,28.95,2019,67572
201,0,47,248,81.05,0.0,18.95,2019,67575
179,0,42,221,81.0,0.0,19.0,2019,67640
587,47,165,799,73.47,5.88,20.65,2019,67669
486,14,124,624,77.88,2.24,19.87,2019,67671
76,0,18,94,80.85,0.0,19.15,2019,67733
47,0,10,57,82.46,0.0,17.54,2019,67747
85,5,6,96,88.54,5.21,6.25,2019,67761
299,27,57,383,78.07,7.05,14.88,2019,67837
509,25,69,603,84.41,4.15,11.44,2019,67839
28,5,24,57,49.12,8.77,42.11,2019,67857
612,63,156,831,73.65,7.58,18.77,2019,67860
348,15,74,437,79.63,3.43,16.93,2019,67870
29,8,15,52,55.77,15.38,28.85,2019,67953
233,5,50,288,80.9,1.74,17.36,2019,67004
4518,124,1433,6075,74.37,2.04,23.59,2019,67005
244,6,97,347,70.32,1.73,27.95,2019,67008
161,2,23,186,86.56,1.08,12.37,2019,67016
11,2,0,13,84.62,15.38,0.0,2019,67021
825,32,93,950,86.84,3.37,9.79,2019,67031
9662,104,814,10580,91.32,0.98,7.69,2019,67037
929,44,441,1414,65.7,3.11,31.19,2019,67045
937,84,152,1173,79.88,7.16,12.96,2019,67056
234,18,69,321,72.9,5.61,21.5,2019,67059
55,0,13,68,80.88,0.0,19.12,2019,67512
18,6,0,24,75.0,25.0,0.0,2019,67518
180,4,54,238,75.63,1.68,22.69,2019,67524
5920,309,1252,7481,79.13,4.13,16.74,2019,67530
222,12,56,290,76.55,4.14,19.31,2019,67552
139,20,32,191,72.77,10.47,16.75,2019,67566
408,26,72,506,80.63,5.14,14.23,2019,67570
100,0,30,130,76.92,0.0,23.08,2019,67581
187,6,43,236,79.24,2.54,18.22,2019,67622
202,1,39,242,83.47,0.41,16.12,2019,67645
85,2,18,105,80.95,1.9,17.14,2019,67650
168,8,27,203,82.76,3.94,13.3,2019,67757
121,0,35,156,77.56,0.0,22.44,2019,67842
121,0,29,150,80.67,0.0,19.33,2019,67849
142,1,14,157,90.45,0.64,8.92,2019,67850
21,10,41,72,29.17,13.89,56.94,2019,67868
347,17,110,474,73.21,3.59,23.21,2019,67876
591,24,183,798,74.06,3.01,22.93,2019,67878
2027,85,466,2578,78.63,3.3,18.08,2019,67880
224,12,54,290,77.24,4.14,18.62,2019,67954
38,0,0,38,100.0,0.0,0.0,2019,67743
142,5,31,178,79.78,2.81,17.42,2019,67745
433,10,148,591,73.27,1.69,25.04,2019,67752
708,15,166,889,79.64,1.69,18.67,2019,67756
239,16,63,318,75.16,5.03,19.81,2019,67838
28,0,13,41,68.29,0.0,31.71,2019,67840
520,24,155,699,74.39,3.43,22.17,2019,67022
326,17,95,438,74.43,3.88,21.69,2019,67029
911,30,218,1159,78.6,2.59,18.81,2019,67039
435,26,235,696,62.5,3.74,33.76,2019,71763
0,0,0,0,,,,2019,71209
73,3,38,114,64.04,2.63,33.33,2019,71233
0,0,0,0,,,,2019,71272
28,0,23,51,54.9,0.0,45.1,2019,71279
1591,49,425,2065,77.05,2.37,20.58,2019,71405
604,47,200,851,70.98,5.52,23.5,2019,69334
486,6,119,611,79.54,0.98,19.48,2019,69347
132,0,20,152,86.84,0.0,13.16,2019,69367
532,32,166,730,72.88,4.38,22.74,2019,69356
8,0,0,8,100.0,0.0,0.0,2019,69365
590,44,130,764,77.23,5.76,17.02,2019,69165
47,0,20,67,70.15,0.0,29.85,2019,69128
7,0,2,9,77.78,0.0,22.22,2019,69042
10205,292,1791,12288,83.05,2.38,14.58,2019,69101
56,2,14,72,77.78,2.78,19.44,2019,58748
91,4,13,108,84.26,3.7,12.04,2019,58758
85,4,14,103,82.52,3.88,13.59,2019,58762
408,25,67,500,81.6,5.0,13.4,2019,58770
133,26,35,194,68.56,13.4,18.04,2019,58782
144,14,15,173,83.24,8.09,8.67,2019,58831
96,2,29,127,75.59,1.57,22.83,2019,58222
86,0,10,96,89.58,0.0,10.42,2019,58223
168,4,46,218,77.06,1.83,21.1,2019,58535
360,28,246,634,56.78,4.42,38.8,2019,58538
184,4,56,244,75.41,1.64,22.95,2019,58541
56,2,9,67,83.58,2.99,13.43,2019,58560
342,22,119,483,70.81,4.55,24.64,2019,58561
64,2,25,91,70.33,2.2,27.47,2019,58625
89,0,17,106,83.96,0.0,16.04,2019,58654
118,3,17,138,85.51,2.17,12.32,2019,58711
110,0,23,133,82.71,0.0,17.29,2019,58725
88,0,21,109,80.73,0.0,19.27,2019,58490
71,1,42,114,62.28,0.88,36.84,2019,58494
402,30,203,635,63.31,4.72,31.97,2019,58495
10870,523,1845,13238,82.11,3.95,13.94,2019,58501
8895,556,1629,11080,80.28,5.02,14.7,2019,58504
0,0,0,0,,,,2019,58505
27,0,21,48,56.25,0.0,43.75,2019,58564
34,0,6,40,85.0,0.0,15.0,2019,58007
84,15,1,100,84.0,15.0,1.0,2019,58016
248,23,40,311,79.74,7.4,12.86,2019,58032
312,22,192,526,59.32,4.18,36.5,2019,58053
119,8,36,163,73.01,4.91,22.09,2019,58061
95,0,12,107,88.79,0.0,11.21,2019,58067
410,13,101,524,78.24,2.48,19.27,2019,59487
21,0,37,58,36.21,0.0,63.79,2019,59463
125,3,36,164,76.22,1.83,21.95,2019,59471
126,12,57,195,64.62,6.15,29.23,2019,59480
170,2,71,243,69.96,0.82,29.22,2019,59524
180,7,92,279,64.52,2.51,32.97,2019,59527
1800,49,101,1950,92.31,2.51,5.18,2019,59634
2327,76,362,2765,84.16,2.75,13.09,2019,59635
162,8,68,238,68.07,3.36,28.57,2019,59648
11096,693,2642,14431,76.89,4.8,18.31,2019,59701
17616,728,2404,20748,84.9,3.51,11.59,2019,59102
37,0,4,41,90.24,0.0,9.76,2019,59338
203,0,39,242,83.88,0.0,16.12,2019,59452
4339,169,762,5270,82.33,3.21,14.46,2019,59501
3,9,18,30,10.0,30.0,60.0,2019,59642
46,7,2,55,83.64,12.73,3.64,2019,59736
407,25,112,544,74.82,4.6,20.59,2019,59824
44,0,8,52,84.62,0.0,15.38,2019,59469
842,188,118,1148,73.34,16.38,10.28,2019,59729
12458,567,1494,14519,85.8,3.91,10.29,2019,59801
0,0,87,87,0.0,0.0,100.0,2019,71662
21,0,0,21,100.0,0.0,0.0,2019,71711
0,0,2,2,0.0,0.0,100.0,2019,71772
0,0,0,0,,,,2019,71998
0,0,0,0,,,,2019,71999
14298,416,935,15649,91.37,2.66,5.97,2019,70810
3963,125,771,4859,81.56,2.57,15.87,2019,70814
13891,397,3229,17517,79.3,2.27,18.43,2019,70001
278,5,202,485,57.32,1.03,41.65,2019,70040
4662,174,1876,6712,69.46,2.59,27.95,2019,70053
1160,169,237,1566,74.07,10.79,15.13,2019,70112
12068,425,2082,14575,82.8,2.92,14.28,2019,70115
7751,351,3588,11690,66.3,3.0,30.69,2019,70117
4382,196,1601,6179,70.92,3.17,25.91,2019,70125
6694,280,2845,9819,68.17,2.85,28.97,2019,70127
1298,31,517,1846,70.31,1.68,28.01,2019,70344
2630,32,468,3130,84.03,1.02,14.95,2019,70359
11222,388,3015,14625,76.73,2.65,20.62,2019,70122
7516,193,465,8174,91.95,2.36,5.69,2019,70124
7460,356,2443,10259,72.72,3.47,23.81,2019,70126
0,0,0,0,,,,2019,70163
14105,248,2957,17310,81.48,1.43,17.08,2019,70301
6493,110,1111,7714,84.17,1.43,14.4,2019,70401
12819,278,1633,14730,87.03,1.89,11.09,2019,70433
700,27,330,1057,66.23,2.55,31.22,2019,70041
56,0,11,67,83.58,0.0,16.42,2019,70050
503,121,132,756,66.53,16.01,17.46,2019,70051
11368,334,2459,14161,80.28,2.36,17.36,2019,70056
15556,449,3217,19222,80.93,2.34,16.74,2019,70065
40,11,15,66,60.61,16.67,22.73,2019,70076
38,14,49,101,37.62,13.86,48.51,2019,70082
537,48,268,853,62.95,5.63,31.42,2019,70086
1915,113,721,2749,69.66,4.11,26.23,2019,70090
4090,228,1239,5557,73.6,4.1,22.3,2019,70121
4205,153,1244,5602,75.06,2.73,22.21,2019,70394
1136,28,558,1722,65.97,1.63,32.4,2019,70441
671,6,371,1048,64.03,0.57,35.4,2019,70450
10782,167,558,11507,93.7,1.45,4.85,2019,70503
1283,25,309,1617,79.34,1.55,19.11,2019,70543
4917,131,1008,6056,81.19,2.16,16.64,2019,70578
1854,174,820,2848,65.1,6.11,28.79,2019,70584
741,69,445,1255,59.04,5.5,35.46,2019,70589
1336,0,510,1846,72.37,0.0,27.63,2019,70591
563,0,250,813,69.25,0.0,30.75,2019,70630
2173,27,458,2658,81.75,1.02,17.23,2019,70648
3963,121,743,4827,82.1,2.51,15.39,2019,70811
62,0,51,113,54.87,0.0,45.13,2019,70585
8157,249,2120,10526,77.49,2.37,20.14,2019,70663
1631,36,705,2372,68.76,1.52,29.72,2019,70668
2643,159,949,3751,70.46,4.24,25.3,2019,70669
1455,123,116,1694,85.89,7.26,6.85,2019,70710
425,12,78,515,82.52,2.33,15.15,2019,70733
31,15,40,86,36.05,17.44,46.51,2019,70747
3998,221,1004,5223,76.55,4.23,19.22,2019,60415
7335,278,674,8287,88.51,3.35,8.13,2019,60439
4209,309,1040,5558,75.73,5.56,18.71,2019,60455
299,14,52,365,81.92,3.84,14.25,2019,60474
3440,91,650,4181,82.28,2.18,15.55,2019,60475
17074,473,4135,21682,78.75,2.18,19.07,2019,60505
509,0,99,608,83.72,0.0,16.28,2019,59932
297,16,54,367,80.93,4.36,14.71,2019,59029
66,0,17,83,79.52,0.0,20.48,2019,59713
47,6,23,76,61.84,7.89,30.26,2019,59727
29,7,19,55,52.73,12.73,34.55,2019,59731
49,9,70,128,38.28,7.03,54.69,2019,59739
7758,281,981,9020,86.01,3.12,10.88,2019,59802
7114,187,1083,8384,84.85,2.23,12.92,2019,59808
757,39,241,1037,73.0,3.76,23.24,2019,59829
4270,159,817,5246,81.4,3.03,15.57,2019,60458
15107,489,2812,18408,82.07,2.66,15.28,2019,60435
7629,208,1378,9215,82.79,2.26,14.95,2019,60459
5542,238,945,6725,82.41,3.54,14.05,2019,60465
1863,83,269,2215,84.11,3.75,12.14,2019,60468
1684,0,222,1906,88.35,0.0,11.65,2019,60469
8238,101,651,8990,91.64,1.12,7.24,2019,60538
1471,18,148,1637,89.86,1.1,9.04,2019,60552
4684,142,177,5003,93.62,2.84,3.54,2019,60555
654,16,67,737,88.74,2.17,9.09,2019,60556
8300,179,628,9107,91.14,1.97,6.9,2019,60561
30793,919,1890,33602,91.64,2.73,5.62,2019,60614
17039,1148,3257,21444,79.46,5.35,15.19,2019,60615
17488,1109,7924,26521,65.94,4.18,29.88,2019,60619
6107,863,3779,10749,56.81,8.03,35.16,2019,60621
6218,482,4295,10995,56.55,4.38,39.06,2019,60636
18447,1499,5667,25613,72.02,5.85,22.13,2019,60639
14316,781,2827,17924,79.87,4.36,15.77,2019,60643
29347,1151,4885,35383,82.94,3.25,13.81,2019,60647
353,3,27,383,92.17,0.78,7.05,2019,60935
1520,51,336,1907,79.71,2.67,17.62,2019,60936
592,13,67,672,88.1,1.93,9.97,2019,60948
3583,101,667,4351,82.35,2.32,15.33,2019,60950
336,6,46,388,86.6,1.55,11.86,2019,60960
15,4,3,22,68.18,18.18,13.64,2019,60969
102,11,19,132,77.27,8.33,14.39,2019,60973
18191,365,1354,19910,91.37,1.83,6.8,2019,60004
4118,57,549,4724,87.17,1.21,11.62,2019,60033
2887,55,329,3271,88.26,1.68,10.06,2019,60042
753,0,24,777,96.91,0.0,3.09,2019,60043
6587,47,182,6816,96.64,0.69,2.67,2019,60093
7723,189,730,8642,89.37,2.19,8.45,2019,60108
180,6,30,216,83.33,2.78,13.89,2019,60109
3401,54,184,3639,93.46,1.48,5.06,2019,60119
5740,163,1093,6996,82.05,2.33,15.62,2019,60130
2338,68,149,2555,91.51,2.66,5.83,2019,60136
662,6,76,744,88.98,0.81,10.22,2019,60150
7491,178,685,8354,89.67,2.13,8.2,2019,60178
4568,119,481,5168,88.39,2.3,9.31,2019,60191
1873,7,68,1948,96.15,0.36,3.49,2019,60195
1306,54,90,1450,90.07,3.72,6.21,2019,60421
7267,65,316,7648,95.02,0.85,4.13,2019,60431
4516,219,1326,6061,74.51,3.61,21.88,2019,60432
1389,61,318,1768,78.56,3.45,17.99,2019,60163
2956,34,653,3643,81.14,0.93,17.92,2019,60171
11194,205,1012,12411,90.19,1.65,8.15,2019,60174
6946,178,632,7756,89.56,2.29,8.15,2019,60194
3730,59,182,3971,93.93,1.49,4.58,2019,60305
1584,17,418,2019,78.45,0.84,20.7,2019,60420
9822,133,600,10555,93.06,1.26,5.68,2019,60423
3986,168,503,4657,85.59,3.61,10.8,2019,60020
668,0,83,751,88.95,0.0,11.05,2019,60034
13231,128,533,13892,95.24,0.92,3.84,2019,60047
4671,157,797,5625,83.04,2.79,14.17,2019,60070
7000,171,958,8129,86.11,2.1,11.78,2019,60008
5613,387,1891,7891,71.13,4.9,23.96,2019,60160
9091,145,460,9696,93.76,1.5,4.74,2019,60091
50,16,18,84,59.52,19.05,21.43,2019,60111
11248,204,911,12363,90.98,1.65,7.37,2019,60142
902,0,77,979,92.13,0.0,7.87,2019,60157
133,0,35,168,79.17,0.0,20.83,2019,59750
52,8,34,94,55.32,8.51,36.17,2019,59751
10,0,0,10,100.0,0.0,0.0,2019,59756
103,0,18,121,85.12,0.0,14.88,2019,59762
704,14,197,915,76.94,1.53,21.53,2019,59821
4980,89,981,6050,82.31,1.47,16.21,2019,59840
1013,41,317,1371,73.89,2.99,23.12,2019,59859
1008,42,229,1279,78.81,3.28,17.9,2019,59865
248,3,91,342,72.51,0.88,26.61,2019,59866
124,0,3,127,97.64,0.0,2.36,2019,59871
1055,3,318,1376,76.67,0.22,23.11,2019,59873
66,0,91,157,42.04,0.0,57.96,2019,59915
56,4,11,71,78.87,5.63,15.49,2019,59916
1385,132,254,1771,78.2,7.45,14.34,2019,59917
34,0,46,80,42.5,0.0,57.5,2019,59928
166,4,14,184,90.22,2.17,7.61,2019,59226
225,6,106,337,66.77,1.78,31.45,2019,59248
49,0,5,54,90.74,0.0,9.26,2019,59260
198,4,36,238,83.19,1.68,15.13,2019,59262
509,27,178,714,71.29,3.78,24.93,2019,59263
180,0,18,198,90.91,0.0,9.09,2019,59275
50,3,6,59,84.75,5.08,10.17,2019,59339
5,0,12,17,29.41,0.0,70.59,2019,59354
61,0,26,87,70.11,0.0,29.89,2019,59010
43,0,4,47,91.49,0.0,8.51,2019,59013
171,7,43,221,77.38,3.17,19.46,2019,59018
584,0,141,725,80.55,0.0,19.45,2019,59037
58,2,13,73,79.45,2.74,17.81,2019,59052
105,9,48,162,64.81,5.56,29.63,2019,59066
66,7,30,103,64.08,6.8,29.13,2019,59067
52,0,2,54,96.3,0.0,3.7,2019,59071
42,0,42,84,50.0,0.0,50.0,2019,59075
20,3,8,31,64.52,9.68,25.81,2019,59076
362,0,68,430,84.19,0.0,15.81,2019,59086
155,3,21,179,86.59,1.68,11.73,2019,59087
560,9,72,641,87.36,1.4,11.23,2019,59088
10938,307,1068,12313,88.83,2.49,8.67,2019,59105
31,0,13,44,70.45,0.0,29.55,2019,59211
408,36,57,501,81.44,7.19,11.38,2019,59317
38,0,5,43,88.37,0.0,11.63,2019,59318
2878,60,739,3677,78.27,1.63,20.1,2019,59330
3,0,0,3,100.0,0.0,0.0,2019,59333
78,9,14,101,77.23,8.91,13.86,2019,59012
6872,121,618,7611,90.29,1.59,8.12,2019,60430
504,32,16,552,91.3,5.8,2.9,2019,60603
8751,261,1086,10098,86.66,2.58,10.75,2019,60914
1501,41,387,1929,77.81,2.13,20.06,2019,60964
529,7,136,672,78.72,1.04,20.24,2019,60924
7211,118,1065,8394,85.91,1.41,12.69,2019,60053
14094,567,2602,17263,81.64,3.28,15.07,2019,59101
89,0,7,96,92.71,0.0,7.29,2019,59222
118,4,45,167,70.66,2.4,26.95,2019,59225
198,9,52,259,76.45,3.47,20.08,2019,59261
82,5,18,105,78.1,4.76,17.14,2019,59274
32,4,2,38,84.21,10.53,5.26,2019,59314
183,15,50,248,73.79,6.05,20.16,2019,59016
170,7,59,236,72.03,2.97,25.0,2019,59032
209,12,165,386,54.15,3.11,42.75,2019,59050
100,0,36,136,73.53,0.0,26.47,2019,59054
76,0,9,85,89.41,0.0,10.59,2019,59064
1075,11,245,1331,80.77,0.83,18.41,2019,59079
82,2,11,95,86.32,2.11,11.58,2019,59243
98,0,22,120,81.67,0.0,18.33,2019,59250
115,3,32,150,76.67,2.0,21.33,2019,59259
2770,79,733,3582,77.33,2.21,20.46,2019,59270
36,0,2,38,94.74,0.0,5.26,2019,59315
770,19,95,884,87.1,2.15,10.75,2019,59323
331,24,143,498,66.47,4.82,28.71,2019,59353
155,15,55,225,68.89,6.67,24.44,2019,59433
12,0,4,16,75.0,0.0,25.0,2019,59441
175,8,41,224,78.12,3.57,18.3,2019,59446
578,25,341,944,61.23,2.65,36.12,2019,59872
4953,165,775,5893,84.05,2.8,13.15,2019,60478
2616,236,682,3534,74.02,6.68,19.3,2019,60501
12504,195,633,13332,93.79,1.46,4.75,2019,60504
9445,281,1054,10780,87.62,2.61,9.78,2019,60510
343,0,86,429,79.95,0.0,20.05,2019,60512
6009,278,769,7056,85.16,3.94,10.9,2019,60513
10717,305,961,11983,89.44,2.55,8.02,2019,60516
4333,153,582,5068,85.5,3.02,11.48,2019,60526
10958,355,982,12295,89.13,2.89,7.99,2019,60532
74,0,0,74,100.0,0.0,0.0,2019,60549
2974,119,666,3759,79.12,3.17,17.72,2019,60534
8834,52,677,9563,92.38,0.54,7.08,2019,60544
3853,52,461,4366,88.25,1.19,10.56,2019,60548
45,0,49,94,47.87,0.0,52.13,2019,60557
11451,696,608,12755,89.78,5.46,4.77,2019,60607
15423,895,4572,20890,73.83,4.28,21.89,2019,60609
24821,1336,3511,29668,83.66,4.5,11.83,2019,60625
9266,285,1402,10953,84.6,2.6,12.8,2019,60646
10663,854,1959,13476,79.13,6.34,14.54,2019,60652
5659,369,953,6981,81.06,5.29,13.65,2019,60805
165,7,47,219,75.34,3.2,21.46,2019,60912
825,8,142,975,84.62,0.82,14.56,2019,60922
21,0,0,21,100.0,0.0,0.0,2019,60926
286,21,32,339,84.37,6.19,9.44,2019,60930
41,0,0,41,100.0,0.0,0.0,2019,60932
652,16,110,778,83.8,2.06,14.14,2019,60938
59,0,17,76,77.63,0.0,22.37,2019,60945
11783,175,1432,13390,88.0,1.31,10.69,2019,60007
3421,89,180,3690,92.71,2.41,4.88,2019,60012
8831,82,419,9332,94.63,0.88,4.49,2019,60013
143,13,65,221,64.71,5.88,29.41,2019,65333
4366,189,945,5500,79.38,3.44,17.18,2019,65340
153,0,18,171,89.47,0.0,10.53,2019,65345
336,23,146,505,66.53,4.55,28.91,2019,65348
536,60,475,1071,50.05,5.6,44.35,2019,65438
101,0,93,194,52.06,0.0,47.94,2019,65449
1197,22,283,1502,79.69,1.46,18.84,2019,54874
8279,485,1384,10148,81.58,4.78,13.64,2019,54902
11303,291,557,12151,93.02,2.39,4.58,2019,55024
8474,112,868,9454,89.63,1.18,9.18,2019,55025
131,6,30,167,78.44,3.59,17.96,2019,55026
15,0,22,37,40.54,0.0,59.46,2019,55036
7566,141,476,8183,92.46,1.72,5.82,2019,55038
328,8,51,387,84.75,2.07,13.18,2019,55053
383,6,64,453,84.55,1.32,14.13,2019,55065
6686,270,1083,8039,83.17,3.36,13.47,2019,55066
852,64,357,1273,66.93,5.03,28.04,2019,55072
161,3,23,187,86.1,1.6,12.3,2019,55085
602,14,66,682,88.27,2.05,9.68,2019,55089
3528,104,358,3990,88.42,2.61,8.97,2019,55092
3606,211,1115,4932,73.11,4.28,22.61,2019,55103
14500,291,1376,16167,89.69,1.8,8.51,2019,55110
1020,61,269,1350,75.56,4.52,19.93,2019,55307
15358,641,2022,18021,85.22,3.56,11.22,2019,55113
10053,453,1673,12179,82.54,3.72,13.74,2019,55118
7059,174,538,7771,90.84,2.24,6.92,2019,55127
60,0,11,71,84.51,0.0,15.49,2019,55150
1672,85,176,1933,86.5,4.4,9.11,2019,55320
387,12,79,478,80.96,2.51,16.53,2019,55324
6701,157,261,7119,94.13,2.21,3.67,2019,55331
607,20,131,758,80.08,2.64,17.28,2019,55342
71,9,32,112,63.39,8.04,28.57,2019,55785
3522,231,1165,4918,71.61,4.7,23.69,2019,55792
1653,26,209,1888,87.55,1.38,11.07,2019,55733
479,40,206,725,66.07,5.52,28.41,2019,55735
478,33,130,641,74.57,5.15,20.28,2019,55736
111,7,32,150,74.0,4.67,21.33,2019,55756
224,7,75,306,73.2,2.29,24.51,2019,55757
768,35,175,978,78.53,3.58,17.89,2019,55783
108,16,45,169,63.91,9.47,26.63,2019,55786
6358,260,740,7358,86.41,3.53,10.06,2019,55803
1924,133,508,2565,75.01,5.19,19.81,2019,55808
291,5,65,361,80.61,1.39,18.01,2019,55918
219,9,67,295,74.24,3.05,22.71,2019,55926
1353,45,204,1602,84.46,2.81,12.73,2019,55927
1098,38,172,1308,83.94,2.91,13.15,2019,55934
2502,96,145,2743,91.21,3.5,5.29,2019,55944
1098,22,209,1329,82.62,1.66,15.73,2019,55946
1470,23,347,1840,79.89,1.25,18.86,2019,55975
9446,128,436,10010,94.37,1.28,4.36,2019,55449
41,0,8,49,83.67,0.0,16.33,2019,55601
72,1,31,104,69.23,0.96,29.81,2019,55602
87,3,19,109,79.82,2.75,17.43,2019,55613
203,14,99,316,64.24,4.43,31.33,2019,55708
153,7,72,232,65.95,3.02,31.03,2019,55712
288,29,132,449,64.14,6.46,29.4,2019,55726
1265,26,331,1622,77.99,1.6,20.41,2019,55741
7296,230,1248,8774,83.15,2.62,14.22,2019,55744
565,19,121,705,80.14,2.7,17.16,2019,55751
81,5,31,117,69.23,4.27,26.5,2019,63782
1261,46,583,1890,66.72,2.43,30.85,2019,63873
792,0,291,1083,73.13,0.0,26.87,2019,63965
53,0,22,75,70.67,0.0,29.33,2019,63551
12,0,2,14,85.71,0.0,14.29,2019,63826
90,0,102,192,46.88,0.0,53.12,2019,63964
8045,346,928,9319,86.33,3.71,9.96,2019,55102
4412,130,628,5170,85.34,2.51,12.15,2019,55107
5748,224,371,6343,90.62,3.53,5.85,2019,55108
14715,535,1642,16892,87.11,3.17,9.72,2019,55112
15540,219,964,16723,92.93,1.31,5.76,2019,55304
1077,33,122,1232,87.42,2.68,9.9,2019,55322
1410,53,213,1676,84.13,3.16,12.71,2019,55325
11885,312,1307,13504,88.01,2.31,9.68,2019,55330
2690,0,195,2885,93.24,0.0,6.76,2019,55340
10575,373,1210,12158,86.98,3.07,9.95,2019,55343
4451,166,301,4918,90.5,3.38,6.12,2019,55301
4591,93,539,5223,87.9,1.78,10.32,2019,55077
11529,298,1190,13017,88.57,2.29,9.14,2019,55109
18128,450,1398,19976,90.75,2.25,7.0,2019,55124
13257,249,430,13936,95.13,1.79,3.09,2019,55311
450,21,120,591,76.14,3.55,20.3,2019,55312
1561,68,240,1869,83.52,3.64,12.84,2019,55321
840,44,269,1153,72.85,3.82,23.33,2019,55334
5967,87,202,6256,95.38,1.39,3.23,2019,55346
695,70,146,911,76.29,7.68,16.03,2019,55368
5086,194,949,6229,81.65,3.11,15.24,2019,55371
8355,931,2805,12091,69.1,7.7,23.2,2019,55404
4500,199,213,4912,91.61,4.05,4.34,2019,55409
6154,286,1212,7652,80.42,3.74,15.84,2019,55430
1203,63,300,1566,76.82,4.02,19.16,2019,55006
17740,341,917,18998,93.38,1.79,4.83,2019,55044
769,3,140,912,84.32,0.33,15.35,2019,55049
2995,145,684,3824,78.32,3.79,17.89,2019,55051
1066,27,118,1211,88.03,2.23,9.74,2019,55073
567,17,78,662,85.65,2.57,11.78,2019,55088
15456,428,2090,17974,85.99,2.38,11.63,2019,55106
9655,431,1223,11309,85.37,3.81,10.81,2019,55116
13341,377,2252,15970,83.54,2.36,14.1,2019,55117
3312,122,301,3735,88.67,3.27,8.06,2019,55121
1071,6,33,1110,96.49,0.54,2.97,2019,55001
670,24,69,763,87.81,3.15,9.04,2019,55012
627,15,65,707,88.68,2.12,9.19,2019,55031
4311,109,437,4857,88.76,2.24,9.0,2019,55040
2921,49,478,3448,84.72,1.42,13.86,2019,55041
3156,36,216,3408,92.61,1.06,6.34,2019,55042
2895,108,605,3608,80.24,2.99,16.77,2019,55063
2401,28,233,2662,90.2,1.05,8.75,2019,55070
770,9,83,862,89.33,1.04,9.63,2019,55074
845,68,448,1361,62.09,5.0,32.92,2019,55802
1121,26,265,1412,79.39,1.84,18.77,2019,55917
1526,39,289,1854,82.31,2.1,15.59,2019,55923
939,15,169,1123,83.62,1.34,15.05,2019,55940
15837,362,1778,17977,88.1,2.01,9.89,2019,55303
6015,94,315,6424,93.63,1.46,4.9,2019,55309
394,20,184,598,65.89,3.34,30.77,2019,55310
325,17,128,470,69.15,3.62,27.23,2019,55314
8493,195,479,9167,92.65,2.13,5.23,2019,55316
9678,133,781,10592,91.37,1.26,7.37,2019,55318
183,6,63,252,72.62,2.38,25.0,2019,64451
139,10,52,201,69.15,4.98,25.87,2019,64466
216,4,27,247,87.45,1.62,10.93,2019,64483
151,14,99,264,57.2,5.3,37.5,2019,64487
563,7,188,758,74.27,0.92,24.8,2019,64489
3144,213,1296,4653,67.57,4.58,27.85,2019,64601
6759,96,1022,7877,85.81,1.22,12.97,2019,53224
4305,108,1180,5593,76.97,1.93,21.1,2019,53404
681,36,116,833,81.75,4.32,13.93,2019,53529
3352,78,742,4172,80.35,1.87,17.79,2019,53549
341,11,88,440,77.5,2.5,20.0,2019,53550
1113,33,200,1346,82.69,2.45,14.86,2019,53108
6307,247,1128,7682,82.1,3.22,14.68,2019,53110
804,51,114,969,82.97,5.26,11.76,2019,53114
119,2,26,147,80.95,1.36,17.69,2019,53016
661,8,92,761,86.86,1.05,12.09,2019,53019
7774,63,662,8499,91.47,0.74,7.79,2019,53045
542,0,119,661,82.0,0.0,18.0,2019,53063
155,3,42,200,77.5,1.5,21.0,2019,53088
3740,164,741,4645,80.52,3.53,15.95,2019,53098
1355,22,95,1472,92.05,1.49,6.45,2019,53103
5212,355,838,6405,81.37,5.54,13.08,2019,53115
1868,30,230,2128,87.78,1.41,10.81,2019,53119
12093,436,982,13511,89.5,3.23,7.27,2019,53151
284,64,24,372,76.34,17.2,6.45,2019,53167
6615,118,593,7326,90.29,1.61,8.09,2019,53185
11890,416,2697,15003,79.25,2.77,17.98,2019,53219
9097,235,1894,11226,81.04,2.09,16.87,2019,53222
516,10,84,610,84.59,1.64,13.77,2019,53510
227,9,38,274,82.85,3.28,13.87,2019,53526
2921,120,468,3509,83.24,3.42,13.34,2019,53536
255,5,101,361,70.64,1.39,27.98,2019,53541
584,5,114,703,83.07,0.71,16.22,2019,53006
657,29,227,913,71.96,3.18,24.86,2019,53007
6480,223,590,7293,88.85,3.06,8.09,2019,53024
960,0,130,1090,88.07,0.0,11.93,2019,53036
504,11,98,613,82.22,1.79,15.99,2019,53057
1392,25,59,1476,94.31,1.69,4.0,2019,53058
2526,92,242,2860,88.32,3.22,8.46,2019,53118
9311,555,2039,11905,78.21,4.66,17.13,2019,53140
8431,148,1300,9879,85.34,1.5,13.16,2019,53144
2799,16,294,3109,90.03,0.51,9.46,2019,53146
8698,140,813,9651,90.13,1.45,8.42,2019,53150
9252,83,556,9891,93.54,0.84,5.62,2019,53189
5122,584,791,6497,78.84,8.99,12.17,2019,53190
852,83,50,985,86.5,8.43,5.08,2019,53203
13797,451,2340,16588,83.17,2.72,14.11,2019,53207
13520,544,4546,18610,72.65,2.92,24.43,2019,53209
9303,200,1748,11251,82.69,1.78,15.54,2019,53220
793,34,181,1008,78.67,3.37,17.96,2019,53502
613,16,215,844,72.63,1.9,25.47,2019,53504
714,13,67,794,89.92,1.64,8.44,2019,53507
14434,1022,3604,19060,75.73,5.36,18.91,2019,53511
642,12,80,734,87.47,1.63,10.9,2019,53517
335,8,69,412,81.31,1.94,16.75,2019,53522
1140,70,263,1473,77.39,4.75,17.85,2019,53525
1884,65,250,2199,85.68,2.96,11.37,2019,53559
727,5,64,796,91.33,0.63,8.04,2019,53561
374,7,89,470,79.57,1.49,18.94,2019,53569
16,0,4,20,80.0,0.0,20.0,2019,56140
136,3,15,154,88.31,1.95,9.74,2019,56155
911,32,222,1165,78.2,2.75,19.06,2019,56159
73,0,14,87,83.91,0.0,16.09,2019,56166
207,11,57,275,75.27,4.0,20.73,2019,56170
395,26,49,470,84.04,5.53,10.43,2019,56181
780,31,225,1036,75.29,2.99,21.72,2019,65452
264,10,151,425,62.12,2.35,35.53,2019,65470
546,44,327,917,59.54,4.8,35.66,2019,65769
543,51,355,949,57.22,5.37,37.41,2019,65779
344,2,159,505,68.12,0.4,31.49,2019,65787
13076,945,4030,18051,72.44,5.24,22.33,2019,65803
503,15,76,594,84.68,2.53,12.79,2019,65256
269,11,110,390,68.97,2.82,28.21,2019,65261
231,4,37,272,84.93,1.47,13.6,2019,65264
53,0,12,65,81.54,0.0,18.46,2019,65278
169,8,42,219,77.17,3.65,19.18,2019,65322
2126,27,231,2384,89.18,1.13,9.69,2019,65336
197,4,53,254,77.56,1.57,20.87,2019,65347
3300,136,1061,4497,73.38,3.02,23.59,2019,65355
130,0,11,141,92.2,0.0,7.8,2019,65440
188,4,50,242,77.69,1.65,20.66,2019,65456
262,65,122,449,58.35,14.48,27.17,2019,65464
669,44,159,872,76.72,5.05,18.23,2019,65351
250,45,119,414,60.39,10.87,28.74,2019,65444
0,43,0,43,0.0,100.0,0.0,2019,65468
197,30,85,312,63.14,9.62,27.24,2019,65534
8782,536,2287,11605,75.67,4.62,19.71,2019,65536
859,52,271,1182,72.67,4.4,22.93,2019,65325
69,2,27,98,70.41,2.04,27.55,2019,65327
136,14,27,177,76.84,7.91,15.25,2019,65329
53,6,5,64,82.81,9.38,7.81,2019,65335
9405,79,352,9836,95.62,0.8,3.58,2019,66223
157,0,13,170,92.35,0.0,7.65,2019,66404
133,1,41,175,76.0,0.57,23.43,2019,66406
96,5,13,114,84.21,4.39,11.4,2019,66408
639,14,175,828,77.17,1.69,21.14,2019,66413
109,0,21,130,83.85,0.0,16.15,2019,66515
494,25,159,678,72.86,3.69,23.45,2019,66521
248,15,62,325,76.31,4.62,19.08,2019,66526
1175,48,219,1442,81.48,3.33,15.19,2019,66534
258,7,66,331,77.95,2.11,19.94,2019,66548
207,5,20,232,89.22,2.16,8.62,2019,66554
631,92,133,856,73.71,10.75,15.54,2019,66619
1430,16,602,2048,69.82,0.78,29.39,2019,66713
3312,222,1168,4702,70.44,4.72,24.84,2019,66720
299,25,125,449,66.59,5.57,27.84,2019,66023
890,153,497,1540,57.79,9.94,32.27,2019,66040
1588,140,553,2281,69.62,6.14,24.24,2019,66064
902,6,155,1063,84.85,0.56,14.58,2019,66070
3037,264,393,3694,82.21,7.15,10.64,2019,66086
2881,236,1539,4656,61.88,5.07,33.05,2019,66101
6387,272,2596,9255,69.01,2.94,28.05,2019,66104
7118,184,727,8029,88.65,2.29,9.05,2019,66203
3956,35,229,4220,93.74,0.83,5.43,2019,66206
5626,27,90,5743,97.96,0.47,1.57,2019,66221
889,112,85,1086,81.86,10.31,7.83,2019,66402
161,0,34,195,82.56,0.0,17.44,2019,66407
1205,25,56,1286,93.7,1.94,4.35,2019,66409
55,0,6,61,90.16,0.0,9.84,2019,67363
73,0,6,79,92.41,0.0,7.59,2019,67423
66,0,42,108,61.11,0.0,38.89,2019,67474
250,14,103,367,68.12,3.81,28.07,2019,67484
452,8,97,557,81.15,1.44,17.41,2019,67854
330,4,113,447,73.83,0.89,25.28,2019,67865
0,0,0,0,,,,2019,63045
21,0,0,21,100.0,0.0,0.0,2019,63047
22,0,6,28,78.57,0.0,21.43,2019,63053
0,0,0,0,,,,2019,63057
1279,33,213,1525,83.87,2.16,13.97,2019,64020
319,14,75,408,78.19,3.43,18.38,2019,64035
1912,55,519,2486,76.91,2.21,20.88,2019,64040
1370,37,123,1530,89.54,2.42,8.04,2019,64048
186,12,54,252,73.81,4.76,21.43,2019,64071
242,6,59,307,78.83,1.95,19.22,2019,64001
1776,57,95,1928,92.12,2.96,4.93,2019,64145
10026,355,813,11194,89.57,3.17,7.26,2019,64151
129,1,34,164,78.66,0.61,20.73,2019,64455
37,0,46,83,44.58,0.0,55.42,2019,64467
85,4,62,151,56.29,2.65,41.06,2019,64475
243,4,96,343,70.85,1.17,27.99,2019,64479
52,2,46,100,52.0,2.0,46.0,2019,64480
138,1,53,192,71.88,0.52,27.6,2019,64486
0,0,0,0,,,,2019,64102
1357,39,541,1937,70.06,2.01,27.93,2019,64633
212,16,129,357,59.38,4.48,36.13,2019,64631
97,0,20,117,82.91,0.0,17.09,2019,64636
957,29,189,1175,81.45,2.47,16.09,2019,64640
256,21,114,391,65.47,5.37,29.16,2019,64642
52,0,19,71,73.24,0.0,26.76,2019,64645
106,3,12,121,87.6,2.48,9.92,2019,64667
160,6,60,226,70.8,2.65,26.55,2019,64688
138,3,47,188,73.4,1.6,25.0,2019,64722
729,26,185,940,77.55,2.77,19.68,2019,64742
2441,170,735,3346,72.95,5.08,21.97,2019,64744
772,53,169,994,77.67,5.33,17.0,2019,64755
177,22,53,252,70.24,8.73,21.03,2019,64769
31,0,6,37,83.78,0.0,16.22,2019,64781
262,21,127,410,63.9,5.12,30.98,2019,64790
8,1,12,21,38.1,4.76,57.14,2019,64833
777,82,103,962,80.77,8.52,10.71,2019,64855
93,19,23,135,68.89,14.07,17.04,2019,64857
4591,238,933,5762,79.68,4.13,16.19,2019,64870
262,15,47,324,80.86,4.63,14.51,2019,64873
86,18,73,177,48.59,10.17,41.24,2019,64017
637,14,124,775,82.19,1.81,16.0,2019,64019
10,0,0,10,100.0,0.0,0.0,2019,64066
1655,146,504,2305,71.8,6.33,21.87,2019,64067
5363,21,206,5590,95.94,0.38,3.69,2019,64082
2987,464,209,3660,81.61,12.68,5.71,2019,64105
4568,133,183,4884,93.53,2.72,3.75,2019,64113
8345,411,1667,10423,80.06,3.94,15.99,2019,64131
753,13,247,1013,74.33,1.28,24.38,2019,64136
187,0,136,323,57.89,0.0,42.11,2019,64421
123,0,46,169,72.78,0.0,27.22,2019,64426
66,2,20,88,75.0,2.27,22.73,2019,64457
198,10,77,285,69.47,3.51,27.02,2019,64428
15,5,7,27,55.56,18.52,25.93,2019,64432
43,0,3,46,93.48,0.0,6.52,2019,50551
220,20,38,278,79.14,7.19,13.67,2019,50560
525,7,84,616,85.23,1.14,13.64,2019,50568
146,0,28,174,83.91,0.0,16.09,2019,50577
943,23,216,1182,79.78,1.95,18.27,2019,50583
85,11,23,119,71.43,9.24,19.33,2019,50586
133,5,47,185,71.89,2.7,25.41,2019,64620
1663,61,678,2402,69.23,2.54,28.23,2019,64628
155,2,50,207,74.88,0.97,24.15,2019,64630
933,34,327,1294,72.1,2.63,25.27,2019,64644
7261,125,740,8126,89.36,1.54,9.11,2019,64063
1115,6,206,1327,84.02,0.45,15.52,2019,64070
3240,177,332,3749,86.42,4.72,8.86,2019,64078
4788,92,292,5172,92.58,1.78,5.65,2019,64079
8272,215,662,9149,90.41,2.35,7.24,2019,64014
1924,63,211,2198,87.53,2.87,9.6,2019,64062
9348,251,807,10406,89.83,2.41,7.76,2019,64093
2330,117,959,3406,68.41,3.44,28.16,2019,64123
4349,145,1842,6336,68.64,2.29,29.07,2019,64127
5479,408,2663,8550,64.08,4.77,31.15,2019,64130
660,24,33,717,92.05,3.35,4.6,2019,64139
1125,74,307,1506,74.7,4.91,20.39,2019,64150
2696,21,89,2806,96.08,0.75,3.17,2019,64156
118,0,38,156,75.64,0.0,24.36,2019,64422
1379,17,348,1744,79.07,0.97,19.95,2019,64424
44,0,15,59,74.58,0.0,25.42,2019,64441
127,0,45,172,73.84,0.0,26.16,2019,64459
1424,85,493,2002,71.13,4.25,24.63,2019,66032
191,15,93,299,63.88,5.02,31.1,2019,66041
424,29,100,553,76.67,5.24,18.08,2019,62560
128,12,40,180,71.11,6.67,22.22,2019,62570
220,10,86,316,69.62,3.16,27.22,2019,62617
389,14,121,524,74.24,2.67,23.09,2019,62638
1218,57,230,1505,80.93,3.79,15.28,2019,62640
68,2,22,92,73.91,2.17,23.91,2019,62663
726,40,181,947,76.66,4.22,19.11,2019,62685
694,22,127,843,82.33,2.61,15.07,2019,62692
8804,865,2312,11981,73.48,7.22,19.3,2019,62703
101,6,11,118,85.59,5.08,9.32,2019,62811
3399,82,952,4433,76.67,1.85,21.48,2019,62812
409,7,109,525,77.9,1.33,20.76,2019,62816
106,2,16,124,85.48,1.61,12.9,2019,62815
574,33,111,718,79.94,4.6,15.46,2019,62868
665,27,102,794,83.75,3.4,12.85,2019,62898
257,11,83,351,73.22,3.13,23.65,2019,62853
38,0,27,65,58.46,0.0,41.54,2019,62861
510,11,263,784,65.05,1.4,33.55,2019,62907
34,0,28,62,54.84,0.0,45.16,2019,62076
3,0,8,11,27.27,0.0,72.73,2019,62098
121,10,37,168,72.02,5.95,22.02,2019,62248
119,3,47,169,70.41,1.78,27.81,2019,62282
6626,139,909,7674,86.34,1.81,11.85,2019,62305
15,0,0,15,100.0,0.0,0.0,2019,62622
6301,164,647,7112,88.6,2.31,9.1,2019,62711
3771,284,185,4240,88.94,6.7,4.36,2019,62712
31,0,15,46,67.39,0.0,32.61,2019,62841
131,7,32,170,77.06,4.12,18.82,2019,62856
1662,33,283,1978,84.02,1.67,14.31,2019,62902
1676,293,1404,3373,49.69,8.69,41.62,2019,62205
239,12,83,334,71.56,3.59,24.85,2019,49744
674,20,182,876,76.94,2.28,20.78,2019,49747
367,93,54,514,71.4,18.09,10.51,2019,49757
190,29,61,280,67.86,10.36,21.79,2019,49760
164,0,0,164,100.0,0.0,0.0,2019,49764
6390,109,981,7480,85.43,1.46,13.11,2019,49770
187,4,26,217,86.18,1.84,11.98,2019,56185
778,26,107,911,85.4,2.85,11.75,2019,56209
88,2,14,104,84.62,1.92,13.46,2019,56226
355,18,104,477,74.42,3.77,21.8,2019,56285
199,10,47,256,77.73,3.91,18.36,2019,56262
60,2,23,85,70.59,2.35,27.06,2019,56274
1965,84,530,2579,76.19,3.26,20.55,2019,56283
154,1,29,184,83.7,0.54,15.76,2019,56291
19,2,8,29,65.52,6.9,27.59,2019,56294
266,3,77,346,76.88,0.87,22.25,2019,56297
489,27,134,650,75.23,4.15,20.62,2019,56326
648,24,181,853,75.97,2.81,21.22,2019,56331
735,43,268,1046,70.27,4.11,25.62,2019,56340
351,21,74,446,78.7,4.71,16.59,2019,56343
496,8,95,599,82.8,1.34,15.86,2019,56354
207,0,53,260,79.62,0.0,20.38,2019,56369
2704,339,241,3284,82.34,10.32,7.34,2019,56374
2392,69,676,3137,76.25,2.2,21.55,2019,56378
6059,284,644,6987,86.72,4.06,9.22,2019,56379
880,20,146,1046,84.13,1.91,13.96,2019,56381
119,0,49,168,70.83,0.0,29.17,2019,56384
10423,295,1774,12492,83.44,2.36,14.2,2019,56401
2853,62,331,3246,87.89,1.91,10.2,2019,56425
360,27,145,532,67.67,5.08,27.26,2019,56440
401,15,72,488,82.17,3.07,14.75,2019,56447
114,2,29,145,78.62,1.38,20.0,2019,56448
1140,21,139,1300,87.69,1.62,10.69,2019,56461
229,14,70,313,73.16,4.47,22.36,2019,56524
1540,46,135,1721,89.48,2.67,7.84,2019,56529
81,8,15,104,77.88,7.69,14.42,2019,56546
664,52,184,900,73.78,5.78,20.44,2019,56551
80,4,24,108,74.07,3.7,22.22,2019,56581
155,15,34,204,75.98,7.35,16.67,2019,56588
406,9,102,517,78.53,1.74,19.73,2019,56010
1587,51,379,2017,78.68,2.53,18.79,2019,56013
215,5,59,279,77.06,1.79,21.15,2019,56014
586,15,58,659,88.92,2.28,8.8,2019,56017
247,10,95,352,70.17,2.84,26.99,2019,56019
242,6,83,331,73.11,1.81,25.08,2019,56027
114,8,39,161,70.81,4.97,24.22,2019,56033
615,10,188,813,75.65,1.23,23.12,2019,56036
323,4,65,392,82.4,1.02,16.58,2019,56045
946,102,235,1283,73.73,7.95,18.32,2019,56062
1502,46,266,1814,82.8,2.54,14.66,2019,56069
1604,102,652,2358,68.02,4.33,27.65,2019,56081
1019,19,225,1263,80.68,1.5,17.81,2019,56087
675,30,190,895,75.42,3.35,21.23,2019,56098
554,25,141,720,76.94,3.47,19.58,2019,56110
137,4,39,180,76.11,2.22,21.67,2019,56111
98,11,25,134,73.13,8.21,18.66,2019,56117
117,5,45,167,70.06,2.99,26.95,2019,56127
657,25,130,812,80.91,3.08,16.01,2019,56128
269,0,67,336,80.06,0.0,19.94,2019,56129
8,0,0,8,100.0,0.0,0.0,2019,64065
17,0,0,17,100.0,0.0,0.0,2019,64092
28,0,6,34,82.35,0.0,17.65,2019,64420
17,0,5,22,77.27,0.0,22.73,2019,64654
4,0,9,13,30.77,0.0,69.23,2019,64765
118,0,0,118,100.0,0.0,0.0,2019,64165
489,12,76,577,84.75,2.08,13.17,2019,67869
195,3,63,261,74.71,1.15,24.14,2019,67436
541,13,95,649,83.36,2.0,14.64,2019,67443
237,12,59,308,76.95,3.9,19.16,2019,67454
71,6,21,98,72.45,6.12,21.43,2019,67459
565,21,210,796,70.98,2.64,26.38,2019,67473
44,6,7,57,77.19,10.53,12.28,2019,67475
20,1,10,31,64.52,3.23,32.26,2019,67478
56,2,39,97,57.73,2.06,40.21,2019,67510
58,0,3,61,95.08,0.0,4.92,2019,67521
59,1,18,78,75.64,1.28,23.08,2019,67529
1009,47,191,1247,80.91,3.77,15.32,2019,67544
546,9,114,669,81.61,1.35,17.04,2019,67548
4,0,0,4,100.0,0.0,0.0,2019,67559
568,17,142,727,78.13,2.34,19.53,2019,67560
385,20,152,557,69.12,3.59,27.29,2019,67578
147,6,7,160,91.88,3.75,4.38,2019,67621
52,0,18,70,74.29,0.0,25.71,2019,67631
60,1,11,72,83.33,1.39,15.28,2019,67639
142,7,50,199,71.36,3.52,25.13,2019,67651
37,0,14,51,72.55,0.0,27.45,2019,67658
95,0,18,113,84.07,0.0,15.93,2019,67664
35,0,8,43,81.4,0.0,18.6,2019,67673
244,3,74,321,76.01,0.93,23.05,2019,67731
1094,9,251,1354,80.8,0.66,18.54,2019,67654
50,0,0,50,100.0,0.0,0.0,2019,67659
44,0,0,44,100.0,0.0,0.0,2019,67660
1123,40,249,1412,79.53,2.83,17.63,2019,67661
1594,66,549,2209,72.16,2.99,24.85,2019,67665
1006,8,157,1171,85.91,0.68,13.41,2019,67672
19,0,9,28,67.86,0.0,32.14,2019,67674
2380,214,284,2878,82.7,7.44,9.87,2019,67701
62,6,19,87,71.26,6.9,21.84,2019,67739
145,0,10,155,93.55,0.0,6.45,2019,67764
7954,180,1906,10040,79.22,1.79,18.98,2019,67801
290,11,48,349,83.09,3.15,13.75,2019,67834
108,0,40,148,72.97,0.0,27.03,2019,67841
283,4,64,351,80.63,1.14,18.23,2019,67140
894,3,108,1005,88.96,0.3,10.75,2019,67144
451,37,222,710,63.52,5.21,31.27,2019,67361
3345,100,860,4305,77.7,2.32,19.98,2019,67410
44,0,17,61,72.13,0.0,27.87,2019,67417
163,20,24,207,78.74,9.66,11.59,2019,67425
64,0,24,88,72.73,0.0,27.27,2019,67438
1423,49,252,1724,82.54,2.84,14.62,2019,67456
162,0,35,197,82.23,0.0,17.77,2019,67470
484,28,101,613,78.96,4.57,16.48,2019,67480
94,0,25,119,78.99,0.0,21.01,2019,67520
245,16,108,369,66.4,4.34,29.27,2019,67009
230,6,39,275,83.64,2.18,14.18,2019,67038
205,8,135,348,58.91,2.3,38.79,2019,67047
31,1,25,57,54.39,1.75,43.86,2019,67061
82,2,9,93,88.17,2.15,9.68,2019,67065
1313,121,456,1890,69.47,6.4,24.13,2019,70343
6160,175,2314,8649,71.22,2.02,26.75,2019,70380
4180,71,844,5095,82.04,1.39,16.57,2019,70452
443,23,89,555,79.82,4.14,16.04,2019,70552
10696,560,4663,15919,67.19,3.52,29.29,2019,70119
2407,68,506,2981,80.74,2.28,16.97,2019,70420
16,0,3,19,84.21,0.0,15.79,2019,50593
140,2,38,180,77.78,1.11,21.11,2019,50599
78,1,37,116,67.24,0.86,31.9,2019,50605
291,2,68,361,80.61,0.55,18.84,2019,50634
324,9,172,505,64.16,1.78,34.06,2019,50641
697,28,140,865,80.58,3.24,16.18,2019,50647
1857,53,486,2396,77.5,2.21,20.28,2019,50659
436,12,58,506,86.17,2.37,11.46,2019,50660
2256,76,587,2919,77.29,2.6,20.11,2019,50662
57,3,17,77,74.03,3.9,22.08,2019,50671
1215,58,275,1548,78.49,3.75,17.76,2019,50674
4036,103,515,4654,86.72,2.21,11.07,2019,50677
656,15,47,718,91.36,2.09,6.55,2019,50682
766,38,157,961,79.71,3.95,16.34,2019,50833
97,5,54,156,62.18,3.21,34.62,2019,50836
6944,209,1194,8347,83.19,2.5,14.3,2019,50702
29,0,7,36,80.56,0.0,19.44,2019,50835
113,9,32,154,73.38,5.84,20.78,2019,50837
236,10,70,316,74.68,3.16,22.15,2019,50858
196,5,41,242,80.99,2.07,16.94,2019,50446
36,0,0,36,100.0,0.0,0.0,2019,50454
756,12,146,914,82.71,1.31,15.97,2019,50458
930,50,245,1225,75.92,4.08,20.0,2019,50459
455,16,179,650,70.0,2.46,27.54,2019,50466
218,17,49,284,76.76,5.99,17.25,2019,50471
212,10,38,260,81.54,3.85,14.62,2019,50479
166,31,35,232,71.55,13.36,15.09,2019,50524
185,5,70,260,71.15,1.92,26.92,2019,50026
771,8,233,1012,76.19,0.79,23.02,2019,50060
97,2,40,139,69.78,1.44,28.78,2019,50611
3781,82,590,4453,84.91,1.84,13.25,2019,50588
120,8,23,151,79.47,5.3,15.23,2019,50591
73,2,9,84,86.9,2.38,10.71,2019,50594
2926,128,793,3847,76.06,3.33,20.61,2019,50595
302,20,95,417,72.42,4.8,22.78,2019,50598
860,23,171,1054,81.59,2.18,16.22,2019,50601
14251,700,1379,16330,87.27,4.29,8.44,2019,50613
3317,93,1037,4447,74.59,2.09,23.32,2019,50616
905,44,334,1283,70.54,3.43,26.03,2019,50627
321,16,166,503,63.82,3.18,33.0,2019,50628
361,9,97,467,77.3,1.93,20.77,2019,50632
496,27,143,666,74.47,4.05,21.47,2019,50635
593,32,150,775,76.52,4.13,19.35,2019,50636
184,7,56,247,74.49,2.83,22.67,2019,50672
2612,84,732,3428,76.2,2.45,21.35,2019,50707
3193,158,674,4025,79.33,3.93,16.75,2019,50801
57,2,19,78,73.08,2.56,24.36,2019,50860
49,2,13,64,76.56,3.12,20.31,2019,50862
67,6,8,81,82.72,7.41,9.88,2019,50863
11400,448,2667,14515,78.54,3.09,18.37,2019,50315
10316,460,2433,13209,78.1,3.48,18.42,2019,50401
94,1,21,116,81.03,0.86,18.1,2019,50420
61,0,31,92,66.3,0.0,33.7,2019,50465
446,14,111,571,78.11,2.45,19.44,2019,52659
40,0,7,47,85.11,0.0,14.89,2019,52701
120,1,15,136,88.24,0.74,11.03,2019,52737
166,6,26,198,83.84,3.03,13.13,2019,52750
1509,57,160,1726,87.43,3.3,9.27,2019,52778
108,6,33,147,73.47,4.08,22.45,2019,52765
6348,257,1282,7887,80.49,3.26,16.25,2019,49783
978,37,131,1146,85.34,3.23,11.43,2019,49788
672,19,208,899,74.75,2.11,23.14,2019,49799
8488,753,3739,12980,65.39,5.8,28.81,2019,49022
1934,100,486,2520,76.75,3.97,19.29,2019,49028
124,0,37,161,77.02,0.0,22.98,2019,49796
198,25,77,300,66.0,8.33,25.67,2019,49718
63,0,25,88,71.59,0.0,28.41,2019,49826
143,4,26,173,82.66,2.31,15.03,2019,49839
40,0,9,49,81.63,0.0,18.37,2019,49852
2125,109,514,2748,77.33,3.97,18.7,2019,49854
18,0,33,51,35.29,0.0,64.71,2019,49864
1202,171,285,1658,72.5,10.31,17.19,2019,49870
590,35,146,771,76.52,4.54,18.94,2019,49885
191,5,59,255,74.9,1.96,23.14,2019,49891
453,12,130,595,76.13,2.02,21.85,2019,49905
93,12,33,138,67.39,8.7,23.91,2019,49910
212,18,57,287,73.87,6.27,19.86,2019,49922
262,3,114,379,69.13,0.79,30.08,2019,49963
7287,196,1431,8914,81.75,2.2,16.05,2019,49017
10807,228,910,11945,90.47,1.91,7.62,2019,49024
2574,206,698,3478,74.01,5.92,20.07,2019,49046
2438,21,289,2748,88.72,0.76,10.52,2019,49053
1988,131,403,2522,78.83,5.19,15.98,2019,49065
3305,34,261,3600,91.81,0.94,7.25,2019,49071
956,22,176,1154,82.84,1.91,15.25,2019,49072
5117,109,877,6103,83.84,1.79,14.37,2019,49080
2749,18,291,3058,89.9,0.59,9.52,2019,49083
1103,33,426,1562,70.61,2.11,27.27,2019,49746
1191,76,410,1677,71.02,4.53,24.45,2019,49765
694,54,196,944,73.52,5.72,20.76,2019,49766
633,11,143,787,80.43,1.4,18.17,2019,49774
47,6,35,88,53.41,6.82,39.77,2019,49793
2095,87,651,2833,73.95,3.07,22.98,2019,49802
87,0,32,119,73.11,0.0,26.89,2019,49808
205,12,77,294,69.73,4.08,26.19,2019,49816
279,1,117,397,70.28,0.25,29.47,2019,49835
208,6,58,272,76.47,2.21,21.32,2019,49840
178,2,38,218,81.65,0.92,17.43,2019,49871
291,19,74,384,75.78,4.95,19.27,2019,49874
1139,35,390,1564,72.83,2.24,24.94,2019,49878
352,10,127,489,71.98,2.04,25.97,2019,49879
189,5,50,244,77.46,2.05,20.49,2019,49895
693,36,206,935,74.12,3.85,22.03,2019,49908
40,4,19,63,63.49,6.35,30.16,2019,49918
77,0,10,87,88.51,0.0,11.49,2019,49919
171,20,36,227,75.33,8.81,15.86,2019,49925
847,14,208,1069,79.23,1.31,19.46,2019,49241
1808,86,239,2133,84.76,4.03,11.2,2019,49228
5725,161,830,6716,85.24,2.4,12.36,2019,49331
3764,47,575,4386,85.82,1.07,13.11,2019,49333
3728,146,1229,5103,73.06,2.86,24.08,2019,49337
12025,157,824,13006,92.46,1.21,6.34,2019,49341
382,12,127,521,73.32,2.3,24.38,2019,53826
397,10,86,493,80.53,2.03,17.44,2019,53911
1507,56,452,2015,74.79,2.78,22.43,2019,53934
699,30,184,913,76.56,3.29,20.15,2019,53951
96,4,20,120,80.0,3.33,16.67,2019,53953
1020,29,217,1266,80.57,2.29,17.14,2019,53956
298,2,18,318,93.71,0.63,5.66,2019,64436
157,2,55,214,73.36,0.93,25.7,2019,65614
9412,546,1534,11492,81.9,4.75,13.35,2019,65616
385,0,79,464,82.97,0.0,17.03,2019,65617
2420,93,435,2948,82.09,3.15,14.76,2019,65619
3,0,2,5,60.0,0.0,40.0,2019,65623
459,3,238,700,65.57,0.43,34.0,2019,65626
217,0,43,260,83.46,0.0,16.54,2019,65640
529,17,161,707,74.82,2.4,22.77,2019,65646
520,7,250,777,66.92,0.9,32.18,2019,65668
2957,193,458,3608,81.96,5.35,12.69,2019,65672
1540,233,417,2190,70.32,10.64,19.04,2019,65689
1112,29,408,1549,71.79,1.87,26.34,2019,65705
2874,226,964,4064,70.72,5.56,23.72,2019,65711
27,3,12,42,64.29,7.14,28.57,2019,65766
553,21,192,766,72.19,2.74,25.07,2019,65767
7493,358,2087,9938,75.4,3.6,21.0,2019,65775
2723,159,365,3247,83.86,4.9,11.24,2019,65781
18,0,21,39,46.15,0.0,53.85,2019,65783
1744,103,550,2397,72.76,4.3,22.95,2019,65793
554,9,104,667,83.06,1.35,15.59,2019,65274
142,8,34,184,77.17,4.35,18.48,2019,65339
12,0,9,21,57.14,0.0,42.86,2019,65320
385,33,144,562,68.51,5.87,25.62,2019,65332
476,25,182,683,69.69,3.66,26.65,2019,65337
1738,135,555,2428,71.58,5.56,22.86,2019,65459
16,0,27,43,37.21,0.0,62.79,2019,65461
70,0,23,93,75.27,0.0,24.73,2019,65479
0,0,17,17,0.0,0.0,100.0,2019,65484
14,0,46,60,23.33,0.0,76.67,2019,65501
42,0,0,42,100.0,0.0,0.0,2019,65564
467,15,292,774,60.34,1.94,37.73,2019,65571
4226,179,783,5188,81.46,3.45,15.09,2019,65605
2115,241,768,3124,67.7,7.71,24.58,2019,65625
122,0,124,246,49.59,0.0,50.41,2019,65627
111,2,1,114,97.37,1.75,0.88,2019,65630
722,65,206,993,72.71,6.55,20.75,2019,65632
416,0,69,485,85.77,0.0,14.23,2019,65637
155,28,35,218,71.1,12.84,16.06,2019,65638
74,0,5,79,93.67,0.0,6.33,2019,65660
768,10,161,939,81.79,1.06,17.15,2019,65679
919,96,280,1295,70.97,7.41,21.62,2019,65723
90,48,25,163,55.21,29.45,15.34,2019,65788
281,0,74,355,79.15,0.0,20.85,2019,65790
14717,1137,2558,18412,79.93,6.18,13.89,2019,65804
2117,177,628,2922,72.45,6.06,21.49,2019,65018
365,34,105,504,72.42,6.75,20.83,2019,65046
424,0,14,438,96.8,0.0,3.2,2019,65047
2700,56,173,2929,92.18,1.91,5.91,2019,65049
178,27,84,289,61.59,9.34,29.07,2019,65061
133,18,71,222,59.91,8.11,31.98,2019,65064
785,39,348,1172,66.98,3.33,29.69,2019,65081
370,1,207,578,64.01,0.17,35.81,2019,65324
38,14,51,103,36.89,13.59,49.51,2019,49027
755,15,319,1089,69.33,1.38,29.29,2019,49032
1013,12,351,1376,73.62,0.87,25.51,2019,49040
1435,67,463,1965,73.03,3.41,23.56,2019,49042
1863,161,398,2422,76.92,6.65,16.43,2019,49055
1295,73,381,1749,74.04,4.17,21.78,2019,49067
693,15,204,912,75.99,1.64,22.37,2019,70528
1760,31,509,2300,76.52,1.35,22.13,2019,70092
1289,34,389,1712,75.29,1.99,22.72,2019,70342
1242,102,339,1683,73.8,6.06,20.14,2019,70032
8446,179,612,9237,91.44,1.94,6.63,2019,70448
5491,74,1451,7016,78.26,1.05,20.68,2019,70520
103,0,56,159,64.78,0.0,35.22,2019,70631
200,14,71,285,70.18,4.91,24.91,2019,70658
451,30,126,607,74.3,4.94,20.76,2019,70725
5027,163,794,5984,84.01,2.72,13.27,2019,70767
3168,0,553,3721,85.14,0.0,14.86,2019,70818
0,0,0,0,,,,2019,70139
77,0,22,99,77.78,0.0,22.22,2019,70340
55,0,11,66,83.33,0.0,16.67,2019,70352
0,0,0,0,,,,2019,70402
39,0,39,78,50.0,0.0,50.0,2019,70519
0,14,16,30,0.0,46.67,53.33,2019,70575
0,0,0,0,,,,2019,70803
708,62,430,1200,59.0,5.17,35.83,2019,70757
3679,418,729,4826,76.23,8.66,15.11,2019,71006
322,22,291,635,50.71,3.46,45.83,2019,71024
411,55,408,874,47.03,6.29,46.68,2019,71073
1125,35,1604,2764,40.7,1.27,58.03,2019,71075
2040,93,400,2533,80.54,3.67,15.79,2019,71078
972,201,812,1985,48.97,10.13,40.91,2019,71082
743,157,83,983,75.58,15.97,8.44,2019,71110
5727,111,1212,7050,81.23,1.57,17.19,2019,71115
273,0,288,561,48.66,0.0,51.34,2019,71933
423,7,140,570,74.21,1.23,24.56,2019,71973
587,23,248,858,68.41,2.68,28.9,2019,71941
4136,412,1299,5847,70.74,7.05,22.22,2019,71953
100,6,44,150,66.67,4.0,29.33,2019,71972
1252,112,750,2114,59.22,5.3,35.48,2019,71417
782,11,290,1083,72.21,1.02,26.78,2019,71430
231,0,215,446,51.79,0.0,48.21,2019,71450
830,17,264,1111,74.71,1.53,23.76,2019,71465
129,0,45,174,74.14,0.0,25.86,2019,71474
8174,843,3791,12808,63.82,6.58,29.6,2019,71603
5,0,28,33,15.15,0.0,84.85,2019,71659
1624,207,959,2790,58.21,7.42,34.37,2019,71667
92,12,80,184,50.0,6.52,43.48,2019,71676
226,6,394,626,36.1,0.96,62.94,2019,71740
77,3,51,131,58.78,2.29,38.93,2019,71745
3750,293,1788,5831,64.31,5.02,30.66,2019,71753
80,0,56,136,58.82,0.0,41.18,2019,71758
885,107,351,1343,65.9,7.97,26.14,2019,71770
2531,89,1048,3668,69.0,2.43,28.57,2019,71822
2877,82,690,3649,78.84,2.25,18.91,2019,71832
70,0,65,135,51.85,0.0,48.15,2019,71839
656,57,285,998,65.73,5.71,28.56,2019,71846
148,29,50,227,65.2,12.78,22.03,2019,71855
147,0,97,244,60.25,0.0,39.75,2019,71859
40,0,17,57,70.18,0.0,29.82,2019,71922
1987,14,83,2084,95.35,0.67,3.98,2019,60021
12840,214,1049,14103,91.04,1.52,7.44,2019,60031
1565,18,314,1897,82.5,0.95,16.55,2019,60040
2799,79,413,3291,85.05,2.4,12.55,2019,60041
7189,98,318,7605,94.53,1.29,4.18,2019,60045
8991,228,681,9900,90.82,2.3,6.88,2019,60061
112,7,13,132,84.85,5.3,9.85,2019,52595
574,20,130,724,79.28,2.76,17.96,2019,52623
12976,335,1275,14586,88.96,2.3,8.74,2019,52722
642,18,136,796,80.65,2.26,17.09,2019,52747
217,1,24,242,89.67,0.41,9.92,2019,52769
8031,213,2330,10574,75.95,2.01,22.04,2019,52804
258,11,74,343,75.22,3.21,21.57,2019,52620
222,20,47,289,76.82,6.92,16.26,2019,52621
864,41,200,1105,78.19,3.71,18.1,2019,52625
4127,145,813,5085,81.16,2.85,15.99,2019,52627
800,10,147,957,83.59,1.04,15.36,2019,52637
69,8,9,86,80.23,9.3,10.47,2019,52647
251,9,41,301,83.39,2.99,13.62,2019,52650
33,0,26,59,55.93,0.0,44.07,2019,52660
1850,78,414,2342,78.99,3.33,17.68,2019,52730
362,4,43,409,88.51,0.98,10.51,2019,52746
698,12,67,777,89.83,1.54,8.62,2019,52755
216,25,107,348,62.07,7.18,30.75,2019,52766
504,3,104,611,82.49,0.49,17.02,2019,52768
1698,28,366,2092,81.17,1.34,17.5,2019,52772
6839,344,1533,8716,78.46,3.95,17.59,2019,52803
5408,146,976,6530,82.82,2.24,14.95,2019,52807
4451,242,561,5254,84.72,4.61,10.68,2019,52003
138,3,29,170,81.18,1.76,17.06,2019,52030
436,10,103,549,79.42,1.82,18.76,2019,52069
349,3,109,461,75.7,0.65,23.64,2019,52070
733,32,185,950,77.16,3.37,19.47,2019,52076
237,0,51,288,82.29,0.0,17.71,2019,52133
249,0,61,310,80.32,0.0,19.68,2019,52135
390,21,139,550,70.91,3.82,25.27,2019,52155
534,13,67,614,86.97,2.12,10.91,2019,52161
75,4,57,136,55.15,2.94,41.91,2019,52168
161,0,58,219,73.52,0.0,26.48,2019,52170
1092,71,309,1472,74.18,4.82,20.99,2019,52175
1351,9,148,1508,89.59,0.6,9.81,2019,52213
243,2,67,312,77.88,0.64,21.47,2019,52215
602,3,115,720,83.61,0.42,15.97,2019,52218
973,3,76,1052,92.49,0.29,7.22,2019,52227
266,17,32,315,84.44,5.4,10.16,2019,52229
8519,261,624,9404,90.59,2.78,6.64,2019,52245
1368,47,475,1890,72.38,2.49,25.13,2019,52247
68,0,24,92,73.91,0.0,26.09,2019,52257
114,12,28,154,74.03,7.79,18.18,2019,52321
270,11,83,364,74.18,3.02,22.8,2019,52053
2614,97,544,3255,80.31,2.98,16.71,2019,52057
1534,28,114,1676,91.53,1.67,6.8,2019,52068
444,19,60,523,84.89,3.63,11.47,2019,52073
267,0,84,351,76.07,0.0,23.93,2019,52079
265,16,110,391,67.77,4.09,28.13,2019,52154
151,5,52,208,72.6,2.4,25.0,2019,52156
874,113,317,1304,67.02,8.67,24.31,2019,52162
105,2,20,127,82.68,1.57,15.75,2019,52164
277,2,45,324,85.49,0.62,13.89,2019,52165
943,65,251,1259,74.9,5.16,19.94,2019,55767
842,34,254,1130,74.51,3.01,22.48,2019,55769
1277,30,195,1502,85.02,2.0,12.98,2019,55779
518,32,114,664,78.01,4.82,17.17,2019,55797
8995,501,865,10361,86.82,4.84,8.35,2019,55902
451,5,105,561,80.39,0.89,18.72,2019,55909
4564,121,535,5220,87.43,2.32,10.25,2019,53959
4173,98,1027,5298,78.77,1.85,19.38,2019,53963
707,14,102,823,85.91,1.7,12.39,2019,53001
7054,85,483,7622,92.55,1.12,6.34,2019,53005
6576,223,611,7410,88.74,3.01,8.25,2019,53012
2635,73,628,3336,78.99,2.19,18.82,2019,53014
19237,603,1365,21205,90.72,2.84,6.44,2019,53711
8273,427,1347,10047,82.34,4.25,13.41,2019,53545
1327,84,195,1606,82.63,5.23,12.14,2019,53020
7877,289,1075,9241,85.24,3.13,11.63,2019,53027
1567,17,338,1922,81.53,0.88,17.59,2019,53032
891,7,66,964,92.43,0.73,6.85,2019,53044
10,0,43,53,18.87,0.0,81.13,2019,53047
678,35,156,869,78.02,4.03,17.95,2019,53065
251,0,60,311,80.71,0.0,19.29,2019,53069
9828,173,709,10710,91.76,1.62,6.62,2019,53072
616,24,72,712,86.52,3.37,10.11,2019,53078
7610,192,693,8495,89.58,2.26,8.16,2019,53092
5171,58,614,5843,88.5,0.99,10.51,2019,53129
6822,122,590,7534,90.55,1.62,7.83,2019,53149
2549,76,350,2975,85.68,2.55,11.76,2019,53010
1917,22,117,2056,93.24,1.07,5.69,2019,53017
2763,61,374,3198,86.4,1.91,11.69,2019,53040
13757,319,1278,15354,89.6,2.08,8.32,2019,53051
1979,39,342,2360,83.86,1.65,14.49,2019,53080
1886,40,239,2165,87.11,1.85,11.04,2019,53104
3443,122,387,3952,87.12,3.09,9.79,2019,53120
1006,34,207,1247,80.67,2.73,16.6,2019,53156
952,24,175,1151,82.71,2.09,15.2,2019,53178
1232,102,242,1576,78.17,6.47,15.36,2019,53184
0,0,0,0,,,,2019,53192
10824,389,2662,13875,78.01,2.8,19.19,2019,53218
12627,281,3043,15951,79.16,1.76,19.08,2019,53221
8721,301,1847,10869,80.24,2.77,16.99,2019,53227
721,24,107,852,84.62,2.82,12.56,2019,53585
1838,41,315,2194,83.77,1.87,14.36,2019,53594
382,18,126,526,72.62,3.42,23.95,2019,53804
1645,28,313,1986,82.83,1.41,15.76,2019,53807
2633,126,576,3335,78.95,3.78,17.27,2019,53821
1105,69,442,1616,68.38,4.27,27.35,2019,53910
8050,139,1408,9597,83.88,1.45,14.67,2019,53916
35,2,6,43,81.4,4.65,13.95,2019,53928
252,18,113,383,65.8,4.7,29.5,2019,53937
1181,67,401,1649,71.62,4.06,24.32,2019,53946
2120,38,534,2692,78.75,1.41,19.84,2019,53949
2069,74,374,2517,82.2,2.94,14.86,2019,53955
2544,67,233,2844,89.45,2.36,8.19,2019,53181
183,3,74,260,70.38,1.15,28.46,2019,53816
44,0,33,77,57.14,0.0,42.86,2019,53817
7320,339,1320,8979,81.52,3.78,14.7,2019,53913
172,4,34,210,81.9,1.9,16.19,2019,53920
397,23,158,578,68.69,3.98,27.34,2019,53924
1135,18,123,1276,88.95,1.41,9.64,2019,53004
6754,134,873,7761,87.02,1.73,11.25,2019,55350
6143,180,665,6988,87.91,2.58,9.52,2019,55362
5755,51,378,6184,93.06,0.82,6.11,2019,55364
14306,139,930,15375,93.05,0.9,6.05,2019,55369
4822,62,369,5253,91.8,1.18,7.02,2019,55374
13606,390,1115,15111,90.04,2.58,7.38,2019,55379
1462,34,363,1859,78.64,1.83,19.53,2019,49073
1332,38,118,1488,89.52,2.55,7.93,2019,49088
98,0,27,125,78.4,0.0,21.6,2019,49116
27,0,8,35,77.14,0.0,22.86,2019,49119
781,87,221,1089,71.72,7.99,20.29,2019,49125
11742,497,2487,14726,79.74,3.37,16.89,2019,49221
565,63,181,809,69.84,7.79,22.37,2019,49235
3176,78,391,3645,87.13,2.14,10.73,2019,49240
749,51,237,1037,72.23,4.92,22.85,2019,49252
666,29,223,918,72.55,3.16,24.29,2019,49259
167,5,47,219,76.26,2.28,21.46,2019,49965
96,1,30,127,75.59,0.79,23.62,2019,49970
598,25,89,712,83.99,3.51,12.5,2019,49264
1990,48,226,2264,87.9,2.12,9.98,2019,49269
3168,19,368,3555,89.11,0.53,10.35,2019,49323
402,27,119,548,73.36,4.93,21.72,2019,49402
2435,101,511,3047,79.91,3.31,16.77,2019,49404
403,58,129,590,68.31,9.83,21.86,2019,49405
9510,156,1236,10902,87.23,1.43,11.34,2019,49418
3771,217,444,4432,85.09,4.9,10.02,2019,49127
237,21,24,282,84.04,7.45,8.51,2019,49129
13057,358,2013,15428,84.63,2.32,13.05,2019,49201
804,31,189,1024,78.52,3.03,18.46,2019,49220
219,27,69,315,69.52,8.57,21.9,2019,49752
732,33,172,937,78.12,3.52,18.36,2019,49753
536,12,167,715,74.97,1.68,23.36,2019,49759
228,1,102,331,68.88,0.3,30.82,2019,49762
560,32,89,681,82.23,4.7,13.07,2019,49769
3782,238,663,4683,80.76,5.08,14.16,2019,49801
189,7,39,235,80.43,2.98,16.6,2019,49817
266,6,148,420,63.33,1.43,35.24,2019,49827
53,0,31,84,63.1,0.0,36.9,2019,49834
155,0,72,227,68.28,0.0,31.72,2019,49838
449,0,66,515,87.18,0.0,12.82,2019,49876
97,6,22,125,77.6,4.8,17.6,2019,49881
514,16,169,699,73.53,2.29,24.18,2019,49893
99,3,33,135,73.33,2.22,24.44,2019,49901
304,20,137,461,65.94,4.34,29.72,2019,49912
153,10,38,201,76.12,4.98,18.91,2019,49927
66,8,15,89,74.16,8.99,16.85,2019,49929
2509,211,918,3638,68.97,5.8,25.23,2019,49938
677,51,190,918,73.75,5.56,20.7,2019,49968
172,18,22,212,81.13,8.49,10.38,2019,49971
966,9,191,1166,82.85,0.77,16.38,2019,49453
2667,50,256,2973,89.71,1.68,8.61,2019,49460
3504,92,438,4034,86.86,2.28,10.86,2019,49544
604,10,139,753,80.21,1.33,18.46,2019,49616
343,6,101,450,76.22,1.33,22.44,2019,49625
586,35,74,695,84.32,5.04,10.65,2019,49630
12,0,5,17,70.59,0.0,29.41,2019,49634
495,41,164,700,70.71,5.86,23.43,2019,49680
12533,362,1159,14054,89.18,2.58,8.25,2019,49686
461,19,112,592,77.87,3.21,18.92,2019,49689
641,23,66,730,87.81,3.15,9.04,2019,53579
166,9,50,225,73.78,4.0,22.22,2019,53580
2788,44,296,3128,89.13,1.41,9.46,2019,53018
1593,55,219,1867,85.32,2.95,11.73,2019,53021
7081,85,641,7807,90.7,1.09,8.21,2019,53022
1835,32,167,2034,90.22,1.57,8.21,2019,53033
2943,95,369,3407,86.38,2.79,10.83,2019,60069
1358,10,118,1486,91.39,0.67,7.94,2019,60071
5682,45,629,6356,89.4,0.71,9.9,2019,60084
1102,12,51,1165,94.59,1.03,4.38,2019,60088
1393,0,49,1442,96.6,0.0,3.4,2019,60112
14282,315,2259,16856,84.73,1.87,13.4,2019,60123
9902,77,430,10409,95.13,0.74,4.13,2019,60134
10544,158,712,11414,92.38,1.38,6.24,2019,60139
6008,209,175,6392,93.99,3.27,2.74,2019,60140
3898,58,528,4484,86.93,1.29,11.78,2019,60152
8532,67,490,9089,93.87,0.74,5.39,2019,60172
3122,90,1092,4304,72.54,2.09,25.37,2019,60176
6942,102,600,7644,90.82,1.33,7.85,2019,60177
557,0,10,567,98.24,0.0,1.76,2019,60180
9548,134,1047,10729,88.99,1.25,9.76,2019,60181
4075,57,304,4436,91.86,1.28,6.85,2019,60190
1467,8,55,1530,95.88,0.52,3.59,2019,60203
1437,66,178,1681,85.48,3.93,10.59,2019,60301
11624,445,1461,13530,85.91,3.29,10.8,2019,60302
5887,232,273,6392,92.1,3.63,4.27,2019,60304
177,5,29,211,83.89,2.37,13.74,2019,60949
753,13,246,1012,74.41,1.28,24.31,2019,60953
1713,24,391,2128,80.5,1.13,18.37,2019,60957
392,12,77,481,81.5,2.49,16.01,2019,60959
73,12,15,100,73.0,12.0,15.0,2019,60974
517,15,103,635,81.42,2.36,16.22,2019,60966
145,9,12,166,87.35,5.42,7.23,2019,60968
55,0,6,61,90.16,0.0,9.84,2019,57466
227,28,94,349,65.04,8.02,26.93,2019,57472
151,2,14,167,90.42,1.2,8.38,2019,57481
334,6,114,454,73.57,1.32,25.11,2019,57523
53,0,0,53,100.0,0.0,0.0,2019,57537
89,0,27,116,76.72,0.0,23.28,2019,57569
66,0,36,102,64.71,0.0,35.29,2019,57576
34,3,0,37,91.89,8.11,0.0,2019,57634
641,21,166,828,77.42,2.54,20.05,2019,57638
43,0,68,111,38.74,0.0,61.26,2019,57658
24,0,6,30,80.0,0.0,20.0,2019,57660
5571,267,402,6240,89.28,4.28,6.44,2019,57703
832,28,35,895,92.96,3.13,3.91,2019,57706
2503,62,675,3240,77.25,1.91,20.83,2019,57717
747,17,87,851,87.78,2.0,10.22,2019,57744
461,51,99,611,75.45,8.35,16.2,2019,57038
1081,44,246,1371,78.85,3.21,17.94,2019,57039
434,9,47,490,88.57,1.84,9.59,2019,57048
413,5,145,563,73.36,0.89,25.75,2019,57059
3946,155,324,4425,89.18,3.5,7.32,2019,57069
1053,129,103,1285,81.95,10.04,8.02,2019,57071
3815,40,275,4130,92.37,0.97,6.66,2019,57107
8440,147,266,8853,95.33,1.66,3.0,2019,57108
94,12,181,287,32.75,4.18,63.07,2019,57566
200,19,222,441,45.35,4.31,50.34,2019,57579
259,19,118,396,65.4,4.8,29.8,2019,57376
122,3,37,162,75.31,1.85,22.84,2019,66418
283,10,94,387,73.13,2.58,24.29,2019,66449
3578,161,1004,4743,75.44,3.39,21.17,2019,66002
402,11,77,490,82.04,2.24,15.71,2019,66865
1092,36,205,1333,81.92,2.7,15.38,2019,66846
366,2,83,451,81.15,0.44,18.4,2019,66857
385,11,34,430,89.53,2.56,7.91,2019,55925
572,25,124,721,79.33,3.47,17.2,2019,55936
272,10,67,349,77.94,2.87,19.2,2019,55953
82,7,16,105,78.1,6.67,15.24,2019,55973
254,5,82,341,74.49,1.47,24.05,2019,55979
667,22,248,937,71.18,2.35,26.47,2019,55007
1259,5,23,1287,97.82,0.39,1.79,2019,55020
8961,245,1768,10974,81.66,2.23,16.11,2019,55021
1350,60,474,1884,71.66,3.18,25.16,2019,55037
1315,29,113,1457,90.25,1.99,7.76,2019,55043
627,36,130,793,79.07,4.54,16.39,2019,55052
1266,41,115,1422,89.03,2.88,8.09,2019,55055
4344,85,598,5027,86.41,1.69,11.9,2019,55056
2918,63,232,3213,90.82,1.96,7.22,2019,55079
5235,181,325,5741,91.19,3.15,5.66,2019,55436
7196,250,331,7777,92.53,3.21,4.26,2019,55441
7,0,0,7,100.0,0.0,0.0,2019,55450
1389,52,283,1724,80.57,3.02,16.42,2019,55604
68,2,14,84,80.95,2.38,16.67,2019,55607
247,6,79,332,74.4,1.81,23.8,2019,55703
1021,68,300,1389,73.51,4.9,21.6,2019,55705
559,13,124,696,80.32,1.87,17.82,2019,55748
808,34,120,962,83.99,3.53,12.47,2019,55750
143,15,45,203,70.44,7.39,22.17,2019,55752
724,27,176,927,78.1,2.91,18.99,2019,55790
231,14,63,308,75.0,4.55,20.45,2019,55793
6135,163,749,7047,87.06,2.31,10.63,2019,55344
1135,39,180,1354,83.83,2.88,13.29,2019,55353
3130,191,644,3965,78.94,4.82,16.24,2019,55355
839,19,80,938,89.45,2.03,8.53,2019,55360
305,16,58,379,80.47,4.22,15.3,2019,55367
223,6,49,278,80.22,2.16,17.63,2019,55370
11265,210,651,12126,92.9,1.73,5.37,2019,55372
1245,50,154,1449,85.92,3.45,10.63,2019,55382
1871,116,192,2179,85.87,5.32,8.81,2019,55388
783,30,206,1019,76.84,2.94,20.22,2019,55389
13372,322,1656,15350,87.11,2.1,10.79,2019,55408
12957,393,1915,15265,84.88,2.57,12.55,2019,55423
6838,291,829,7958,85.93,3.66,10.42,2019,55431
8117,139,340,8596,94.43,1.62,3.96,2019,55447
352,27,98,477,73.79,5.66,20.55,2019,55713
9482,227,865,10574,89.67,2.15,8.18,2019,55448
244,23,5,272,89.71,8.46,1.84,2019,55612
102,3,46,151,67.55,1.99,30.46,2019,55716
5117,176,1431,6724,76.1,2.62,21.28,2019,55720
305,31,153,489,62.37,6.34,31.29,2019,55722
758,17,201,976,77.66,1.74,20.59,2019,55723
77,0,7,84,91.67,0.0,8.33,2019,55725
2428,39,437,2904,83.61,1.34,15.05,2019,55731
469,14,150,633,74.09,2.21,23.7,2019,55775
36,7,28,71,50.7,9.86,39.44,2019,55780
279,5,56,340,82.06,1.47,16.47,2019,55781
146,6,34,186,78.49,3.23,18.28,2019,55782
463,8,110,581,79.69,1.38,18.93,2019,64439
1495,99,297,1891,79.06,5.24,15.71,2019,64465
654,37,175,866,75.52,4.27,20.21,2019,64469
17,0,9,26,65.38,0.0,34.62,2019,64496
112,0,58,170,65.88,0.0,34.12,2019,64652
78,0,25,103,75.73,0.0,24.27,2019,64655
848,63,187,1098,77.23,5.74,17.03,2019,55384
409,1,98,508,80.51,0.2,19.29,2019,55030
1873,18,188,2079,90.09,0.87,9.04,2019,55071
1005,8,43,1056,95.17,0.76,4.07,2019,55341
7675,194,238,8107,94.67,2.39,2.94,2019,55317
2314,146,486,2946,78.55,4.96,16.5,2019,55336
994,28,143,1165,85.32,2.4,12.27,2019,55357
2080,25,139,2244,92.69,1.11,6.19,2019,55359
1458,4,54,1516,96.17,0.26,3.56,2019,55375
4779,185,411,5375,88.91,3.44,7.65,2019,55376
361,27,20,408,88.48,6.62,4.9,2019,55402
12482,549,1889,14920,83.66,3.68,12.66,2019,55407
9200,2070,760,12030,76.48,17.21,6.32,2019,55414
8075,368,1443,9886,81.68,3.72,14.6,2019,55429
5798,290,984,7072,81.99,4.1,13.91,2019,55435
6662,185,283,7130,93.44,2.59,3.97,2019,55438
3238,105,151,3494,92.67,3.01,4.32,2019,55439
6819,150,642,7611,89.59,1.97,8.44,2019,55906
1795,68,267,2130,84.27,3.19,12.54,2019,55963
35,2,23,60,58.33,3.33,38.33,2019,55950
488,15,150,653,74.73,2.3,22.97,2019,55951
791,17,153,961,82.31,1.77,15.92,2019,55952
1120,20,119,1259,88.96,1.59,9.45,2019,55960
595,29,106,730,81.51,3.97,14.52,2019,55985
263,15,100,378,69.58,3.97,26.46,2019,55990
366,6,25,397,92.19,1.51,6.3,2019,55969
3626,248,955,4829,75.09,5.14,19.78,2019,55805
937,35,170,1142,82.05,3.06,14.89,2019,55971
337,12,72,421,80.05,2.85,17.1,2019,55941
4288,156,381,4825,88.87,3.23,7.9,2019,55387
9502,731,1077,11310,84.01,6.46,9.52,2019,55403
1713,41,102,1856,92.3,2.21,5.5,2019,55315
2920,61,331,3312,88.16,1.84,9.99,2019,55352
881,12,191,1084,81.27,1.11,17.62,2019,55354
589,20,52,661,89.11,3.03,7.87,2019,55084
27,0,6,33,81.82,0.0,18.18,2019,55029
738,0,0,738,100.0,0.0,0.0,2019,55054
13,8,4,25,52.0,32.0,16.0,2019,55111
4376,142,1018,5536,79.05,2.57,18.39,2019,55130
0,0,0,0,,,,2019,55155
178,9,34,221,80.54,4.07,15.38,2019,55366
7,0,1,8,87.5,0.0,12.5,2019,55766
24,2,7,33,72.73,6.06,21.21,2019,55772
0,0,0,0,,,,2019,55814
0,0,0,0,,,,2019,55905
40,0,4,44,90.91,0.0,9.09,2019,55968
2573,54,418,3045,84.5,1.77,13.73,2019,55302
11300,262,1681,13243,85.33,1.98,12.69,2019,55418
10646,481,1573,12700,83.83,3.79,12.39,2019,55422
10744,276,1123,12143,88.48,2.27,9.25,2019,55432
4502,86,435,5023,89.63,1.71,8.66,2019,55444
2726,86,481,3293,82.78,2.61,14.61,2019,55616
202,0,29,231,87.45,0.0,12.55,2019,55702
35,0,18,53,66.04,0.0,33.96,2019,64458
455,6,186,647,70.32,0.93,28.75,2019,64473
105,0,31,136,77.21,0.0,22.79,2019,64476
674,30,194,898,75.06,3.34,21.6,2019,64491
4080,103,878,5061,80.62,2.04,17.35,2019,64507
108,7,35,150,72.0,4.67,23.33,2019,64623
1404,20,264,1688,83.18,1.18,15.64,2019,53039
2310,64,431,2805,82.35,2.28,15.37,2019,53050
1208,9,135,1352,89.35,0.67,9.99,2019,53075
498,23,92,613,81.24,3.75,15.01,2019,53079
7520,168,944,8632,87.12,1.95,10.94,2019,53090
6397,149,986,7532,84.93,1.98,13.09,2019,53094
2749,51,273,3073,89.46,1.66,8.88,2019,53128
853,33,119,1005,84.88,3.28,11.84,2019,53139
7311,191,1344,8846,82.65,2.16,15.19,2019,53143
13172,421,1121,14714,89.52,2.86,7.62,2019,53154
1029,2,220,1251,82.25,0.16,17.59,2019,53191
9876,277,1267,11420,86.48,2.43,11.09,2019,53213
9813,373,2985,13171,74.5,2.83,22.66,2019,53216
9576,480,2285,12341,77.6,3.89,18.52,2019,53223
7086,229,933,8248,85.91,2.78,11.31,2019,53226
3729,163,811,4703,79.29,3.47,17.24,2019,53235
830,35,132,997,83.25,3.51,13.24,2019,53515
1400,44,370,1814,77.18,2.43,20.4,2019,53530
5082,340,546,5968,85.15,5.7,9.15,2019,53532
5928,248,1205,7381,80.31,3.36,16.33,2019,53538
74,3,23,100,74.0,3.0,23.0,2019,53540
1149,45,160,1354,84.86,3.32,11.82,2019,54015
11161,287,1023,12471,89.5,2.3,8.2,2019,54016
1315,53,155,1523,86.34,3.48,10.18,2019,54023
1644,74,356,2074,79.27,3.57,17.16,2019,54024
1433,32,455,1920,74.64,1.67,23.7,2019,54612
418,17,86,521,80.23,3.26,16.51,2019,54621
76,0,22,98,77.55,0.0,22.45,2019,54637
343,22,171,536,63.99,4.1,31.9,2019,54651
112,12,55,179,62.57,6.7,30.73,2019,54967
113,0,22,135,83.7,0.0,16.3,2019,54844
389,12,107,508,76.57,2.36,21.06,2019,54875
8656,255,1429,10340,83.71,2.47,13.82,2019,54911
2893,168,793,3854,75.06,4.36,20.58,2019,54923
2953,74,816,3843,76.84,1.93,21.23,2019,54929
144,0,9,153,94.12,0.0,5.88,2019,54934
629,16,226,871,72.22,1.84,25.95,2019,54943
309,6,53,368,83.97,1.63,14.4,2019,54964
608,23,125,756,80.42,3.04,16.53,2019,54966
2581,80,614,3275,78.81,2.44,18.75,2019,54001
324,13,96,433,74.83,3.0,22.17,2019,54007
2466,83,359,2908,84.8,2.85,12.35,2019,54020
784,11,149,944,83.05,1.17,15.78,2019,54028
389,5,150,544,71.51,0.92,27.57,2019,54104
1520,49,438,2007,75.73,2.44,21.82,2019,54106
816,6,150,972,83.95,0.62,15.43,2019,54111
1885,47,524,2456,76.75,1.91,21.34,2019,54114
15883,368,1344,17595,90.27,2.09,7.64,2019,54115
996,11,263,1270,78.43,0.87,20.71,2019,54129
363,14,101,478,75.94,2.93,21.13,2019,54138
1774,64,491,2329,76.17,2.75,21.08,2019,54154
2154,59,239,2452,87.85,2.41,9.75,2019,54157
5709,191,1357,7257,78.67,2.63,18.7,2019,54166
361,31,106,498,72.49,6.22,21.29,2019,56137
158,4,20,182,86.81,2.2,10.99,2019,56158
111,11,19,141,78.72,7.8,13.48,2019,56161
1018,59,200,1277,79.72,4.62,15.66,2019,56175
238,14,38,290,82.07,4.83,13.1,2019,56221
623,6,107,736,84.65,0.82,14.54,2019,56229
12,0,7,19,63.16,0.0,36.84,2019,66863
98,0,10,108,90.74,0.0,9.26,2019,66958
109,3,24,136,80.15,2.21,17.65,2019,66962
218,7,89,314,69.43,2.23,28.34,2019,66966
99,23,57,179,55.31,12.85,31.84,2019,66091
7953,303,727,8983,88.53,3.37,8.09,2019,66109
7150,261,667,8078,88.51,3.23,8.26,2019,66202
8153,129,300,8582,95.0,1.5,3.5,2019,66210
213,19,74,306,69.61,6.21,24.18,2019,66949
850,9,274,1133,75.02,0.79,24.18,2019,66748
2479,103,704,3286,75.44,3.13,21.42,2019,66749
213,6,71,290,73.45,2.07,24.48,2019,66751
115,0,47,162,70.99,0.0,29.01,2019,66769
32,0,34,66,48.48,0.0,51.52,2019,66843
254,3,59,316,80.38,0.95,18.67,2019,66854
969,7,321,1297,74.71,0.54,24.75,2019,66861
835,21,283,1139,73.31,1.84,24.85,2019,66935
151,26,19,196,77.04,13.27,9.69,2019,66948
247,5,38,290,85.17,1.72,13.1,2019,66951
174,4,70,248,70.16,1.61,28.23,2019,66953
53,1,10,64,82.81,1.56,15.62,2019,66960
77,1,7,85,90.59,1.18,8.24,2019,66963
776,16,129,921,84.26,1.74,14.01,2019,66967
8256,447,1361,10064,82.03,4.44,13.52,2019,66441
3483,63,235,3781,92.12,1.67,6.22,2019,66442
696,63,191,950,73.26,6.63,20.11,2019,66524
359,105,124,588,61.05,17.86,21.09,2019,66533
758,96,109,963,78.71,9.97,11.32,2019,66539
157,1,29,187,83.96,0.53,15.51,2019,66550
2178,219,586,2983,73.01,7.34,19.64,2019,66609
3416,191,277,3884,87.95,4.92,7.13,2019,66610
3588,53,1060,4701,76.32,1.13,22.55,2019,66701
1174,58,351,1583,74.16,3.66,22.17,2019,66743
246,21,108,375,65.6,5.6,28.8,2019,66755
388,9,64,461,84.16,1.95,13.88,2019,66507
93,2,28,123,75.61,1.63,22.76,2019,66516
1197,20,327,1544,77.53,1.3,21.18,2019,66523
239,18,41,298,80.2,6.04,13.76,2019,66532
939,34,145,1118,83.99,3.04,12.97,2019,66536
330,7,83,420,78.57,1.67,19.76,2019,66537
1609,68,748,2425,66.35,2.8,30.85,2019,66616
175,4,69,248,70.56,1.61,27.82,2019,66711
176,16,38,230,76.52,6.96,16.52,2019,66039
103,0,36,139,74.1,0.0,25.9,2019,66014
106,0,28,134,79.1,0.0,20.9,2019,66016
404,5,125,534,75.66,0.94,23.41,2019,66020
175,27,83,285,61.4,9.47,29.12,2019,66042
9418,453,976,10847,86.83,4.18,9.0,2019,66044
643,59,129,831,77.38,7.1,15.52,2019,66050
85,1,27,113,75.22,0.88,23.89,2019,66058
3791,467,925,5183,73.14,9.01,17.85,2019,66071
268,13,49,330,81.21,3.94,14.85,2019,66079
3167,47,520,3734,84.82,1.26,13.93,2019,66111
85,0,8,93,91.4,0.0,8.6,2019,67071
79,5,19,103,76.7,4.85,18.45,2019,67111
37,0,11,48,77.08,0.0,22.92,2019,67159
614,158,325,1097,55.97,14.4,29.63,2019,67202
9831,312,2548,12691,77.46,2.46,20.08,2019,67203
6122,342,820,7284,84.05,4.7,11.26,2019,67208
1001,32,299,1332,75.15,2.4,22.45,2019,64658
131,1,36,168,77.98,0.6,21.43,2019,64664
593,2,189,784,75.64,0.26,24.11,2019,64671
45,2,5,52,86.54,3.85,9.62,2019,64681
2445,16,690,3151,77.59,0.51,21.9,2019,64683
238,13,87,338,70.41,3.85,25.74,2019,64723
307,13,39,359,85.52,3.62,10.86,2019,64739
76,5,24,105,72.38,4.76,22.86,2019,64743
151,0,45,196,77.04,0.0,22.96,2019,64780
231,10,101,342,67.54,2.92,29.53,2019,64783
367,39,79,485,75.67,8.04,16.29,2019,64784
1030,120,430,1580,65.19,7.59,27.22,2019,64856
10069,202,1309,11580,86.95,1.74,11.3,2019,64015
206,2,42,250,82.4,0.8,16.8,2019,64021
75,2,30,107,70.09,1.87,28.04,2019,64036
1714,68,512,2294,74.72,2.96,22.32,2019,64037
6619,307,2281,9207,71.89,3.33,24.77,2019,64050
7225,155,1610,8990,80.37,1.72,17.91,2019,64052
12108,219,2201,14528,83.34,1.51,15.15,2019,64055
4573,77,467,5117,89.37,1.5,9.13,2019,64060
4063,79,595,4737,85.77,1.67,12.56,2019,64080
2439,143,825,3407,71.59,4.2,24.21,2019,64085
1050,27,223,1300,80.77,2.08,17.15,2019,64098
3337,539,444,4320,77.25,12.48,10.28,2019,64106
5401,416,1183,7000,77.16,5.94,16.9,2019,64110
8078,963,1043,10084,80.11,9.55,10.34,2019,64111
6028,701,783,7512,80.24,9.33,10.42,2019,64116
14617,634,1504,16755,87.24,3.78,8.98,2019,64118
2863,222,1128,4213,67.96,5.27,26.77,2019,64124
128,0,23,151,84.77,0.0,15.23,2019,64149
2197,24,181,2402,91.47,1.0,7.54,2019,64153
58,0,23,81,71.6,0.0,28.4,2019,64453
269,7,40,316,85.13,2.22,12.66,2019,64423
292,2,57,351,83.19,0.57,16.24,2019,64430
113,2,25,140,80.71,1.43,17.86,2019,64431
721,38,234,993,72.61,3.83,23.56,2019,64454
474,11,143,628,75.48,1.75,22.77,2019,64463
269,9,76,354,75.99,2.54,21.47,2019,64481
2356,176,548,3080,76.49,5.71,17.79,2019,64485
635,20,72,727,87.35,2.75,9.9,2019,64492
267,10,81,358,74.58,2.79,22.63,2019,64494
226,5,54,285,79.3,1.75,18.95,2019,64074
4300,96,386,4782,89.92,2.01,8.07,2019,64089
15,0,0,15,100.0,0.0,0.0,2019,64101
3595,458,363,4416,81.41,10.37,8.22,2019,64108
125,2,39,166,75.3,1.2,23.49,2019,64120
12298,576,1948,14822,82.97,3.89,13.14,2019,64133
719,0,28,747,96.25,0.0,3.75,2019,64146
10189,142,426,10757,94.72,1.32,3.96,2019,64152
8099,251,372,8722,92.86,2.88,4.27,2019,64155
1788,113,14,1915,93.37,5.9,0.73,2019,64158
167,12,61,240,69.58,5.0,25.42,2019,64437
201,14,67,282,71.28,4.96,23.76,2019,64440
49,2,57,108,45.37,1.85,52.78,2019,50473
507,17,126,650,78.0,2.62,19.38,2019,50475
385,10,58,453,84.99,2.21,12.8,2019,50510
44,7,2,53,83.02,13.21,3.77,2019,50520
109,0,21,130,83.85,0.0,16.15,2019,50528
343,5,99,447,76.73,1.12,22.15,2019,50530
131,10,36,177,74.01,5.65,20.34,2019,64632
160,14,48,222,72.07,6.31,21.62,2019,64637
185,13,90,288,64.24,4.51,31.25,2019,64653
25,0,38,63,39.68,0.0,60.32,2019,64672
128,8,46,182,70.33,4.4,25.27,2019,64674
48,5,21,74,64.86,6.76,28.38,2019,64676
209,0,31,240,87.08,0.0,12.92,2019,64689
4279,266,991,5536,77.29,4.8,17.9,2019,64701
1930,97,724,2751,70.16,3.53,26.32,2019,64730
348,23,74,445,78.2,5.17,16.63,2019,64733
383,34,144,561,68.27,6.06,25.67,2019,64746
195,0,94,289,67.47,0.0,32.53,2019,64756
53,5,6,64,82.81,7.81,9.38,2019,64849
648,85,736,1469,44.11,5.79,50.1,2019,64854
121,36,201,358,33.8,10.06,56.15,2019,64861
1128,72,265,1465,77.0,4.91,18.09,2019,64747
107,2,58,167,64.07,1.2,34.73,2019,64750
199,25,67,291,68.38,8.59,23.02,2019,64752
404,20,92,516,78.29,3.88,17.83,2019,64761
304,0,16,320,95.0,0.0,5.0,2019,64767
638,49,306,993,64.25,4.93,30.82,2019,64779
11627,477,1920,14024,82.91,3.4,13.69,2019,64804
591,47,125,763,77.46,6.16,16.38,2019,64835
76,14,103,193,39.38,7.25,53.37,2019,64847
56,0,0,56,100.0,0.0,0.0,2019,64858
259,23,295,577,44.89,3.99,51.13,2019,64863
1613,114,561,2288,70.5,4.98,24.52,2019,64865
74,0,13,87,85.06,0.0,14.94,2019,64639
197,6,70,273,72.16,2.2,25.64,2019,64641
400,22,274,696,57.47,3.16,39.37,2019,64648
200,2,70,272,73.53,0.74,25.74,2019,64649
141,4,12,157,89.81,2.55,7.64,2019,64657
313,13,65,391,80.05,3.32,16.62,2019,64659
60,4,55,119,50.42,3.36,46.22,2019,64682
179,1,34,214,83.64,0.47,15.89,2019,64728
607,56,201,864,70.25,6.48,23.26,2019,64740
129,6,55,190,67.89,3.16,28.95,2019,64771
6031,149,422,6602,91.35,2.26,6.39,2019,64029
4629,206,850,5685,81.42,3.62,14.95,2019,64735
1333,337,563,2233,59.7,15.09,25.21,2019,64831
6452,400,1746,8598,75.04,4.65,20.31,2019,64836
150,13,35,198,75.76,6.57,17.68,2019,64841
833,68,438,1339,62.21,5.08,32.71,2019,64843
316,2,89,407,77.64,0.49,21.87,2019,64866
422,0,211,633,66.67,0.0,33.33,2019,64084
931,41,377,1349,69.01,3.04,27.95,2019,64054
3280,202,1449,4931,66.52,4.1,29.39,2019,64128
15,0,18,33,45.45,0.0,54.55,2019,64499
54,7,23,84,64.29,8.33,27.38,2019,64686
117,10,11,138,84.78,7.25,7.97,2019,64161
4676,218,822,5716,81.81,3.81,14.38,2019,64117
325,15,77,417,77.94,3.6,18.47,2019,64448
118,2,13,133,88.72,1.5,9.77,2019,64497
544,8,85,637,85.4,1.26,13.34,2019,49342
4364,36,868,5268,82.84,0.68,16.48,2019,49345
402,17,48,467,86.08,3.64,10.28,2019,49347
791,29,140,960,82.4,3.02,14.58,2019,49403
2762,82,887,3731,74.03,2.2,23.77,2019,49408
499,72,200,771,64.72,9.34,25.94,2019,49410
1380,139,364,1883,73.29,7.38,19.33,2019,49749
958,21,239,1218,78.65,1.72,19.62,2019,49332
555,29,196,780,71.15,3.72,25.13,2019,49338
458,9,159,626,73.16,1.44,25.4,2019,49411
1529,101,692,2322,65.85,4.35,29.8,2019,49421
1094,20,149,1263,86.62,1.58,11.8,2019,49435
322,69,219,610,52.79,11.31,35.9,2019,49440
7706,253,2079,10038,76.77,2.52,20.71,2019,49444
1142,91,265,1498,76.23,6.07,17.69,2019,49448
1324,48,449,1821,72.71,2.64,24.66,2019,49455
8986,268,1023,10277,87.44,2.61,9.95,2019,49464
13053,793,1926,15772,82.76,5.03,12.21,2019,49503
256,12,26,294,87.07,4.08,8.84,2019,49782
125,0,10,135,92.59,0.0,7.41,2019,49791
1249,19,244,1512,82.61,1.26,16.14,2019,49807
7349,74,1013,8436,87.11,0.88,12.01,2019,49002
572,25,277,874,65.45,2.86,31.69,2019,49030
629,18,76,723,87.0,2.49,10.51,2019,49033
728,22,197,947,76.87,2.32,20.8,2019,49051
1694,33,488,2215,76.48,1.49,22.03,2019,49057
5195,113,1063,6371,81.54,1.77,16.68,2019,49068
2963,109,657,3729,79.46,2.92,17.62,2019,49078
488,11,148,647,75.43,1.7,22.87,2019,49089
576,20,187,783,73.56,2.55,23.88,2019,49092
36,4,20,60,60.0,6.67,33.33,2019,49289
262,3,74,339,77.29,0.88,21.83,2019,49276
1092,19,278,1389,78.62,1.37,20.01,2019,49277
1826,71,235,2132,85.65,3.33,11.02,2019,49285
676,32,256,964,70.12,3.32,26.56,2019,49305
615,4,76,695,88.49,0.58,10.94,2019,49325
848,141,237,1226,69.17,11.5,19.33,2019,49911
2077,135,525,2737,75.89,4.93,19.18,2019,49913
142,2,28,172,82.56,1.16,16.28,2019,49915
31,0,8,39,79.49,0.0,20.51,2019,49952
26,3,17,46,56.52,6.52,36.96,2019,49961
81,6,25,112,72.32,5.36,22.32,2019,49962
1333,51,203,1587,83.99,3.21,12.79,2019,49267
380,14,89,483,78.67,2.9,18.43,2019,49268
1779,96,248,2123,83.8,4.52,11.68,2019,49270
865,58,246,1169,73.99,4.96,21.04,2019,49284
975,80,492,1547,63.03,5.17,31.8,2019,49304
3588,64,269,3921,91.51,1.63,6.86,2019,49306
5728,381,975,7084,80.86,5.38,13.76,2019,49307
455,12,267,734,61.99,1.63,36.38,2019,49309
691,48,317,1056,65.44,4.55,30.02,2019,49310
82,7,49,138,59.42,5.07,35.51,2019,49312
6070,171,581,6822,88.98,2.51,8.52,2019,49321
2256,54,745,3055,73.85,1.77,24.39,2019,49329
363,6,34,403,90.07,1.49,8.44,2019,49406
11439,209,865,12513,91.42,1.67,6.91,2019,49426
10569,145,877,11591,91.18,1.25,7.57,2019,49525
11243,479,3524,15246,73.74,3.14,23.11,2019,49442
796,61,110,967,82.32,6.31,11.38,2019,49446
1165,17,131,1313,88.73,1.29,9.98,2019,54180
1607,44,537,2188,73.45,2.01,24.54,2019,54201
645,14,123,782,82.48,1.79,15.73,2019,54205
56,0,4,60,93.33,0.0,6.67,2019,54207
451,22,15,488,92.42,4.51,3.07,2019,54212
2242,54,564,2860,78.39,1.89,19.72,2019,54217
3275,432,2330,6037,54.25,7.16,38.6,2019,67214
137,0,0,137,100.0,0.0,0.0,2019,67341
821,33,241,1095,74.98,3.01,22.01,2019,67356
598,25,191,814,73.46,3.07,23.46,2019,67547
1576,63,502,2141,73.61,2.94,23.45,2019,67550
417,40,128,585,71.28,6.84,21.88,2019,67422
1349,74,268,1691,79.78,4.38,15.85,2019,67554
52,4,32,88,59.09,4.55,36.36,2019,67573
43,0,2,45,95.56,0.0,4.44,2019,67628
62,1,0,63,98.41,1.59,0.0,2019,67629
91,0,24,115,79.13,0.0,20.87,2019,67632
72,3,6,81,88.89,3.7,7.41,2019,67634
77,0,62,139,55.4,0.0,44.6,2019,67638
651,14,198,863,75.43,1.62,22.94,2019,67642
277,0,55,332,83.43,0.0,16.57,2019,67646
168,1,27,196,85.71,0.51,13.78,2019,67653
41,0,0,41,100.0,0.0,0.0,2019,67656
100,3,18,121,82.64,2.48,14.88,2019,67625
896,43,170,1109,80.79,3.88,15.33,2019,67637
95,0,10,105,90.48,0.0,9.52,2019,67647
189,0,69,258,73.26,0.0,26.74,2019,67648
56,1,7,64,87.5,1.56,10.94,2019,67667
52,0,36,88,59.09,0.0,40.91,2019,67675
685,5,100,790,86.71,0.63,12.66,2019,67730
88,4,9,101,87.13,3.96,8.91,2019,67736
188,9,62,259,72.59,3.47,23.94,2019,67738
47,0,24,71,66.2,0.0,33.8,2019,67744
102,2,26,130,78.46,1.54,20.0,2019,67751
71,0,8,79,89.87,0.0,10.13,2019,67762
214,3,23,240,89.17,1.25,9.58,2019,67853
73,3,24,100,73.0,3.0,24.0,2019,67862
102,0,26,128,79.69,0.0,20.31,2019,67863
625,7,142,774,80.75,0.9,18.35,2019,67877
1192,58,383,1633,72.99,3.55,23.45,2019,67951
154,0,32,186,82.8,0.0,17.2,2019,67151
6576,178,1244,7998,82.22,2.23,15.55,2019,67204
5653,176,2359,8188,69.04,2.15,28.81,2019,67211
9636,241,1663,11540,83.5,2.09,14.41,2019,67217
7330,441,1768,9539,76.84,4.62,18.53,2019,67218
4335,53,110,4498,96.38,1.18,2.45,2019,67235
1063,13,338,1414,75.18,0.92,23.9,2019,67335
408,25,216,649,62.87,3.85,33.28,2019,67336
40,20,9,69,57.97,28.99,13.04,2019,67418
618,49,160,827,74.73,5.93,19.35,2019,67431
422,11,86,519,81.31,2.12,16.57,2019,67879
42,1,12,55,76.36,1.82,21.82,2019,67836
781,24,66,871,89.67,2.76,7.58,2019,67851
451,21,173,645,69.92,3.26,26.82,2019,67855
574,6,165,745,77.05,0.81,22.15,2019,67864
125,7,10,142,88.03,4.93,7.04,2019,67485
66,5,11,82,80.49,6.1,13.41,2019,67492
7552,389,1836,9777,77.24,3.98,18.78,2019,67501
26,0,13,39,66.67,0.0,33.33,2019,67513
5152,221,3284,8657,59.51,2.55,37.93,2019,71202
1948,91,496,2535,76.84,3.59,19.57,2019,71225
478,7,299,784,60.97,0.89,38.14,2019,71226
1201,270,1201,2672,44.95,10.1,44.95,2019,71232
1379,18,253,1650,83.58,1.09,15.33,2019,71245
38,0,66,104,36.54,0.0,63.46,2019,71250
172,7,38,217,79.26,3.23,17.51,2019,50539
42,0,22,64,65.62,0.0,34.38,2019,50117
161,7,38,206,78.16,3.4,18.45,2019,50141
1007,62,185,1254,80.3,4.94,14.75,2019,50212
378,11,93,482,78.42,2.28,19.29,2019,50680
228,5,15,248,91.94,2.02,6.05,2019,50167
825,34,221,1080,76.39,3.15,20.46,2019,50144
277,4,133,414,66.91,0.97,32.13,2019,50157
639,22,80,741,86.23,2.97,10.8,2019,50161
2728,88,789,3605,75.67,2.44,21.89,2019,50220
7,0,3,10,70.0,0.0,30.0,2019,50227
943,19,79,1041,90.59,1.83,7.59,2019,50228
15,0,16,31,48.39,0.0,51.61,2019,50239
169,10,46,225,75.11,4.44,20.44,2019,50242
703,8,50,761,92.38,1.05,6.57,2019,50244
293,11,85,389,75.32,2.83,21.85,2019,50257
721,48,161,930,77.53,5.16,17.31,2019,50250
4066,330,1302,5698,71.36,5.79,22.85,2019,50316
99,0,53,152,65.13,0.0,34.87,2019,50460
124,4,30,158,78.48,2.53,18.99,2019,50544
4570,142,167,4879,93.67,2.91,3.42,2019,50323
91,0,28,119,76.47,0.0,23.53,2019,50433
194,2,28,224,86.61,0.89,12.5,2019,50464
187,10,39,236,79.24,4.24,16.53,2019,50523
814,23,157,994,81.89,2.31,15.79,2019,50574
97,0,7,104,93.27,0.0,6.73,2019,50521
277,7,46,330,83.94,2.12,13.94,2019,50557
513,7,142,662,77.49,1.06,21.45,2019,50621
826,23,165,1014,81.46,2.27,16.27,2019,50658
832,54,221,1107,75.16,4.88,19.96,2019,50841
100,21,22,143,69.93,14.69,15.38,2019,50848
4,1,0,5,80.0,20.0,0.0,2019,50033
149,4,37,190,78.42,2.11,19.47,2019,50108
199,3,52,254,78.35,1.18,20.47,2019,50151
0,0,0,0,,,,2019,50011
3,5,0,8,37.5,62.5,0.0,2019,50012
12667,536,708,13911,91.06,3.85,5.09,2019,50023
0,0,0,0,,,,2019,50127
252,0,122,374,67.38,0.0,32.62,2019,50163
25,0,4,29,86.21,0.0,13.79,2019,50255
0,0,0,0,,,,2019,50319
1747,89,307,2143,81.52,4.15,14.33,2019,50324
3729,88,371,4188,89.04,2.1,8.86,2019,50327
32,0,4,36,88.89,0.0,11.11,2019,50467
13,0,6,19,68.42,0.0,31.58,2019,50620
17,0,0,17,100.0,0.0,0.0,2019,50664
10,1,13,24,41.67,4.17,54.17,2019,50839
28,5,4,37,75.68,13.51,10.81,2019,50842
571,5,52,628,90.92,0.8,8.28,2019,50046
438,6,132,576,76.04,1.04,22.92,2019,50070
391,15,138,544,71.88,2.76,25.37,2019,50174
485,16,164,665,72.93,2.41,24.66,2019,50028
489,5,67,561,87.17,0.89,11.94,2019,50130
368,6,72,446,82.51,1.35,16.14,2019,52209
131,0,16,147,89.12,0.0,10.88,2019,52220
100,0,9,109,91.74,0.0,8.26,2019,52221
258,8,72,338,76.33,2.37,21.3,2019,52235
1885,164,401,2450,76.94,6.69,16.37,2019,52531
421,2,181,604,69.7,0.33,29.97,2019,52540
15894,320,1683,17897,88.81,1.79,9.4,2019,49424
6,0,0,6,100.0,0.0,0.0,2019,49434
2122,114,503,2739,77.47,4.16,18.36,2019,49437
12422,368,2331,15121,82.15,2.43,15.42,2019,49441
619,11,113,743,83.31,1.48,15.21,2019,49452
1983,24,400,2407,82.38,1.0,16.62,2019,49099
502,29,36,567,88.54,5.11,6.35,2019,49102
513,0,88,601,85.36,0.0,14.64,2019,49130
920,26,178,1124,81.85,2.31,15.84,2019,49237
524,39,172,735,71.29,5.31,23.4,2019,49271
4237,241,1200,5678,74.62,4.24,21.13,2019,49858
1353,24,350,1727,78.34,1.39,20.27,2019,49868
37,0,13,50,74.0,0.0,26.0,2019,49873
337,17,121,475,70.95,3.58,25.47,2019,49880
459,22,121,602,76.25,3.65,20.1,2019,49896
62,0,20,82,75.61,0.0,24.39,2019,49917
136,0,18,154,88.31,0.0,11.69,2019,49921
2551,198,468,3217,79.3,6.15,14.55,2019,49931
102,9,21,132,77.27,6.82,15.91,2019,49942
1274,23,316,1613,78.98,1.43,19.59,2019,49946
117,15,17,149,78.52,10.07,11.41,2019,49955
261,0,83,344,75.87,0.0,24.13,2019,49958
2552,82,775,3409,74.86,2.41,22.73,2019,49646
1021,1,88,1110,91.98,0.09,7.93,2019,49650
316,22,59,397,79.6,5.54,14.86,2019,49675
833,66,262,1161,71.75,5.68,22.57,2019,49953
43,1,24,68,63.24,1.47,35.29,2019,49960
389,61,154,604,64.4,10.1,25.5,2019,49969
141,11,29,181,77.9,6.08,16.02,2019,49768
464,22,163,649,71.49,3.39,25.12,2019,49780
909,8,100,1017,89.38,0.79,9.83,2019,49272
269,30,62,361,74.52,8.31,17.17,2019,49279
132,0,9,141,93.62,0.0,6.38,2019,49282
373,12,157,542,68.82,2.21,28.97,2019,49288
7479,119,722,8320,89.89,1.43,8.68,2019,49315
1114,25,355,1494,74.56,1.67,23.76,2019,49336
601,30,175,806,74.57,3.72,21.71,2019,49339
1123,12,230,1365,82.27,0.88,16.85,2019,49344
16210,772,1457,18439,87.91,4.19,7.9,2019,49009
6695,84,1413,8192,81.73,1.03,17.25,2019,49014
472,9,119,600,78.67,1.5,19.83,2019,49029
853,29,127,1009,84.54,2.87,12.59,2019,49034
39,2,29,70,55.71,2.86,41.43,2019,49822
77,0,35,112,68.75,0.0,31.25,2019,49833
2446,82,390,2918,83.82,2.81,13.37,2019,49841
365,14,69,448,81.47,3.12,15.4,2019,49847
8616,1124,626,10366,83.12,10.84,6.04,2019,49006
10325,326,1371,12022,85.88,2.71,11.4,2019,49548
297,22,89,408,72.79,5.39,21.81,2019,49619
72,0,18,90,80.0,0.0,20.0,2019,49627
846,64,104,1014,83.43,6.31,10.26,2019,49648
183,9,35,227,80.62,3.96,15.42,2019,49667
722,36,198,956,75.52,3.77,20.71,2019,49688
780,13,101,894,87.25,1.45,11.3,2019,53011
1089,27,215,1331,81.82,2.03,16.15,2019,53013
880,22,142,1044,84.29,2.11,13.6,2019,53015
634,6,71,711,89.17,0.84,9.99,2019,53034
424,22,58,504,84.13,4.37,11.51,2019,53046
1686,20,169,1875,89.92,1.07,9.01,2019,53070
98,3,17,118,83.05,2.54,14.41,2019,56295
5653,371,849,6873,82.25,5.4,12.35,2019,56304
542,21,109,672,80.65,3.12,16.22,2019,56315
2721,142,410,3273,83.13,4.34,12.53,2019,56320
516,8,70,594,86.87,1.35,11.78,2019,56330
908,70,283,1261,72.01,5.55,22.44,2019,56342
1038,65,301,1404,73.93,4.63,21.44,2019,56359
1453,43,277,1773,81.95,2.43,15.62,2019,56368
26,5,14,45,57.78,11.11,31.11,2019,56371
978,18,204,1200,81.5,1.5,17.0,2019,56373
240,13,52,305,78.69,4.26,17.05,2019,56386
338,23,164,525,64.38,4.38,31.24,2019,56437
1175,16,185,1376,85.39,1.16,13.44,2019,56444
100,2,16,118,84.75,1.69,13.56,2019,56517
560,24,140,724,77.35,3.31,19.34,2019,56528
431,8,81,520,82.88,1.54,15.58,2019,56534
6097,456,1635,8188,74.46,5.57,19.97,2019,56537
628,22,171,821,76.49,2.68,20.83,2019,56540
518,42,184,744,69.62,5.65,24.73,2019,56178
3968,304,901,5173,76.71,5.88,17.42,2019,56187
675,70,281,1026,65.79,6.82,27.39,2019,56208
195,15,102,312,62.5,4.81,32.69,2019,56214
1502,105,371,1978,75.94,5.31,18.76,2019,56215
223,20,38,281,79.36,7.12,13.52,2019,56216
470,6,100,576,81.6,1.04,17.36,2019,56223
463,15,170,648,71.45,2.31,26.23,2019,56243
111,0,20,131,84.73,0.0,15.27,2019,56249
5020,253,647,5920,84.8,4.27,10.93,2019,56258
155,1,50,206,75.24,0.49,24.27,2019,56263
460,10,153,623,73.84,1.61,24.56,2019,56266
2164,102,353,2619,82.63,3.89,13.48,2019,56267
62,8,29,99,62.63,8.08,29.29,2019,56276
408,17,70,495,82.42,3.43,14.14,2019,56279
800,10,193,1003,79.76,1.0,19.24,2019,56296
446,45,71,562,79.36,8.01,12.63,2019,56309
183,0,54,237,77.22,0.0,22.78,2019,56323
454,13,118,585,77.61,2.22,20.17,2019,56382
2716,222,380,3318,81.86,6.69,11.45,2019,56387
12,2,6,20,60.0,10.0,30.0,2019,56687
169,28,45,242,69.83,11.57,18.6,2019,56710
112,9,35,156,71.79,5.77,22.44,2019,56760
634,35,187,856,74.07,4.09,21.85,2019,56630
211,21,69,301,70.1,6.98,22.92,2019,56644
218,3,39,260,83.85,1.15,15.0,2019,56647
182,7,38,227,80.18,3.08,16.74,2019,56651
217,13,44,274,79.2,4.74,16.06,2019,56662
182,5,43,230,79.13,2.17,18.7,2019,56667
540,15,116,671,80.48,2.24,17.29,2019,56676
0,0,0,0,,,,2019,56711
1,0,4,5,20.0,0.0,80.0,2019,56720
341,186,91,618,55.18,30.1,14.72,2019,56726
318,8,82,408,77.94,1.96,20.1,2019,56737
1585,49,405,2039,77.73,2.4,19.86,2019,56544
12304,460,2934,15698,78.38,2.93,18.69,2019,48910
12549,283,1539,14371,87.32,1.97,10.71,2019,48430
582,26,127,735,79.18,3.54,17.28,2019,48435
9807,135,776,10718,91.5,1.26,7.24,2019,48335
7445,129,2088,9662,77.05,1.34,21.61,2019,48340
8191,39,482,8712,94.02,0.45,5.53,2019,48348
687,66,1002,1755,39.15,3.76,57.09,2019,71254
207,5,194,406,50.99,1.23,47.78,2019,71264
1699,328,1392,3419,49.69,9.59,40.71,2019,71282
87,16,79,182,47.8,8.79,43.41,2019,71286
941,74,431,1446,65.08,5.12,29.81,2019,71327
22,0,21,43,51.16,0.0,48.84,2019,71345
434,18,269,721,60.19,2.5,37.31,2019,71353
793,52,330,1175,67.49,4.43,28.09,2019,71355
198,53,205,456,43.42,11.62,44.96,2019,71375
217,14,147,378,57.41,3.7,38.89,2019,71416
320,9,186,515,62.14,1.75,36.12,2019,71028
1159,17,724,1900,61.0,0.89,38.11,2019,71001
228,16,51,295,77.29,5.42,17.29,2019,71045
8801,429,2320,11550,76.2,3.71,20.09,2019,71901
6612,239,800,7651,86.42,3.12,10.46,2019,71909
4324,427,1303,6054,71.42,7.05,21.52,2019,71923
476,23,214,713,66.76,3.23,30.01,2019,71940
800,71,338,1209,66.17,5.87,27.96,2019,71744
308,3,130,441,69.84,0.68,29.48,2019,71835
39,0,36,75,52.0,0.0,48.0,2019,71865
22,12,39,73,30.14,16.44,53.42,2019,71029
725,40,189,954,76.0,4.19,19.81,2019,71032
1202,83,1647,2932,41.0,2.83,56.17,2019,71040
3385,82,916,4383,77.23,1.87,20.9,2019,71047
613,55,598,1266,48.42,4.34,47.24,2019,71064
308,14,177,499,61.72,2.81,35.47,2019,71065
581,0,85,666,87.24,0.0,12.76,2019,71030
619,30,455,1104,56.07,2.72,41.21,2019,71260
6795,304,1602,8701,78.09,3.49,18.41,2019,71201
10308,321,2834,13463,76.57,2.38,21.05,2019,71203
318,105,232,655,48.55,16.03,35.42,2019,71259
171,6,107,284,60.21,2.11,37.68,2019,71044
315,25,135,475,66.32,5.26,28.42,2019,71046
359,0,14,373,96.25,0.0,3.75,2019,71007
2081,79,806,2966,70.16,2.66,27.17,2019,71019
955,78,497,1530,62.42,5.1,32.48,2019,71023
861,54,417,1332,64.64,4.05,31.31,2019,71049
542,64,278,884,61.31,7.24,31.45,2019,71060
378,10,244,632,59.81,1.58,38.61,2019,71072
3637,133,692,4462,81.51,2.98,15.51,2019,71119
128,13,126,267,47.94,4.87,47.19,2019,71004
155,5,180,340,45.59,1.47,52.94,2019,71031
132,4,8,144,91.67,2.78,5.56,2019,71034
588,2,104,694,84.73,0.29,14.99,2019,71039
3929,225,3711,7865,49.96,2.86,47.18,2019,71055
4461,267,3402,8130,54.87,3.28,41.85,2019,71220
297,21,161,479,62.0,4.38,33.61,2019,71229
217,35,284,536,40.49,6.53,52.99,2019,71237
299,3,164,466,64.16,0.64,35.19,2019,71247
2207,468,1695,4370,50.5,10.71,38.79,2019,71269
10416,213,1755,12384,84.11,1.72,14.17,2019,71270
143,0,127,270,52.96,0.0,47.04,2019,71333
335,9,319,663,50.53,1.36,48.11,2019,71357
11120,624,2105,13849,80.29,4.51,15.2,2019,57401
21,0,0,21,100.0,0.0,0.0,2019,57421
61,2,19,82,74.39,2.44,23.17,2019,57424
167,12,55,234,71.37,5.13,23.5,2019,57428
107,0,19,126,84.92,0.0,15.08,2019,57435
149,5,42,196,76.02,2.55,21.43,2019,57436
478,1,128,607,78.75,0.16,21.09,2019,52563
227,6,103,336,67.56,1.79,30.65,2019,52574
618,33,110,761,81.21,4.34,14.45,2019,52639
5012,162,933,6107,82.07,2.65,15.28,2019,52577
215,0,37,252,85.32,0.0,14.68,2019,52619
38,0,18,56,67.86,0.0,32.14,2019,52573
635,28,138,801,79.28,3.5,17.23,2019,52332
71,0,8,79,89.87,0.0,10.13,2019,52334
1153,9,116,1278,90.22,0.7,9.08,2019,52340
429,19,109,557,77.02,3.41,19.57,2019,52347
193,7,44,244,79.1,2.87,18.03,2019,52550
5864,212,619,6695,87.59,3.17,9.25,2019,52002
44,0,6,50,88.0,0.0,12.0,2019,52044
775,16,157,948,81.75,1.69,16.56,2019,52045
161,0,23,184,87.5,0.0,12.5,2019,52050
108,0,17,125,86.4,0.0,13.6,2019,52134
736,36,94,866,84.99,4.16,10.85,2019,52203
145,2,20,167,86.83,1.2,11.98,2019,52207
207,10,43,260,79.62,3.85,16.54,2019,52210
192,2,44,238,80.67,0.84,18.49,2019,52217
0,0,0,0,,,,2019,52242
169,6,24,199,84.92,3.02,12.06,2019,52309
320,14,122,456,70.18,3.07,26.75,2019,52320
321,2,52,375,85.6,0.53,13.87,2019,52325
1000,23,57,1080,92.59,2.13,5.28,2019,52328
2305,35,153,2493,92.46,1.4,6.14,2019,52333
470,4,24,498,94.38,0.8,4.82,2019,52346
473,0,34,507,93.29,0.0,6.71,2019,52351
1277,44,212,1533,83.3,2.87,13.83,2019,52358
15227,459,1643,17329,87.87,2.65,9.48,2019,52402
2739,26,87,2852,96.04,0.91,3.05,2019,52411
99,0,31,130,76.15,0.0,23.85,2019,52543
191,3,64,258,74.03,1.16,24.81,2019,52576
220,0,34,254,86.61,0.0,13.39,2019,52580
111,8,42,161,68.94,4.97,26.09,2019,52583
983,22,269,1274,77.16,1.73,21.11,2019,52591
339,3,178,520,65.19,0.58,34.23,2019,52626
105,2,66,173,60.69,1.16,38.15,2019,52630
224,6,98,328,68.29,1.83,29.88,2019,52635
3708,150,813,4671,79.38,3.21,17.41,2019,52641
126,8,37,171,73.68,4.68,21.64,2019,52644
1064,19,329,1412,75.35,1.35,23.3,2019,52645
254,3,56,313,81.15,0.96,17.89,2019,52721
1629,73,122,1824,89.31,4.0,6.69,2019,52726
1045,17,339,1401,74.59,1.21,24.2,2019,52738
2473,12,549,3034,81.51,0.4,18.09,2019,52742
1851,8,215,2074,89.25,0.39,10.37,2019,52753
239,9,75,323,73.99,2.79,23.22,2019,52731
8507,374,2296,11177,76.11,3.35,20.54,2019,52732
71,0,12,83,85.54,0.0,14.46,2019,52757
9619,487,1953,12059,79.77,4.04,16.2,2019,52761
42,0,0,42,100.0,0.0,0.0,2019,52767
35,0,12,47,74.47,0.0,25.53,2019,52774
44,2,3,49,89.8,4.08,6.12,2019,55784
490,19,202,711,68.92,2.67,28.41,2019,55732
8679,108,862,9649,89.95,1.12,8.93,2019,55427
10914,225,348,11487,95.01,1.96,3.03,2019,55347
815,14,100,929,87.73,1.51,10.76,2019,55390
6199,180,393,6772,91.54,2.66,5.8,2019,55391
14661,463,2825,17949,81.68,2.58,15.74,2019,53081
2650,148,478,3276,80.89,4.52,14.59,2019,53925
859,42,228,1129,76.09,3.72,20.19,2019,53929
1060,30,180,1270,83.46,2.36,14.17,2019,53933
486,20,96,602,80.73,3.32,15.95,2019,53936
78,2,33,113,69.03,1.77,29.2,2019,53939
1127,40,269,1436,78.48,2.79,18.73,2019,53952
2341,65,451,2857,81.94,2.28,15.79,2019,53954
261,18,49,328,79.57,5.49,14.94,2019,53961
707,39,271,1017,69.52,3.83,26.65,2019,53968
116,7,35,158,73.42,4.43,22.15,2019,53557
10372,991,766,12129,85.51,8.17,6.32,2019,53705
827,20,185,1032,80.14,1.94,17.93,2019,53919
132,0,18,150,88.0,0.0,12.0,2019,53969
7210,206,2352,9768,73.81,2.11,24.08,2019,53210
1404,4,185,1593,88.14,0.25,11.61,2019,53038
10126,310,1145,11581,87.44,2.68,9.89,2019,53105
11882,249,1802,13933,85.28,1.79,12.93,2019,53186
772,10,130,912,84.65,1.1,14.25,2019,53516
67,9,25,101,66.34,8.91,24.75,2019,53827
2256,48,197,2501,90.2,1.92,7.88,2019,53528
909,55,217,1181,76.97,4.66,18.37,2019,53556
849,39,203,1091,77.82,3.57,18.61,2019,53570
23,0,13,36,63.89,0.0,36.11,2019,53571
973,45,319,1337,72.77,3.37,23.86,2019,53573
411,5,62,478,85.98,1.05,12.97,2019,53582
6699,332,433,7464,89.75,4.45,5.8,2019,53597
47,12,0,59,79.66,20.34,0.0,2019,53706
1816,32,443,2291,79.27,1.4,19.34,2019,53813
4698,141,713,5552,84.62,2.54,12.84,2019,53818
301,26,230,557,54.04,4.67,41.29,2019,53926
58,5,20,83,69.88,6.02,24.1,2019,53947
7231,253,851,8335,86.75,3.04,10.21,2019,53083
4226,205,678,5109,82.72,4.01,13.27,2019,53085
13473,537,1686,15696,85.84,3.42,10.74,2019,53202
1867,155,1289,3311,56.39,4.68,38.93,2019,53205
8390,313,3368,12071,69.51,2.59,27.9,2019,53208
12803,495,1211,14509,88.24,3.41,8.35,2019,53211
873,10,108,991,88.09,1.01,10.9,2019,53002
957,45,80,1082,88.45,4.16,7.39,2019,53049
1898,8,97,2003,94.76,0.4,4.84,2019,53097
64,0,13,77,83.12,0.0,16.88,2019,53195
110,5,33,148,74.32,3.38,22.3,2019,53505
1279,60,185,1524,83.92,3.94,12.14,2019,53560
3267,194,304,3765,86.77,5.15,8.07,2019,53555
368,20,122,510,72.16,3.92,23.92,2019,53587
4938,124,1093,6155,80.23,2.01,17.76,2019,53901
1158,35,246,1439,80.47,2.43,17.1,2019,53048
734,18,54,806,91.07,2.23,6.7,2019,53125
0,0,0,0,,,,2019,53031
0,0,0,0,,,,2019,53295
46,0,0,46,100.0,0.0,0.0,2019,53501
6195,376,1086,7657,80.91,4.91,14.18,2019,53548
525,32,92,649,80.89,4.93,14.18,2019,55710
152,13,34,199,76.38,6.53,17.09,2019,55711
144,0,5,149,96.64,0.0,3.36,2019,55717
5415,264,1478,7157,75.66,3.69,20.65,2019,55746
58,0,17,75,77.33,0.0,22.67,2019,55758
294,12,69,375,78.4,3.2,18.4,2019,55765
1416,62,170,1648,85.92,3.76,10.32,2019,56241
266,4,64,334,79.64,1.2,19.16,2019,56251
58,2,16,76,76.32,2.63,21.05,2019,56680
6930,257,1797,8984,77.14,2.86,20.0,2019,56007
454,3,89,546,83.15,0.55,16.3,2019,56028
521,1,100,622,83.76,0.16,16.08,2019,56037
236,8,92,336,70.24,2.38,27.38,2019,56225
806,31,191,1028,78.4,3.02,18.58,2019,56232
150,6,58,214,70.09,2.8,27.1,2019,56235
113,12,7,132,85.61,9.09,5.3,2019,56236
401,20,58,479,83.72,4.18,12.11,2019,56244
252,17,82,351,71.79,4.84,23.36,2019,56248
187,3,56,246,76.02,1.22,22.76,2019,56257
2532,83,704,3319,76.29,2.5,21.21,2019,56265
21,0,15,36,58.33,0.0,41.67,2019,56287
1715,55,238,2008,85.41,2.74,11.85,2019,56288
376,21,119,516,72.87,4.07,23.06,2019,56293
338,7,100,445,75.96,1.57,22.47,2019,56314
288,19,39,346,83.24,5.49,11.27,2019,56349
181,4,41,226,80.09,1.77,18.14,2019,56355
697,47,229,973,71.63,4.83,23.54,2019,56361
298,12,33,343,86.88,3.5,9.62,2019,56375
111,6,19,136,81.62,4.41,13.97,2019,56376
239,10,101,350,68.29,2.86,28.86,2019,56385
357,6,48,411,86.86,1.46,11.68,2019,56016
9,0,13,22,40.91,0.0,59.09,2019,56022
263,22,51,336,78.27,6.55,15.18,2019,56029
148,9,36,193,76.68,4.66,18.65,2019,56043
501,14,90,605,82.81,2.31,14.88,2019,56050
259,20,42,321,80.69,6.23,13.08,2019,56052
1377,47,290,1714,80.34,2.74,16.92,2019,56055
913,35,151,1099,83.08,3.18,13.74,2019,56065
58,0,19,77,75.32,0.0,24.68,2019,56089
126,3,16,145,86.9,2.07,11.03,2019,56091
4070,63,779,4912,82.86,1.28,15.86,2019,56093
1015,28,209,1252,81.07,2.24,16.69,2019,56096
381,22,87,490,77.76,4.49,17.76,2019,56678
349,8,53,410,85.12,1.95,12.93,2019,56713
340,63,89,492,69.11,12.8,18.09,2019,56732
358,11,59,428,83.64,2.57,13.79,2019,56736
1620,332,365,2317,69.92,14.33,15.75,2019,56751
315,17,54,386,81.61,4.4,13.99,2019,56757
862,57,155,1074,80.26,5.31,14.43,2019,56762
5228,90,880,6198,84.35,1.45,14.2,2019,56003
493,3,90,586,84.13,0.51,15.36,2019,56009
99,2,11,112,88.39,1.79,9.82,2019,56032
356,13,53,422,84.36,3.08,12.56,2019,56068
430,30,59,519,82.85,5.78,11.37,2019,56570
1490,100,341,1931,77.16,5.18,17.66,2019,56549
82,4,18,104,78.85,3.85,17.31,2019,56553
313,30,103,446,70.18,6.73,23.09,2019,56556
276,20,55,351,78.63,5.7,15.67,2019,56576
283,24,113,420,67.38,5.71,26.9,2019,56585
1461,19,476,1956,74.69,0.97,24.34,2019,48756
1661,76,291,2028,81.9,3.75,14.35,2019,48763
872,21,111,1004,86.85,2.09,11.06,2019,48819
904,30,112,1046,86.42,2.87,10.71,2019,48822
948,6,135,1089,87.05,0.55,12.4,2019,48835
1495,55,508,2058,72.64,2.67,24.68,2019,48658
194,3,35,232,83.62,1.29,15.09,2019,57441
590,8,140,738,79.95,1.08,18.97,2019,57445
709,74,109,892,79.48,8.3,12.22,2019,57451
203,21,62,286,70.98,7.34,21.68,2019,57456
112,0,19,131,85.5,0.0,14.5,2019,57460
1176,28,245,1449,81.16,1.93,16.91,2019,57469
35,5,11,51,68.63,9.8,21.57,2019,57520
595,22,199,816,72.92,2.7,24.39,2019,57533
135,22,69,226,59.73,9.73,30.53,2019,57552
44,2,84,130,33.85,1.54,64.62,2019,57560
325,44,39,408,79.66,10.78,9.56,2019,57002
624,0,64,688,90.7,0.0,9.3,2019,57003
1297,27,202,1526,84.99,1.77,13.24,2019,57004
232,2,67,301,77.08,0.66,22.26,2019,57015
1614,30,287,1931,83.58,1.55,14.86,2019,57022
97,0,15,112,86.61,0.0,13.39,2019,57052
570,32,108,710,80.28,4.51,15.21,2019,57058
309,21,42,372,83.06,5.65,11.29,2019,57063
131,13,21,165,79.39,7.88,12.73,2019,57065
251,8,114,373,67.29,2.14,30.56,2019,57248
150,0,74,224,66.96,0.0,33.04,2019,57257
121,10,38,169,71.6,5.92,22.49,2019,57261
130,18,47,195,66.67,9.23,24.1,2019,57268
6699,275,1103,8077,82.94,3.4,13.66,2019,57301
1078,50,219,1347,80.03,3.71,16.26,2019,57325
83,12,8,103,80.58,11.65,7.77,2019,57775
45,0,32,77,58.44,0.0,41.56,2019,57759
181,26,261,468,38.68,5.56,55.77,2019,57764
54,0,19,73,73.97,0.0,26.03,2019,57773
91,1,8,100,91.0,1.0,8.0,2019,57791
135,0,0,135,100.0,0.0,0.0,2019,57787
766,22,124,912,83.99,2.41,13.6,2019,57793
534,40,177,751,71.11,5.33,23.57,2019,57001
375,18,105,498,75.3,3.61,21.08,2019,57012
1298,46,331,1675,77.49,2.75,19.76,2019,57013
298,7,42,347,85.88,2.02,12.1,2019,57034
192,7,55,254,75.59,2.76,21.65,2019,57036
94,1,67,162,58.02,0.62,41.36,2019,57040
104,8,7,119,87.39,6.72,5.88,2019,57050
108,5,38,151,71.52,3.31,25.17,2019,57051
173,3,49,225,76.89,1.33,21.78,2019,57024
1795,48,160,2003,89.62,2.4,7.99,2019,57033
414,22,160,596,69.46,3.69,26.85,2019,57043
318,29,136,483,65.84,6.0,28.16,2019,57045
2571,92,268,2931,87.72,3.14,9.14,2019,57049
380,2,101,483,78.67,0.41,20.91,2019,57062
460,6,47,513,89.67,1.17,9.16,2019,57077
238,13,69,320,74.38,4.06,21.56,2019,57221
45,2,6,53,84.91,3.77,11.32,2019,57224
722,8,147,877,82.33,0.91,16.76,2019,57226
383,53,77,513,74.66,10.33,15.01,2019,57234
8227,356,1119,9702,84.8,3.67,11.53,2019,57006
199,5,27,231,86.15,2.16,11.69,2019,57010
0,0,0,0,,,,2019,66115
0,0,0,0,,,,2019,66118
343,0,100,443,77.43,0.0,22.57,2019,66724
1123,16,519,1658,67.73,0.97,31.3,2019,66736
82,1,28,111,73.87,0.9,25.23,2019,66738
1604,84,375,2063,77.75,4.07,18.18,2019,66739
6349,272,764,7385,85.97,3.68,10.35,2019,55405
8088,95,467,8650,93.5,1.1,5.4,2019,55410
6853,191,1688,8732,78.48,2.19,19.33,2019,55412
5617,284,759,6660,84.34,4.26,11.4,2019,55413
1686,196,96,1978,85.24,9.91,4.85,2019,55415
10910,253,943,12106,90.12,2.09,7.79,2019,55426
9429,406,2175,12010,78.51,3.38,18.11,2019,55428
3957,15,233,4205,94.1,0.36,5.54,2019,55445
100,0,18,118,84.75,0.0,15.25,2019,55606
927,53,179,1159,79.98,4.57,15.44,2019,55614
106,8,9,123,86.18,6.5,7.32,2019,55615
345,23,70,438,78.77,5.25,15.98,2019,55704
663,20,206,889,74.58,2.25,23.17,2019,55706
1015,73,226,1314,77.25,5.56,17.2,2019,55718
2245,67,282,2594,86.55,2.58,10.87,2019,55719
3369,178,710,4257,79.14,4.18,16.68,2019,55806
3406,101,727,4234,80.44,2.39,17.17,2019,55807
87,1,7,95,91.58,1.05,7.37,2019,55933
1054,37,182,1273,82.8,2.91,14.3,2019,55943
434,9,95,538,80.67,1.67,17.66,2019,55945
603,18,159,780,77.31,2.31,20.38,2019,55956
776,24,83,883,87.88,2.72,9.4,2019,55959
265,3,65,333,79.58,0.9,19.52,2019,55962
9840,325,732,10897,90.3,2.98,6.72,2019,55443
8989,186,380,9555,94.08,1.95,3.98,2019,55446
184,9,80,273,67.4,3.3,29.3,2019,55603
282,12,51,345,81.74,3.48,14.78,2019,55605
95,0,0,95,100.0,0.0,0.0,2019,55609
282,8,60,350,80.57,2.29,17.14,2019,55724
2152,77,452,2681,80.27,2.87,16.86,2019,55734
362,7,103,472,76.69,1.48,21.82,2019,55753
220,2,43,265,83.02,0.75,16.23,2019,55763
192,15,91,298,64.43,5.03,30.54,2019,55764
950,0,308,1258,75.52,0.0,24.48,2019,55768
566,18,131,715,79.16,2.52,18.32,2019,55771
436,28,131,595,73.28,4.71,22.02,2019,55795
3157,52,271,3480,90.72,1.49,7.79,2019,55812
1605,62,357,2024,79.3,3.06,17.64,2019,55921
128,4,25,157,81.53,2.55,15.92,2019,55931
279,6,51,336,83.04,1.79,15.18,2019,55935
3005,62,267,3334,90.13,1.86,8.01,2019,55947
844,14,54,912,92.54,1.54,5.92,2019,55955
1498,57,267,1822,82.22,3.13,14.65,2019,55972
689,31,163,883,78.03,3.51,18.46,2019,55974
1496,54,199,1749,85.53,3.09,11.38,2019,55981
151,0,33,184,82.07,0.0,17.93,2019,55982
457,24,85,566,80.74,4.24,15.02,2019,55991
1353,66,323,1742,77.67,3.79,18.54,2019,55964
321,12,41,374,85.83,3.21,10.96,2019,55967
543,19,119,681,79.74,2.79,17.47,2019,55983
8054,211,517,8782,91.71,2.4,5.89,2019,55345
1247,81,238,1566,79.63,5.17,15.2,2019,55349
1932,19,136,2087,92.57,0.91,6.52,2019,55356
291,0,67,358,81.28,0.0,18.72,2019,64442
3564,190,734,4488,79.41,4.23,16.35,2019,64075
1732,44,441,2217,78.12,1.98,19.89,2019,64053
12648,216,1154,14018,90.23,1.54,8.23,2019,64068
176,2,58,236,74.58,0.85,24.58,2019,64072
2826,175,708,3709,76.19,4.72,19.09,2019,64076
5275,93,396,5764,91.52,1.61,6.87,2019,55804
2625,108,213,2946,89.1,3.67,7.23,2019,55920
218,4,162,384,56.77,1.04,42.19,2019,55922
425,7,108,540,78.7,1.3,20.0,2019,55924
227,9,55,291,78.01,3.09,18.9,2019,55957
141,9,32,182,77.47,4.95,17.58,2019,55961
788,20,172,980,80.41,2.04,17.55,2019,55080
3112,80,359,3551,87.64,2.25,10.11,2019,55115
8931,170,402,9503,93.98,1.79,4.23,2019,55123
8816,97,133,9046,97.46,1.07,1.47,2019,55129
9029,167,739,9935,90.88,1.68,7.44,2019,55305
10043,329,800,11172,89.89,2.94,7.16,2019,55126
288,18,55,361,79.78,4.99,15.24,2019,55018
2206,88,240,2534,87.06,3.47,9.47,2019,55013
9071,134,534,9739,93.14,1.38,5.48,2019,55014
1027,32,149,1208,85.02,2.65,12.33,2019,55027
2685,84,321,3090,86.89,2.72,10.39,2019,55045
9816,95,607,10518,93.33,0.9,5.77,2019,55068
103,3,35,141,73.05,2.13,24.82,2019,55090
1483,17,121,1621,91.49,1.05,7.46,2019,55005
2778,41,379,3198,86.87,1.28,11.85,2019,55009
10991,299,738,12028,91.38,2.49,6.14,2019,55016
242,6,53,301,80.4,1.99,17.61,2019,55017
1815,24,110,1949,93.12,1.23,5.64,2019,55046
7063,222,753,8038,87.87,2.76,9.37,2019,55057
7008,143,910,8061,86.94,1.77,11.29,2019,55075
7609,373,873,8855,85.93,4.21,9.86,2019,55076
15282,247,791,16320,93.64,1.51,4.85,2019,55125
14466,612,1890,16968,85.25,3.61,11.14,2019,55104
9685,142,577,10404,93.09,1.36,5.55,2019,55105
1353,149,93,1595,84.83,9.34,5.83,2019,55114
13649,277,1483,15409,88.58,1.8,9.62,2019,55119
1720,81,130,1931,89.07,4.19,6.73,2019,55120
11945,189,854,12988,91.97,1.46,6.58,2019,55122
10238,192,1207,11637,87.98,1.65,10.37,2019,55128
5721,149,480,6350,90.09,2.35,7.56,2019,55306
2964,51,202,3217,92.14,1.59,6.28,2019,55308
1717,57,155,1929,89.01,2.95,8.04,2019,55319
2981,123,289,3393,87.86,3.63,8.52,2019,55328
16083,401,1868,18352,87.64,2.19,10.18,2019,55337
351,20,73,444,79.05,4.5,16.44,2019,55338
893,131,115,1139,78.4,11.5,10.1,2019,55003
10175,204,1449,11828,86.02,1.72,12.25,2019,55060
138,0,5,143,96.5,0.0,3.5,2019,55087
614,39,173,826,74.33,4.72,20.94,2019,55329
2508,13,171,2692,93.16,0.48,6.35,2019,55386
7002,147,730,7879,88.87,1.87,9.27,2019,55437
364,2,112,478,76.15,0.42,23.43,2019,55919
11583,467,1729,13779,84.06,3.39,12.55,2019,55987
1435,47,318,1800,79.72,2.61,17.67,2019,56621
89,0,15,104,85.58,0.0,14.42,2019,56629
130,3,18,151,86.09,1.99,11.92,2019,56174
165,9,42,216,76.39,4.17,19.44,2019,56218
166,17,60,243,68.31,7.0,24.69,2019,65250
5523,224,1386,7133,77.43,3.14,19.43,2019,65251
289,14,91,394,73.35,3.55,23.1,2019,65323
271,14,61,346,78.32,4.05,17.63,2019,65334
1950,119,151,2220,87.84,5.36,6.8,2019,65473
299,0,225,524,57.06,0.0,42.94,2019,65567
9056,338,2519,11913,76.02,2.84,21.14,2019,54303
918,44,185,1147,80.03,3.84,16.13,2019,54405
678,13,166,857,79.11,1.52,19.37,2019,54410
269,18,102,389,69.15,4.63,26.22,2019,54418
589,16,181,786,74.94,2.04,23.03,2019,54425
411,12,63,486,84.57,2.47,12.96,2019,54427
539,2,78,619,87.08,0.32,12.6,2019,54974
529,8,72,609,86.86,1.31,11.82,2019,54977
5627,108,942,6677,84.27,1.62,14.11,2019,54981
420,12,80,512,82.03,2.34,15.62,2019,54838
2125,53,360,2538,83.73,2.09,14.18,2019,54021
11202,286,1639,13127,85.34,2.18,12.49,2019,54401
985,22,221,1228,80.21,1.79,18.0,2019,54440
194,10,54,258,75.19,3.88,20.93,2019,54493
268,19,155,442,60.63,4.3,35.07,2019,54527
915,18,191,1124,81.41,1.6,16.99,2019,54629
233,10,29,272,85.66,3.68,10.66,2019,54769
553,23,102,678,81.56,3.39,15.04,2019,54856
2250,110,652,3012,74.7,3.65,21.65,2019,54982
152,5,108,265,57.36,1.89,40.75,2019,54125
966,16,368,1350,71.56,1.19,27.26,2019,54174
1142,33,458,1633,69.93,2.02,28.05,2019,54634
917,9,215,1141,80.37,0.79,18.84,2019,54666
819,22,231,1072,76.4,2.05,21.55,2019,54819
1486,39,366,1891,78.58,2.06,19.35,2019,54758
67,5,41,113,59.29,4.42,36.28,2019,54760
1500,42,247,1789,83.85,2.35,13.81,2019,54940
207,25,116,348,59.48,7.18,33.33,2019,54828
1190,36,208,1434,82.98,2.51,14.5,2019,54873
506,10,168,684,73.98,1.46,24.56,2019,54766
408,53,135,596,68.46,8.89,22.65,2019,54805
3490,251,1111,4852,71.93,5.17,22.9,2019,54806
307,24,98,429,71.56,5.59,22.84,2019,54835
1675,55,338,2068,81.0,2.66,16.34,2019,54110
14115,356,1698,16169,87.3,2.2,10.5,2019,54701
599,36,159,794,75.44,4.53,20.03,2019,54754
803,31,172,1006,79.82,3.08,17.1,2019,54817
212,12,60,284,74.65,4.23,21.13,2019,54006
756,18,113,887,85.23,2.03,12.74,2019,54014
1242,34,90,1366,90.92,2.49,6.59,2019,54113
141,5,36,182,77.47,2.75,19.78,2019,54832
114,2,26,142,80.28,1.41,18.31,2019,54839
80,1,32,113,70.8,0.88,28.32,2019,54862
10326,512,2450,13288,77.71,3.85,18.44,2019,54880
1358,48,377,1783,76.16,2.69,21.14,2019,54893
11519,716,1603,13838,83.24,5.17,11.58,2019,54901
8060,153,769,8982,89.74,1.7,8.56,2019,54904
363,7,84,454,79.96,1.54,18.5,2019,54611
802,0,123,925,86.7,0.0,13.3,2019,54562
1636,46,369,2051,79.77,2.24,17.99,2019,54727
331,16,50,397,83.38,4.03,12.59,2019,54750
2484,115,498,3097,80.21,3.71,16.08,2019,54153
362,22,98,482,75.1,4.56,20.33,2019,54540
235,12,44,291,80.76,4.12,15.12,2019,56650
91,3,23,117,77.78,2.56,19.66,2019,56660
563,44,268,875,64.34,5.03,30.63,2019,56671
389,4,109,502,77.49,0.8,21.71,2019,56252
448,37,116,601,74.54,6.16,19.3,2019,56282
538,24,220,782,68.8,3.07,28.13,2019,56284
53,0,24,77,68.83,0.0,31.17,2019,66741
210,7,95,312,67.31,2.24,30.45,2019,66773
40,0,29,69,57.97,0.0,42.03,2019,66775
117,12,143,272,43.01,4.41,52.57,2019,66777
2799,135,664,3598,77.79,3.75,18.45,2019,65559
64,0,24,88,72.73,0.0,27.27,2019,65603
5482,287,886,6655,82.37,4.31,13.31,2019,65613
154,0,108,262,58.78,0.0,41.22,2019,65629
175,3,31,209,83.73,1.44,14.83,2019,65635
690,58,351,1099,62.78,5.28,31.94,2019,65667
668,78,284,1030,64.85,7.57,27.57,2019,65674
91,0,25,116,78.45,0.0,21.55,2019,65541
540,87,201,828,65.22,10.51,24.28,2019,65552
1423,34,681,2138,66.56,1.59,31.85,2019,65556
4086,278,1563,5927,68.94,4.69,26.37,2019,65560
1375,74,592,2041,67.37,3.63,29.01,2019,65565
342,0,172,514,66.54,0.0,33.46,2019,65590
987,30,392,1409,70.05,2.13,27.82,2019,65604
165,22,108,295,55.93,7.46,36.61,2019,65609
71,0,0,71,100.0,0.0,0.0,2019,65620
694,63,135,892,77.8,7.06,15.13,2019,65644
922,35,410,1367,67.45,2.56,29.99,2019,65652
278,7,143,428,64.95,1.64,33.41,2019,65662
237,12,240,489,48.47,2.45,49.08,2019,65764
400,42,54,496,80.65,8.47,10.89,2019,65771
113,0,71,184,61.41,0.0,38.59,2019,65778
1223,59,558,1840,66.47,3.21,30.33,2019,65791
666,24,167,857,77.71,2.8,19.49,2019,65681
550,52,139,741,74.22,7.02,18.76,2019,65682
347,17,195,559,62.08,3.04,34.88,2019,65692
61,13,34,108,56.48,12.04,31.48,2019,65702
2710,114,617,3441,78.76,3.31,17.93,2019,65712
596,40,277,913,65.28,4.38,30.34,2019,65717
480,34,35,549,87.43,6.19,6.38,2019,65722
70,0,21,91,76.92,0.0,23.08,2019,65727
1157,30,219,1406,82.29,2.13,15.58,2019,65740
176,16,66,258,68.22,6.2,25.58,2019,65754
386,15,213,614,62.87,2.44,34.69,2019,65761
114,0,127,241,47.3,0.0,52.7,2019,65768
818,56,343,1217,67.21,4.6,28.18,2019,65734
696,17,314,1027,67.77,1.66,30.57,2019,65014
4099,205,1000,5304,77.28,3.87,18.85,2019,65020
313,34,104,451,69.4,7.54,23.06,2019,65024
111,0,250,361,30.75,0.0,69.25,2019,65034
346,27,115,488,70.9,5.53,23.57,2019,65040
552,20,31,603,91.54,3.32,5.14,2019,65053
7,0,0,7,100.0,0.0,0.0,2019,65062
88,34,29,151,58.28,22.52,19.21,2019,65067
7589,999,2211,10799,70.28,9.25,20.47,2019,65101
21570,558,2135,24263,88.9,2.3,8.8,2019,65203
74,2,36,112,66.07,1.79,32.14,2019,65232
2602,189,560,3351,77.65,5.64,16.71,2019,65240
549,19,194,762,72.05,2.49,25.46,2019,65243
1148,29,178,1355,84.72,2.14,13.14,2019,67025
124,0,22,146,84.93,0.0,15.07,2019,67073
587,14,76,677,86.71,2.07,11.23,2019,67117
5531,346,775,6652,83.15,5.2,11.65,2019,67460
424,20,138,582,72.85,3.44,23.71,2019,67428
1639,158,696,2493,65.74,6.34,27.92,2019,67432
8348,312,829,9489,87.98,3.29,8.74,2019,64081
8137,256,806,9199,88.46,2.78,8.76,2019,64083
7778,341,622,8741,88.98,3.9,7.12,2019,64086
294,19,123,436,67.43,4.36,28.21,2019,64096
8960,265,1239,10464,85.63,2.53,11.84,2019,64012
34,4,19,57,59.65,7.02,33.33,2019,64022
5172,173,843,6188,83.58,2.8,13.62,2019,64024
8762,354,918,10034,87.32,3.53,9.15,2019,64030
349,6,128,483,72.26,1.24,26.5,2019,64643
78,21,3,102,76.47,20.59,2.94,2019,64498
198,3,40,241,82.16,1.24,16.6,2019,64625
185,18,74,277,66.79,6.5,26.71,2019,64638
129,1,37,167,77.25,0.6,22.16,2019,64647
175,1,86,262,66.79,0.38,32.82,2019,64650
509,22,121,652,78.07,3.37,18.56,2019,64668
149,11,105,265,56.23,4.15,39.62,2019,64679
1041,82,310,1433,72.64,5.72,21.63,2019,64720
54,0,31,85,63.53,0.0,36.47,2019,64741
437,12,267,716,61.03,1.68,37.29,2019,64748
393,62,175,630,62.38,9.84,27.78,2019,64762
507,13,164,684,74.12,1.9,23.98,2019,64788
11705,1050,2474,15229,76.86,6.89,16.25,2019,64801
235,34,56,325,72.31,10.46,17.23,2019,64830
2844,282,333,3459,82.22,8.15,9.63,2019,64834
938,13,207,1158,81.0,1.12,17.88,2019,64840
230,19,95,344,66.86,5.52,27.62,2019,64842
1229,35,539,1803,68.16,1.94,29.89,2019,64844
111,37,80,228,48.68,16.23,35.09,2019,64848
990,69,403,1462,67.72,4.72,27.56,2019,64862
356,5,113,474,75.11,1.05,23.84,2019,64867
151,16,109,276,54.71,5.8,39.49,2019,64874
829,49,365,1243,66.69,3.94,29.36,2019,64011
275,51,21,347,79.25,14.7,6.05,2019,64018
3322,276,1074,4672,71.1,5.91,22.99,2019,64109
392,23,183,598,65.55,3.85,30.6,2019,64125
1565,24,676,2265,69.09,1.06,29.85,2019,64126
6768,313,1886,8967,75.48,3.49,21.03,2019,64134
8216,580,1689,10485,78.36,5.53,16.11,2019,64138
59,0,17,76,77.63,0.0,22.37,2019,64646
68,8,25,101,67.33,7.92,24.75,2019,64656
203,15,99,317,64.04,4.73,31.23,2019,64661
234,1,98,333,70.27,0.3,29.43,2019,64670
87,1,48,136,63.97,0.74,35.29,2019,64726
690,14,55,759,90.91,1.84,7.25,2019,64734
338,6,101,445,75.96,1.35,22.7,2019,64738
2208,155,798,3161,69.85,4.9,25.25,2019,64759
451,38,199,688,65.55,5.52,28.92,2019,64763
288,14,106,408,70.59,3.43,25.98,2019,64770
4535,228,738,5501,82.44,4.14,13.42,2019,64772
1082,54,531,1667,64.91,3.24,31.85,2019,64776
167,13,48,228,73.25,5.7,21.05,2019,64778
219,29,45,293,74.74,9.9,15.36,2019,64832
6268,446,1966,8680,72.21,5.14,22.65,2019,64850
123,2,79,204,60.29,0.98,38.73,2019,50222
67,0,22,89,75.28,0.0,24.72,2019,50254
83,0,17,100,83.0,0.0,17.0,2019,49261
19,0,3,22,86.36,0.0,13.64,2019,49320
9813,341,1128,11282,86.98,3.02,10.0,2019,49519
7609,307,845,8761,86.85,3.5,9.65,2019,49534
606,52,343,1001,60.54,5.19,34.27,2019,65588
1957,139,1065,3161,61.91,4.4,33.69,2019,65622
376,17,106,499,75.35,3.41,21.24,2019,65641
768,59,406,1233,62.29,4.79,32.93,2019,65655
29,0,12,41,70.73,0.0,29.27,2019,65657
610,34,262,906,67.33,3.75,28.92,2019,65663
779,14,173,966,80.64,1.45,17.91,2019,65669
390,48,86,524,74.43,9.16,16.41,2019,65680
257,11,47,315,81.59,3.49,14.92,2019,65685
4250,399,1169,5818,73.05,6.86,20.09,2019,65706
686,24,302,1012,67.79,2.37,29.84,2019,65713
0,0,0,0,,,,2019,65728
199,12,107,318,62.58,3.77,33.65,2019,65733
2794,92,399,3285,85.05,2.8,12.15,2019,65737
391,25,56,472,82.84,5.3,11.86,2019,65739
16,0,18,34,47.06,0.0,52.94,2019,65744
272,18,152,442,61.54,4.07,34.39,2019,65774
137,0,20,157,87.26,0.0,12.74,2019,65777
4221,653,1622,6496,64.98,10.05,24.97,2019,65806
4113,236,404,4753,86.53,4.97,8.5,2019,65809
38,0,7,45,84.44,0.0,15.56,2019,65457
10736,380,1935,13051,82.26,2.91,14.83,2019,65401
33,0,7,40,82.5,0.0,17.5,2019,65443
69,0,66,135,51.11,0.0,48.89,2019,65446
539,5,106,650,82.92,0.77,16.31,2019,65462
1038,23,332,1393,74.52,1.65,23.83,2019,65486
1483,84,664,2231,66.47,3.77,29.76,2019,65548
273,39,173,485,56.29,8.04,35.67,2019,65555
35,0,0,35,100.0,0.0,0.0,2019,65557
107,0,128,235,45.53,0.0,54.47,2019,65570
430,0,76,506,84.98,0.0,15.02,2019,65591
722,43,558,1323,54.57,3.25,42.18,2019,65606
360,0,167,527,68.31,0.0,31.69,2019,65650
240,32,202,474,50.63,6.75,42.62,2019,65017
491,19,130,640,76.72,2.97,20.31,2019,65023
236,19,71,326,72.39,5.83,21.78,2019,65075
293,0,177,470,62.34,0.0,37.66,2019,65080
82,0,12,94,87.23,0.0,12.77,2019,65083
126,12,8,146,86.3,8.22,5.48,2019,65244
127,10,75,212,59.91,4.72,35.38,2019,65258
4457,96,1349,5902,75.52,1.63,22.86,2019,65270
99,3,27,129,76.74,2.33,20.93,2019,65280
685,17,216,918,74.62,1.85,23.53,2019,65281
195,0,81,276,70.65,0.0,29.35,2019,65283
128,0,26,154,83.12,0.0,16.88,2019,65287
71,3,19,93,76.34,3.23,20.43,2019,65344
144,2,51,197,73.1,1.02,25.89,2019,65354
1353,14,434,1801,75.12,0.78,24.1,2019,65360
1952,61,374,2387,81.78,2.56,15.67,2019,65653
140,0,19,159,88.05,0.0,11.95,2019,65731
1487,96,296,1879,79.14,5.11,15.75,2019,65656
465,62,163,690,67.39,8.99,23.62,2019,65658
1927,17,215,2159,89.25,0.79,9.96,2019,65686
1266,55,384,1705,74.25,3.23,22.52,2019,49709
1129,23,176,1328,85.02,1.73,13.25,2019,49715
481,30,86,597,80.57,5.03,14.41,2019,49719
301,1,91,393,76.59,0.25,23.16,2019,49724
247,17,80,344,71.8,4.94,23.26,2019,49705
1706,129,487,2322,73.47,5.56,20.97,2019,49420
4934,112,208,5254,93.91,2.13,3.96,2019,48374
6942,166,675,7783,89.19,2.13,8.67,2019,48377
420,30,127,577,72.79,5.2,22.01,2019,48401
7139,317,1372,8828,80.87,3.59,15.54,2019,48420
2022,73,601,2696,75.0,2.71,22.29,2019,48422
1142,32,87,1261,90.56,2.54,6.9,2019,48145
7050,132,620,7802,90.36,1.69,7.95,2019,48094
21750,317,1385,23452,92.74,1.35,5.91,2019,48103
59,0,0,59,100.0,0.0,0.0,2019,48139
11061,204,1287,12552,88.12,1.63,10.25,2019,48152
12747,202,1379,14328,88.97,1.41,9.62,2019,48154
2470,92,517,3079,80.22,2.99,16.79,2019,48158
4275,245,476,4996,85.57,4.9,9.53,2019,48118
0,5,0,5,0.0,100.0,0.0,2019,48109
14550,1010,1531,17091,85.13,5.91,8.96,2019,48111
9949,266,845,11060,89.95,2.41,7.64,2019,48116
2505,132,342,2979,84.09,4.43,11.48,2019,48131
1678,88,390,2156,77.83,4.08,18.09,2019,48133
10479,1269,2496,14244,73.57,8.91,17.52,2019,48146
2807,36,256,3099,90.58,1.16,8.26,2019,48164
15030,671,1872,17573,85.53,3.82,10.65,2019,48183
8679,620,1771,11070,78.4,5.6,16.0,2019,48192
10191,449,2056,12696,80.27,3.54,16.19,2019,48195
9146,921,3097,13164,69.48,7.0,23.53,2019,48205
7095,665,3045,10805,65.66,6.15,28.18,2019,48212
6968,699,2322,9989,69.76,7.0,23.25,2019,48214
9308,1093,3817,14218,65.47,7.69,26.85,2019,48224
3613,231,418,4262,84.77,5.42,9.81,2019,48226
436,14,160,610,71.48,2.3,26.23,2019,48860
7672,139,1120,8931,85.9,1.56,12.54,2019,48842
237,12,73,322,73.6,3.73,22.67,2019,48845
13260,2199,1772,17231,76.95,12.76,10.28,2019,48858
1466,13,145,1624,90.27,0.8,8.93,2019,48876
2069,74,543,2686,77.03,2.76,20.22,2019,48883
1176,64,373,1613,72.91,3.97,23.12,2019,48884
290,6,78,374,77.54,1.6,20.86,2019,48885
528,16,245,789,66.92,2.03,31.05,2019,48886
8944,325,1446,10715,83.47,3.03,13.5,2019,48080
9862,307,701,10870,90.73,2.82,6.45,2019,48316
6141,66,195,6402,95.92,1.03,3.05,2019,48323
1113,49,286,1448,76.86,3.38,19.75,2019,48759
404,7,174,585,69.06,1.2,29.74,2019,48760
593,52,202,847,70.01,6.14,23.85,2019,48767
1912,96,323,2331,82.02,4.12,13.86,2019,50436
125,3,24,152,82.24,1.97,15.79,2019,50444
312,3,70,385,81.04,0.78,18.18,2019,50008
2748,206,817,3771,72.87,5.46,21.67,2019,50022
86,1,37,124,69.35,0.81,29.84,2019,50051
918,57,161,1136,80.81,5.02,14.17,2019,50054
485,11,59,555,87.39,1.98,10.63,2019,50056
260,15,68,343,75.8,4.37,19.83,2019,50106
335,3,61,399,83.96,0.75,15.29,2019,50118
121,0,19,140,86.43,0.0,13.57,2019,50119
346,18,168,532,65.04,3.38,31.58,2019,49459
6718,284,1733,8735,76.91,3.25,19.84,2019,49601
777,34,109,920,84.46,3.7,11.85,2019,49620
92,6,53,151,60.93,3.97,35.1,2019,49626
1769,98,611,2478,71.39,3.95,24.66,2019,49631
1200,48,222,1470,81.63,3.27,15.1,2019,49635
349,22,119,490,71.22,4.49,24.29,2019,67448
399,2,90,491,81.26,0.41,18.33,2019,67464
757,33,99,889,85.15,3.71,11.14,2019,67017
31,0,18,49,63.27,0.0,36.73,2019,67018
309,8,82,399,77.44,2.01,20.55,2019,67019
87,1,11,99,87.88,1.01,11.11,2019,67041
4475,61,743,5279,84.77,1.16,14.07,2019,67060
1072,34,305,1411,75.97,2.41,21.62,2019,67063
341,12,53,406,83.99,2.96,13.05,2019,67070
40,11,37,88,45.45,12.5,42.05,2019,67072
458,16,157,631,72.58,2.54,24.88,2019,67074
706,77,167,950,74.32,8.11,17.58,2019,67104
445,28,85,558,79.75,5.02,15.23,2019,67108
298,5,76,379,78.63,1.32,20.05,2019,67583
138,7,39,184,75.0,3.8,21.2,2019,67952
2244,74,271,2589,86.67,2.86,10.47,2019,67052
81,1,27,109,74.31,0.92,24.77,2019,67112
10,0,13,23,43.48,0.0,56.52,2019,67334
9663,415,1283,11361,85.05,3.65,11.29,2019,67207
256,4,104,364,70.33,1.1,28.57,2019,67344
182,2,56,240,75.83,0.83,23.33,2019,67859
572,17,161,750,76.27,2.27,21.47,2019,67058
817,27,282,1126,72.56,2.4,25.04,2019,67467
15,0,27,42,35.71,0.0,64.29,2019,67055
179,14,28,221,81.0,6.33,12.67,2019,67223
81,0,22,103,78.64,0.0,21.36,2019,67227
693,0,4,697,99.43,0.0,0.57,2019,67228
157,46,0,203,77.34,22.66,0.0,2019,67232
0,0,0,0,,,,2019,67260
73,0,30,103,70.87,0.0,29.13,2019,67843
59,11,22,92,64.13,11.96,23.91,2019,67155
44,7,12,63,69.84,11.11,19.05,2019,67442
179,17,47,243,73.66,7.0,19.34,2019,67481
4107,126,1131,5364,76.57,2.35,21.09,2019,68776
165,11,27,203,81.28,5.42,13.3,2019,68778
335,21,122,478,70.08,4.39,25.52,2019,68780
510,7,207,724,70.44,0.97,28.59,2019,68784
2179,60,223,2462,88.51,2.44,9.06,2019,68787
57,0,36,93,61.29,0.0,38.71,2019,68816
1954,38,245,2237,87.35,1.7,10.95,2019,68818
89,7,57,153,58.17,4.58,37.25,2019,68820
94,0,33,127,74.02,0.0,25.98,2019,68828
585,23,72,680,86.03,3.38,10.59,2019,68836
78,3,16,97,80.41,3.09,16.49,2019,68846
1137,45,275,1457,78.04,3.09,18.87,2019,68873
0,0,0,0,,,,2019,68881
396,20,72,488,81.15,4.1,14.75,2019,68924
203,4,71,278,73.02,1.44,25.54,2019,68926
499,30,70,599,83.31,5.01,11.69,2019,68930
73,8,33,114,64.04,7.02,28.95,2019,68936
206,0,27,233,88.41,0.0,11.59,2019,68940
236,24,64,324,72.84,7.41,19.75,2019,68941
5,0,6,11,45.45,0.0,54.55,2019,68946
39,0,0,39,100.0,0.0,0.0,2019,71406
1124,16,500,1640,68.54,0.98,30.49,2019,71423
226,27,127,380,59.47,7.11,33.42,2019,71432
817,48,488,1353,60.38,3.55,36.07,2019,71435
482,21,179,682,70.67,3.08,26.25,2019,71438
518,7,184,709,73.06,0.99,25.95,2019,71439
12,0,0,12,100.0,0.0,0.0,2019,49674
42,23,0,65,64.62,35.38,0.0,2019,49717
12,0,3,15,80.0,0.0,20.0,2019,49819
200,1,25,226,88.5,0.44,11.06,2019,49806
45,3,16,64,70.31,4.69,25.0,2019,49863
838,32,183,1053,79.58,3.04,17.38,2019,49945
4855,198,1302,6355,76.4,3.12,20.49,2019,49047
1455,85,222,1762,82.58,4.82,12.6,2019,49117
257,9,58,324,79.32,2.78,17.9,2019,49248
5262,167,880,6309,83.4,2.65,13.95,2019,49319
1928,155,743,2826,68.22,5.48,26.29,2019,49935
2654,77,491,3222,82.37,2.39,15.24,2019,49740
430,15,129,574,74.91,2.61,22.47,2019,49821
799,36,289,1124,71.09,3.2,25.71,2019,49887
513,13,140,666,77.03,1.95,21.02,2019,49729
138,0,20,158,87.34,0.0,12.66,2019,49805
280,14,112,406,68.97,3.45,27.59,2019,49812
421,12,93,526,80.04,2.28,17.68,2019,49814
300,4,124,428,70.09,0.93,28.97,2019,49818
78,0,20,98,79.59,0.0,20.41,2019,49825
247,12,73,332,74.4,3.61,21.99,2019,49831
347,6,187,540,64.26,1.11,34.63,2019,49853
686,16,141,843,81.38,1.9,16.73,2019,49892
39,14,38,91,42.86,15.38,41.76,2019,49902
957,19,124,1100,87.0,1.73,11.27,2019,49916
2110,159,449,2718,77.63,5.85,16.52,2019,49930
314,10,14,338,92.9,2.96,4.14,2019,49934
614,17,272,903,68.0,1.88,30.12,2019,49043
1177,35,238,1450,81.17,2.41,16.41,2019,49076
3632,146,525,4303,84.41,3.39,12.2,2019,49097
1739,141,384,2264,76.81,6.23,16.96,2019,49106
872,43,389,1304,66.87,3.3,29.83,2019,49056
3086,236,733,4055,76.1,5.82,18.08,2019,49007
1215,37,124,1376,88.3,2.69,9.01,2019,49012
1502,52,530,2084,72.07,2.5,25.43,2019,49045
221,6,99,326,67.79,1.84,30.37,2019,49052
2774,330,561,3665,75.69,9.0,15.31,2019,49103
985,47,355,1387,71.02,3.39,25.59,2019,49064
8562,584,1041,10187,84.05,5.73,10.22,2019,49085
4755,183,1277,6215,76.51,2.94,20.55,2019,49090
3305,242,597,4144,79.75,5.84,14.41,2019,49107
11775,727,2667,15169,77.63,4.79,17.58,2019,49120
331,10,138,479,69.1,2.09,28.81,2019,49227
1092,21,132,1245,87.71,1.69,10.6,2019,49246
1281,37,216,1534,83.51,2.41,14.08,2019,49249
1822,85,418,2325,78.37,3.66,17.98,2019,49251
1983,67,181,2231,88.88,3.0,8.11,2019,49265
368,19,72,459,80.17,4.14,15.69,2019,49701
303,7,35,345,87.83,2.03,10.14,2019,49716
6041,252,1065,7358,82.1,3.42,14.47,2019,49093
1319,85,261,1665,79.22,5.11,15.68,2019,49094
909,23,285,1217,74.69,1.89,23.42,2019,49096
1617,151,491,2259,71.58,6.68,21.74,2019,49098
462,25,132,619,74.64,4.04,21.32,2019,52142
590,25,180,795,74.21,3.14,22.64,2019,52157
116,3,24,143,81.12,2.1,16.78,2019,52169
318,12,40,370,85.95,3.24,10.81,2019,52202
2717,68,706,3491,77.83,1.95,20.22,2019,52205
441,8,112,561,78.61,1.43,19.96,2019,52216
2462,112,711,3285,74.95,3.41,21.64,2019,49651
994,103,273,1370,72.55,7.52,19.93,2019,49111
108,3,53,164,65.85,1.83,32.32,2019,49959
218,1,72,291,74.91,0.34,24.74,2019,49725
706,20,136,862,81.9,2.32,15.78,2019,49733
3530,89,659,4278,82.52,2.08,15.4,2019,49738
701,11,124,836,83.85,1.32,14.83,2019,49751
29,5,10,44,65.91,11.36,22.73,2019,49775
1483,78,298,1859,79.77,4.2,16.03,2019,49781
7612,219,1053,8884,85.68,2.47,11.85,2019,49001
6058,123,682,6863,88.27,1.79,9.94,2019,49008
9253,127,1806,11186,82.72,1.14,16.15,2019,49015
779,26,159,964,80.81,2.7,16.49,2019,49026
2320,107,631,3058,75.87,3.5,20.63,2019,49031
2567,372,913,3852,66.64,9.66,23.7,2019,49038
451,26,135,612,73.69,4.25,22.06,2019,49050
6046,180,1338,7564,79.93,2.38,17.69,2019,49058
450,0,132,582,77.32,0.0,22.68,2019,49061
172,5,41,218,78.9,2.29,18.81,2019,49066
2065,39,234,2338,88.32,1.67,10.01,2019,49087
731,20,142,893,81.86,2.24,15.9,2019,49095
3350,168,468,3986,84.04,4.21,11.74,2019,49112
123,29,80,232,53.02,12.5,34.48,2019,49115
1069,66,103,1238,86.35,5.33,8.32,2019,49229
903,3,190,1096,82.39,0.27,17.34,2019,49233
567,30,67,664,85.39,4.52,10.09,2019,49238
172,0,110,282,60.99,0.0,39.01,2019,49894
655,47,191,893,73.35,5.26,21.39,2019,49755
7536,65,514,8115,92.87,0.8,6.33,2019,49316
752,8,220,980,76.73,0.82,22.45,2019,49070
12800,332,2591,15723,81.41,2.11,16.48,2019,49203
272,0,76,348,78.16,0.0,21.84,2019,49303
7287,349,1384,9020,80.79,3.87,15.34,2019,49036
28,4,22,54,51.85,7.41,40.74,2019,49075
4382,176,692,5250,83.47,3.35,13.18,2019,49079
1754,38,556,2348,74.7,1.62,23.68,2019,49082
6041,197,1567,7805,77.4,2.52,20.08,2019,49091
1135,85,223,1443,78.66,5.89,15.45,2019,49128
648,31,274,953,68.0,3.25,28.75,2019,49232
1003,22,262,1287,77.93,1.71,20.36,2019,49253
1174,11,325,1510,77.75,0.73,21.52,2019,49254
5169,108,639,5916,87.37,1.83,10.8,2019,49286
439,30,83,552,79.53,5.43,15.04,2019,49318
2379,93,679,3151,75.5,2.95,21.55,2019,49327
984,64,172,1220,80.66,5.25,14.1,2019,49101
6437,573,1616,8626,74.62,6.64,18.73,2019,49202
986,15,128,1129,87.33,1.33,11.34,2019,49283
3972,152,721,4845,81.98,3.14,14.88,2019,49348
534,31,135,700,76.29,4.43,19.29,2019,49436
805,23,204,1032,78.0,2.23,19.77,2019,49614
10448,939,1417,12804,81.6,7.33,11.07,2019,49855
424,39,156,619,68.5,6.3,25.2,2019,49950
84,0,0,84,100.0,0.0,0.0,2019,49666
0,0,29,29,0.0,0.0,100.0,2019,53599
65,0,0,65,100.0,0.0,0.0,2019,53702
2270,44,70,2384,95.22,1.85,2.94,2019,53726
0,0,0,0,,,,2019,53792
22,0,3,25,88.0,0.0,12.0,2019,53802
4226,156,579,4961,85.18,3.14,11.67,2019,53534
199,35,44,278,71.58,12.59,15.83,2019,48432
37,2,7,46,80.43,4.35,15.22,2019,48434
7405,555,3599,11559,64.06,4.8,31.14,2019,48503
1027,31,325,1383,74.26,2.24,23.5,2019,48610
375,19,163,557,67.32,3.41,29.26,2019,48614
354,8,145,507,69.82,1.58,28.6,2019,48621
1852,52,391,2295,80.7,2.27,17.04,2019,48622
4745,228,1746,6719,70.62,3.39,25.99,2019,48624
182,0,62,244,74.59,0.0,25.41,2019,48721
1039,13,235,1287,80.73,1.01,18.26,2019,48722
399,7,194,600,66.5,1.17,32.33,2019,48737
2561,78,542,3181,80.51,2.45,17.04,2019,48746
8549,108,474,9131,93.63,1.18,5.19,2019,48009
4800,191,696,5687,84.4,3.36,12.24,2019,48017
18262,202,884,19348,94.39,1.04,4.57,2019,48044
779,1,188,968,80.48,0.1,19.42,2019,48414
3060,157,484,3701,82.68,4.24,13.08,2019,48415
882,33,169,1084,81.37,3.04,15.59,2019,48417
726,47,191,964,75.31,4.88,19.81,2019,48419
9263,439,1847,11549,80.21,3.8,15.99,2019,48162
3645,101,653,4399,82.86,2.3,14.84,2019,48166
7677,402,574,8653,88.72,4.65,6.63,2019,48169
14434,256,588,15278,94.48,1.68,3.85,2019,48188
78,0,0,78,100.0,0.0,0.0,2019,48190
5578,823,2016,8417,66.27,9.78,23.95,2019,48201
4971,750,4151,9872,50.35,7.6,42.05,2019,48203
2384,415,1384,4183,56.99,9.92,33.09,2019,48208
1330,76,650,2056,64.69,3.7,31.61,2019,48211
13318,998,5617,19933,66.81,5.01,28.18,2019,48228
5821,206,450,6477,89.87,3.18,6.95,2019,48230
11064,350,2315,13729,80.59,2.55,16.86,2019,48239
16434,377,1189,18000,91.3,2.09,6.61,2019,48307
2452,48,230,2730,89.82,1.76,8.42,2019,48350
2655,189,303,3147,84.37,6.01,9.63,2019,48357
3493,9,239,3741,93.37,0.24,6.39,2019,48359
2064,19,155,2238,92.23,0.85,6.93,2019,48363
2111,160,657,2928,72.1,5.46,22.44,2019,48413
11483,609,1904,13996,82.04,4.35,13.6,2019,48423
228,34,137,399,57.14,8.52,34.34,2019,48426
2858,197,778,3833,74.56,5.14,20.3,2019,48429
9337,502,1125,10964,85.16,4.58,10.26,2019,48101
2554,352,818,3724,68.58,9.45,21.97,2019,48122
9828,608,1196,11632,84.49,5.23,10.28,2019,48124
5354,144,288,5786,92.53,2.49,4.98,2019,48130
1690,144,238,2072,81.56,6.95,11.49,2019,48137
734,28,174,936,78.42,2.99,18.59,2019,48159
721,55,177,953,75.66,5.77,18.57,2019,48877
419,19,107,545,76.88,3.49,19.63,2019,48878
10239,426,1970,12635,81.04,3.37,15.59,2019,48021
1762,8,224,1994,88.37,0.4,11.23,2019,48023
12270,265,1943,14478,84.75,1.83,13.42,2019,48035
9102,273,2020,11395,79.88,2.4,17.73,2019,48867
1602,78,326,2006,79.86,3.89,16.25,2019,48893
2891,120,483,3494,82.74,3.43,13.82,2019,49712
4746,225,1252,6223,76.27,3.62,20.12,2019,49721
77,0,62,139,55.4,0.0,44.6,2019,49722
79,8,27,114,69.3,7.02,23.68,2019,49728
6798,235,1029,8062,84.32,2.91,12.76,2019,49735
659,16,166,841,78.36,1.9,19.74,2019,49730
200,0,43,243,82.3,0.0,17.7,2019,71466
158,6,53,217,72.81,2.76,24.42,2019,71480
4094,784,1490,6368,64.29,12.31,23.4,2019,71104
834,0,461,1295,64.4,0.0,35.6,2019,71067
662,37,312,1011,65.48,3.66,30.86,2019,71071
1089,313,1445,2847,38.25,10.99,50.76,2019,71101
7410,1067,1336,9813,75.51,10.87,13.61,2019,71105
271,32,199,502,53.98,6.37,39.64,2019,71219
17,7,53,77,22.08,9.09,68.83,2019,71253
1294,201,1473,2968,43.6,6.77,49.63,2019,71263
9760,508,3024,13292,73.43,3.82,22.75,2019,71291
7470,243,1217,8930,83.65,2.72,13.63,2019,71303
1742,105,546,2393,72.8,4.39,22.82,2019,71322
2265,78,1122,3465,65.37,2.25,32.38,2019,71334
186,0,156,342,54.39,0.0,45.61,2019,71340
664,59,279,1002,66.27,5.89,27.84,2019,71346
665,42,282,989,67.24,4.25,28.51,2019,71369
54,0,13,67,80.6,0.0,19.4,2019,71377
1609,20,409,2038,78.95,0.98,20.07,2019,71409
735,37,583,1355,54.24,2.73,43.03,2019,71411
6323,468,3189,9980,63.36,4.69,31.95,2019,71457
98,9,183,290,33.79,3.1,63.1,2019,71468
114,0,88,202,56.44,0.0,43.56,2019,71473
236,10,94,340,69.41,2.94,27.65,2019,71479
87,14,95,196,44.39,7.14,48.47,2019,71630
5370,98,2088,7556,71.07,1.3,27.63,2019,71292
12,0,9,21,57.14,0.0,42.86,2019,71316
160,16,132,308,51.95,5.19,42.86,2019,71326
273,52,98,423,64.54,12.29,23.17,2019,71331
705,34,390,1129,62.44,3.01,34.54,2019,71749
578,38,360,976,59.22,3.89,36.89,2019,71720
96,6,94,196,48.98,3.06,47.96,2019,71725
7717,739,3463,11919,64.75,6.2,29.05,2019,71730
151,41,159,351,43.02,11.68,45.3,2019,71751
582,26,301,909,64.03,2.86,33.11,2019,71762
8,0,0,8,100.0,0.0,0.0,2019,71820
143,3,25,171,83.63,1.75,14.62,2019,71825
272,5,134,411,66.18,1.22,32.6,2019,71826
248,12,128,388,63.92,3.09,32.99,2019,71841
696,24,147,867,80.28,2.77,16.96,2019,71842
528,48,225,801,65.92,5.99,28.09,2019,71851
2532,211,1020,3763,67.29,5.61,27.11,2019,71852
10548,488,2806,13842,76.2,3.53,20.27,2019,71854
1435,21,615,2071,69.29,1.01,29.7,2019,71857
130,2,185,317,41.01,0.63,58.36,2019,71862
5439,394,1447,7280,74.71,5.41,19.88,2019,71037
453,54,175,682,66.42,7.92,25.66,2019,71061
1246,102,1036,2384,52.27,4.28,43.46,2019,71103
9775,365,2829,12969,75.37,2.81,21.81,2019,71106
7361,1159,3553,12073,60.97,9.6,29.43,2019,71107
8889,1949,3098,13936,63.78,13.99,22.23,2019,71112
3874,183,1001,5058,76.59,3.62,19.79,2019,71129
547,27,611,1185,46.16,2.28,51.56,2019,71222
843,28,23,894,94.3,3.13,2.57,2019,54141
97,0,21,118,82.2,0.0,17.8,2019,54160
922,11,283,1216,75.82,0.9,23.27,2019,54161
995,8,41,1044,95.31,0.77,3.93,2019,54169
386,18,84,488,79.1,3.69,17.21,2019,54175
337,5,47,389,86.63,1.29,12.08,2019,54210
1076,24,82,1182,91.03,2.03,6.94,2019,52228
12920,644,1714,15278,84.57,4.22,11.22,2019,52240
159,0,76,235,67.66,0.0,32.34,2019,52251
285,12,85,382,74.61,3.14,22.25,2019,52254
18,3,4,25,72.0,12.0,16.0,2019,52312
420,11,71,502,83.67,2.19,14.14,2019,52315
275,4,67,346,79.48,1.16,19.36,2019,52323
241,0,77,318,75.79,0.0,24.21,2019,52335
793,46,94,933,84.99,4.93,10.08,2019,52336
1032,78,335,1445,71.42,5.4,23.18,2019,52339
8113,331,1300,9744,83.26,3.4,13.34,2019,52403
107,6,28,141,75.89,4.26,19.86,2019,52542
39,0,1,40,97.5,0.0,2.5,2019,52548
551,16,144,711,77.5,2.25,20.25,2019,52553
531,47,194,772,68.78,6.09,25.13,2019,52565
8762,236,1890,10888,80.47,2.17,17.36,2019,52806
333,7,107,447,74.5,1.57,23.94,2019,52037
454,44,109,607,74.79,7.25,17.96,2019,52032
279,1,67,347,80.4,0.29,19.31,2019,52054
332,10,105,447,74.27,2.24,23.49,2019,52065
98,0,15,113,86.73,0.0,13.27,2019,52072
107,0,24,131,81.68,0.0,18.32,2019,52074
202,13,79,294,68.71,4.42,26.87,2019,52078
4291,114,718,5123,83.76,2.23,14.02,2019,52101
93,0,6,99,93.94,0.0,6.06,2019,52758
311,10,74,395,78.73,2.53,18.73,2019,52035
134,43,26,203,66.01,21.18,12.81,2019,52038
262,1,76,339,77.29,0.29,22.42,2019,52039
204,11,56,271,75.28,4.06,20.66,2019,52047
1784,51,324,2159,82.63,2.36,15.01,2019,52031
743,35,106,884,84.05,3.96,11.99,2019,52046
1118,51,180,1349,82.88,3.78,13.34,2019,52214
694,13,117,824,84.22,1.58,14.2,2019,52224
61,0,38,99,61.62,0.0,38.38,2019,52231
65,1,9,75,86.67,1.33,12.0,2019,52232
241,13,31,285,84.56,4.56,10.88,2019,52236
601,8,108,717,83.82,1.12,15.06,2019,52248
283,9,60,352,80.4,2.56,17.05,2019,52329
299,10,95,404,74.01,2.48,23.51,2019,52585
1720,55,843,2618,65.7,2.1,32.2,2019,52537
424,7,161,592,71.62,1.18,27.2,2019,52554
150,7,120,277,54.15,2.53,43.32,2019,52569
9,0,0,9,100.0,0.0,0.0,2019,52588
125,6,20,151,82.78,3.97,13.25,2019,52646
829,7,233,1069,77.55,0.65,21.8,2019,52656
263,30,105,398,66.08,7.54,26.38,2019,52658
270,6,50,326,82.82,1.84,15.34,2019,52720
149,6,84,239,62.34,2.51,35.15,2019,52745
310,13,21,344,90.12,3.78,6.1,2019,52749
325,4,49,378,85.98,1.06,12.96,2019,52751
160,2,33,195,82.05,1.03,16.92,2019,52752
673,31,33,737,91.32,4.21,4.48,2019,52756
434,16,149,599,72.45,2.67,24.87,2019,52042
9580,146,522,10248,93.48,1.42,5.09,2019,55378
911,14,196,1121,81.27,1.25,17.48,2019,55395
697,14,199,910,76.59,1.54,21.87,2019,55396
909,50,102,1061,85.67,4.71,9.61,2019,55397
5041,138,307,5486,91.89,2.52,5.6,2019,55398
5990,485,270,6745,88.81,7.19,4.0,2019,55401
14321,398,1195,15914,89.99,2.5,7.51,2019,53590
12623,263,993,13879,90.95,1.89,7.15,2019,53066
5206,217,758,6181,84.23,3.51,12.26,2019,53073
4861,103,575,5539,87.76,1.86,10.38,2019,53074
2923,46,294,3263,89.58,1.41,9.01,2019,53086
6911,113,408,7432,92.99,1.52,5.49,2019,53089
738,23,100,861,85.71,2.67,11.61,2019,53091
6419,167,952,7538,85.16,2.22,12.63,2019,53121
2076,37,174,2287,90.77,1.62,7.61,2019,53122
2296,108,291,2695,85.19,4.01,10.8,2019,53126
2687,71,383,3141,85.55,2.26,12.19,2019,53130
11931,294,1428,13653,87.39,2.15,10.46,2019,53132
565,19,83,667,84.71,2.85,12.44,2019,53137
10904,309,1150,12363,88.2,2.5,9.3,2019,53142
6214,225,848,7287,85.28,3.09,11.64,2019,53147
5594,137,603,6334,88.32,2.16,9.52,2019,53158
2946,139,335,3420,86.14,4.06,9.8,2019,53168
7146,232,1229,8607,83.03,2.7,14.28,2019,53172
254,7,58,319,79.62,2.19,18.18,2019,53544
6102,173,832,7107,85.86,2.43,11.71,2019,53714
3904,554,422,4880,80.0,11.35,8.65,2019,53715
7089,289,739,8117,87.34,3.56,9.1,2019,53716
6056,292,350,6698,90.42,4.36,5.23,2019,53718
584,30,161,775,75.35,3.87,20.77,2019,53806
184,2,38,224,82.14,0.89,16.96,2019,53553
5116,260,1146,6522,78.44,3.99,17.57,2019,53566
1235,61,200,1496,82.55,4.08,13.37,2019,53574
2270,83,333,2686,84.51,3.09,12.4,2019,53578
13169,592,5347,19108,68.92,3.1,27.98,2019,53215
10522,127,788,11437,92.0,1.11,6.89,2019,53217
8161,410,1959,10530,77.5,3.89,18.6,2019,53403
8451,212,1554,10217,82.72,2.07,15.21,2019,53405
9272,210,1422,10904,85.03,1.93,13.04,2019,53406
655,34,141,830,78.92,4.1,16.99,2019,53503
1256,11,187,1454,86.38,0.76,12.86,2019,53521
3344,145,363,3852,86.81,3.76,9.42,2019,53527
1612,40,103,1755,91.85,2.28,5.87,2019,53531
263,2,63,328,80.18,0.61,19.21,2019,53537
1627,47,345,2019,80.58,2.33,17.09,2019,53565
3500,71,350,3921,89.26,1.81,8.93,2019,53572
49,0,14,63,77.78,0.0,22.22,2019,53003
465,6,69,540,86.11,1.11,12.78,2019,53023
7515,65,408,7988,94.08,0.81,5.11,2019,53029
787,18,133,938,83.9,1.92,14.18,2019,53035
3578,72,312,3962,90.31,1.82,7.87,2019,53037
2344,70,433,2847,82.33,2.46,15.21,2019,53042
633,7,102,742,85.31,0.94,13.75,2019,53059
1840,46,227,2113,87.08,2.18,10.74,2019,53061
1376,54,60,1490,92.35,3.62,4.03,2019,53076
695,15,77,787,88.31,1.91,9.78,2019,53093
9767,389,1531,11687,83.57,3.33,13.1,2019,53095
841,10,35,886,94.92,1.13,3.95,2019,53153
2326,45,149,2520,92.3,1.79,5.91,2019,53179
674,4,147,825,81.7,0.48,17.82,2019,56222
69,5,13,87,79.31,5.75,14.94,2019,56227
946,37,186,1169,80.92,3.17,15.91,2019,56256
277,2,68,347,79.83,0.58,19.6,2019,56260
1631,52,318,2001,81.51,2.6,15.89,2019,56273
849,88,325,1262,67.27,6.97,25.75,2019,56277
439,8,71,518,84.75,1.54,13.71,2019,57055
429,40,181,650,66.0,6.15,27.85,2019,57070
235,8,51,294,79.93,2.72,17.35,2019,57072
159,0,30,189,84.13,0.0,15.87,2019,57076
8748,460,2430,11638,75.17,3.95,20.88,2019,57104
400,9,83,492,81.3,1.83,16.87,2019,57223
548,22,146,716,76.54,3.07,20.39,2019,57231
1429,93,452,1974,72.39,4.71,22.9,2019,57262
406,26,72,504,80.56,5.16,14.29,2019,57018
984,46,177,1207,81.52,3.81,14.66,2019,57025
8599,171,828,9598,89.59,1.78,8.63,2019,57105
220,26,47,293,75.09,8.87,16.04,2019,57213
418,55,111,584,71.58,9.42,19.01,2019,57216
288,12,58,358,80.45,3.35,16.2,2019,57260
388,9,109,506,76.68,1.78,21.54,2019,57315
99,3,35,137,72.26,2.19,25.55,2019,57329
510,22,73,605,84.3,3.64,12.07,2019,57017
120,3,6,129,93.02,2.33,4.65,2019,57465
854,45,294,1193,71.58,3.77,24.64,2019,59538
53,4,13,70,75.71,5.71,18.57,2019,59544
148,0,76,224,66.07,0.0,33.93,2019,59008
128,0,72,200,64.0,0.0,36.0,2019,59024
314,4,53,371,84.64,1.08,14.29,2019,59027
547,30,131,708,77.26,4.24,18.5,2019,59041
166,0,16,182,91.21,0.0,8.79,2019,59344
268,18,143,429,62.47,4.2,33.33,2019,59414
106,0,11,117,90.6,0.0,9.4,2019,59416
38,4,44,86,44.19,4.65,51.16,2019,59444
55,17,12,84,65.48,20.24,14.29,2019,59462
12,0,8,20,60.0,0.0,40.0,2019,59465
173,0,46,219,79.0,0.0,21.0,2019,59483
312,16,82,410,76.1,3.9,20.0,2019,59520
482,34,177,693,69.55,4.91,25.54,2019,59522
27,0,7,34,79.41,0.0,20.59,2019,59535
11520,380,1975,13875,83.03,2.74,14.23,2019,59601
53,0,133,186,28.49,0.0,71.51,2019,59643
2963,80,946,3989,74.28,2.01,23.72,2019,59711
623,35,76,734,84.88,4.77,10.35,2019,59001
37,0,10,47,78.72,0.0,21.28,2019,59002
1016,56,275,1347,75.43,4.16,20.42,2019,59011
1328,26,249,1603,82.84,1.62,15.53,2019,59019
47,5,44,96,48.96,5.21,45.83,2019,59026
1233,96,353,1682,73.31,5.71,20.99,2019,59034
66,0,9,75,88.0,0.0,12.0,2019,59035
127,4,39,170,74.71,2.35,22.94,2019,59046
310,4,95,409,75.79,0.98,23.23,2019,59070
1527,21,421,1969,77.55,1.07,21.38,2019,59072
121,0,54,175,69.14,0.0,30.86,2019,59074
24,0,0,24,100.0,0.0,0.0,2019,59077
67,0,71,138,48.55,0.0,51.45,2019,59089
357,5,86,448,79.69,1.12,19.2,2019,59324
731,33,329,1093,66.88,3.02,30.1,2019,59327
337,9,93,439,76.77,2.05,21.18,2019,59349
415,0,76,491,84.52,0.0,15.48,2019,65710
6092,471,1051,7614,80.01,6.19,13.8,2019,65738
1476,38,261,1775,83.15,2.14,14.7,2019,65753
164,0,43,207,79.23,0.0,20.77,2019,65756
131,4,44,179,73.18,2.23,24.58,2019,65676
77,2,30,109,70.64,1.83,27.52,2019,65543
60,10,14,84,71.43,11.9,16.67,2019,54536
388,25,95,508,76.38,4.92,18.7,2019,54554
798,83,160,1041,76.66,7.97,15.37,2019,54558
3157,120,860,4137,76.31,2.9,20.79,2019,54615
661,15,155,831,79.54,1.81,18.65,2019,54642
493,29,179,701,70.33,4.14,25.53,2019,54655
2692,28,357,3077,87.49,0.91,11.6,2019,54669
686,17,160,863,79.49,1.97,18.54,2019,54740
1625,35,225,1885,86.21,1.86,11.94,2019,54742
346,9,90,445,77.75,2.02,20.22,2019,54761
333,16,114,463,71.92,3.46,24.62,2019,54763
1244,28,411,1683,73.92,1.66,24.42,2019,54768
480,12,58,550,87.27,2.18,10.55,2019,54213
6439,227,1444,8110,79.4,2.8,17.81,2019,54235
7837,142,1220,9199,85.19,1.54,13.26,2019,54301
13783,216,946,14945,92.22,1.45,6.33,2019,54313
4482,139,1066,5687,78.81,2.44,18.74,2019,54409
690,15,136,841,82.05,1.78,16.17,2019,54412
772,7,122,901,85.68,0.78,13.54,2019,54423
539,15,140,694,77.67,2.16,20.17,2019,54424
37,2,18,57,64.91,3.51,31.58,2019,54430
684,9,133,826,82.81,1.09,16.1,2019,54443
2941,69,637,3647,80.64,1.89,17.47,2019,54457
6777,72,795,7644,88.66,0.94,10.4,2019,54476
659,10,223,892,73.88,1.12,25.0,2019,54486
3610,76,740,4426,81.56,1.72,16.72,2019,54487
2728,78,550,3356,81.29,2.32,16.39,2019,54495
934,46,248,1228,76.06,3.75,20.2,2019,54499
700,6,147,853,82.06,0.7,17.23,2019,54514
230,8,108,346,66.47,2.31,31.21,2019,54526
104,7,76,187,55.61,3.74,40.64,2019,54564
747,19,238,1004,74.4,1.89,23.71,2019,54616
752,12,123,887,84.78,1.35,13.87,2019,54622
391,10,117,518,75.48,1.93,22.59,2019,54626
624,18,102,744,83.87,2.42,13.71,2019,54627
527,15,168,710,74.23,2.11,23.66,2019,54631
705,43,281,1029,68.51,4.18,27.31,2019,54639
5719,101,1249,7069,80.9,1.43,17.67,2019,54656
5241,148,1163,6552,79.99,2.26,17.75,2019,54660
212,10,77,299,70.9,3.34,25.75,2019,54731
193,5,18,216,89.35,2.31,8.33,2019,54737
345,6,78,429,80.42,1.4,18.18,2019,54772
1445,127,371,1943,74.37,6.54,19.09,2019,54812
659,33,285,977,67.45,3.38,29.17,2019,54824
159,5,48,212,75.0,2.36,22.64,2019,54846
451,10,52,513,87.91,1.95,10.14,2019,54864
603,27,88,718,83.98,3.76,12.26,2019,54870
213,0,0,213,100.0,0.0,0.0,2019,54927
1197,46,326,1569,76.29,2.93,20.78,2019,54945
368,14,121,503,73.16,2.78,24.06,2019,54962
1089,26,248,1363,79.9,1.91,18.2,2019,54984
49,2,8,59,83.05,3.39,13.56,2019,54517
932,46,221,1199,77.73,3.84,18.43,2019,54534
2121,24,234,2379,89.16,1.01,9.84,2019,56367
1201,13,289,1503,79.91,0.86,19.23,2019,56484
61,8,24,93,65.59,8.6,25.81,2019,56543
108,3,32,143,75.52,2.1,22.38,2019,56627
164,3,55,222,73.87,1.35,24.77,2019,56652
4461,286,828,5575,80.02,5.13,14.85,2019,56701
13631,513,1427,15571,87.54,3.29,9.16,2019,55406
6963,331,2170,9464,73.57,3.5,22.93,2019,55411
7185,276,1069,8530,84.23,3.24,12.53,2019,55420
9730,202,1787,11719,83.03,1.72,15.25,2019,55421
7859,273,884,9016,87.17,3.03,9.8,2019,55313
1293,0,53,1346,96.06,0.0,3.94,2019,55327
533,35,172,740,72.03,4.73,23.24,2019,55332
245,24,62,331,74.02,7.25,18.73,2019,55333
462,19,147,628,73.57,3.03,23.41,2019,55335
368,12,51,431,85.38,2.78,11.83,2019,55339
1776,60,227,2063,86.09,2.91,11.0,2019,55358
1401,41,194,1636,85.64,2.51,11.86,2019,55363
14899,442,1253,16594,89.79,2.66,7.55,2019,55416
1944,45,185,2174,89.42,2.07,8.51,2019,55373
666,11,141,818,81.42,1.34,17.24,2019,55381
415,19,93,527,78.75,3.61,17.65,2019,55385
9715,400,752,10867,89.4,3.68,6.92,2019,55417
308,15,64,387,79.59,3.88,16.54,2019,55970
2526,154,374,3054,82.71,5.04,12.25,2019,55976
48,0,21,69,69.57,0.0,30.43,2019,55977
1806,23,188,2017,89.54,1.14,9.32,2019,55992
4875,172,420,5467,89.17,3.15,7.68,2019,55442
3436,167,394,3997,85.96,4.18,9.86,2019,55425
12106,182,1473,13761,87.97,1.32,10.7,2019,55433
10068,219,1091,11378,88.49,1.92,9.59,2019,55434
1955,432,1067,3454,56.6,12.51,30.89,2019,55454
0,0,0,0,,,,2019,55455
1014,86,245,1345,75.39,6.39,18.22,2019,55707
1292,29,305,1626,79.46,1.78,18.76,2019,55709
1075,6,272,1353,79.45,0.44,20.1,2019,55721
150,9,49,208,72.12,4.33,23.56,2019,55738
109,2,24,135,80.74,1.48,17.78,2019,55742
163,0,37,200,81.5,0.0,18.5,2019,55749
1098,58,322,1478,74.29,3.92,21.79,2019,55760
212,5,41,258,82.17,1.94,15.89,2019,55787
204,6,48,258,79.07,2.33,18.6,2019,55798
2813,166,598,3577,78.64,4.64,16.72,2019,55810
9099,452,1572,11123,81.8,4.06,14.13,2019,55811
20261,974,1642,22877,88.56,4.26,7.18,2019,55901
9125,305,1139,10569,86.34,2.89,10.78,2019,55904
385,15,88,488,78.89,3.07,18.03,2019,55910
9191,371,1850,11412,80.54,3.25,16.21,2019,55912
399,22,54,475,84.0,4.63,11.37,2019,55929
714,17,94,825,86.55,2.06,11.39,2019,55932
510,40,212,762,66.93,5.25,27.82,2019,55939
551,36,120,707,77.93,5.09,16.97,2019,55949
466,18,113,597,78.06,3.02,18.93,2019,55954
871,36,164,1071,81.33,3.36,15.31,2019,55965
10213,135,389,10737,95.12,1.26,3.62,2019,55419
3305,80,122,3507,94.24,2.28,3.48,2019,55424
4741,140,1057,5938,79.84,2.36,17.8,2019,55008
3380,109,238,3727,90.69,2.92,6.39,2019,55011
693,10,48,751,92.28,1.33,6.39,2019,55019
369,28,114,511,72.21,5.48,22.31,2019,64859
255,25,38,318,80.19,7.86,11.95,2019,64461
4805,96,850,5751,83.55,1.67,14.78,2019,64468
496,2,174,672,73.81,0.3,25.89,2019,64470
798,43,195,1036,77.03,4.15,18.82,2019,64482
3773,118,1239,5130,73.55,2.3,24.15,2019,64505
1066,8,190,1264,84.34,0.63,15.03,2019,56278
142,6,63,211,67.3,2.84,29.86,2019,56292
10628,491,908,12027,88.37,4.08,7.55,2019,56301
243,10,58,311,78.14,3.22,18.65,2019,56311
359,9,59,427,84.07,2.11,13.82,2019,56318
570,15,84,669,85.2,2.24,12.56,2019,56332
507,29,104,640,79.22,4.53,16.25,2019,56336
2856,79,582,3517,81.21,2.25,16.55,2019,56353
580,18,167,765,75.82,2.35,21.83,2019,56433
590,13,107,710,83.1,1.83,15.07,2019,56449
760,10,139,909,83.61,1.1,15.29,2019,56465
656,29,156,841,78.0,3.45,18.55,2019,56481
2097,74,663,2834,73.99,2.61,23.39,2019,56482
229,7,83,319,71.79,2.19,26.02,2019,56527
711,35,124,870,81.72,4.02,14.25,2019,56531
108,12,53,173,62.43,6.94,30.64,2019,56536
925,35,222,1182,78.26,2.96,18.78,2019,56542
932,57,270,1259,74.03,4.53,21.45,2019,56567
1663,44,458,2165,76.81,2.03,21.15,2019,56572
2142,109,579,2830,75.69,3.85,20.46,2019,56573
494,8,107,609,81.12,1.31,17.57,2019,56587
11395,460,1780,13635,83.57,3.37,13.05,2019,56601
75,0,12,87,86.21,0.0,13.79,2019,56637
48,5,29,82,58.54,6.1,35.37,2019,56663
46,1,13,60,76.67,1.67,21.67,2019,56688
123,16,26,165,74.55,9.7,15.76,2019,56733
210,46,51,307,68.4,14.98,16.61,2019,56735
2705,30,353,3088,87.6,0.97,11.43,2019,56011
621,19,157,797,77.92,2.38,19.7,2019,56026
136,0,30,166,81.93,0.0,18.07,2019,56035
339,9,48,396,85.61,2.27,12.12,2019,56054
777,9,126,912,85.2,0.99,13.82,2019,56072
2006,137,402,2545,78.82,5.38,15.8,2019,56101
309,11,62,382,80.89,2.88,16.23,2019,56119
732,51,165,948,77.22,5.38,17.41,2019,56131
159,15,37,211,75.36,7.11,17.54,2019,56132
300,5,66,371,80.86,1.35,17.79,2019,56138
220,6,60,286,76.92,2.1,20.98,2019,56157
1932,91,376,2399,80.53,3.79,15.67,2019,56164
238,8,64,310,76.77,2.58,20.65,2019,56167
254,4,68,326,77.91,1.23,20.86,2019,56168
345,17,106,468,73.72,3.63,22.65,2019,56180
7490,196,1391,9077,82.52,2.16,15.32,2019,56201
162,4,20,186,87.1,2.15,10.75,2019,56025
4268,78,915,5261,81.13,1.48,17.39,2019,56031
360,11,81,452,79.65,2.43,17.92,2019,56041
234,10,60,304,76.97,3.29,19.74,2019,56051
673,21,100,794,84.76,2.64,12.59,2019,56074
74,2,6,82,90.24,2.44,7.32,2019,56075
110,0,30,140,78.57,0.0,21.43,2019,56255
227,12,42,281,80.78,4.27,14.95,2019,56090
1166,63,316,1545,75.47,4.08,20.45,2019,56097
168,19,69,256,65.62,7.42,26.95,2019,56122
955,91,136,1182,80.8,7.7,11.51,2019,62903
13,0,0,13,100.0,0.0,0.0,2019,62961
32,0,2,34,94.12,0.0,5.88,2019,62965
84,15,34,133,63.16,11.28,25.56,2019,62413
223,19,129,371,60.11,5.12,34.77,2019,62268
234,6,92,332,70.48,1.81,27.71,2019,62343
79,0,18,97,81.44,0.0,18.56,2019,65529
359,7,116,482,74.48,1.45,24.07,2019,65535
1305,162,498,1965,66.41,8.24,25.34,2019,65542
244,38,54,336,72.62,11.31,16.07,2019,65566
560,58,321,939,59.64,6.18,34.19,2019,65582
3779,280,487,4546,83.13,6.16,10.71,2019,65583
1430,51,399,1880,76.06,2.71,21.22,2019,65610
688,44,168,900,76.44,4.89,18.67,2019,65611
1705,43,284,2032,83.91,2.12,13.98,2019,65631
1137,66,312,1515,75.05,4.36,20.59,2019,65633
141,8,78,227,62.11,3.52,34.36,2019,65230
1718,45,496,2259,76.05,1.99,21.96,2019,65648
528,12,152,692,76.3,1.73,21.97,2019,65649
762,28,309,1099,69.34,2.55,28.12,2019,65661
701,16,160,877,79.93,1.82,18.24,2019,65707
183,3,174,360,50.83,0.83,48.33,2019,65720
9877,307,1444,11628,84.94,2.64,12.42,2019,65721
0,0,0,0,,,,2019,65730
5,0,27,32,15.62,0.0,84.38,2019,65735
3741,173,1075,4989,74.98,3.47,21.55,2019,65742
1495,90,942,2527,59.16,3.56,37.28,2019,65746
126,12,33,171,73.68,7.02,19.3,2019,65752
396,94,275,765,51.76,12.29,35.95,2019,65772
7932,652,763,9347,84.86,6.98,8.16,2019,65810
388,49,169,606,64.03,8.09,27.89,2019,65276
624,6,120,750,83.2,0.8,16.0,2019,65279
731,13,77,821,89.04,1.58,9.38,2019,65284
192,0,27,219,87.67,0.0,12.33,2019,65285
29,0,6,35,82.86,0.0,17.14,2019,65286
959,5,7,971,98.76,0.51,0.72,2019,65305
797,36,355,1188,67.09,3.03,29.88,2019,65338
826,20,208,1054,78.37,1.9,19.73,2019,65349
602,26,112,740,81.35,3.51,15.14,2019,65350
13956,1176,4099,19231,72.57,6.12,21.31,2019,65802
367,85,265,717,51.19,11.85,36.96,2019,65011
183,22,44,249,73.49,8.84,17.67,2019,65025
897,9,69,975,92.0,0.92,7.08,2019,65039
1001,58,213,1272,78.69,4.56,16.75,2019,65052
2068,57,303,2428,85.17,2.35,12.48,2019,65066
1501,66,199,1766,84.99,3.74,11.27,2019,65079
1531,162,669,2362,64.82,6.86,28.32,2019,65084
3161,332,1125,4618,68.45,7.19,24.36,2019,65026
3200,242,685,4127,77.54,5.86,16.6,2019,65043
224,6,208,438,51.14,1.37,47.49,2019,65058
220,60,29,309,71.2,19.42,9.39,2019,65059
195,16,85,296,65.88,5.41,28.72,2019,65076
287,0,91,378,75.93,0.0,24.07,2019,65082
330,14,151,495,66.67,2.83,30.51,2019,65085
15995,492,2828,19315,82.81,2.55,14.64,2019,65202
3350,153,761,4264,78.56,3.59,17.85,2019,65233
230,15,111,356,64.61,4.21,31.18,2019,65237
10293,311,2493,13097,78.59,2.37,19.03,2019,65301
131,2,38,171,76.61,1.17,22.22,2019,65330
129,2,26,157,82.17,1.27,16.56,2019,68337
143,4,23,170,84.12,2.35,13.53,2019,68344
67,1,25,93,72.04,1.08,26.88,2019,68350
330,6,53,389,84.83,1.54,13.62,2019,68351
97,4,27,128,75.78,3.12,21.09,2019,68357
92,0,25,117,78.63,0.0,21.37,2019,68365
111,47,21,179,62.01,26.26,11.73,2019,56761
411,132,73,616,66.72,21.43,11.85,2019,56728
1104,0,215,1319,83.7,0.0,16.3,2019,63072
122,15,19,156,78.21,9.62,12.18,2019,63438
336,4,108,448,75.0,0.89,24.11,2019,63441
993,68,354,1415,70.18,4.81,25.02,2019,63445
79,5,35,119,66.39,4.2,29.41,2019,63460
199,1,62,262,75.95,0.38,23.66,2019,63533
575,55,297,927,62.03,5.93,32.04,2019,63549
121,24,69,214,56.54,11.21,32.24,2019,63563
4705,159,1386,6250,75.28,2.54,22.18,2019,63601
249,15,104,368,67.66,4.08,28.26,2019,63622
212,8,84,304,69.74,2.63,27.63,2019,63663
368,4,167,539,68.27,0.74,30.98,2019,63629
184,1,49,234,78.63,0.43,20.94,2019,63633
234,0,39,273,85.71,0.0,14.29,2019,63654
70,0,31,101,69.31,0.0,30.69,2019,63665
4,0,4,8,50.0,0.0,50.0,2019,63750
885,50,193,1128,78.46,4.43,17.11,2019,63771
43,0,11,54,79.63,0.0,20.37,2019,63774
1194,27,391,1612,74.07,1.67,24.26,2019,63825
14,0,21,35,40.0,0.0,60.0,2019,63847
372,22,99,493,75.46,4.46,20.08,2019,63852
4046,174,922,5142,78.69,3.38,17.93,2019,63857
1110,23,368,1501,73.95,1.53,24.52,2019,63869
36,0,20,56,64.29,0.0,35.71,2019,63880
138,0,259,397,34.76,0.0,65.24,2019,63932
186,0,83,269,69.14,0.0,30.86,2019,63942
436,5,168,609,71.59,0.82,27.59,2019,63953
1807,57,561,2425,74.52,2.35,23.13,2019,63957
83,0,21,104,79.81,0.0,20.19,2019,63656
323,24,122,469,68.87,5.12,26.01,2019,63626
159,7,100,266,59.77,2.63,37.59,2019,63636
427,22,76,525,81.33,4.19,14.48,2019,63653
2413,92,1169,3674,65.68,2.5,31.82,2019,63664
1094,65,213,1372,79.74,4.74,15.52,2019,63736
47,2,30,79,59.49,2.53,37.97,2019,63543
682,72,367,1121,60.84,6.42,32.74,2019,63660
42,0,23,65,64.62,0.0,35.38,2019,63567
2343,32,49,2424,96.66,1.32,2.02,2019,63038
71,5,10,86,82.56,5.81,11.63,2019,63451
178,16,23,217,82.03,7.37,10.6,2019,63373
72,0,10,82,87.8,0.0,12.2,2019,63450
5808,462,1510,7780,74.65,5.94,19.41,2019,63501
45,4,21,70,64.29,5.71,30.0,2019,63828
516,13,110,639,80.75,2.03,17.21,2019,63462
297,25,160,482,61.62,5.19,33.2,2019,63620
302,9,99,410,73.66,2.2,24.15,2019,63867
305,2,151,458,66.59,0.44,32.97,2019,63781
73,0,12,85,85.88,0.0,14.12,2019,63853
83,0,10,93,89.25,0.0,10.75,2019,63473
63,0,29,92,68.48,0.0,31.52,2019,63557
417,0,169,586,71.16,0.0,28.84,2019,63637
969,48,251,1268,76.42,3.79,19.79,2019,50450
285,9,88,382,74.61,2.36,23.04,2019,50452
139,0,32,171,81.29,0.0,18.71,2019,50455
608,23,138,769,79.06,2.99,17.95,2019,50456
519,9,75,603,86.07,1.49,12.44,2019,50469
294,12,39,345,85.22,3.48,11.3,2019,50480
519,19,145,683,75.99,2.78,21.23,2019,64624
224,11,58,293,76.45,3.75,19.8,2019,64651
127,4,44,175,72.57,2.29,25.14,2019,64660
555,31,271,857,64.76,3.62,31.62,2019,64673
640,8,165,813,78.72,0.98,20.3,2019,64724
676,41,133,850,79.53,4.82,15.65,2019,64725
60,0,10,70,85.71,0.0,14.29,2019,64745
37,0,10,47,78.72,0.0,21.28,2019,64090
4842,182,765,5789,83.64,3.14,13.21,2019,64056
2128,82,294,2504,84.98,3.27,11.74,2019,64058
400,8,143,551,72.6,1.45,25.95,2019,64097
4127,436,270,4833,85.39,9.02,5.59,2019,64112
10818,492,1160,12470,86.75,3.95,9.3,2019,64114
2937,178,688,3803,77.23,4.68,18.09,2019,64129
3725,159,1571,5455,68.29,2.91,28.8,2019,64132
67,5,113,185,36.22,2.7,61.08,2019,64147
6163,123,117,6403,96.25,1.92,1.83,2019,64157
105,0,0,105,100.0,0.0,0.0,2019,64164
0,0,0,0,,,,2019,64192
797,23,219,1039,76.71,2.21,21.08,2019,64402
179,10,73,262,68.32,3.82,27.86,2019,64427
2933,158,758,3849,76.2,4.1,19.69,2019,64429
162,8,32,202,80.2,3.96,15.84,2019,64434
403,46,54,503,80.12,9.15,10.74,2019,64444
1540,49,282,1871,82.31,2.62,15.07,2019,64016
5168,159,656,5983,86.38,2.66,10.96,2019,64057
986,51,247,1284,76.79,3.97,19.24,2019,64061
6667,90,320,7077,94.21,1.27,4.52,2019,64064
564,10,107,681,82.82,1.47,15.71,2019,64077
431,11,87,529,81.47,2.08,16.45,2019,64088
10042,413,903,11358,88.41,3.64,7.95,2019,64119
3557,278,479,4314,82.45,6.44,11.1,2019,64137
141,8,96,245,57.55,3.27,39.18,2019,64449
466,5,126,597,78.06,0.84,21.11,2019,64456
120,1,26,147,81.63,0.68,17.69,2019,64471
241,12,62,315,76.51,3.81,19.68,2019,64474
1118,28,321,1467,76.21,1.91,21.88,2019,64477
271,4,106,381,71.13,1.05,27.82,2019,64484
534,16,183,733,72.85,2.18,24.97,2019,64490
159,0,44,203,78.33,0.0,21.67,2019,64493
3161,39,1292,4492,70.37,0.87,28.76,2019,64501
3882,182,756,4820,80.54,3.78,15.68,2019,64503
3263,37,937,4237,77.01,0.87,22.11,2019,64504
6992,241,1828,9061,77.17,2.66,20.17,2019,64506
129,6,52,187,68.98,3.21,27.81,2019,64622
151,9,60,220,68.64,4.09,27.27,2019,64635
3181,18,135,3334,95.41,0.54,4.05,2019,64034
146,0,0,146,100.0,0.0,0.0,2019,64167
4098,96,317,4511,90.84,2.13,7.03,2019,64154
300,35,51,386,77.72,9.07,13.21,2019,64163
76,0,13,89,85.39,0.0,14.61,2019,64166
49,4,29,82,59.76,4.88,35.37,2019,64438
512,11,92,615,83.25,1.79,14.96,2019,64443
360,5,120,485,74.23,1.03,24.74,2019,49126
3719,78,1249,5046,73.7,1.55,24.75,2019,49224
923,48,102,1073,86.02,4.47,9.51,2019,49234
441,28,286,755,58.41,3.71,37.88,2019,49255
1034,20,294,1348,76.71,1.48,21.81,2019,49266
952,59,243,1254,75.92,4.7,19.38,2019,49274
379,22,121,522,72.61,4.21,23.18,2019,62473
406,7,177,590,68.81,1.19,30.0,2019,62571
784,24,428,1236,63.43,1.94,34.63,2019,62952
430,41,183,654,65.75,6.27,27.98,2019,65032
521,21,157,699,74.54,3.0,22.46,2019,65035
1502,136,488,2126,70.65,6.4,22.95,2019,65037
1772,37,553,2362,75.02,1.57,23.41,2019,65041
1051,263,473,1787,58.81,14.72,26.47,2019,65051
202,1,56,259,77.99,0.39,21.62,2019,65068
730,128,256,1114,65.53,11.49,22.98,2019,65074
1014,52,362,1428,71.01,3.64,25.35,2019,65078
16,0,4,20,80.0,0.0,20.0,2019,65246
2079,101,252,2432,85.49,4.15,10.36,2019,65010
856,34,385,1275,67.14,2.67,30.2,2019,65013
420,71,81,572,73.43,12.41,14.16,2019,65016
21,0,33,54,38.89,0.0,61.11,2019,65048
48,20,135,203,23.65,9.85,66.5,2019,65050
1038,54,144,1236,83.98,4.37,11.65,2019,65063
2173,89,160,2422,89.72,3.67,6.61,2019,65065
208,16,25,249,83.53,6.43,10.04,2019,65069
537,52,95,684,78.51,7.6,13.89,2019,65072
119,0,38,157,75.8,0.0,24.2,2019,65077
12041,1867,2548,16456,73.17,11.35,15.48,2019,65109
13466,2233,1490,17189,78.34,12.99,8.67,2019,65201
377,12,192,581,64.89,2.07,33.05,2019,65236
424,12,88,524,80.92,2.29,16.79,2019,65239
487,1,100,588,82.82,0.17,17.01,2019,65257
4450,155,1336,5941,74.9,2.61,22.49,2019,65265
993,9,203,1205,82.41,0.75,16.85,2019,65725
325,6,17,348,93.39,1.72,4.89,2019,65732
1213,153,111,1477,82.13,10.36,7.52,2019,65747
2245,79,515,2839,79.08,2.78,18.14,2019,65757
440,3,92,535,82.24,0.56,17.2,2019,65759
245,0,34,279,87.81,0.0,12.19,2019,65773
1573,149,455,2177,72.26,6.84,20.9,2019,65785
1043,36,287,1366,76.35,2.64,21.01,2019,65248
817,68,176,1061,77.0,6.41,16.59,2019,65259
848,18,274,1140,74.39,1.58,24.04,2019,65275
643,21,242,906,70.97,2.32,26.71,2019,65326
27,0,0,27,100.0,0.0,0.0,2019,65436
37,19,8,64,57.81,29.69,12.5,2019,65439
1732,48,521,2301,75.27,2.09,22.64,2019,65441
2403,130,880,3413,70.41,3.81,25.78,2019,65453
240,72,98,410,58.54,17.56,23.9,2019,65463
469,6,180,655,71.6,0.92,27.48,2019,65466
1229,209,357,1795,68.47,11.64,19.89,2019,65483
858,6,351,1215,70.62,0.49,28.89,2019,65550
3,0,31,34,8.82,0.0,91.18,2019,65589
189,3,48,240,78.75,1.25,20.0,2019,65601
375,7,101,483,77.64,1.45,20.91,2019,64401
21,1,3,25,84.0,4.0,12.0,2019,64433
75,0,42,117,64.1,0.0,35.9,2019,64445
355,30,110,495,71.72,6.06,22.22,2019,64446
6043,243,1620,7906,76.44,3.07,20.49,2019,49829
6,0,2,8,75.0,0.0,25.0,2019,49877
189,6,61,256,73.83,2.34,23.83,2019,49948
752,0,25,777,96.78,0.0,3.22,2019,49060
559,53,166,778,71.85,6.81,21.34,2019,49113
1216,30,285,1531,79.43,1.96,18.62,2019,49256
1142,12,71,1225,93.22,0.98,5.8,2019,68372
59,0,22,81,72.84,0.0,27.16,2019,68403
2762,123,339,3224,85.67,3.82,10.51,2019,68434
307,3,56,366,83.88,0.82,15.3,2019,68628
1287,14,276,1577,81.61,0.89,17.5,2019,68632
1406,104,349,1859,75.63,5.59,18.77,2019,68305
319,15,86,420,75.95,3.57,20.48,2019,68340
1815,69,357,2241,80.99,3.08,15.93,2019,68355
18,0,7,25,72.0,0.0,28.0,2019,68362
717,5,190,912,78.62,0.55,20.83,2019,68370
244,5,41,290,84.14,1.72,14.14,2019,68378
71,6,16,93,76.34,6.45,17.2,2019,68416
446,8,129,583,76.5,1.37,22.13,2019,68420
174,9,11,194,89.69,4.64,5.67,2019,68422
461,11,13,485,95.05,2.27,2.68,2019,68428
126,3,19,148,85.14,2.03,12.84,2019,68431
5264,30,151,5445,96.68,0.55,2.77,2019,68512
12258,311,1192,13761,89.08,2.26,8.66,2019,68521
2219,140,101,2460,90.2,5.69,4.11,2019,68528
1011,16,162,1189,85.03,1.35,13.62,2019,68620
3260,160,885,4305,75.73,3.72,20.56,2019,68112
6805,179,2245,9229,73.73,1.94,24.33,2019,68107
3825,215,1067,5107,74.9,4.21,20.89,2019,68108
5611,152,744,6507,86.23,2.34,11.43,2019,68124
8672,195,1133,10000,86.72,1.95,11.33,2019,68127
1700,63,50,1813,93.77,3.47,2.76,2019,68142
101,3,8,112,90.18,2.68,7.14,2019,68304
366,41,45,452,80.97,9.07,9.96,2019,68015
760,50,119,929,81.81,5.38,12.81,2019,68037
18,1,9,28,64.29,3.57,32.14,2019,68042
185,26,77,288,64.24,9.03,26.74,2019,68050
83,1,30,114,72.81,0.88,26.32,2019,68063
450,27,114,591,76.14,4.57,19.29,2019,68065
193,26,103,322,59.94,8.07,31.99,2019,68067
32,4,2,38,84.21,10.53,5.26,2019,68068
3437,55,45,3537,97.17,1.55,1.27,2019,68118
4666,198,547,5411,86.23,3.66,10.11,2019,68131
4940,145,559,5644,87.53,2.57,9.9,2019,68132
8496,393,1034,9923,85.62,3.96,10.42,2019,68144
4792,113,1033,5938,80.7,1.9,17.4,2019,68310
284,2,69,355,80.0,0.56,19.44,2019,68331
222,6,70,298,74.5,2.01,23.49,2019,68424
24,1,1,26,92.31,3.85,3.85,2019,68444
255,0,76,331,77.04,0.0,22.96,2019,68461
5293,188,803,6284,84.23,2.99,12.78,2019,68503
11298,350,1347,12995,86.94,2.69,10.37,2019,68506
3893,141,320,4354,89.41,3.24,7.35,2019,68522
9016,295,1889,11200,80.5,2.63,16.87,2019,68601
128,7,43,178,71.91,3.93,24.16,2019,68631
115,3,36,154,74.68,1.95,23.38,2019,68637
394,7,90,491,80.24,1.43,18.33,2019,68641
425,11,128,564,75.35,1.95,22.7,2019,68781
174,5,43,222,78.38,2.25,19.37,2019,67352
9070,332,1931,11333,80.03,2.93,17.04,2019,70454
575,8,243,826,69.61,0.97,29.42,2019,70456
20,0,26,46,43.48,0.0,56.52,2019,70463
162,0,0,162,100.0,0.0,0.0,2019,70464
2418,94,542,3054,79.17,3.08,17.75,2019,70466
15139,268,1133,16540,91.53,1.62,6.85,2019,70508
4399,180,476,5055,87.02,3.56,9.42,2019,50211
282,0,15,297,94.95,0.0,5.05,2019,50214
457,3,71,531,86.06,0.56,13.37,2019,50233
109,22,31,162,67.28,13.58,19.14,2019,50235
973,16,255,1244,78.22,1.29,20.5,2019,50237
316,7,63,386,81.87,1.81,16.32,2019,50541
1940,94,487,2521,76.95,3.73,19.32,2019,50548
94,1,24,119,78.99,0.84,20.17,2019,50567
241,15,88,344,70.06,4.36,25.58,2019,50569
55,5,14,74,74.32,6.76,18.92,2019,50570
220,3,73,296,74.32,1.01,24.66,2019,50606
134,19,21,174,77.01,10.92,12.07,2019,50609
958,49,64,1071,89.45,4.58,5.98,2019,50643
1155,51,262,1468,78.68,3.47,17.85,2019,50651
889,41,284,1214,73.23,3.38,23.39,2019,50665
772,41,130,943,81.87,4.35,13.79,2019,50670
720,23,157,900,80.0,2.56,17.44,2019,50676
1270,48,152,1470,86.39,3.27,10.34,2019,50648
750,52,181,983,76.3,5.29,18.41,2019,50669
766,25,158,949,80.72,2.63,16.65,2019,50675
459,13,146,618,74.27,2.1,23.62,2019,50020
9898,334,705,10937,90.5,3.05,6.45,2019,50021
196,11,71,278,70.5,3.96,25.54,2019,50029
2127,71,612,2810,75.69,2.53,21.78,2019,50049
43,4,15,62,69.35,6.45,24.19,2019,50052
3831,88,734,4653,82.33,1.89,15.77,2019,50112
2538,99,572,3209,79.09,3.09,17.82,2019,50511
91,4,12,107,85.05,3.74,11.21,2019,50531
628,15,149,792,79.29,1.89,18.81,2019,50554
55,3,48,106,51.89,2.83,45.28,2019,50556
184,3,27,214,85.98,1.4,12.62,2019,50561
163,8,25,196,83.16,4.08,12.76,2019,50566
111,3,26,140,79.29,2.14,18.57,2019,50576
422,13,89,524,80.53,2.48,16.98,2019,50585
95,0,27,122,77.87,0.0,22.13,2019,50057
72,1,3,76,94.74,1.32,3.95,2019,50064
53,14,0,67,79.1,20.9,0.0,2019,50102
4931,104,356,5391,91.47,1.93,6.6,2019,50111
52,0,16,68,76.47,0.0,23.53,2019,50116
204,0,51,255,80.0,0.0,20.0,2019,50143
973,39,156,1168,83.3,3.34,13.36,2019,50563
287,8,70,365,78.63,2.19,19.18,2019,50581
617,2,189,808,76.36,0.25,23.39,2019,50604
123,2,33,158,77.85,1.27,20.89,2019,50607
1133,38,112,1283,88.31,2.96,8.73,2019,50622
555,13,70,638,86.99,2.04,10.97,2019,50624
24,2,16,42,57.14,4.76,38.1,2019,50652
232,13,27,272,85.29,4.78,9.93,2019,50653
164,2,29,195,84.1,1.03,14.87,2019,50654
387,7,69,463,83.59,1.51,14.9,2019,50668
56,1,11,68,82.35,1.47,16.18,2019,50673
310,6,98,414,74.88,1.45,23.67,2019,50542
14,5,14,33,42.42,15.15,42.42,2019,50573
639,33,184,856,74.65,3.86,21.5,2019,52151
493,4,114,611,80.69,0.65,18.66,2019,52255
251,4,81,336,74.7,1.19,24.11,2019,52330
13420,1061,2444,16925,79.29,6.27,14.44,2019,52404
134,0,26,160,83.75,0.0,16.25,2019,52048
1039,22,278,1339,77.6,1.64,20.76,2019,52208
2662,51,220,2933,90.76,1.74,7.5,2019,49302
1374,30,284,1688,81.4,1.78,16.82,2019,49326
75,0,0,75,100.0,0.0,0.0,2019,49335
800,17,231,1048,76.34,1.62,22.04,2019,49340
1447,80,400,1927,75.09,4.15,20.76,2019,49343
2137,109,875,3121,68.47,3.49,28.04,2019,49349
3473,146,749,4368,79.51,3.34,17.15,2019,49412
2162,101,331,2594,83.35,3.89,12.76,2019,49415
5986,337,1230,7553,79.25,4.46,16.28,2019,49431
7273,218,890,8381,86.78,2.6,10.62,2019,49445
1689,93,365,2147,78.67,4.33,17.0,2019,49451
9814,350,2132,12296,79.81,2.85,17.34,2019,49507
8746,137,1128,10011,87.36,1.37,11.27,2019,49509
6770,91,788,7649,88.51,1.19,10.3,2019,49512
899,33,186,1118,80.41,2.95,16.64,2019,49622
59,0,10,69,85.51,0.0,14.49,2019,49628
507,24,235,766,66.19,3.13,30.68,2019,49776
1496,69,428,1993,75.06,3.46,21.48,2019,49779
106,5,39,150,70.67,3.33,26.0,2019,49820
3150,55,744,3949,79.77,1.39,18.84,2019,49837
3931,279,876,5086,77.29,5.49,17.22,2019,49849
2637,131,412,3180,82.92,4.12,12.96,2019,49866
45,0,24,69,65.22,0.0,34.78,2019,49872
196,4,37,237,82.7,1.69,15.61,2019,49886
23,2,20,45,51.11,4.44,44.44,2019,49903
1296,104,450,1850,70.05,5.62,24.32,2019,49920
146,21,48,215,67.91,9.77,22.33,2019,49947
144,20,49,213,67.61,9.39,23.0,2019,49967
2301,63,430,2794,82.36,2.25,15.39,2019,49419
13894,428,2441,16763,82.88,2.55,14.56,2019,49423
1034,61,221,1316,78.57,4.64,16.79,2019,49425
8778,287,1024,10089,87.01,2.84,10.15,2019,49428
3138,183,526,3847,81.57,4.76,13.67,2019,49457
12588,403,1810,14801,85.05,2.72,12.23,2019,49508
11241,506,1380,13127,85.63,3.85,10.51,2019,49546
227,13,51,291,78.01,4.47,17.53,2019,49613
1406,38,285,1729,81.32,2.2,16.48,2019,49615
1316,14,176,1506,87.38,0.93,11.69,2019,49621
303,7,134,444,68.24,1.58,30.18,2019,49623
798,40,132,970,82.27,4.12,13.61,2019,49629
353,23,71,447,78.97,5.15,15.88,2019,49632
243,3,108,354,68.64,0.85,30.51,2019,49638
2419,36,249,2704,89.46,1.33,9.21,2019,49643
884,56,327,1267,69.77,4.42,25.81,2019,49655
2021,104,551,2676,75.52,3.89,20.59,2019,49659
1531,102,586,2219,69.0,4.6,26.41,2019,49663
14026,578,2211,16815,83.41,3.44,13.15,2019,49684
1449,97,235,1781,81.36,5.45,13.19,2019,49706
125,9,66,200,62.5,4.5,33.0,2019,49710
725,33,117,875,82.86,3.77,13.37,2019,49713
3194,296,562,4052,78.83,7.31,13.87,2019,49720
407,14,86,507,80.28,2.76,16.96,2019,49726
2260,106,628,2994,75.48,3.54,20.98,2019,49727
1036,96,267,1399,74.05,6.86,19.09,2019,52052
2080,81,374,2535,82.05,3.2,14.75,2019,53583
1222,33,286,1541,79.3,2.14,18.56,2019,53809
731,51,96,878,83.26,5.81,10.93,2019,53576
5503,87,501,6091,90.35,1.43,8.23,2019,53575
464,11,107,582,79.73,1.89,18.38,2019,53577
6762,200,1806,8768,77.12,2.28,20.6,2019,49037
8819,212,878,9909,89.0,2.14,8.86,2019,49048
21,9,50,80,26.25,11.25,62.5,2019,49074
0,0,7,7,0.0,0.0,100.0,2019,49084
0,0,0,0,,,,2019,49104
114,0,25,139,82.01,0.0,17.99,2019,49815
237,30,105,372,63.71,8.06,28.23,2019,49836
36,0,10,46,78.26,0.0,21.74,2019,49848
181,4,56,241,75.1,1.66,23.24,2019,49861
1118,90,231,1439,77.69,6.25,16.05,2019,49862
27,1,17,45,60.0,2.22,37.78,2019,49883
73,4,49,126,57.94,3.17,38.89,2019,49884
3749,179,555,4483,83.63,3.99,12.38,2019,49230
1650,51,186,1887,87.44,2.7,9.86,2019,49236
4244,202,1238,5684,74.67,3.55,21.78,2019,49242
1332,47,475,1854,71.84,2.54,25.62,2019,49245
1752,71,461,2284,76.71,3.11,20.18,2019,49247
1924,89,460,2473,77.8,3.6,18.6,2019,49250
336,20,150,506,66.4,3.95,29.64,2019,49262
25,0,0,25,100.0,0.0,0.0,2019,49263
688,25,92,805,85.47,3.11,11.43,2019,49287
6542,71,204,6817,95.97,1.04,2.99,2019,49301
379,26,116,521,72.74,4.99,22.26,2019,49322
1128,47,343,1518,74.31,3.1,22.6,2019,49328
1332,84,369,1785,74.62,4.71,20.67,2019,49330
5484,933,451,6868,79.85,13.58,6.57,2019,49401
11017,345,1269,12631,87.22,2.73,10.05,2019,49417
599,15,316,930,64.41,1.61,33.98,2019,49450
7133,136,763,8032,88.81,1.69,9.5,2019,49456
34,0,16,50,68.0,0.0,32.0,2019,49458
12485,482,2454,15421,80.96,3.13,15.91,2019,49504
11272,469,1741,13482,83.61,3.48,12.91,2019,49505
11389,271,920,12580,90.53,2.15,7.31,2019,49506
97,0,3,100,97.0,0.0,3.0,2019,49611
487,5,114,606,80.36,0.83,18.81,2019,49612
1039,18,204,1261,82.39,1.43,16.18,2019,49617
184,8,4,196,93.88,4.08,2.04,2019,49636
1149,0,133,1282,89.63,0.0,10.37,2019,49637
534,10,88,632,84.49,1.58,13.92,2019,49640
1889,95,219,2203,85.75,4.31,9.94,2019,49649
211,19,15,245,86.12,7.76,6.12,2019,49654
335,26,114,475,70.53,5.47,24.0,2019,49679
7790,302,1829,9921,78.52,3.04,18.44,2019,49707
163,5,78,246,66.26,2.03,31.71,2019,49736
184,15,161,360,51.11,4.17,44.72,2019,49642
479,21,110,610,78.52,3.44,18.03,2019,49645
643,11,165,819,78.51,1.34,20.15,2019,49653
406,21,205,632,64.24,3.32,32.44,2019,49656
5674,109,590,6373,89.03,1.71,9.26,2019,49004
4923,155,1644,6722,73.24,2.31,24.46,2019,49010
658,7,151,816,80.64,0.86,18.5,2019,49011
1433,62,399,1894,75.66,3.27,21.07,2019,49013
1864,126,411,2401,77.63,5.25,17.12,2019,49021
2802,47,500,3349,83.67,1.4,14.93,2019,53182
1008,8,65,1081,93.25,0.74,6.01,2019,53183
12598,384,1431,14413,87.41,2.66,9.93,2019,53188
7795,448,4830,13073,59.63,3.43,36.95,2019,53204
4791,286,2902,7979,60.05,3.58,36.37,2019,53206
11763,545,3334,15642,75.2,3.48,21.31,2019,53214
58,5,51,114,50.88,4.39,44.74,2019,70524
3948,178,1075,5201,75.91,3.42,20.67,2019,70525
2509,65,1182,3756,66.8,1.73,31.47,2019,70544
1331,78,708,2117,62.87,3.68,33.44,2019,70554
2708,22,272,3002,90.21,0.73,9.06,2019,70555
710,30,243,983,72.23,3.05,24.72,2019,70559
111,0,0,111,100.0,0.0,0.0,2019,70580
7505,232,1892,9629,77.94,2.41,19.65,2019,70634
157,0,43,200,78.5,0.0,21.5,2019,70639
137,0,157,294,46.6,0.0,53.4,2019,70646
949,8,295,1252,75.8,0.64,23.56,2019,70653
218,0,99,317,68.77,0.0,31.23,2019,70436
2513,62,1171,3746,67.08,1.66,31.26,2019,70444
12164,361,1573,14098,86.28,2.56,11.16,2019,70458
8072,41,382,8495,95.02,0.48,4.5,2019,70592
371,11,189,571,64.97,1.93,33.1,2019,70049
1103,173,378,1654,66.69,10.46,22.85,2019,70057
363,18,146,527,68.88,3.42,27.7,2019,70080
1074,69,492,1635,65.69,4.22,30.09,2019,70341
838,13,197,1048,79.96,1.24,18.8,2019,70372
200,22,81,303,66.01,7.26,26.73,2019,70393
1116,57,638,1811,61.62,3.15,35.23,2019,70426
6440,266,939,7645,84.24,3.48,12.28,2019,70460
1385,60,678,2123,65.24,2.83,31.94,2019,70462
7486,368,1857,9711,77.09,3.79,19.12,2019,70510
2933,71,617,3621,81.0,1.96,17.04,2019,70512
4847,194,1682,6723,72.1,2.89,25.02,2019,70526
3755,180,709,4644,80.86,3.88,15.27,2019,70529
4702,145,1627,6474,72.63,2.24,25.13,2019,70546
942,122,440,1504,62.63,8.11,29.26,2019,70577
5187,386,1716,7289,71.16,5.3,23.54,2019,70582
4999,146,2316,7461,67.0,1.96,31.04,2019,70586
3278,178,1250,4706,69.66,3.78,26.56,2019,70615
298,0,24,322,92.55,0.0,7.45,2019,70637
394,30,108,532,74.06,5.64,20.3,2019,70659
6284,444,737,7465,84.18,5.95,9.87,2019,70706
69,10,55,134,51.49,7.46,41.04,2019,70541
7782,168,1923,9873,78.82,1.7,19.48,2019,70517
207,0,85,292,70.89,0.0,29.11,2019,70523
498,0,453,951,52.37,0.0,47.63,2019,70532
1188,6,276,1470,80.82,0.41,18.78,2019,70542
0,0,0,0,,,,2019,70550
219,0,73,292,75.0,0.0,25.0,2019,70576
8655,391,2435,11481,75.39,3.41,21.21,2019,70607
48,3,72,123,39.02,2.44,58.54,2019,70640
2416,175,799,3390,71.27,5.16,23.57,2019,70647
9740,659,1837,12236,79.6,5.39,15.01,2019,70806
5691,519,818,7028,80.98,7.38,11.64,2019,70820
0,0,0,0,,,,2019,70558
90,0,79,169,53.25,0.0,46.75,2019,70643
78,23,35,136,57.35,16.91,25.74,2019,70712
13781,217,1238,15236,90.45,1.42,8.13,2019,70769
4956,132,2182,7270,68.17,1.82,30.01,2019,70438
68,7,8,83,81.93,8.43,9.64,2019,59351
4729,189,1412,6330,74.71,2.99,22.31,2019,59401
10262,339,2882,13483,76.11,2.51,21.38,2019,59405
1251,44,911,2206,56.71,1.99,41.3,2019,59417
850,25,243,1118,76.03,2.24,21.74,2019,59422
55,0,33,88,62.5,0.0,37.5,2019,59456
0,0,0,0,,,,2019,52557
22,2,4,28,78.57,7.14,14.29,2019,52657
304,3,98,405,75.06,0.74,24.2,2019,52535
163,17,89,269,60.59,6.32,33.09,2019,52549
257,6,92,355,72.39,1.69,25.92,2019,52552
107,2,43,152,70.39,1.32,28.29,2019,52555
4159,225,727,5111,81.37,4.4,14.22,2019,52556
355,10,35,400,88.75,2.5,8.75,2019,52561
230,8,84,322,71.43,2.48,26.09,2019,52567
474,39,90,603,78.61,6.47,14.93,2019,52571
118,0,26,144,81.94,0.0,18.06,2019,52581
251,10,212,473,53.07,2.11,44.82,2019,52590
66,0,13,79,83.54,0.0,16.46,2019,52593
9844,272,2462,12578,78.26,2.16,19.57,2019,52601
3687,245,1359,5291,69.68,4.63,25.69,2019,52632
173,4,35,212,81.6,1.89,16.51,2019,52638
400,29,110,539,74.21,5.38,20.41,2019,52640
283,9,71,363,77.96,2.48,19.56,2019,52649
150,8,104,262,57.25,3.05,39.69,2019,52651
1103,42,222,1367,80.69,3.07,16.24,2019,52653
520,3,106,629,82.67,0.48,16.85,2019,52654
100,9,50,159,62.89,5.66,31.45,2019,52727
297,8,62,367,80.93,2.18,16.89,2019,52729
3161,83,306,3550,89.04,2.34,8.62,2019,52748
439,5,143,587,74.79,0.85,24.36,2019,52754
178,0,48,226,78.76,0.0,21.24,2019,52760
907,11,176,1094,82.91,1.01,16.09,2019,52773
1223,46,314,1583,77.26,2.91,19.84,2019,52776
367,7,80,454,80.84,1.54,17.62,2019,52777
495,27,223,745,66.44,3.62,29.93,2019,52801
2604,123,1114,3841,67.79,3.2,29.0,2019,52802
14011,722,2459,17192,81.5,4.2,14.3,2019,52001
1021,48,212,1281,79.7,3.75,16.55,2019,52033
2041,54,347,2442,83.58,2.21,14.21,2019,52040
461,15,87,563,81.88,2.66,15.45,2019,52049
726,26,105,857,84.71,3.03,12.25,2019,52132
1951,102,436,2489,78.38,4.1,17.52,2019,52136
176,24,73,273,64.47,8.79,26.74,2019,52140
382,6,116,504,75.79,1.19,23.02,2019,52141
340,6,80,426,79.81,1.41,18.78,2019,52146
337,13,85,435,77.47,2.99,19.54,2019,52147
292,5,101,398,73.37,1.26,25.38,2019,52171
377,35,34,446,84.53,7.85,7.62,2019,52223
99,0,25,124,79.84,0.0,20.16,2019,52225
296,7,87,390,75.9,1.79,22.31,2019,52249
14272,448,1985,16705,85.44,2.68,11.88,2019,52302
7355,169,272,7796,94.34,2.17,3.49,2019,52317
592,19,71,682,86.8,2.79,10.41,2019,52324
207,6,75,288,71.88,2.08,26.04,2019,52337
418,0,35,453,92.27,0.0,7.73,2019,52341
463,4,113,580,79.83,0.69,19.48,2019,52352
331,28,62,421,78.62,6.65,14.73,2019,52362
123,0,6,129,95.35,0.0,4.65,2019,52624
239,17,77,333,71.77,5.11,23.12,2019,54826
1218,49,373,1640,74.27,2.99,22.74,2019,54837
71,4,40,115,61.74,3.48,34.78,2019,54841
1339,36,443,1818,73.65,1.98,24.37,2019,54853
204,6,29,239,85.36,2.51,12.13,2019,54855
211,2,41,254,83.07,0.79,16.14,2019,54865
3207,96,1072,4375,73.3,2.19,24.5,2019,53581
8693,177,462,9332,93.15,1.9,4.95,2019,53593
14466,1321,842,16629,86.99,7.94,5.06,2019,53703
12697,334,584,13615,93.26,2.45,4.29,2019,53719
266,11,101,378,70.37,2.91,26.72,2019,53801
412,11,97,520,79.23,2.12,18.65,2019,53803
1505,35,445,1985,75.82,1.76,22.42,2019,53805
108,4,31,143,75.52,2.8,21.68,2019,53810
770,12,172,954,80.71,1.26,18.03,2019,53820
409,6,101,516,79.26,1.16,19.57,2019,53930
78,3,10,91,85.71,3.3,10.99,2019,53931
253,5,100,358,70.67,1.4,27.93,2019,53943
2560,115,631,3306,77.43,3.48,19.09,2019,53948
1632,55,334,2021,80.75,2.72,16.53,2019,53950
74,9,13,96,77.08,9.38,13.54,2019,53935
111,2,63,176,63.07,1.14,35.8,2019,53825
562,13,175,750,74.93,1.73,23.33,2019,53923
859,33,111,1003,85.64,3.29,11.07,2019,53932
964,39,211,1214,79.41,3.21,17.38,2019,53941
1147,54,239,1440,79.65,3.75,16.6,2019,53960
3773,231,660,4664,80.9,4.95,14.15,2019,53965
329,14,100,443,74.27,3.16,22.57,2019,53506
1967,35,191,2193,89.69,1.6,8.71,2019,53508
472,14,118,604,78.15,2.32,19.54,2019,53518
1910,42,190,2142,89.17,1.96,8.87,2019,53523
2538,37,453,3028,83.82,1.22,14.96,2019,53533
682,13,215,910,74.95,1.43,23.63,2019,53586
974,17,36,1027,94.84,1.66,3.51,2019,53598
18362,721,1778,20861,88.02,3.46,8.52,2019,53704
393,0,99,492,79.88,0.0,20.12,2019,53808
1040,42,196,1278,81.38,3.29,15.34,2019,53811
302,3,86,391,77.24,0.77,21.99,2019,53922
681,13,200,894,76.17,1.45,22.37,2019,53944
1179,30,265,1474,79.99,2.04,17.98,2019,53964
535,14,138,687,77.87,2.04,20.09,2019,53543
3014,79,372,3465,86.98,2.28,10.74,2019,53551
280,18,101,399,70.18,4.51,25.31,2019,53554
4466,66,266,4798,93.08,1.38,5.54,2019,53558
717,32,124,873,82.13,3.67,14.2,2019,53170
2192,44,309,2545,86.13,1.73,12.14,2019,53177
10048,434,2713,13195,76.15,3.29,20.56,2019,53212
7668,327,1902,9897,77.48,3.3,19.22,2019,53225
5169,199,881,6249,82.72,3.18,14.1,2019,53228
2756,356,1419,4531,60.83,7.86,31.32,2019,53233
11832,280,1531,13643,86.73,2.05,11.22,2019,53402
2055,63,535,2653,77.46,2.37,20.17,2019,53520
10369,676,1227,12272,84.49,5.51,10.0,2019,53546
10254,304,778,11336,90.46,2.68,6.86,2019,53562
3527,197,534,4258,82.83,4.63,12.54,2019,53563
1409,68,242,1719,81.97,3.96,14.08,2019,53588
6866,170,1081,8117,84.59,2.09,13.32,2019,53589
8539,423,837,9799,87.14,4.32,8.54,2019,53713
5663,78,296,6037,93.8,1.29,4.9,2019,53717
1173,41,107,1321,88.8,3.1,8.1,2019,55032
10134,201,1450,11785,85.99,1.71,12.3,2019,55033
965,19,39,1023,94.33,1.86,3.81,2019,55047
1423,56,288,1767,80.53,3.17,16.3,2019,55069
12512,375,1066,13953,89.67,2.69,7.64,2019,55082
4031,211,443,4685,86.04,4.5,9.46,2019,55101
6651,347,794,7792,85.36,4.45,10.19,2019,82609
3157,267,420,3844,82.13,6.95,10.93,2019,82633
87,59,0,146,59.59,40.41,0.0,2019,82712
335,0,127,462,72.51,0.0,27.49,2019,82727
610,4,9,623,97.91,0.64,1.44,2019,82732
85,0,34,119,71.43,0.0,28.57,2019,82831
12,0,12,24,50.0,0.0,50.0,2019,82837
179,0,0,179,100.0,0.0,0.0,2019,82923
585,25,75,685,85.4,3.65,10.95,2019,82939
600,19,168,787,76.24,2.41,21.35,2019,82410
918,31,219,1168,78.6,2.65,18.75,2019,82426
25,0,7,32,78.12,0.0,21.88,2019,82430
5628,275,1294,7197,78.2,3.82,17.98,2019,82501
36,4,30,70,51.43,5.71,42.86,2019,82635
25,0,0,25,100.0,0.0,0.0,2019,82640
46,9,0,55,83.64,16.36,0.0,2019,82711
8809,151,389,9349,94.22,1.62,4.16,2019,82718
258,0,40,298,86.58,0.0,13.42,2019,82832
1257,11,208,1476,85.16,0.75,14.09,2019,82937
10,0,0,10,100.0,0.0,0.0,2019,82844
4753,93,351,5197,91.46,1.79,6.75,2019,82930
21,0,5,26,80.77,0.0,19.23,2019,82934
319,11,95,425,75.06,2.59,22.35,2019,82836
6889,278,1273,8440,81.62,3.29,15.08,2019,82007
12458,329,1032,13819,90.15,2.38,7.47,2019,82009
7,0,0,7,100.0,0.0,0.0,2019,82058
7438,322,828,8588,86.61,3.75,9.64,2019,82070
47,1,17,65,72.31,1.54,26.15,2019,82215
15,0,1,16,93.75,0.0,6.25,2019,82242
32,8,9,49,65.31,16.33,18.37,2019,82322
120,9,61,190,63.16,4.74,32.11,2019,82329
48,20,5,73,65.75,27.4,6.85,2019,82428
1036,67,185,1288,80.43,5.2,14.36,2019,82431
67,0,35,102,65.69,0.0,34.31,2019,82510
136,13,17,166,81.93,7.83,10.24,2019,82515
4014,102,881,4997,80.33,2.04,17.63,2019,82520
85,1,30,116,73.28,0.86,25.86,2019,82643
0,62,0,62,0.0,100.0,0.0,2019,82929
0,0,0,0,,,,2019,82005
0,0,0,0,,,,2019,82073
0,1,0,1,0.0,100.0,0.0,2019,82229
186,0,36,222,83.78,0.0,16.22,2019,82334
73,0,0,73,100.0,0.0,0.0,2019,82450
0,0,0,0,,,,2019,82630
0,0,0,0,,,,2019,82638
0,0,0,0,,,,2019,82646
10,0,0,10,100.0,0.0,0.0,2019,82648
0,0,0,0,,,,2019,82715
187,48,102,337,55.49,14.24,30.27,2019,82720
129,15,20,164,78.66,9.15,12.2,2019,82932
9,0,13,22,40.91,0.0,59.09,2019,80434
1514,16,137,1667,90.82,0.96,8.22,2019,80446
901,0,52,953,94.54,0.0,5.46,2019,80447
333,0,118,451,73.84,0.0,26.16,2019,85610
11135,462,1507,13104,84.97,3.53,11.5,2019,85614
412,23,101,536,76.87,4.29,18.84,2019,85624
7759,173,627,8559,90.65,2.02,7.33,2019,85629
737,19,181,937,78.66,2.03,19.32,2019,85630
7262,129,602,7993,90.85,1.61,7.53,2019,85715
1001,113,431,1545,64.79,7.31,27.9,2019,85193
2562,47,405,3014,85.0,1.56,13.44,2019,85194
14667,493,1105,16265,90.18,3.03,6.79,2019,85209
5341,41,98,5480,97.46,0.75,1.79,2019,85266
14043,173,319,14535,96.62,1.19,2.19,2019,85286
14256,187,346,14789,96.4,1.26,2.34,2019,85295
9543,126,176,9845,96.93,1.28,1.79,2019,85297
9964,147,126,10237,97.33,1.44,1.23,2019,85298
0,0,0,0,,,,2019,85341
29,0,36,65,44.62,0.0,55.38,2019,85343
123,10,61,194,63.4,5.15,31.44,2019,85352
54,11,26,91,59.34,12.09,28.57,2019,85371
1595,49,106,1750,91.14,2.8,6.06,2019,85377
16946,107,232,17285,98.04,0.62,1.34,2019,85383
4266,49,407,4722,90.34,1.04,8.62,2019,85387
8709,111,151,8971,97.08,1.24,1.68,2019,85388
12076,126,640,12842,94.04,0.98,4.98,2019,85392
9345,106,619,10070,92.8,1.05,6.15,2019,85395
6520,51,283,6854,95.13,0.74,4.13,2019,85396
81,0,50,131,61.83,0.0,38.17,2019,85551
191,13,41,245,77.96,5.31,16.73,2019,85620
3174,110,318,3602,88.12,3.05,8.83,2019,85622
331,0,34,365,90.68,0.0,9.32,2019,85626
4513,73,336,4922,91.69,1.48,6.83,2019,85658
0,0,0,0,,,,2019,85707
0,0,0,0,,,,2019,85723
0,0,0,0,,,,2019,85724
0,0,0,0,,,,2019,85726
6855,102,269,7226,94.87,1.41,3.72,2019,85755
9947,200,1070,11217,88.68,1.78,9.54,2019,85756
5270,85,903,6258,84.21,1.36,14.43,2019,85757
62,22,51,135,45.93,16.3,37.78,2019,85912
11191,321,1164,12676,88.28,2.53,9.18,2019,85203
13820,735,7542,22097,62.54,3.33,34.13,2019,85301
15900,371,2737,19008,83.65,1.95,14.4,2019,85365
98,2,430,530,18.49,0.38,81.13,2019,86031
169,10,404,583,28.99,1.72,69.3,2019,86034
427,0,94,521,81.96,0.0,18.04,2019,86017
434,0,308,742,58.49,0.0,41.51,2019,86021
111,7,43,161,68.94,4.35,26.71,2019,86036
0,0,0,0,,,,2019,86052
7249,161,1307,8717,83.16,1.85,14.99,2019,86303
2148,34,331,2513,85.48,1.35,13.17,2019,86325
3802,167,655,4624,82.22,3.61,14.17,2019,86327
510,32,217,759,67.19,4.22,28.59,2019,86023
111,5,272,388,28.61,1.29,70.1,2019,86030
21,7,240,268,7.84,2.61,89.55,2019,86540
432,4,585,1021,42.31,0.39,57.3,2019,86511
277,11,666,954,29.04,1.15,69.81,2019,86044
2068,48,481,2597,79.63,1.85,18.52,2019,86046
5602,103,614,6319,88.65,1.63,9.72,2019,86336
88,8,299,395,22.28,2.03,75.7,2019,86506
81,0,493,574,14.11,0.0,85.89,2019,86043
14074,621,2142,16837,83.59,3.69,12.72,2019,85711
12405,468,3751,16624,74.62,2.82,22.56,2019,85713
13386,413,1592,15391,86.97,2.68,10.34,2019,85730
5777,290,1024,7091,81.47,4.09,14.44,2019,85901
1500,80,143,1723,87.06,4.64,8.3,2019,85925
3225,168,286,3679,87.66,4.57,7.77,2019,85012
101,31,107,239,42.26,12.97,44.77,2019,56666
3031,101,371,3503,86.53,2.88,10.59,2019,56716
99,6,34,139,71.22,4.32,24.46,2019,56722
239,11,48,298,80.2,3.69,16.11,2019,56727
497,23,102,622,79.9,3.7,16.4,2019,56738
271,14,22,307,88.27,4.56,7.17,2019,56116
216,17,57,290,74.48,5.86,19.66,2019,56121
166,4,38,208,79.81,1.92,18.27,2019,56123
401,21,112,534,75.09,3.93,20.97,2019,56136
305,20,92,417,73.14,4.8,22.06,2019,56142
937,44,168,1149,81.55,3.83,14.62,2019,56150
252,7,77,336,75.0,2.08,22.92,2019,56151
411,18,155,584,70.38,3.08,26.54,2019,56152
230,5,26,261,88.12,1.92,9.96,2019,56169
418,16,134,568,73.59,2.82,23.59,2019,56183
117,9,17,143,81.82,6.29,11.89,2019,56186
967,61,199,1227,78.81,4.97,16.22,2019,56435
762,39,129,930,81.94,4.19,13.87,2019,56452
611,12,110,733,83.36,1.64,15.01,2019,56455
152,0,17,169,89.94,0.0,10.06,2019,56458
980,60,323,1363,71.9,4.4,23.7,2019,56466
203,4,39,246,82.52,1.63,15.85,2019,56748
781,38,194,1013,77.1,3.75,19.15,2019,56750
26,0,7,33,78.79,0.0,21.21,2019,56755
78,8,9,95,82.11,8.42,9.47,2019,56759
841,54,270,1165,72.19,4.64,23.18,2019,56477
465,3,120,588,79.08,0.51,20.41,2019,56443
1624,54,182,1860,87.31,2.9,9.78,2019,56468
488,9,116,613,79.61,1.47,18.92,2019,56475
221,17,62,300,73.67,5.67,20.67,2019,56521
138,4,40,182,75.82,2.2,21.98,2019,56522
3127,136,793,4056,77.1,3.35,19.55,2019,56649
65,16,43,124,52.42,12.9,34.68,2019,56626
1223,23,463,1709,71.56,1.35,27.09,2019,56633
459,11,133,603,76.12,1.82,22.06,2019,56634
608,18,157,783,77.65,2.3,20.05,2019,56655
674,44,236,954,70.65,4.61,24.74,2019,56672
246,7,81,334,73.65,2.1,24.25,2019,56548
128,4,48,180,71.11,2.22,26.67,2019,56550
732,43,266,1041,70.32,4.13,25.55,2019,56557
11,1,9,21,52.38,4.76,42.86,2019,56565
183,40,60,283,64.66,14.13,21.2,2019,56575
57,0,9,66,86.36,0.0,13.64,2019,56583
613,179,272,1064,57.61,16.82,25.56,2019,56623
135,7,35,177,76.27,3.95,19.77,2019,56139
50,4,27,81,61.73,4.94,33.33,2019,56434
752,23,276,1051,71.55,2.19,26.26,2019,56438
444,22,179,645,68.84,3.41,27.75,2019,56446
3456,76,637,4169,82.9,1.82,15.28,2019,56721
124,0,22,146,84.93,0.0,15.07,2019,56715
273,11,53,337,81.01,3.26,15.73,2019,56725
104,26,60,190,54.74,13.68,31.58,2019,56734
144,41,49,234,61.54,17.52,20.94,2019,56756
5722,295,891,6908,82.83,4.27,12.9,2019,50036
287,3,51,341,84.16,0.88,14.96,2019,50055
668,44,109,821,81.36,5.36,13.28,2019,50058
655,19,17,691,94.79,2.75,2.46,2019,50061
204,7,123,334,61.08,2.1,36.83,2019,50065
103,0,18,121,85.12,0.0,14.88,2019,50067
4892,105,902,5899,82.93,1.78,15.29,2019,80701
2530,73,328,2931,86.32,2.49,11.19,2019,80723
63,0,28,91,69.23,0.0,30.77,2019,80750
5756,244,824,6824,84.35,3.58,12.08,2019,80751
98,18,38,154,63.64,11.69,24.68,2019,80818
491,17,80,588,83.5,2.89,13.61,2019,80864
8674,208,1287,10169,85.3,2.05,12.66,2019,80904
6075,38,302,6415,94.7,0.59,4.71,2019,80908
13737,439,2021,16197,84.81,2.71,12.48,2019,80909
85,0,0,85,100.0,0.0,0.0,2019,80913
12077,769,808,13654,88.45,5.63,5.92,2019,80209
7964,260,802,9026,88.23,2.88,8.89,2019,80212
9813,666,1620,12099,81.11,5.5,13.39,2019,80214
13736,354,868,14958,91.83,2.37,5.8,2019,80227
725,39,187,951,76.24,4.1,19.66,2019,80440
0,0,0,0,,,,2019,80448
1155,123,215,1493,77.36,8.24,14.4,2019,80452
74,8,0,82,90.24,9.76,0.0,2019,80463
5941,64,135,6140,96.76,1.04,2.2,2019,80465
428,0,105,533,80.3,0.0,19.7,2019,80480
4397,60,359,4816,91.3,1.25,7.45,2019,80513
5787,64,244,6095,94.95,1.05,4.0,2019,80534
828,15,61,904,91.59,1.66,6.75,2019,80536
10124,227,469,10820,93.57,2.1,4.33,2019,80550
142,1,10,153,92.81,0.65,6.54,2019,80747
280,0,88,368,76.09,0.0,23.91,2019,80624
1232,66,201,1499,82.19,4.4,13.41,2019,80651
67,9,24,100,67.0,9.0,24.0,2019,80745
117,5,23,145,80.69,3.45,15.86,2019,80735
7544,234,308,8086,93.3,2.89,3.81,2019,80831
13201,239,400,13840,95.38,1.73,2.89,2019,80920
9272,100,1206,10578,87.65,0.95,11.4,2019,80207
15359,286,2560,18205,84.37,1.57,14.06,2019,80229
14691,235,1894,16820,87.34,1.4,11.26,2019,80233
10667,185,666,11518,92.61,1.61,5.78,2019,80301
10911,616,429,11956,91.26,5.15,3.59,2019,80302
1951,0,168,2119,92.07,0.0,7.93,2019,80422
2862,178,425,3465,82.6,5.14,12.27,2019,80424
126,5,56,187,67.38,2.67,29.95,2019,80805
408,7,86,501,81.44,1.4,17.17,2019,80810
297,0,57,354,83.9,0.0,16.1,2019,80820
651,32,106,789,82.51,4.06,13.43,2019,80828
155,0,19,174,89.08,0.0,10.92,2019,80834
5831,241,1023,7095,82.18,3.4,14.42,2019,80903
9632,176,232,10040,95.94,1.75,2.31,2019,80922
3478,10,121,3609,96.37,0.28,3.35,2019,80925
11799,249,599,12647,93.29,1.97,4.74,2019,80122
177,5,14,196,90.31,2.55,7.14,2019,80481
441,17,39,497,88.73,3.42,7.85,2019,80648
7460,185,516,8161,91.41,2.27,6.32,2019,80403
269,10,55,334,80.54,2.99,16.47,2019,80420
2,0,25,27,7.41,0.0,92.59,2019,80426
3441,52,130,3623,94.98,1.44,3.59,2019,80433
3786,181,2508,6475,58.47,2.8,38.73,2019,87532
304,0,195,499,60.92,0.0,39.08,2019,87548
262,0,76,338,77.51,0.0,22.49,2019,87549
99,0,0,99,100.0,0.0,0.0,2019,87564
502,27,187,716,70.11,3.77,26.12,2019,87710
100,0,0,100,100.0,0.0,0.0,2019,87712
8702,103,781,9586,90.78,1.07,8.15,2019,85737
13104,277,1088,14469,90.57,1.91,7.52,2019,85741
7393,101,309,7803,94.75,1.29,3.96,2019,85748
12,0,0,12,100.0,0.0,0.0,2019,85922
6763,345,5855,12963,52.17,2.66,45.17,2019,85009
5395,291,2072,7758,69.54,3.75,26.71,2019,85019
5161,390,2397,7948,64.93,4.91,30.16,2019,85031
12026,603,2511,15140,79.43,3.98,16.59,2019,85035
3920,31,158,4109,95.4,0.75,3.85,2019,85054
14941,284,445,15670,95.35,1.81,2.84,2019,85234
18740,572,1587,20899,89.67,2.74,7.59,2019,85251
1402,53,26,1481,94.67,3.58,1.76,2019,85263
11099,250,690,12039,92.19,2.08,5.73,2019,85268
3958,42,393,4393,90.1,0.96,8.95,2019,85305
639,32,157,828,77.17,3.86,18.96,2019,85342
6292,255,1707,8254,76.23,3.09,20.68,2019,85349
8973,340,1388,10701,83.85,3.18,12.97,2019,85353
1817,60,416,2293,79.24,2.62,18.14,2019,85354
3509,243,833,4585,76.53,5.3,18.17,2019,85390
949,6,102,1057,89.78,0.57,9.65,2019,85540
7736,188,1873,9797,78.96,1.92,19.12,2019,85541
1747,77,584,2408,72.55,3.2,24.25,2019,85616
79,92,144,315,25.08,29.21,45.71,2019,85545
1892,34,233,2159,87.63,1.57,10.79,2019,85552
0,0,0,0,,,,2019,85608
331,9,267,607,54.53,1.48,43.99,2019,85618
697,9,195,901,77.36,1.0,21.64,2019,85638
16,0,0,16,100.0,0.0,0.0,2019,88114
67,5,29,101,66.34,4.95,28.71,2019,88120
12,0,0,12,100.0,0.0,0.0,2019,88126
14,0,0,14,100.0,0.0,0.0,2019,88134
242,40,146,428,56.54,9.35,34.11,2019,88301
72,0,0,72,100.0,0.0,0.0,2019,88265
0,0,38,38,0.0,0.0,100.0,2019,88268
13,0,20,33,39.39,0.0,60.61,2019,88416
63,0,60,123,51.22,0.0,48.78,2019,88053
22,0,17,39,56.41,0.0,43.59,2019,88024
44,0,10,54,81.48,0.0,18.52,2019,88051
2412,121,1868,4401,54.81,2.75,42.44,2019,88063
156,2,38,196,79.59,1.02,19.39,2019,88116
81,0,12,93,87.1,0.0,12.9,2019,88132
379,0,117,496,76.41,0.0,23.59,2019,88135
7460,289,2277,10026,74.41,2.88,22.71,2019,88201
5152,203,1362,6717,76.7,3.02,20.28,2019,88210
9952,493,2464,12909,77.09,3.82,19.09,2019,88240
194,40,86,320,60.62,12.5,26.88,2019,88253
12,0,0,12,100.0,0.0,0.0,2019,88255
11859,461,2445,14765,80.32,3.12,16.56,2019,88310
0,0,0,0,,,,2019,88323
75,0,3,78,96.15,0.0,3.85,2019,88324
0,0,12,12,0.0,0.0,100.0,2019,88344
67,0,16,83,80.72,0.0,19.28,2019,88418
38,7,7,52,73.08,13.46,13.46,2019,88422
386,20,163,569,67.84,3.51,28.65,2019,93252
1171,73,383,1627,71.97,4.49,23.54,2019,93270
15109,265,2055,17429,86.69,1.52,11.79,2019,93291
11521,625,2835,14981,76.9,4.17,18.92,2019,93304
18004,613,3248,21865,82.34,2.8,14.85,2019,93306
18021,547,4017,22585,79.79,2.42,17.79,2019,93307
13447,1047,2344,16838,79.86,6.22,13.92,2019,85016
13456,505,3111,17072,78.82,2.96,18.22,2019,85029
12902,367,1447,14716,87.67,2.49,9.83,2019,85037
12363,585,4385,17333,71.33,3.38,25.3,2019,85041
11148,248,680,12076,92.32,2.05,5.63,2019,85050
8477,88,275,8840,95.89,1.0,3.11,2019,85085
10701,132,240,11073,96.64,1.19,2.17,2019,85212
17859,297,445,18601,96.01,1.6,2.39,2019,85255
9284,76,297,9657,96.14,0.79,3.08,2019,85259
8160,390,1354,9904,82.39,3.94,13.67,2019,85303
0,0,0,0,,,,2019,85309
2924,89,971,3984,73.39,2.23,24.37,2019,85344
3415,68,138,3621,94.31,1.88,3.81,2019,85355
0,0,0,0,,,,2019,85535
148,24,25,197,75.13,12.18,12.69,2019,85536
468,76,228,772,60.62,9.84,29.53,2019,85645
5755,88,661,6504,88.48,1.35,10.16,2019,85650
12448,471,2059,14978,83.11,3.14,13.75,2019,85716
18577,735,2621,21933,84.7,3.35,11.95,2019,85204
17033,338,772,18143,93.88,1.86,4.26,2019,85260
284,62,83,429,66.2,14.45,19.35,2019,85264
2996,39,352,3387,88.46,1.15,10.39,2019,85307
23027,491,1232,24750,93.04,1.98,4.98,2019,85308
6427,99,139,6665,96.43,1.49,2.09,2019,85310
178,12,101,291,61.17,4.12,34.71,2019,85322
455,9,207,671,67.81,1.34,30.85,2019,85325
538,23,231,792,67.93,2.9,29.17,2019,85337
10245,158,657,11060,92.63,1.43,5.94,2019,85340
2980,191,930,4101,72.67,4.66,22.68,2019,85003
9664,638,2864,13166,73.4,4.85,21.75,2019,85014
8395,1080,2404,11879,70.67,9.09,20.24,2019,85017
11938,591,3825,16354,73.0,3.61,23.39,2019,85021
2488,16,24,2528,98.42,0.63,0.95,2019,85045
14082,259,696,15037,93.65,1.72,4.63,2019,85086
12084,642,2000,14726,82.06,4.36,13.58,2019,85210
5303,17,204,5524,96.0,0.31,3.69,2019,85262
13477,250,405,14132,95.37,1.77,2.87,2019,85296
512,64,201,777,65.89,8.24,25.87,2019,85332
292,89,133,514,56.81,17.32,25.88,2019,85334
17914,567,3923,22404,79.96,2.53,17.51,2019,85008
19466,489,2376,22331,87.17,2.19,10.64,2019,85022
10826,540,1380,12746,84.94,4.24,10.83,2019,85023
9411,228,539,10178,92.46,2.24,5.3,2019,85024
23957,1044,3126,28127,85.17,3.71,11.11,2019,85032
12985,272,348,13605,95.44,2.0,2.56,2019,85048
2916,32,156,3104,93.94,1.03,5.03,2019,85087
5021,124,2274,7419,67.68,1.67,30.65,2019,85621
513,75,649,1237,41.47,6.06,52.47,2019,85550
210,0,87,297,70.71,0.0,29.29,2019,85554
3548,33,359,3940,90.05,0.84,9.11,2019,85615
288,12,81,381,75.59,3.15,21.26,2019,85632
2,0,7,9,22.22,0.0,77.78,2019,85633
41,23,20,84,48.81,27.38,23.81,2019,85640
2698,95,877,3670,73.51,2.59,23.9,2019,90716
7294,240,943,8477,86.04,2.83,11.12,2019,90717
18510,623,3562,22695,81.56,2.75,15.7,2019,90731
11871,538,2379,14788,80.27,3.64,16.09,2019,90744
7228,207,770,8205,88.09,2.52,9.38,2019,90746
0,0,0,0,,,,2019,90822
401,15,96,512,78.32,2.93,18.75,2019,50071
1689,196,317,2202,76.7,8.9,14.4,2019,50129
297,32,94,423,70.21,7.57,22.22,2019,50150
112,0,39,151,74.17,0.0,25.83,2019,50155
2838,198,316,3352,84.67,5.91,9.43,2019,50201
107,1,45,153,69.93,0.65,29.41,2019,50027
25,0,0,25,100.0,0.0,0.0,2019,50041
43,3,16,62,69.35,4.84,25.81,2019,50066
358,3,58,419,85.44,0.72,13.84,2019,50069
783,20,94,897,87.29,2.23,10.48,2019,50072
126,10,36,172,73.26,5.81,20.93,2019,50074
490,23,128,641,76.44,3.59,19.97,2019,50514
84,0,7,91,92.31,0.0,7.69,2019,50515
98,0,4,102,96.08,0.0,3.92,2019,50527
1392,41,360,1793,77.64,2.29,20.08,2019,50536
521,13,76,610,85.41,2.13,12.46,2019,50543
286,9,56,351,81.48,2.56,15.95,2019,50575
713,13,210,936,76.18,1.39,22.44,2019,50619
598,17,142,757,79.0,2.25,18.76,2019,50630
341,6,89,436,78.21,1.38,20.41,2019,50645
284,7,61,352,80.68,1.99,17.33,2019,50650
285,12,25,322,88.51,3.73,7.76,2019,50655
246,1,54,301,81.73,0.33,17.94,2019,50667
5379,220,2177,7776,69.17,2.83,28.0,2019,50703
23,4,12,39,58.97,10.26,30.77,2019,50847
188,2,69,259,72.59,0.77,26.64,2019,50859
54,4,28,86,62.79,4.65,32.56,2019,50078
10,0,2,12,83.33,0.0,16.67,2019,50101
32,0,12,44,72.73,0.0,27.27,2019,50104
423,32,65,520,81.35,6.15,12.5,2019,50122
2022,67,717,2806,72.06,2.39,25.55,2019,50126
142,7,36,185,76.76,3.78,19.46,2019,50128
152,0,26,178,85.39,0.0,14.61,2019,50136
317,18,58,393,80.66,4.58,14.76,2019,50142
182,6,16,204,89.22,2.94,7.84,2019,50160
54,0,2,56,96.43,0.0,3.57,2019,50165
572,5,78,655,87.33,0.76,11.91,2019,50166
144,20,45,209,68.9,9.57,21.53,2019,50206
689,23,155,867,79.47,2.65,17.88,2019,50207
897,82,83,1062,84.46,7.72,7.82,2019,50216
49,9,15,73,67.12,12.33,20.55,2019,50218
4430,230,556,5216,84.93,4.41,10.66,2019,50219
132,0,68,200,66.0,0.0,34.0,2019,50232
605,28,39,672,90.03,4.17,5.8,2019,50236
242,3,60,305,79.34,0.98,19.67,2019,50246
727,3,189,919,79.11,0.33,20.57,2019,50247
8898,219,583,9700,91.73,2.26,6.01,2019,50263
52,6,7,65,80.0,9.23,10.77,2019,50272
76,10,5,91,83.52,10.99,5.49,2019,50274
168,6,83,257,65.37,2.33,32.3,2019,50275
5079,142,1339,6560,77.42,2.16,20.41,2019,50313
11441,529,2810,14780,77.41,3.58,19.01,2019,50317
5968,176,448,6592,90.53,2.67,6.8,2019,50325
1138,30,218,1386,82.11,2.16,15.73,2019,51249
512,8,51,571,89.67,1.4,8.93,2019,51331
172,0,50,222,77.48,0.0,22.52,2019,51333
406,13,123,542,74.91,2.4,22.69,2019,51342
432,8,55,495,87.27,1.62,11.11,2019,51354
280,3,68,351,79.77,0.85,19.37,2019,51364
149,16,114,279,53.41,5.73,40.86,2019,87722
0,0,27,27,0.0,0.0,100.0,2019,87724
60,2,64,126,47.62,1.59,50.79,2019,87743
154,46,203,403,38.21,11.41,50.37,2019,87830
2003,120,997,3120,64.2,3.85,31.96,2019,87901
146,0,196,342,42.69,0.0,57.31,2019,87941
107,0,38,145,73.79,0.0,26.21,2019,87005
46,0,44,90,51.11,0.0,48.89,2019,87032
0,5,124,129,0.0,3.88,96.12,2019,87040
38,6,29,73,52.05,8.22,39.73,2019,87063
1174,136,545,1855,63.29,7.33,29.38,2019,87068
210,7,738,955,21.99,0.73,77.28,2019,87305
1243,118,1948,3309,37.56,3.57,58.87,2019,87420
295,42,209,546,54.03,7.69,38.28,2019,87421
112,17,418,547,20.48,3.11,76.42,2019,87455
6529,196,964,7689,84.91,2.55,12.54,2019,87501
317,25,207,549,57.74,4.55,37.7,2019,87520
289,3,126,418,69.14,0.72,30.14,2019,87567
3,0,7,10,30.0,0.0,70.0,2019,87730
228,0,81,309,73.79,0.0,26.21,2019,87745
26,3,17,46,56.52,6.52,36.96,2019,87733
138,0,88,226,61.06,0.0,38.94,2019,87821
761,18,369,1148,66.29,1.57,32.14,2019,87021
61,0,9,70,87.14,0.0,12.86,2019,87046
311,27,29,367,84.74,7.36,7.9,2019,87051
0,0,0,0,,,,2019,87117
13200,354,890,14444,91.39,2.45,6.16,2019,87144
50,10,98,158,31.65,6.33,62.03,2019,87499
4488,78,1400,5966,75.23,1.31,23.47,2019,87506
14484,518,3080,18082,80.1,2.86,17.03,2019,87507
7189,106,595,7890,91.12,1.34,7.54,2019,87508
109,0,90,199,54.77,0.0,45.23,2019,87523
116,0,159,275,42.18,0.0,57.82,2019,87538
0,0,0,0,,,,2019,87554
18,0,26,44,40.91,0.0,59.09,2019,87574
10,12,24,46,21.74,26.09,52.17,2019,87746
29,0,28,57,50.88,0.0,49.12,2019,87749
93,0,91,184,50.54,0.0,49.46,2019,87530
29,0,3,32,90.62,0.0,9.38,2019,87729
21,0,61,82,25.61,0.0,74.39,2019,87028
291,45,487,823,35.36,5.47,59.17,2019,87375
93,0,137,230,40.43,0.0,59.57,2019,87527
263,31,34,328,80.18,9.45,10.37,2019,84620
212,12,44,268,79.1,4.48,16.42,2019,84628
879,13,106,998,88.08,1.3,10.62,2019,84629
121,0,10,131,92.37,0.0,7.63,2019,84630
344,6,68,418,82.3,1.44,16.27,2019,84634
1086,14,239,1339,81.11,1.05,17.85,2019,84647
8654,205,694,9553,90.59,2.15,7.26,2019,84663
42,3,8,53,79.25,5.66,15.09,2019,84710
2598,138,83,2819,92.16,4.9,2.94,2019,84004
74,0,47,121,61.16,0.0,38.84,2019,84529
7,0,185,192,3.65,0.0,96.35,2019,84531
88,0,8,96,91.67,0.0,8.33,2019,94929
5009,12,176,5197,96.38,0.23,3.39,2019,94065
13649,226,1188,15063,90.61,1.5,7.89,2019,94066
18309,314,941,19564,93.59,1.6,4.81,2019,94086
1699,55,92,1846,92.04,2.98,4.98,2019,94304
24909,410,2185,27504,90.57,1.49,7.94,2019,94110
10465,318,951,11734,89.19,2.71,8.1,2019,93420
9831,185,1650,11666,84.27,1.59,14.14,2019,93454
11369,149,1658,13176,86.29,1.13,12.58,2019,93458
259,9,255,523,49.52,1.72,48.76,2019,93461
18377,770,2280,21427,85.77,3.59,10.64,2019,93536
2528,57,369,2954,85.58,1.93,12.49,2019,93546
1627,100,221,1948,83.52,5.13,11.34,2019,93591
1166,57,318,1541,75.67,3.7,20.64,2019,93609
498,19,190,707,70.44,2.69,26.87,2019,93616
6009,478,1735,8222,73.08,5.81,21.1,2019,93618
745,12,92,849,87.75,1.41,10.84,2019,93626
1350,96,473,1919,70.35,5.0,24.65,2019,93501
3247,87,871,4205,77.22,2.07,20.71,2019,93505
224,30,52,306,73.2,9.8,16.99,2019,93526
10,0,0,10,100.0,0.0,0.0,2019,93530
8656,248,902,9806,88.27,2.53,9.2,2019,93552
5926,196,1026,7148,82.9,2.74,14.35,2019,93560
213,16,132,361,59.0,4.43,36.57,2019,93608
86,0,0,86,100.0,0.0,0.0,2019,93669
2097,170,1150,3417,61.37,4.98,33.66,2019,93701
4704,105,1023,5832,80.66,1.8,17.54,2019,93728
2361,34,149,2544,92.81,1.34,5.86,2019,93924
296,15,119,430,68.84,3.49,27.67,2019,93925
7695,567,826,9088,84.67,6.24,9.09,2019,93933
8830,478,2906,12214,72.29,3.91,23.79,2019,93638
541,0,126,667,81.11,0.0,18.89,2019,93651
668,20,329,1017,65.68,1.97,32.35,2019,93660
184,0,25,209,88.04,0.0,11.96,2019,93664
680,29,155,864,78.7,3.36,17.94,2019,93667
117,0,70,187,62.57,0.0,37.43,2019,93673
14411,386,1132,15929,90.47,2.42,7.11,2019,93711
16923,174,1028,18125,93.37,0.96,5.67,2019,93720
6433,76,871,7380,87.17,1.03,11.8,2019,93907
1596,22,125,1743,91.57,1.26,7.17,2019,93921
3275,84,988,4347,75.34,1.93,22.73,2019,93930
12072,211,926,13209,91.39,1.6,7.01,2019,93012
11679,238,2700,14617,79.9,1.63,18.47,2019,93030
421,4,99,524,80.34,0.76,18.89,2019,93040
5805,128,524,6457,89.9,1.98,8.12,2019,93110
2779,123,1484,4386,63.36,2.8,33.83,2019,93212
155,13,90,258,60.08,5.04,34.88,2019,93218
47,0,57,104,45.19,0.0,54.81,2019,93260
337,19,325,681,49.49,2.79,47.72,2019,93261
3742,103,1980,5825,64.24,1.77,33.99,2019,93263
1250,55,558,1863,67.1,2.95,29.95,2019,93267
16799,493,4176,21468,78.25,2.3,19.45,2019,93274
32,4,13,49,65.31,8.16,26.53,2019,93276
11147,363,1283,12793,87.13,2.84,10.03,2019,93422
14236,233,1049,15518,91.74,1.5,6.76,2019,93455
11185,362,1944,13491,82.91,2.68,14.41,2019,93612
57,0,0,57,100.0,0.0,0.0,2019,93621
35,0,0,35,100.0,0.0,0.0,2019,93627
2,0,0,2,100.0,0.0,0.0,2019,93634
109,0,49,158,68.99,0.0,31.01,2019,95387
14140,316,1647,16103,87.81,1.96,10.23,2019,95403
11043,318,949,12310,89.71,2.58,7.71,2019,95409
4302,128,1532,5962,72.16,2.15,25.7,2019,95422
1141,48,479,1668,68.41,2.88,28.72,2019,95423
3667,150,295,4112,89.18,3.65,7.17,2019,95425
11216,740,2902,14858,75.49,4.98,19.53,2019,90008
4372,230,2706,7308,59.82,3.15,37.03,2019,90013
12614,1050,3554,17218,73.26,6.1,20.64,2019,90016
8192,589,2729,11510,71.17,5.12,23.71,2019,90017
16977,792,790,18559,91.48,4.27,4.26,2019,90036
10232,105,746,11083,92.32,0.95,6.73,2019,90064
13473,353,1588,15414,87.41,2.29,10.3,2019,90065
11285,459,1432,13176,85.65,3.48,10.87,2019,90241
3096,215,466,3777,81.97,5.69,12.34,2019,90248
4495,562,1627,6684,67.25,8.41,24.34,2019,90270
14467,253,824,15544,93.07,1.63,5.3,2019,90275
4854,228,732,5814,83.49,3.92,12.59,2019,90305
3877,181,545,4603,84.23,3.93,11.84,2019,90401
4795,42,162,4999,95.92,0.84,3.24,2019,90402
8894,397,666,9957,89.32,3.99,6.69,2019,90404
4210,100,552,4862,86.59,2.06,11.35,2019,90670
13201,238,1497,14936,88.38,1.59,10.02,2019,90745
10134,300,2354,12788,79.25,2.35,18.41,2019,90806
12557,664,3971,17192,73.04,3.86,23.1,2019,90813
10462,659,2548,13669,76.54,4.82,18.64,2019,90001
10298,328,2590,13216,77.92,2.48,19.6,2019,90012
22897,489,1862,25248,90.69,1.94,7.37,2019,90034
5104,255,2037,7396,69.01,3.45,27.54,2019,90061
22532,1137,2116,25785,87.38,4.41,8.21,2019,90066
12719,366,1265,14350,88.63,2.55,8.82,2019,90638
9515,115,708,10338,92.04,1.11,6.85,2019,90712
12506,380,2069,14955,83.62,2.54,13.83,2019,90804
11033,353,1355,12741,86.59,2.77,10.63,2019,90807
7782,380,1238,9400,82.79,4.04,13.17,2019,90810
12567,230,1445,14242,88.24,1.61,10.15,2019,90501
13470,431,2951,16852,79.93,2.56,17.51,2019,90660
1334,136,83,1553,85.9,8.76,5.34,2019,90704
7297,74,472,7843,93.04,0.94,6.02,2019,90720
11343,775,2089,14207,79.84,5.46,14.7,2019,90723
15151,593,974,16718,90.63,3.55,5.83,2019,90803
11975,949,4679,17603,68.03,5.39,26.58,2019,90022
19862,1086,3516,24464,81.19,4.44,14.37,2019,90019
13645,683,2075,16403,83.19,4.16,12.65,2019,90028
12411,633,4655,17699,70.12,3.58,26.3,2019,90037
8631,76,954,9661,89.34,0.79,9.87,2019,90041
10794,166,676,11636,92.76,1.43,5.81,2019,90048
11279,650,5369,17298,65.2,3.76,31.04,2019,90057
1237,70,114,1421,87.05,4.93,8.02,2019,90067
10745,157,414,11316,94.95,1.39,3.66,2019,90068
11612,108,768,12488,92.99,0.86,6.15,2019,90069
7292,79,565,7936,91.89,1.0,7.12,2019,90210
8659,1154,2331,12144,71.3,9.5,19.19,2019,90221
5924,227,447,6598,89.78,3.44,6.77,2019,90232
6517,317,710,7544,86.39,4.2,9.41,2019,90240
12628,643,2730,16001,78.92,4.02,17.06,2019,90247
8595,199,359,9153,93.9,2.17,3.92,2019,90274
6302,78,224,6604,95.43,1.18,3.39,2019,90293
9699,436,1911,12046,80.52,3.62,15.86,2019,90301
14873,210,900,15983,93.06,1.31,5.63,2019,92064
13616,273,1067,14956,91.04,1.83,7.13,2019,92069
560,13,85,658,85.11,1.98,12.92,2019,92086
23951,330,937,25218,94.98,1.31,3.72,2019,92126
19531,129,248,19908,98.11,0.65,1.25,2019,92130
11485,210,3906,15601,73.62,1.35,25.04,2019,92236
784,24,120,928,84.48,2.59,12.93,2019,51001
934,24,119,1077,86.72,2.23,11.05,2019,51002
21,1,7,29,72.41,3.45,24.14,2019,51011
606,55,64,725,83.59,7.59,8.83,2019,51030
1249,59,324,1632,76.53,3.62,19.85,2019,51040
2188,18,197,2403,91.05,0.75,8.2,2019,51041
202,2,55,259,77.99,0.77,21.24,2019,51049
186,3,58,247,75.3,1.21,23.48,2019,51060
103,20,9,132,78.03,15.15,6.82,2019,51649
106,8,47,161,65.84,4.97,29.19,2019,51565
157,1,72,230,68.26,0.43,31.3,2019,51572
441,2,122,565,78.05,0.35,21.59,2019,51638
126,0,11,137,91.97,0.0,8.03,2019,51654
60,9,16,85,70.59,10.59,18.82,2019,51630
466,29,94,589,79.12,4.92,15.96,2019,51653
377,17,41,435,86.67,3.91,9.43,2019,51355
3445,141,536,4122,83.58,3.42,13.0,2019,51360
125,6,25,156,80.13,3.85,16.03,2019,51365
4272,133,918,5323,80.26,2.5,17.25,2019,51401
256,10,45,311,82.32,3.22,14.47,2019,51430
553,26,91,670,82.54,3.88,13.58,2019,51443
460,19,109,588,78.23,3.23,18.54,2019,51458
20,2,7,29,68.97,6.9,24.14,2019,51459
249,19,14,282,88.3,6.74,4.96,2019,51022
2546,53,719,3318,76.73,1.6,21.67,2019,51442
261,0,82,343,76.09,0.0,23.91,2019,51465
206,2,48,256,80.47,0.78,18.75,2019,51467
74,0,17,91,81.32,0.0,18.68,2019,51520
331,13,81,425,77.88,3.06,19.06,2019,51533
125,0,16,141,88.65,0.0,11.35,2019,51540
1606,88,433,2127,75.51,4.14,20.36,2019,51555
113,19,55,187,60.43,10.16,29.41,2019,51564
392,1,61,454,86.34,0.22,13.44,2019,51573
276,29,63,368,75.0,7.88,17.12,2019,51639
565,47,88,700,80.71,6.71,12.57,2019,51640
65,1,15,81,80.25,1.23,18.52,2019,51647
535,16,121,672,79.61,2.38,18.01,2019,51652
276,12,148,436,63.3,2.75,33.94,2019,51006
433,24,98,555,78.02,4.32,17.66,2019,51016
124,11,14,149,83.22,7.38,9.4,2019,51018
149,9,25,183,81.42,4.92,13.66,2019,51037
92,1,20,113,81.42,0.88,17.7,2019,51044
207,2,47,256,80.86,0.78,18.36,2019,51048
919,34,258,1211,75.89,2.81,21.3,2019,51023
246,13,74,333,73.87,3.9,22.22,2019,51026
149,5,22,176,84.66,2.84,12.5,2019,51033
520,24,186,730,71.23,3.29,25.48,2019,51038
604,9,126,739,81.73,1.22,17.05,2019,51046
877,22,164,1063,82.5,2.07,15.43,2019,51050
2333,74,529,2936,79.46,2.52,18.02,2019,51537
133,14,78,225,59.11,6.22,34.67,2019,51543
67,7,59,133,50.38,5.26,44.36,2019,51545
344,22,69,435,79.08,5.06,15.86,2019,51553
337,3,28,368,91.58,0.82,7.61,2019,54003
5866,110,906,6882,85.24,1.6,13.16,2019,54017
812,12,209,1033,78.61,1.16,20.23,2019,54112
165,1,69,235,70.21,0.43,29.36,2019,54119
6609,237,799,7645,86.45,3.1,10.45,2019,54937
7252,152,960,8364,86.7,1.82,11.48,2019,54022
21315,273,1827,23415,91.03,1.17,7.8,2019,94112
9118,258,938,10314,88.4,2.5,9.09,2019,94132
610,12,284,906,67.33,1.32,31.35,2019,94511
19232,293,1165,20690,92.95,1.42,5.63,2019,94513
21473,547,2018,24038,89.33,2.28,8.4,2019,94533
12556,271,1115,13942,90.06,1.94,8.0,2019,94061
7351,198,1054,8603,85.45,2.3,12.25,2019,91945
5018,150,135,5303,94.63,2.83,2.55,2019,91377
10762,44,594,11400,94.4,0.39,5.21,2019,91403
8191,238,1064,9493,86.28,2.51,11.21,2019,91411
6435,320,767,7522,85.55,4.25,10.2,2019,91506
7858,241,695,8794,89.36,2.74,7.9,2019,91752
9665,131,1494,11290,85.61,1.16,13.23,2019,91754
8328,386,1519,10233,81.38,3.77,14.84,2019,91763
14186,156,777,15119,93.83,1.03,5.14,2019,91765
23986,285,1018,25289,94.85,1.13,4.03,2019,91709
6146,226,1891,8263,74.38,2.74,22.89,2019,91731
8564,181,2281,11026,77.67,1.64,20.69,2019,91733
7350,36,588,7974,92.17,0.45,7.37,2019,91737
8128,152,616,8896,91.37,1.71,6.92,2019,91741
14891,174,1259,16324,91.22,1.07,7.71,2019,91745
6672,136,1237,8045,82.93,1.69,15.38,2019,91768
9953,233,1169,11355,87.65,2.05,10.3,2019,91780
7778,81,726,8585,90.6,0.94,8.46,2019,91792
189,0,21,210,90.0,0.0,10.0,2019,91917
167,0,0,167,100.0,0.0,0.0,2019,91931
10880,149,891,11920,91.28,1.25,7.47,2019,91325
12137,135,506,12778,94.98,1.06,3.96,2019,91326
4584,116,702,5402,84.86,2.15,13.0,2019,91345
10619,329,854,11802,89.98,2.79,7.24,2019,91356
15035,515,4289,19839,75.79,2.6,21.62,2019,91402
5230,64,306,5600,93.39,1.14,5.46,2019,91436
6872,149,1036,8057,85.29,1.85,12.86,2019,91501
11239,1497,3535,16271,69.07,9.2,21.73,2019,91605
5271,188,774,6233,84.57,3.02,12.42,2019,91723
11294,158,211,11663,96.84,1.35,1.81,2019,91739
7202,182,924,8308,86.69,2.19,11.12,2019,91740
15983,234,2752,18969,84.26,1.23,14.51,2019,91744
5366,81,1223,6670,80.45,1.21,18.34,2019,91746
10869,280,961,12110,89.75,2.31,7.94,2019,91750
144,4,9,157,91.72,2.55,5.73,2019,91759
14121,759,2756,17636,80.07,4.3,15.63,2019,91762
9565,181,444,10190,93.87,1.78,4.36,2019,94062
19162,409,1871,21442,89.37,1.91,8.73,2019,94080
15753,318,774,16845,93.52,1.89,4.59,2019,94114
8877,127,538,9542,93.03,1.33,5.64,2019,94402
6376,110,438,6924,92.09,1.59,6.33,2019,94519
6834,60,273,7167,95.35,0.84,3.81,2019,94563
11960,270,1439,13669,87.5,1.98,10.53,2019,94520
20355,228,1639,22222,91.6,1.03,7.38,2019,94538
9063,196,951,10210,88.77,1.92,9.31,2019,94559
12291,211,2000,14502,84.75,1.45,13.79,2019,94578
8052,46,781,8879,90.69,0.52,8.8,2019,94580
904,0,96,1000,90.4,0.0,9.6,2019,92386
1590,39,163,1792,88.73,2.18,9.1,2019,92397
958,95,143,1196,80.1,7.94,11.96,2019,92549
17245,260,584,18089,95.33,1.44,3.23,2019,92563
12219,297,582,13098,93.29,2.27,4.44,2019,92591
5416,80,107,5603,96.66,1.43,1.91,2019,92610
870,0,206,1076,80.86,0.0,19.14,2019,95454
418,17,17,452,92.48,3.76,3.76,2019,95456
197,0,49,246,80.08,0.0,19.92,2019,95459
647,21,308,976,66.29,2.15,31.56,2019,95464
100,0,83,183,54.64,0.0,45.36,2019,95493
488,36,128,652,74.85,5.52,19.63,2019,95525
81,6,35,122,66.39,4.92,28.69,2019,95526
277,30,147,454,61.01,6.61,32.38,2019,95548
104,18,52,174,59.77,10.34,29.89,2019,95555
847,77,102,1026,82.55,7.5,9.94,2019,95570
548,10,76,634,86.44,1.58,11.99,2019,95573
11356,188,865,12409,91.51,1.52,6.97,2019,91316
8266,342,779,9387,88.06,3.64,8.3,2019,91504
6962,238,894,8094,86.01,2.94,11.05,2019,91724
6946,167,1402,8515,81.57,1.96,16.47,2019,91103
321,38,67,426,75.35,8.92,15.73,2019,91008
51,0,44,95,53.68,0.0,46.32,2019,91046
210,18,0,228,92.11,7.89,0.0,2019,91210
0,0,0,0,,,,2019,91330
0,0,0,0,,,,2019,91371
12138,96,581,12815,94.72,0.75,4.53,2019,91387
5512,124,364,6000,91.87,2.07,6.07,2019,91390
727,0,0,727,100.0,0.0,0.0,2019,91708
8622,36,73,8731,98.75,0.41,0.84,2019,91915
19117,3179,2802,25098,76.17,12.67,11.16,2019,92335
4358,208,702,5268,82.73,3.95,13.33,2019,92371
1710,93,274,2077,82.33,4.48,13.19,2019,92372
14357,263,1260,15880,90.41,1.66,7.93,2019,92392
12227,273,1200,13700,89.25,1.99,8.76,2019,92505
431,61,270,762,56.56,8.01,35.43,2019,92401
2483,403,754,3640,68.21,11.07,20.71,2019,92408
14401,198,1970,16569,86.92,1.2,11.89,2019,92504
13365,302,1025,14692,90.97,2.06,6.98,2019,92506
16411,439,1885,18735,87.6,2.34,10.06,2019,92509
1231,81,317,1629,75.57,4.97,19.46,2019,92539
9526,348,2901,12775,74.57,2.72,22.71,2019,92543
7053,179,1817,9049,77.94,1.98,20.08,2019,92586
23209,350,985,24544,94.56,1.43,4.01,2019,92592
18650,203,394,19247,96.9,1.05,2.05,2019,92618
5413,39,307,5759,93.99,0.68,5.33,2019,92625
10779,33,51,10863,99.23,0.3,0.47,2019,92679
15003,234,747,15984,93.86,1.46,4.67,2019,92688
17178,373,1205,18756,91.59,1.99,6.42,2019,92708
11077,265,997,12339,89.77,2.15,8.08,2019,92806
10161,246,1426,11833,85.87,2.08,12.05,2019,92843
15984,209,984,17177,93.05,1.22,5.73,2019,92870
826,0,310,1136,72.71,0.0,27.29,2019,92004
4222,108,289,4619,91.41,2.34,6.26,2019,92007
15591,331,744,16666,93.55,1.99,4.46,2019,92037
17243,322,1691,19256,89.55,1.67,8.78,2019,92020
13872,511,1574,15957,86.93,3.2,9.86,2019,92025
14402,478,1709,16589,86.82,2.88,10.3,2019,92027
10962,211,710,11883,92.25,1.78,5.97,2019,92065
286,0,23,309,92.56,0.0,7.44,2019,80451
2651,62,570,3283,80.75,1.89,17.36,2019,80461
18171,406,902,19479,93.29,2.08,4.63,2019,80504
4736,97,352,5185,91.34,1.87,6.79,2019,80517
483,33,0,516,93.6,6.4,0.0,2019,80520
7484,156,263,7903,94.7,1.97,3.33,2019,80528
1235,31,190,1456,84.82,2.13,13.05,2019,92256
261,19,232,512,50.98,3.71,45.31,2019,92283
77,82,71,230,33.48,35.65,30.87,2019,92328
1743,24,421,2188,79.66,1.1,19.24,2019,92363
10260,248,799,11307,90.74,2.19,7.07,2019,92008
847,8,348,1203,70.41,0.67,28.93,2019,92036
7084,292,335,7711,91.87,3.79,4.34,2019,92106
10467,267,338,11072,94.54,2.41,3.05,2019,92108
20719,559,695,21973,94.29,2.54,3.16,2019,92109
1804,45,9,1858,97.09,2.42,0.48,2019,92121
19638,246,926,20810,94.37,1.18,4.45,2019,92128
5544,132,1552,7228,76.7,1.83,21.47,2019,92227
1581,112,243,1936,81.66,5.79,12.55,2019,92249
291,37,163,491,59.27,7.54,33.2,2019,92257
9474,252,1332,11058,85.68,2.28,12.05,2019,92264
7469,450,992,8911,83.82,5.05,11.13,2019,92277
6515,478,963,7956,81.89,6.01,12.1,2019,92301
1969,38,236,2243,87.78,1.69,10.52,2019,92315
17547,551,3860,21958,79.91,2.51,17.58,2019,92105
12785,422,536,13743,93.03,3.07,3.9,2019,92107
4192,80,710,4982,84.14,1.61,14.25,2019,72012
789,38,253,1080,73.06,3.52,23.43,2019,72016
139,16,145,300,46.33,5.33,48.33,2019,72017
273,48,201,522,52.3,9.2,38.51,2019,72027
389,13,381,783,49.68,1.66,48.66,2019,72029
1382,101,322,1805,76.57,5.6,17.84,2019,72065
251,19,176,446,56.28,4.26,39.46,2019,72073
138,16,35,189,73.02,8.47,18.52,2019,72080
310,5,117,432,71.76,1.16,27.08,2019,72084
847,29,208,1084,78.14,2.68,19.19,2019,72135
338,74,95,507,66.67,14.6,18.74,2019,72157
95,14,30,139,68.35,10.07,21.58,2019,72170
90,10,53,153,58.82,6.54,34.64,2019,72179
7623,668,2974,11265,67.67,5.93,26.4,2019,72209
37,0,5,42,88.1,0.0,11.9,2019,72311
578,229,258,1065,54.27,21.5,24.23,2019,72554
1834,764,1007,3605,50.87,21.19,27.93,2019,72560
49,0,0,49,100.0,0.0,0.0,2019,72578
68,49,16,133,51.13,36.84,12.03,2019,72584
2918,130,1040,4088,71.38,3.18,25.44,2019,72616
176,14,160,350,50.29,4.0,45.71,2019,72628
123,0,49,172,71.51,0.0,28.49,2019,72629
89,2,26,117,76.07,1.71,22.22,2019,72630
1402,40,352,1794,78.15,2.23,19.62,2019,72634
111,33,86,230,48.26,14.35,37.39,2019,72639
9807,563,2327,12697,77.24,4.43,18.33,2019,72653
201,14,56,271,74.17,5.17,20.66,2019,72661
0,0,7,7,0.0,0.0,100.0,2019,72679
77,8,9,94,81.91,8.51,9.57,2019,72683
9410,282,924,10616,88.64,2.66,8.7,2019,72704
85,0,67,152,55.92,0.0,44.08,2019,72721
1515,135,283,1933,78.38,6.98,14.64,2019,72744
33,0,92,125,26.4,0.0,73.6,2019,72747
276,0,95,371,74.39,0.0,25.61,2019,86438
157,12,409,578,27.16,2.08,70.76,2019,86507
42,5,360,407,10.32,1.23,88.45,2019,86545
2131,139,425,2695,79.07,5.16,15.77,2019,86333
1424,142,337,1903,74.83,7.46,17.71,2019,86334
5474,169,558,6201,88.28,2.73,9.0,2019,86426
239,18,27,284,84.15,6.34,9.51,2019,54560
478,7,95,580,82.41,1.21,16.38,2019,54531
251,9,46,306,82.03,2.94,15.03,2019,54550
422,0,36,458,92.14,0.0,7.86,2019,54557
255,5,81,341,74.78,1.47,23.75,2019,54559
0,0,0,0,,,,2019,54561
365,14,158,537,67.97,2.61,29.42,2019,54659
1271,72,337,1680,75.65,4.29,20.06,2019,54646
47,0,0,47,100.0,0.0,0.0,2019,54654
1032,33,325,1390,74.24,2.37,23.38,2019,54722
2585,25,451,3061,84.45,0.82,14.73,2019,54724
512,28,156,696,73.56,4.02,22.41,2019,54726
1729,38,205,1972,87.68,1.93,10.4,2019,54730
314,11,92,417,75.3,2.64,22.06,2019,54756
1061,65,221,1347,78.77,4.83,16.41,2019,54767
703,12,136,851,82.61,1.41,15.98,2019,54770
1006,33,294,1333,75.47,2.48,22.06,2019,54773
763,29,209,1001,76.22,2.9,20.88,2019,54810
9702,414,1374,11490,84.44,3.6,11.96,2019,54952
16280,272,1986,18538,87.82,1.47,10.71,2019,54956
951,42,261,1254,75.84,3.35,20.81,2019,54970
1572,55,355,1982,79.31,2.77,17.91,2019,54840
54,3,8,65,83.08,4.62,12.31,2019,54842
838,39,140,1017,82.4,3.83,13.77,2019,54847
2010,60,511,2581,77.88,2.32,19.8,2019,54848
352,15,80,447,78.75,3.36,17.9,2019,54921
14164,503,2900,17567,80.63,2.86,16.51,2019,54935
94,10,19,123,76.42,8.13,15.45,2019,54123
1180,19,318,1517,77.79,1.25,20.96,2019,54124
27,0,4,31,87.1,0.0,12.9,2019,54127
9071,159,1049,10279,88.25,1.55,10.21,2019,54130
553,14,189,756,73.15,1.85,25.0,2019,54156
623,17,69,709,87.87,2.4,9.73,2019,54204
5138,153,1186,6477,79.33,2.36,18.31,2019,54241
723,14,151,888,81.42,1.58,17.0,2019,54245
740,18,132,890,83.15,2.02,14.83,2019,54247
46,0,22,68,67.65,0.0,32.35,2019,54413
9714,197,1713,11624,83.57,1.69,14.74,2019,54449
6544,222,1534,8300,78.84,2.67,18.48,2019,54452
1962,66,523,2551,76.91,2.59,20.5,2019,54456
240,10,41,291,82.47,3.44,14.09,2019,54463
5158,96,539,5793,89.04,1.66,9.3,2019,54467
610,24,96,730,83.56,3.29,13.15,2019,54469
1537,12,220,1769,86.89,0.68,12.44,2019,54474
502,25,153,680,73.82,3.68,22.5,2019,54475
591,24,107,722,81.86,3.32,14.82,2019,54489
484,13,118,615,78.7,2.11,19.19,2019,54519
100,0,27,127,78.74,0.0,21.26,2019,54525
433,6,90,529,81.85,1.13,17.01,2019,54529
244,26,109,379,64.38,6.86,28.76,2019,54530
667,15,120,802,83.17,1.87,14.96,2019,54849
509,25,208,742,68.6,3.37,28.03,2019,54858
696,32,178,906,76.82,3.53,19.65,2019,54859
157,1,40,198,79.29,0.51,20.2,2019,56211
859,25,269,1153,74.5,2.17,23.33,2019,56220
97,3,34,134,72.39,2.24,25.37,2019,56224
206,5,23,234,88.03,2.14,9.83,2019,56239
718,17,127,862,83.29,1.97,14.73,2019,56264
196,2,40,238,82.35,0.84,16.81,2019,56281
2523,100,176,2799,90.14,3.57,6.29,2019,92624
11190,194,459,11843,94.49,1.64,3.88,2019,92629
13064,350,925,14339,91.11,2.44,6.45,2019,92649
10414,93,2702,13209,78.84,0.7,20.46,2019,92701
12016,134,1005,13155,91.34,1.02,7.64,2019,92675
24047,552,3035,27634,87.02,2.0,10.98,2019,92683
16099,188,763,17050,94.42,1.1,4.48,2019,92691
8081,122,1152,9355,86.38,1.3,12.31,2019,92706
7162,79,194,7435,96.33,1.06,2.61,2019,92808
18901,461,1948,21310,88.7,2.16,9.14,2019,92882
6667,47,133,6847,97.37,0.69,1.94,2019,92887
185,0,103,288,64.24,0.0,35.76,2019,92327
11300,317,1155,12772,88.47,2.48,9.04,2019,92307
1691,17,107,1815,93.17,0.94,5.9,2019,92003
19702,461,2355,22518,87.49,2.05,10.46,2019,92021
407,2,96,505,80.59,0.4,19.01,2019,92059
18398,394,1029,19821,92.82,1.99,5.19,2019,92024
14210,361,1726,16297,87.19,2.22,10.59,2019,92028
240,2,86,328,73.17,0.61,26.22,2019,92070
17527,411,1230,19168,91.44,2.14,6.42,2019,92071
20806,759,2790,24355,85.43,3.12,11.46,2019,92101
10092,246,1050,11388,88.62,2.16,9.22,2019,92110
15392,240,1488,17120,89.91,1.4,8.69,2019,92111
8744,114,680,9538,91.68,1.2,7.13,2019,92119
15387,72,350,15809,97.33,0.46,2.21,2019,92127
17388,106,549,18043,96.37,0.59,3.04,2019,92129
18428,536,4643,23607,78.06,2.27,19.67,2019,92201
2347,62,248,2657,88.33,2.33,9.33,2019,92210
11265,442,1010,12717,88.58,3.48,7.94,2019,92211
2714,32,827,3573,75.96,0.9,23.15,2019,92241
524,0,86,610,85.9,0.0,14.1,2019,92242
10565,360,2076,13001,81.26,2.77,15.97,2019,92243
4929,14,409,5352,92.1,0.26,7.64,2019,92251
3195,141,596,3932,81.26,3.59,15.16,2019,92252
13408,550,1879,15837,84.66,3.47,11.86,2019,92260
53,0,22,75,70.67,0.0,29.33,2019,92266
0,0,6,6,0.0,0.0,100.0,2019,92267
8359,290,641,9290,89.98,3.12,6.9,2019,92270
1962,89,533,2584,75.93,3.44,20.63,2019,92276
341,0,29,370,92.16,0.0,7.84,2019,92278
377,11,66,454,83.04,2.42,14.54,2019,92282
0,0,13,13,0.0,0.0,100.0,2019,92304
224,0,27,251,89.24,0.0,10.76,2019,92305
2616,85,504,3205,81.62,2.65,15.73,2019,92320
0,0,0,0,,,,2019,92338
1693,28,622,2343,72.26,1.2,26.55,2019,92356
1516,46,154,1716,88.34,2.68,8.97,2019,92382
10,0,3,13,76.92,0.0,23.08,2019,92384
4048,1011,1369,6428,62.97,15.73,21.3,2019,92411
13152,280,2034,15466,85.04,1.81,13.15,2019,92530
7504,328,1517,9349,80.27,3.51,16.23,2019,92583
5651,109,355,6115,92.41,1.78,5.81,2019,92585
8469,124,909,9502,89.13,1.3,9.57,2019,92595
213,0,33,246,86.59,0.0,13.41,2019,80436
9499,181,409,10089,94.15,1.79,4.05,2019,80439
1276,90,71,1437,88.8,6.26,4.94,2019,80470
3,0,0,3,100.0,0.0,0.0,2019,80473
521,0,50,571,91.24,0.0,8.76,2019,80478
12341,265,1075,13681,90.21,1.94,7.86,2019,80503
244,3,22,269,90.71,1.12,8.18,2019,84711
38,0,0,38,100.0,0.0,0.0,2019,84731
3372,16,157,3545,95.12,0.45,4.43,2019,84738
58,1,10,69,84.06,1.45,14.49,2019,84740
2,0,0,2,100.0,0.0,0.0,2019,84743
534,15,88,637,83.83,2.35,13.81,2019,84759
151,2,37,190,79.47,1.05,19.47,2019,84760
412,10,37,459,89.76,2.18,8.06,2019,84052
205,0,41,246,83.33,0.0,16.67,2019,84082
64,0,14,78,82.05,0.0,17.95,2019,84530
186,17,73,276,67.39,6.16,26.45,2019,84637
1640,206,304,2150,76.28,9.58,14.14,2019,84741
121,0,22,143,84.62,0.0,15.38,2019,84715
13657,652,1557,15866,86.08,4.11,9.81,2019,84790
8946,932,1184,11062,80.87,8.43,10.7,2019,84116
6803,286,167,7256,93.76,3.94,2.3,2019,84005
6730,246,35,7011,95.99,3.51,0.5,2019,84045
12963,171,264,13398,96.75,1.28,1.97,2019,84081
12176,752,212,13140,92.66,5.72,1.61,2019,84096
133,98,0,231,57.58,42.42,0.0,2019,84144
89,3,2,94,94.68,3.19,2.13,2019,84308
0,0,0,0,,,,2019,84515
133,2,15,150,88.67,1.33,10.0,2019,84665
6200,305,866,7371,84.11,4.14,11.75,2019,84721
95,0,4,99,95.96,0.0,4.04,2019,84742
365,45,49,459,79.52,9.8,10.68,2019,84746
108,0,12,120,90.0,0.0,10.0,2019,84756
87,5,18,110,79.09,4.55,16.36,2019,84763
133,11,32,176,75.57,6.25,18.18,2019,84767
226,0,180,406,55.67,0.0,44.33,2019,84784
88,0,0,88,100.0,0.0,0.0,2019,84626
2349,51,118,2518,93.29,2.03,4.69,2019,84664
65,0,21,86,75.58,0.0,24.42,2019,84749
10293,189,428,10910,94.34,1.73,3.92,2019,84037
18640,1747,581,20968,88.9,8.33,2.77,2019,84095
1305,20,18,1343,97.17,1.49,1.34,2019,84318
497,30,108,635,78.27,4.72,17.01,2019,84542
149,6,18,173,86.13,3.47,10.4,2019,84750
66,0,42,108,61.11,0.0,38.89,2019,84035
192,2,39,233,82.4,0.86,16.74,2019,84305
6794,662,575,8031,84.6,8.24,7.16,2019,84341
845,55,185,1085,77.88,5.07,17.05,2019,84535
364,18,62,444,81.98,4.05,13.96,2019,84724
1334,60,394,1788,74.61,3.36,22.04,2019,81328
428,4,108,540,79.26,0.74,20.0,2019,81415
598,0,70,668,89.52,0.0,10.48,2019,81418
1530,35,509,2074,73.77,1.69,24.54,2019,81425
111,0,47,158,70.25,0.0,29.75,2019,81431
10313,255,1175,11743,87.82,2.17,10.01,2019,81504
5533,168,721,6422,86.16,2.62,11.23,2019,81521
52,0,0,52,100.0,0.0,0.0,2019,81128
291,15,48,354,82.2,4.24,13.56,2019,81130
0,0,24,24,0.0,0.0,100.0,2019,81330
8,0,6,14,57.14,0.0,42.86,2019,88424
48,0,18,66,72.73,0.0,27.27,2019,88427
455,40,553,1048,43.42,3.82,52.77,2019,88435
0,0,0,0,,,,2019,88004
0,0,0,0,,,,2019,88421
254,27,45,326,77.91,8.28,13.8,2019,88426
6855,94,980,7929,86.45,1.19,12.36,2019,86404
9085,223,1232,10540,86.2,2.12,11.69,2019,86406
2835,83,597,3515,80.65,2.36,16.98,2019,86429
25,0,0,25,100.0,0.0,0.0,2019,86433
34,0,8,42,80.95,0.0,19.05,2019,86437
509,0,195,704,72.3,0.0,27.7,2019,86444
34,3,162,199,17.09,1.51,81.41,2019,86508
513,17,828,1358,37.78,1.25,60.97,2019,86510
157,30,498,685,22.92,4.38,72.7,2019,86512
60,13,367,440,13.64,2.95,83.41,2019,86520
56,0,295,351,15.95,0.0,84.05,2019,86535
66,4,257,327,20.18,1.22,78.59,2019,86544
241,0,278,519,46.44,0.0,53.56,2019,86042
274,14,314,602,45.51,2.33,52.16,2019,86053
7705,80,633,8418,91.53,0.95,7.52,2019,86305
11094,589,2496,14179,78.24,4.15,17.6,2019,86442
275,24,172,471,58.39,5.1,36.52,2019,86434
342,0,291,633,54.03,0.0,45.97,2019,86436
855,16,319,1190,71.85,1.34,26.81,2019,86441
578,38,1450,2066,27.98,1.84,70.18,2019,86505
178,7,697,882,20.18,0.79,79.02,2019,86514
477,111,702,1290,36.98,8.6,54.42,2019,86515
87,8,562,657,13.24,1.22,85.54,2019,86538
13044,295,2428,15767,82.73,1.87,15.4,2019,86314
1544,83,455,2082,74.16,3.99,21.85,2019,86324
2781,9,370,3160,88.01,0.28,11.71,2019,86351
6170,102,1377,7649,80.66,1.33,18.0,2019,86403
172,0,97,269,63.94,0.0,36.06,2019,86431
302,19,104,425,71.06,4.47,24.47,2019,86018
2429,69,579,3077,78.94,2.24,18.82,2019,86440
67,10,280,357,18.77,2.8,78.43,2019,86502
517,120,2629,3266,15.83,3.67,80.5,2019,86503
520,68,1192,1780,29.21,3.82,66.97,2019,86504
1356,9,368,1733,78.25,0.52,21.23,2019,86025
8699,444,978,10121,85.95,4.39,9.66,2019,86301
618,23,129,770,80.26,2.99,16.75,2019,86321
1729,66,286,2081,83.09,3.17,13.74,2019,86335
8700,138,1465,10303,84.44,1.34,14.22,2019,86401
3788,146,1318,5252,72.12,2.78,25.1,2019,86413
0,0,0,0,,,,2019,86435
11441,435,1422,13298,86.04,3.27,10.69,2019,86004
511,41,152,704,72.59,5.82,21.59,2019,86022
149,18,228,395,37.72,4.56,57.72,2019,86039
593,36,251,880,67.39,4.09,28.52,2019,86320
8216,328,2098,10642,77.2,3.08,19.71,2019,86326
15253,845,1378,17476,87.28,4.84,7.89,2019,86001
0,0,17,17,0.0,0.0,100.0,2019,86016
454,12,68,534,85.02,2.25,12.73,2019,86032
615,11,1633,2259,27.22,0.49,72.29,2019,86033
976,30,1992,2998,32.56,1.0,66.44,2019,86045
148,10,352,510,29.02,1.96,69.02,2019,86054
5802,289,944,7035,82.47,4.11,13.42,2019,86323
629,27,228,884,71.15,3.05,25.79,2019,86332
5589,81,454,6124,91.26,1.32,7.41,2019,85653
2339,99,286,2724,85.87,3.63,10.5,2019,85701
14954,294,2145,17393,85.98,1.69,12.33,2019,85706
7080,342,2901,10323,68.58,3.31,28.1,2019,85040
12015,504,2067,14586,82.37,3.46,14.17,2019,85208
13124,325,428,13877,94.57,2.34,3.08,2019,85249
193,13,77,283,68.2,4.59,27.21,2019,56289
1433,103,361,1897,75.54,5.43,19.03,2019,56307
9126,506,1781,11413,79.96,4.43,15.61,2019,56308
1781,49,265,2095,85.01,2.34,12.65,2019,56310
773,34,173,980,78.88,3.47,17.65,2019,56312
28,1,8,37,75.68,2.7,21.62,2019,56313
281,6,35,322,87.27,1.86,10.87,2019,56327
58,5,12,75,77.33,6.67,16.0,2019,56328
2083,90,444,2617,79.59,3.44,16.97,2019,56329
1723,48,523,2294,75.11,2.09,22.8,2019,56352
87,0,27,114,76.32,0.0,23.68,2019,56356
321,17,71,409,78.48,4.16,17.36,2019,56357
969,72,229,1270,76.3,5.67,18.03,2019,56358
1286,46,373,1705,75.43,2.7,21.88,2019,56360
599,20,163,782,76.6,2.56,20.84,2019,56171
133,2,38,173,76.88,1.16,21.97,2019,56060
1360,12,215,1587,85.7,0.76,13.55,2019,56048
1185,54,251,1490,79.53,3.62,16.85,2019,56057
1835,44,447,2326,78.89,1.89,19.22,2019,56058
5911,120,977,7008,84.35,1.71,13.94,2019,56073
4203,165,479,4847,86.71,3.4,9.88,2019,56082
271,12,108,391,69.31,3.07,27.62,2019,56083
1730,80,428,2238,77.3,3.57,19.12,2019,56085
103,12,22,137,75.18,8.76,16.06,2019,56114
62,10,25,97,63.92,10.31,25.77,2019,56207
390,10,132,532,73.31,1.88,24.81,2019,56469
1455,76,364,1895,76.78,4.01,19.21,2019,56474
6162,285,901,7348,83.86,3.88,12.26,2019,56501
677,65,191,933,72.56,6.97,20.47,2019,56510
1150,37,225,1412,81.44,2.62,15.93,2019,56514
74,3,42,119,62.18,2.52,35.29,2019,56519
173,9,27,209,82.78,4.31,12.92,2019,56523
154,11,38,203,75.86,5.42,18.72,2019,56552
51,0,19,70,72.86,0.0,27.14,2019,56568
76,4,22,102,74.51,3.92,21.57,2019,56574
269,7,22,298,90.27,2.35,7.38,2019,56578
393,23,69,485,81.03,4.74,14.23,2019,56579
445,14,59,518,85.91,2.7,11.39,2019,56580
375,12,181,568,66.02,2.11,31.87,2019,56584
176,5,17,198,88.89,2.53,8.59,2019,56594
176,9,40,225,78.22,4.0,17.78,2019,56639
140,6,38,184,76.09,3.26,20.65,2019,56646
482,4,118,604,79.8,0.66,19.54,2019,56653
85,130,75,290,29.31,44.83,25.86,2019,56673
88,6,24,118,74.58,5.08,20.34,2019,56681
254,6,72,332,76.51,1.81,21.69,2019,56683
27,1,19,47,57.45,2.13,40.43,2019,56685
157,98,62,317,49.53,30.91,19.56,2019,56686
1071,40,92,1203,89.03,3.33,7.65,2019,56063
153,8,32,193,79.27,4.15,16.58,2019,56134
378,13,66,457,82.71,2.84,14.44,2019,56176
304,14,63,381,79.79,3.67,16.54,2019,56742
265,3,101,369,71.82,0.81,27.37,2019,56661
136,7,29,172,79.07,4.07,16.86,2019,50434
84,1,7,92,91.3,1.09,7.61,2019,50439
164,6,19,189,86.77,3.17,10.05,2019,50440
1528,99,585,2212,69.08,4.48,26.45,2019,50441
201,5,45,251,80.08,1.99,17.93,2019,50451
1920,50,373,2343,81.95,2.13,15.92,2019,50461
11624,1107,564,13295,87.43,8.33,4.24,2019,80521
382,0,123,505,75.64,0.0,24.36,2019,80545
1004,4,230,1238,81.1,0.32,18.58,2019,80610
97,36,11,144,67.36,25.0,7.64,2019,80612
1239,47,306,1592,77.83,2.95,19.22,2019,80645
818,10,165,993,82.38,1.01,16.62,2019,80654
870,25,190,1085,80.18,2.3,17.51,2019,80720
76,0,20,96,79.17,0.0,20.83,2019,80721
157,0,17,174,90.23,0.0,9.77,2019,80722
456,12,66,534,85.39,2.25,12.36,2019,80731
206,0,21,227,90.75,0.0,9.25,2019,80733
10892,145,235,11272,96.63,1.29,2.08,2019,80919
793,90,120,1003,79.06,8.97,11.96,2019,80103
320,11,66,397,80.6,2.77,16.62,2019,80449
125,8,22,155,80.65,5.16,14.19,2019,80649
270,22,15,307,87.95,7.17,4.89,2019,80827
17447,351,927,18725,93.17,1.87,4.95,2019,80918
8098,37,230,8365,96.81,0.44,2.75,2019,80023
486,39,39,564,86.17,6.91,6.91,2019,80045
9373,66,125,9564,98.0,0.69,1.31,2019,80108
7396,144,295,7835,94.4,1.84,3.77,2019,80109
9253,180,1141,10574,87.51,1.7,10.79,2019,80113
11445,142,286,11873,96.4,1.2,2.41,2019,80129
9684,52,246,9982,97.01,0.52,2.46,2019,80130
133,0,8,141,94.33,0.0,5.67,2019,80131
7406,132,108,7646,96.86,1.73,1.41,2019,80238
12205,303,2009,14517,84.07,2.09,13.84,2019,80247
6447,175,371,6993,92.19,2.5,5.31,2019,80305
0,0,0,0,,,,2019,80310
0,0,0,0,,,,2019,80419
41,0,0,41,100.0,0.0,0.0,2019,80453
0,0,0,0,,,,2019,80471
0,0,0,0,,,,2019,80475
34,9,0,43,79.07,20.93,0.0,2019,80477
60,0,0,60,100.0,0.0,0.0,2019,80488
89,39,0,128,69.53,30.47,0.0,2019,80497
0,0,0,0,,,,2019,80511
54,0,0,54,100.0,0.0,0.0,2019,80544
156,6,107,269,57.99,2.23,39.78,2019,80438
140,12,29,181,77.35,6.63,16.02,2019,80468
3864,76,367,4307,89.71,1.76,8.52,2019,80549
1837,24,304,2165,84.85,1.11,14.04,2019,80808
80,0,19,99,80.81,0.0,19.19,2019,80546
11151,113,364,11628,95.9,0.97,3.13,2019,80602
3910,108,435,4453,87.81,2.43,9.77,2019,80603
45,0,11,56,80.36,0.0,19.64,2019,80622
8,1,15,24,33.33,4.17,62.5,2019,80746
2772,41,46,2859,96.96,1.43,1.61,2019,80902
41,0,0,41,100.0,0.0,0.0,2019,80914
10404,106,134,10644,97.75,1.0,1.26,2019,80923
3047,27,113,3187,95.61,0.85,3.55,2019,80924
1345,23,0,1368,98.32,1.68,0.0,2019,80927
25,0,0,25,100.0,0.0,0.0,2019,80938
73,0,358,431,16.94,0.0,83.06,2019,84536
7327,2941,294,10562,69.37,27.85,2.78,2019,84606
1552,85,274,1911,81.21,4.45,14.34,2019,84624
107,1,22,130,82.31,0.77,16.92,2019,84309
59,4,26,89,66.29,4.49,29.21,2019,84316
683,8,77,768,88.93,1.04,10.03,2019,84317
451,42,142,635,71.02,6.61,22.36,2019,88232
421,30,212,663,63.5,4.52,31.98,2019,88256
0,0,4,4,0.0,0.0,100.0,2019,88262
0,0,17,17,0.0,0.0,100.0,2019,88264
669,38,163,870,76.9,4.37,18.74,2019,88316
343,9,30,382,89.79,2.36,7.85,2019,88325
670,29,63,762,87.93,3.81,8.27,2019,88337
431,19,386,836,51.56,2.27,46.17,2019,88346
30,0,0,30,100.0,0.0,0.0,2019,88347
57,8,79,144,39.58,5.56,54.86,2019,88353
0,0,16,16,0.0,0.0,100.0,2019,88354
37,0,19,56,66.07,0.0,33.93,2019,88430
775,27,311,1113,69.63,2.43,27.94,2019,88340
1405,0,501,1906,73.71,0.0,26.29,2019,88352
1211,79,1059,2349,51.55,3.36,45.08,2019,88401
19,0,5,24,79.17,0.0,20.83,2019,88411
9,0,0,9,100.0,0.0,0.0,2019,88431
31,0,18,49,63.27,0.0,36.73,2019,88436
3517,282,2176,5975,58.86,4.72,36.42,2019,88021
0,0,0,0,,,,2019,88003
2596,100,284,2980,87.11,3.36,9.53,2019,88008
33,12,11,56,58.93,21.43,19.64,2019,88040
421,0,148,569,73.99,0.0,26.01,2019,88041
402,8,156,566,71.02,1.41,27.56,2019,88043
49,0,45,94,52.13,0.0,47.87,2019,88052
5735,337,1779,7851,73.05,4.29,22.66,2019,88061
155,11,91,257,60.31,4.28,35.41,2019,88065
14160,347,2913,17420,81.29,1.99,16.72,2019,88101
149,41,41,231,64.5,17.75,17.75,2019,88039
41,10,77,128,32.03,7.81,60.16,2019,88027
430,23,183,636,67.61,3.62,28.77,2019,88119
17,0,0,17,100.0,0.0,0.0,2019,88314
560,8,108,676,82.84,1.18,15.98,2019,88317
1096,0,0,1096,100.0,0.0,0.0,2019,88330
245,18,55,318,77.04,5.66,17.3,2019,88341
0,0,4,4,0.0,0.0,100.0,2019,88343
51,5,24,80,63.75,6.25,30.0,2019,88351
5,0,2,7,71.43,0.0,28.57,2019,88414
92,13,53,158,58.23,8.23,33.54,2019,88434
9389,654,3704,13747,68.3,4.76,26.94,2019,88001
238,26,81,345,68.99,7.54,23.48,2019,88022
628,33,290,951,66.04,3.47,30.49,2019,88023
70,0,16,86,81.4,0.0,18.6,2019,88025
2146,67,348,2561,83.8,2.62,13.59,2019,88242
20,0,19,39,51.28,0.0,48.72,2019,88115
11198,285,2134,13617,82.24,2.09,15.67,2019,88220
877,33,238,1148,76.39,2.87,20.73,2019,88231
243,21,28,292,83.22,7.19,9.59,2019,88002
2,0,0,2,100.0,0.0,0.0,2019,88009
272,32,252,556,48.92,5.76,45.32,2019,88026
902,69,331,1302,69.28,5.3,25.42,2019,88045
138,9,41,188,73.4,4.79,21.81,2019,88049
82,7,22,111,73.87,6.31,19.82,2019,88056
9264,414,1795,11473,80.75,3.61,15.65,2019,93635
1591,83,1292,2966,53.64,2.8,43.56,2019,93640
1932,241,875,3048,63.39,7.91,28.71,2019,93646
2090,137,705,2932,71.28,4.67,24.05,2019,93647
406,50,86,542,74.91,9.23,15.87,2019,93653
8248,259,2213,10720,76.94,2.42,20.64,2019,93657
7214,169,230,7613,94.76,2.22,3.02,2019,85253
17497,556,523,18576,94.19,2.99,2.82,2019,85254
12314,200,623,13137,93.74,1.52,4.74,2019,85258
21149,971,2724,24844,85.13,3.91,10.96,2019,85281
17204,498,2107,19809,86.85,2.51,10.64,2019,85283
980,38,361,1379,71.07,2.76,26.18,2019,85324
11534,155,353,12042,95.78,1.29,2.93,2019,85331
16844,552,2446,19842,84.89,2.78,12.33,2019,85345
154,0,27,181,85.08,0.0,14.92,2019,85347
3949,332,1602,5883,67.13,5.64,27.23,2019,85350
13561,562,3166,17289,78.44,3.25,18.31,2019,85351
3224,397,1645,5266,61.22,7.54,31.24,2019,85501
10957,1026,3198,15181,72.18,6.76,21.07,2019,85015
15924,261,921,17106,93.09,1.53,5.38,2019,85044
9897,269,1123,11289,87.67,2.38,9.95,2019,85053
15766,783,3481,20030,78.71,3.91,17.38,2019,85201
14523,531,2583,17637,82.34,3.01,14.65,2019,85205
13288,391,1966,15645,84.93,2.5,12.57,2019,85206
11375,410,960,12745,89.25,3.22,7.53,2019,85213
15590,270,1199,17059,91.39,1.58,7.03,2019,85224
3331,104,579,4014,82.98,2.59,14.42,2019,83669
639,33,177,849,75.27,3.89,20.85,2019,83849
537,49,94,680,78.97,7.21,13.82,2019,83654
29,5,27,61,47.54,8.2,44.26,2019,83808
629,26,193,848,74.17,3.07,22.76,2019,83629
269,10,36,315,85.4,3.17,11.43,2019,83645
875,12,15,902,97.01,1.33,1.66,2019,83648
1691,33,398,2122,79.69,1.56,18.76,2019,83660
32,27,0,59,54.24,45.76,0.0,2019,83677
14255,450,2519,17224,82.76,2.61,14.62,2019,83686
2410,118,308,2836,84.98,4.16,10.86,2019,83801
370,0,155,525,70.48,0.0,29.52,2019,83810
64,0,22,86,74.42,0.0,25.58,2019,83827
118,0,42,160,73.75,0.0,26.25,2019,83830
507,35,79,621,81.64,5.64,12.72,2019,83832
379,41,39,459,82.57,8.93,8.5,2019,83836
107,0,68,175,61.14,0.0,38.86,2019,83841
9898,684,629,11211,88.29,6.1,5.61,2019,83843
250,0,96,346,72.25,0.0,27.75,2019,83846
190,4,22,216,87.96,1.85,10.19,2019,83239
748,8,78,834,89.69,0.96,9.35,2019,83241
1427,17,162,1606,88.85,1.06,10.09,2019,83252
438,6,84,528,82.95,1.14,15.91,2019,83255
114,0,9,123,92.68,0.0,7.32,2019,83287
4995,74,615,5684,87.88,1.3,10.82,2019,83318
257,10,49,316,81.33,3.16,15.51,2019,83320
3106,54,400,3560,87.25,1.52,11.24,2019,83333
618,6,140,764,80.89,0.79,18.32,2019,83334
16,0,0,16,100.0,0.0,0.0,2019,83446
176,10,68,254,69.29,3.94,26.77,2019,83451
13642,722,1760,16124,84.61,4.48,10.92,2019,83854
6174,221,459,6854,90.08,3.22,6.7,2019,83001
235,23,28,286,82.17,8.04,9.79,2019,83114
10539,147,999,11685,90.19,1.26,8.55,2019,90504
5730,365,1548,7643,74.97,4.78,20.25,2019,90602
19164,441,1624,21229,90.27,2.08,7.65,2019,90631
8536,161,468,9165,93.14,1.76,5.11,2019,90814
13303,313,940,14556,91.39,2.15,6.46,2019,90815
114,0,5,119,95.8,0.0,4.2,2019,90071
555,17,92,664,83.58,2.56,13.86,2019,50468
814,28,118,960,84.79,2.92,12.29,2019,50472
217,4,52,273,79.49,1.47,19.05,2019,50483
205,28,20,253,81.03,11.07,7.91,2019,50516
116,3,41,160,72.5,1.88,25.62,2019,50518
275,0,70,345,79.71,0.0,20.29,2019,50522
1062,48,443,1553,68.38,3.09,28.53,2019,50525
359,2,82,443,81.04,0.45,18.51,2019,50535
89,5,51,145,61.38,3.45,35.17,2019,50546
201,4,42,247,81.38,1.62,17.0,2019,50558
107,6,37,150,71.33,4.0,24.67,2019,50559
131,3,39,173,75.72,1.73,22.54,2019,50562
163,6,17,186,87.63,3.23,9.14,2019,50565
123,7,25,155,79.35,4.52,16.13,2019,50571
282,20,107,409,68.95,4.89,26.16,2019,50590
509,25,146,680,74.85,3.68,21.47,2019,50602
131,0,65,196,66.84,0.0,33.16,2019,50603
309,20,126,455,67.91,4.4,27.69,2019,50625
2853,42,696,3591,79.45,1.17,19.38,2019,50644
284,11,56,351,80.91,3.13,15.95,2019,50075
454,17,134,605,75.04,2.81,22.15,2019,50002
272,36,65,373,72.92,9.65,17.43,2019,50005
563,28,120,711,79.18,3.94,16.88,2019,50006
44,0,0,44,100.0,0.0,0.0,2019,50038
101,3,16,120,84.17,2.5,13.33,2019,50042
120,10,28,158,75.95,6.33,17.72,2019,50103
319,9,22,350,91.14,2.57,6.29,2019,50105
1063,27,71,1161,91.56,2.33,6.12,2019,50109
7729,281,554,8564,90.25,3.28,6.47,2019,50131
226,2,54,282,80.14,0.71,19.15,2019,50134
3788,242,1040,5070,74.71,4.77,20.51,2019,50138
284,7,88,379,74.93,1.85,23.22,2019,50149
1557,95,281,1933,80.55,4.91,14.54,2019,50156
9151,362,2295,11808,77.5,3.07,19.44,2019,50158
255,11,37,303,84.16,3.63,12.21,2019,50217
343,35,60,438,78.31,7.99,13.7,2019,50230
62,2,9,73,84.93,2.74,12.33,2019,50231
811,9,110,930,87.2,0.97,11.83,2019,50261
181,12,51,244,74.18,4.92,20.9,2019,50271
11075,434,1747,13256,83.55,3.27,13.18,2019,50310
6392,493,766,7651,83.54,6.44,10.01,2019,50312
6714,233,1086,8033,83.58,2.9,13.52,2019,50320
2935,75,280,3290,89.21,2.28,8.51,2019,50321
11439,222,1101,12762,89.63,1.74,8.63,2019,50322
95,1,25,121,78.51,0.83,20.66,2019,50432
736,41,109,886,83.07,4.63,12.3,2019,50169
992,23,179,1194,83.08,1.93,14.99,2019,50170
226,40,62,328,68.9,12.2,18.9,2019,50173
480,30,136,646,74.3,4.64,21.05,2019,50210
2355,114,440,2909,80.96,3.92,15.13,2019,50213
258,5,25,288,89.58,1.74,8.68,2019,50223
945,22,176,1143,82.68,1.92,15.4,2019,50225
1847,54,109,2010,91.89,2.69,5.42,2019,50226
353,21,94,468,75.43,4.49,20.09,2019,51053
23,0,13,36,63.89,0.0,36.11,2019,51111
2051,37,508,2596,79.01,1.43,19.57,2019,51201
66,3,11,80,82.5,3.75,13.75,2019,51242
2254,60,522,2836,79.48,2.12,18.41,2019,51334
537,10,132,679,79.09,1.47,19.44,2019,51347
211,0,34,245,86.12,0.0,13.88,2019,84324
266,0,36,302,88.08,0.0,11.92,2019,84022
15826,477,395,16698,94.78,2.86,2.37,2019,84043
6226,101,256,6583,94.58,1.53,3.89,2019,84054
433,6,34,473,91.54,1.27,7.19,2019,84055
10894,596,314,11804,92.29,5.05,2.66,2019,84065
17819,511,1354,19684,90.53,2.6,6.88,2019,84118
14615,897,1621,17133,85.3,5.24,9.46,2019,84119
1455,0,30,1485,97.98,0.0,2.02,2019,84310
147,3,24,174,84.48,1.72,13.79,2019,84311
529,15,41,585,90.43,2.56,7.01,2019,84326
88,1,11,100,88.0,1.0,11.0,2019,84331
755,25,90,870,86.78,2.87,10.34,2019,84333
8760,175,348,9283,94.37,1.89,3.75,2019,84414
231,3,33,267,86.52,1.12,12.36,2019,84521
705,25,183,913,77.22,2.74,20.04,2019,84528
941,16,145,1102,85.39,1.45,13.16,2019,84631
219,12,31,262,83.59,4.58,11.83,2019,84635
158,1,28,187,84.49,0.53,14.97,2019,84643
1684,36,343,2063,81.63,1.75,16.63,2019,84648
182,18,50,250,72.8,7.2,20.0,2019,84723
302,8,62,372,81.18,2.15,16.67,2019,84726
15,0,0,15,100.0,0.0,0.0,2019,84728
30,0,16,46,65.22,0.0,34.78,2019,84329
162,23,448,633,25.59,3.63,70.77,2019,84534
383,3,93,479,79.96,0.63,19.42,2019,84537
520,3,62,585,88.89,0.51,10.6,2019,84622
1582,285,192,2059,76.83,13.84,9.32,2019,84627
270,15,54,339,79.65,4.42,15.93,2019,84632
2253,23,107,2383,94.54,0.97,4.49,2019,84653
777,24,192,993,78.25,2.42,19.34,2019,84654
144,2,46,192,75.0,1.04,23.96,2019,84657
161,0,140,301,53.49,0.0,46.51,2019,87575
45,0,53,98,45.92,0.0,54.08,2019,87583
82,0,35,117,70.09,0.0,29.91,2019,87731
38,0,39,77,49.35,0.0,50.65,2019,87735
2359,58,1111,3528,66.87,1.64,31.49,2019,87740
436,6,184,626,69.65,0.96,29.39,2019,87747
0,0,0,0,,,,2019,87750
8,0,25,33,24.24,0.0,75.76,2019,87820
161,14,120,295,54.58,4.75,40.68,2019,87823
35,7,11,53,66.04,13.21,20.75,2019,87831
261,0,204,465,56.13,0.0,43.87,2019,87931
19481,1272,3603,24356,79.98,5.22,14.79,2019,87121
12940,798,3482,17220,75.15,4.63,20.22,2019,87123
77,6,187,270,28.52,2.22,69.26,2019,87310
226,45,835,1106,20.43,4.07,75.5,2019,87311
45,0,51,96,46.88,0.0,53.12,2019,87347
809,109,560,1478,54.74,7.37,37.89,2019,87552
233,19,209,461,50.54,4.12,45.34,2019,87553
1395,56,720,2171,64.26,2.58,33.16,2019,87557
89,0,73,162,54.94,0.0,45.06,2019,87562
90,13,9,112,80.36,11.61,8.04,2019,87578
6480,221,798,7499,86.41,2.95,10.64,2019,94702
7250,567,434,8251,87.87,6.87,5.26,2019,94704
4653,11,174,4838,96.18,0.23,3.6,2019,94707
4867,96,339,5302,91.8,1.81,6.39,2019,94904
12353,214,1477,14044,87.96,1.52,10.52,2019,94014
615,13,33,661,93.04,1.97,4.99,2019,94020
7632,185,2084,9901,77.08,1.87,21.05,2019,93703
4879,191,1765,6835,71.38,2.79,25.82,2019,93725
14818,387,2305,17510,84.63,2.21,13.16,2019,93436
353,0,51,404,87.38,0.0,12.62,2019,93441
126,0,196,322,39.13,0.0,60.87,2019,93452
274,12,86,372,73.66,3.23,23.12,2019,93518
23,0,36,59,38.98,0.0,61.02,2019,93522
32,0,26,58,55.17,0.0,44.83,2019,93528
174,0,64,238,73.11,0.0,26.89,2019,93606
81,21,75,177,45.76,11.86,42.37,2019,93624
2288,352,1509,4149,55.15,8.48,36.37,2019,93648
6109,336,2127,8572,71.27,3.92,24.81,2019,93654
1110,49,531,1690,65.68,2.9,31.42,2019,93656
14657,108,1277,16042,91.37,0.67,7.96,2019,93010
4127,39,1022,5188,79.55,0.75,19.7,2019,93015
14048,1120,891,16059,87.48,6.97,5.55,2019,93117
836,13,313,1162,71.94,1.12,26.94,2019,93202
2178,72,662,2912,74.79,2.47,22.73,2019,93223
103,4,10,117,88.03,3.42,8.55,2019,93244
15325,342,2474,18141,84.48,1.89,13.64,2019,93277
11499,169,1926,13594,84.59,1.24,14.17,2019,93292
8057,512,2132,10701,75.29,4.78,19.92,2019,93305
13086,379,1016,14481,90.37,2.62,7.02,2019,93313
8051,253,347,8651,93.06,2.92,4.01,2019,93405
422,45,40,507,83.23,8.88,7.89,2019,93424
517,65,23,605,85.45,10.74,3.8,2019,93432
4868,16,423,5307,91.73,0.3,7.97,2019,93433
109,0,95,204,53.43,0.0,46.57,2019,93450
1899,15,109,2023,93.87,0.74,5.39,2019,93460
3056,28,273,3357,91.03,0.83,8.13,2019,93465
904,51,21,976,92.62,5.23,2.15,2019,93532
17869,716,2963,21548,82.93,3.32,13.75,2019,93550
14424,364,983,15771,91.46,2.31,6.23,2019,93551
9483,536,1660,11679,81.2,4.59,14.21,2019,93561
96,0,0,96,100.0,0.0,0.0,2019,93563
1053,20,327,1400,75.21,1.43,23.36,2019,93602
52,0,5,57,91.23,0.0,8.77,2019,93605
3727,127,856,4710,79.13,2.7,18.17,2019,93610
2867,120,572,3559,80.56,3.37,16.07,2019,93644
6610,292,1905,8807,75.05,3.32,21.63,2019,93662
177,0,176,353,50.14,0.0,49.86,2019,93668
9571,377,1386,11334,84.45,3.33,12.23,2019,93704
11625,264,2246,14135,82.24,1.87,15.89,2019,93726
14800,180,1820,16800,88.1,1.07,10.83,2019,93906
4140,24,271,4435,93.35,0.54,6.11,2019,93908
4945,97,529,5571,88.76,1.74,9.5,2019,93923
61,0,173,234,26.07,0.0,73.93,2019,93665
8014,356,3591,11961,67.0,2.98,30.02,2019,93702
9099,486,2518,12103,75.18,4.02,20.8,2019,93705
7325,524,3177,11026,66.43,4.75,28.81,2019,93706
9530,468,1240,11238,84.8,4.16,11.03,2019,93710
9607,200,3208,13015,73.81,1.54,24.65,2019,93905
11985,149,1224,13358,89.72,1.12,9.16,2019,93940
1364,24,117,1505,90.63,1.59,7.77,2019,95623
49,4,18,71,69.01,5.63,25.35,2019,95140
461,0,75,536,86.01,0.0,13.99,2019,95937
103,11,78,192,53.65,5.73,40.62,2019,95939
483,0,371,854,56.56,0.0,43.44,2019,95951
261,16,71,348,75.0,4.6,20.4,2019,95960
1069,87,230,1386,77.13,6.28,16.59,2019,95634
34,0,0,34,100.0,0.0,0.0,2019,95646
4842,199,349,5390,89.83,3.69,6.47,2019,95650
528,0,50,578,91.35,0.0,8.65,2019,95664
4451,93,414,4958,89.77,1.88,8.35,2019,95673
940,41,324,1305,72.03,3.14,24.83,2019,95684
609,19,98,726,83.88,2.62,13.5,2019,95689
3101,87,289,3477,89.19,2.5,8.31,2019,95694
340,0,41,381,89.24,0.0,10.76,2019,95703
170,19,35,224,75.89,8.48,15.62,2019,95714
14134,194,249,14577,96.96,1.33,1.71,2019,95762
5129,77,942,6148,83.43,1.25,15.32,2019,95817
7286,133,482,7901,92.22,1.68,6.1,2019,95819
6883,351,1869,9103,75.61,3.86,20.53,2019,95824
13352,166,757,14275,93.53,1.16,5.3,2019,95843
1002,13,89,1104,90.76,1.18,8.06,2019,95917
1133,0,157,1290,87.83,0.0,12.17,2019,95918
270,2,49,321,84.11,0.62,15.26,2019,95922
13383,249,1310,14942,89.57,1.67,8.77,2019,95926
2320,56,498,2874,80.72,1.95,17.33,2019,95932
95,0,35,130,73.08,0.0,26.92,2019,95935
1313,51,158,1522,86.27,3.35,10.38,2019,95938
3391,90,318,3799,89.26,2.37,8.37,2019,95946
367,5,141,513,71.54,0.97,27.49,2019,95955
6478,167,893,7538,85.94,2.22,11.85,2019,95959
5240,208,1535,6983,75.04,2.98,21.98,2019,95965
9268,360,1638,11266,82.27,3.2,14.54,2019,95966
194,4,56,254,76.38,1.57,22.05,2019,95970
10667,206,1412,12285,86.83,1.68,11.49,2019,95993
8882,357,1837,11076,80.19,3.22,16.59,2019,95204
231,3,35,269,85.87,1.12,13.01,2019,95230
518,34,225,777,66.67,4.38,28.96,2019,95231
416,0,129,545,76.33,0.0,23.67,2019,95246
1324,51,255,1630,81.23,3.13,15.64,2019,95247
3221,88,313,3622,88.93,2.43,8.64,2019,95315
40,0,0,40,100.0,0.0,0.0,2019,95325
3025,48,392,3465,87.3,1.39,11.31,2019,95326
879,21,205,1105,79.55,1.9,18.55,2019,95328
7208,133,850,8191,88.0,1.62,10.38,2019,95841
1315,10,251,1576,83.44,0.63,15.93,2019,95912
463,23,78,564,82.09,4.08,13.83,2019,95942
0,0,14,14,0.0,0.0,100.0,2019,95944
3125,78,515,3718,84.05,2.1,13.85,2019,95948
121,0,30,151,80.13,0.0,19.87,2019,95950
2687,111,464,3262,82.37,3.4,14.22,2019,95953
118,8,41,167,70.66,4.79,24.55,2019,95956
132,0,17,149,88.59,0.0,11.41,2019,95983
1503,18,245,1766,85.11,1.02,13.87,2019,95987
3781,64,640,4485,84.3,1.43,14.27,2019,95334
10731,173,1144,12048,89.07,1.44,9.5,2019,95337
10527,81,869,11477,91.72,0.71,7.57,2019,95356
6666,43,897,7606,87.64,0.57,11.79,2019,95363
1670,25,83,1778,93.93,1.41,4.67,2019,95383
400,21,231,652,61.35,3.22,35.43,2019,86337
154,5,19,178,86.52,2.81,10.67,2019,86338
921,0,632,1553,59.3,0.0,40.7,2019,86432
335,4,39,378,88.62,1.06,10.32,2019,86024
211,48,302,561,37.61,8.56,53.83,2019,86035
2465,92,648,3205,76.91,2.87,20.22,2019,86040
238,19,93,350,68.0,5.43,26.57,2019,51019
239,15,167,421,56.77,3.56,39.67,2019,51101
607,5,162,774,78.42,0.65,20.93,2019,51240
711,16,118,845,84.14,1.89,13.96,2019,51248
112,1,22,135,82.96,0.74,16.3,2019,51343
61,2,17,80,76.25,2.5,21.25,2019,51363
92,6,24,122,75.41,4.92,19.67,2019,51447
164,3,73,240,68.33,1.25,30.42,2019,51448
392,5,93,490,80.0,1.02,18.98,2019,51461
97,26,40,163,59.51,15.95,24.54,2019,51536
138,7,43,188,73.4,3.72,22.87,2019,51541
836,65,222,1123,74.44,5.79,19.77,2019,51546
143,8,25,176,81.25,4.55,14.2,2019,51562
178,6,17,201,88.56,2.99,8.46,2019,51571
101,3,16,120,84.17,2.5,13.33,2019,51645
2621,191,1149,3961,66.17,4.82,29.01,2019,51105
470,0,32,502,93.63,0.0,6.37,2019,51235
35,0,5,40,87.5,0.0,12.5,2019,51244
10,0,12,22,45.45,0.0,54.55,2019,51341
768,55,180,1003,76.57,5.48,17.95,2019,51346
1581,82,301,1964,80.5,4.18,15.33,2019,51351
157,1,32,190,82.63,0.53,16.84,2019,51431
106,13,10,129,82.17,10.08,7.75,2019,51440
955,21,239,1215,78.6,1.73,19.67,2019,51445
698,6,176,880,79.32,0.68,20.0,2019,51449
10188,773,2953,13914,73.22,5.56,21.22,2019,51501
266,10,33,309,86.08,3.24,10.68,2019,51531
26,0,1,27,96.3,0.0,3.7,2019,51578
586,30,65,681,86.05,4.41,9.54,2019,51003
179,9,19,207,86.47,4.35,9.18,2019,51007
792,34,98,924,85.71,3.68,10.61,2019,51028
124,0,20,144,86.11,0.0,13.89,2019,51029
233,12,35,280,83.21,4.29,12.5,2019,51047
176,4,26,206,85.44,1.94,12.62,2019,51061
132,1,29,162,81.48,0.62,17.9,2019,51062
360,15,74,449,80.18,3.34,16.48,2019,51063
79,7,45,131,60.31,5.34,34.35,2019,51650
353,9,71,433,81.52,2.08,16.4,2019,51561
195,21,82,298,65.44,7.05,27.52,2019,51530
496,25,106,627,79.11,3.99,16.91,2019,51055
55,2,13,70,78.57,2.86,18.57,2019,51550
538,8,90,636,84.59,1.26,14.15,2019,51005
69,4,14,87,79.31,4.6,16.09,2019,51009
11,0,4,15,73.33,0.0,26.67,2019,51656
154,21,55,230,66.96,9.13,23.91,2019,51446
60,10,7,77,77.92,12.99,9.09,2019,52566
201,2,126,329,61.09,0.61,38.3,2019,52570
274,9,144,427,64.17,2.11,33.72,2019,52572
99,3,10,112,88.39,2.68,8.93,2019,52594
453,19,123,595,76.13,3.19,20.67,2019,52237
788,29,152,969,81.32,2.99,15.69,2019,52322
206,1,23,230,89.57,0.43,10.0,2019,52305
36,4,25,65,55.38,6.15,38.46,2019,52308
1000,54,227,1281,78.06,4.22,17.72,2019,54871
469,29,125,623,75.28,4.65,20.06,2019,54876
311,9,72,392,79.34,2.3,18.37,2019,54027
311,10,121,442,70.36,2.26,27.38,2019,54102
1107,40,234,1381,80.16,2.9,16.94,2019,54107
194,0,121,315,61.59,0.0,38.41,2019,54150
2406,15,87,2508,95.93,0.6,3.47,2019,94028
13378,248,941,14567,91.84,1.7,6.46,2019,94040
12889,1277,3870,18036,71.46,7.08,21.46,2019,94102
1942,40,229,2211,87.83,1.81,10.36,2019,94111
15303,126,633,16062,95.27,0.78,3.94,2019,94010
12771,203,776,13750,92.88,1.48,5.64,2019,94044
10815,108,614,11537,93.74,0.94,5.32,2019,94070
5167,283,37,5487,94.17,5.16,0.67,2019,94105
15496,344,1608,17448,88.81,1.97,9.22,2019,94121
6252,344,446,7042,88.78,4.88,6.33,2019,94301
12455,508,1347,14310,87.04,3.55,9.41,2019,94303
2120,1409,49,3578,59.25,39.38,1.37,2019,94305
15517,145,867,16529,93.88,0.88,5.25,2019,94403
3029,117,227,3373,89.8,3.47,6.73,2019,94572
6000,121,679,6800,88.24,1.78,9.99,2019,94579
8457,196,1132,9785,86.43,2.0,11.57,2019,94589
7408,286,2312,10006,74.04,2.86,23.11,2019,94603
13667,513,2266,16446,83.1,3.12,13.78,2019,94605
6742,289,1719,8750,77.05,3.3,19.65,2019,94612
6750,890,341,7981,84.58,11.15,4.27,2019,94706
411,18,77,506,81.23,3.56,15.22,2019,94923
14899,384,1110,16393,90.89,2.34,6.77,2019,94928
307,24,43,374,82.09,6.42,11.5,2019,94938
2947,40,140,3127,94.24,1.28,4.48,2019,94939
6835,133,432,7400,92.36,1.8,5.84,2019,94945
70,0,0,70,100.0,0.0,0.0,2019,94964
16,0,0,16,100.0,0.0,0.0,2019,94512
83,0,0,83,100.0,0.0,0.0,2019,94569
4562,40,195,4797,95.1,0.83,4.07,2019,94517
8452,157,805,9414,89.78,1.67,8.55,2019,94545
5590,50,241,5881,95.05,0.85,4.1,2019,94556
3446,62,288,3796,90.78,1.63,7.59,2019,94574
11536,192,368,12096,95.37,1.59,3.04,2019,94583
273,0,32,305,89.51,0.0,10.49,2019,94586
11594,841,3101,15536,74.63,5.41,19.96,2019,94601
6243,463,2979,9685,64.46,4.78,30.76,2019,94621
4577,85,87,4749,96.38,1.79,1.83,2019,94708
2856,124,123,3103,92.04,4.0,3.96,2019,94710
17278,194,772,18244,94.71,1.06,4.23,2019,94117
10624,198,1350,12172,87.28,1.63,11.09,2019,94134
13768,126,447,14341,96.0,0.88,3.12,2019,94404
8073,24,180,8277,97.54,0.29,2.17,2019,94506
18741,325,2471,21537,87.02,1.51,11.47,2019,94509
10557,150,632,11339,93.1,1.32,5.57,2019,94510
8045,141,1149,9335,86.18,1.51,12.31,2019,94801
8500,112,502,9114,93.26,1.23,5.51,2019,94803
14269,550,1171,15990,89.24,3.44,7.32,2019,94901
9383,147,656,10186,92.12,1.44,6.44,2019,94947
12374,299,1113,13786,89.76,2.17,8.07,2019,94952
6061,54,168,6283,96.47,0.86,2.67,2019,94960
343,25,10,378,90.74,6.61,2.65,2019,94970
4207,81,104,4392,95.79,1.84,2.37,2019,94542
16744,294,1079,18117,92.42,1.62,5.96,2019,94550
7736,58,268,8062,95.96,0.72,3.32,2019,92602
1448,0,53,1501,96.47,0.0,3.53,2019,92661
12800,322,991,14113,90.7,2.28,7.02,2019,92672
9903,112,304,10319,95.97,1.09,2.95,2019,92673
1458,0,0,1458,100.0,0.0,0.0,2019,92823
7783,136,594,8513,91.42,1.6,6.98,2019,92835
158,0,45,203,77.83,0.0,22.17,2019,95979
13,0,0,13,100.0,0.0,0.0,2019,95981
11574,325,2533,14432,80.2,2.25,17.55,2019,95991
9312,126,825,10263,90.73,1.23,8.04,2019,95003
1954,9,471,2434,80.28,0.37,19.35,2019,95012
214,0,45,259,82.63,0.0,17.37,2019,95017
4804,109,175,5088,94.42,2.14,3.44,2019,95030
15763,340,1194,17297,91.13,1.97,6.9,2019,95037
236,4,44,284,83.1,1.41,15.49,2019,95043
1211,18,205,1434,84.45,1.26,14.3,2019,95045
12727,321,1064,14112,90.19,2.27,7.54,2019,95050
5207,67,324,5598,93.02,1.2,5.79,2019,95066
12078,94,350,12522,96.45,0.75,2.8,2019,95120
21660,536,1005,23201,93.36,2.31,4.33,2019,95123
100,0,60,160,62.5,0.0,37.5,2019,95225
1494,52,182,1728,86.46,3.01,10.53,2019,95228
8828,185,1008,10021,88.1,1.85,10.06,2019,95242
0,0,0,0,,,,2019,95250
1166,49,226,1441,80.92,3.4,15.68,2019,95258
10539,252,1208,11999,87.83,2.1,10.07,2019,95301
2356,75,447,2878,81.86,2.61,15.53,2019,95324
5116,123,403,5642,90.68,2.18,7.14,2019,95330
520,0,21,541,96.12,0.0,3.88,2019,95346
846,127,380,1353,62.53,9.39,28.09,2019,95365
11330,328,2812,14470,78.3,2.27,19.43,2019,95380
140,0,8,148,94.59,0.0,5.41,2019,95385
215,9,59,283,75.97,3.18,20.85,2019,95389
7551,107,516,8174,92.38,1.31,6.31,2019,95405
124,0,29,153,81.05,0.0,18.95,2019,95412
0,0,0,0,,,,2019,95431
2466,89,268,2823,87.35,3.15,9.49,2019,95436
534,21,69,624,85.58,3.37,11.06,2019,95441
3682,19,920,4621,79.68,0.41,19.91,2019,95451
536,7,40,583,91.94,1.2,6.86,2019,95462
1878,26,212,2116,88.75,1.23,10.02,2019,95470
11592,279,622,12493,92.79,2.23,4.98,2019,95472
9607,327,1517,11451,83.9,2.86,13.25,2019,95482
557,0,47,604,92.22,0.0,7.78,2019,95497
8826,197,1203,10226,86.31,1.93,11.76,2019,95503
6731,54,767,7552,89.13,0.72,10.16,2019,95519
6870,443,1184,8497,80.85,5.21,13.93,2019,95531
931,14,179,1124,82.83,1.25,15.93,2019,95536
114,0,0,114,100.0,0.0,0.0,2019,95537
14,0,35,49,28.57,0.0,71.43,2019,95559
128,12,18,158,81.01,7.59,11.39,2019,95564
145,6,16,167,86.83,3.59,9.58,2019,95607
22574,520,2346,25440,88.73,2.04,9.22,2019,95608
1760,119,280,2159,81.52,5.51,12.97,2019,95619
18619,423,906,19948,93.34,2.12,4.54,2019,95624
1167,52,33,1252,93.21,4.15,2.64,2019,95004
9172,108,560,9840,93.21,1.1,5.69,2019,95032
17197,446,1270,18913,90.93,2.36,6.71,2019,95060
13624,485,1136,15245,89.37,3.18,7.45,2019,92040
12,0,0,12,100.0,0.0,0.0,2019,81021
15,5,26,46,32.61,10.87,56.52,2019,81059
61,8,53,122,50.0,6.56,43.44,2019,81155
119,10,32,161,73.91,6.21,19.88,2019,81222
384,13,52,449,85.52,2.9,11.58,2019,81233
144,2,42,188,76.6,1.06,22.34,2019,81244
56,0,4,60,93.33,0.0,6.67,2019,83283
253,0,43,296,85.47,0.0,14.53,2019,83325
615,24,237,876,70.21,2.74,27.05,2019,83539
1148,37,104,1289,89.06,2.87,8.07,2019,88312
49,0,48,97,50.52,0.0,49.48,2019,88336
35,0,0,35,100.0,0.0,0.0,2019,88338
20,0,29,49,40.82,0.0,59.18,2019,88410
36,2,2,40,90.0,5.0,5.0,2019,88419
113,0,48,161,70.19,0.0,29.81,2019,88042
373,0,223,596,62.58,0.0,37.42,2019,88072
30,0,7,37,81.08,0.0,18.92,2019,88113
248,16,74,338,73.37,4.73,21.89,2019,83327
1766,5,164,1935,91.27,0.26,8.48,2019,83340
17954,752,2641,21347,84.11,3.52,12.37,2019,83301
1541,45,265,1851,83.25,2.43,14.32,2019,83336
441,17,77,535,82.43,3.18,14.39,2019,83346
114,0,7,121,94.21,0.0,5.79,2019,83421
973,26,104,1103,88.21,2.36,9.43,2019,83422
175,0,21,196,89.29,0.0,10.71,2019,83428
521,3,57,581,89.67,0.52,9.81,2019,83434
531,27,75,633,83.89,4.27,11.85,2019,83448
84,2,41,127,66.14,1.57,32.28,2019,83464
108,0,29,137,78.83,0.0,21.17,2019,83466
11696,451,2313,14460,80.89,3.12,16.0,2019,83501
139,26,8,173,80.35,15.03,4.62,2019,83670
513,11,184,708,72.46,1.55,25.99,2019,83804
43,0,23,66,65.15,0.0,34.85,2019,83834
9394,389,2248,12031,78.08,3.23,18.69,2019,83705
9,0,15,24,37.5,0.0,62.5,2019,83812
445,0,0,445,100.0,0.0,0.0,2019,83813
12222,556,1565,14343,85.21,3.88,10.91,2019,83815
482,38,129,649,74.27,5.86,19.88,2019,83833
53,0,10,63,84.13,0.0,15.87,2019,83842
499,20,169,688,72.53,2.91,24.56,2019,83847
1864,150,510,2524,73.85,5.94,20.21,2019,83861
255,20,84,359,71.03,5.57,23.4,2019,83868
69,4,34,107,64.49,3.74,31.78,2019,83870
252,9,0,261,96.55,3.45,0.0,2019,83872
52,11,39,102,50.98,10.78,38.24,2019,83806
139,0,0,139,100.0,0.0,0.0,2019,83809
412,22,222,656,62.8,3.35,33.84,2019,83811
0,0,0,0,,,,2019,83826
600,32,177,809,74.17,3.96,21.88,2019,83850
178,29,0,207,85.99,14.01,0.0,2019,83867
494,40,270,804,61.44,4.98,33.58,2019,83873
98,0,17,115,85.22,0.0,14.78,2019,83821
460,5,151,616,74.68,0.81,24.51,2019,83823
317,6,118,441,71.88,1.36,26.76,2019,83535
341,11,106,458,74.45,2.4,23.14,2019,83552
361,25,103,489,73.82,5.11,21.06,2019,83553
12,0,0,12,100.0,0.0,0.0,2019,83601
7071,259,1124,8454,83.64,3.06,13.3,2019,83607
380,29,159,568,66.9,5.11,27.99,2019,83623
13215,1137,4985,19337,68.34,5.88,25.78,2019,90006
11265,210,2018,13493,83.49,1.56,14.96,2019,90032
18383,359,2275,21017,87.47,1.71,10.82,2019,90042
12807,881,3688,17376,73.71,5.07,21.22,2019,90043
13115,928,3850,17893,73.3,5.19,21.52,2019,90047
15845,188,687,16720,94.77,1.12,4.11,2019,90049
107,4,27,138,77.54,2.9,19.57,2019,54211
2235,92,406,2733,81.78,3.37,14.86,2019,54216
1806,6,146,1958,92.24,0.31,7.46,2019,54229
1441,72,320,1833,78.61,3.93,17.46,2019,54230
284,9,55,348,81.61,2.59,15.8,2019,54232
10013,373,1918,12304,81.38,3.03,15.59,2019,54304
528,8,61,597,88.44,1.34,10.22,2019,54407
1059,28,230,1317,80.41,2.13,17.46,2019,54414
20,0,0,20,100.0,0.0,0.0,2019,54417
223,8,164,395,56.46,2.03,41.52,2019,54422
1374,56,296,1726,79.61,3.24,17.15,2019,54448
412,16,118,546,75.46,2.93,21.61,2019,54459
1626,53,307,1986,81.87,2.67,15.46,2019,54484
1096,53,373,1522,72.01,3.48,24.51,2019,54538
525,21,58,604,86.92,3.48,9.6,2019,54539
378,19,92,489,77.3,3.89,18.81,2019,54541
5606,189,654,6449,86.93,2.93,10.14,2019,54603
87,0,32,119,73.11,0.0,26.89,2019,54625
11596,236,1264,13096,88.55,1.8,9.65,2019,54914
377,23,165,565,66.73,4.07,29.2,2019,54922
373,3,75,451,82.71,0.67,16.63,2019,54932
931,45,154,1130,82.39,3.98,13.63,2019,54941
3562,15,172,3749,95.01,0.4,4.59,2019,54942
2946,77,364,3387,86.98,2.27,10.75,2019,54944
80,0,37,117,68.38,0.0,31.62,2019,54948
2367,22,477,2866,82.59,0.77,16.64,2019,54963
976,30,241,1247,78.27,2.41,19.33,2019,54968
3556,107,837,4500,79.02,2.38,18.6,2019,54971
0,0,0,0,,,,2019,54985
703,22,118,843,83.39,2.61,14.0,2019,54909
15025,264,1741,17030,88.23,1.55,10.22,2019,54915
872,9,155,1036,84.17,0.87,14.96,2019,54947
1526,79,272,1877,81.3,4.21,14.49,2019,54822
475,8,80,563,84.37,1.42,14.21,2019,54159
2502,133,421,3056,81.87,4.35,13.78,2019,54165
1108,43,237,1388,79.83,3.1,17.07,2019,54170
386,11,72,469,82.3,2.35,15.35,2019,54632
588,16,156,760,77.37,2.11,20.53,2019,54635
4666,84,421,5171,90.23,1.62,8.14,2019,54636
506,0,78,584,86.64,0.0,13.36,2019,54644
780,43,323,1146,68.06,3.75,28.18,2019,54950
260,4,68,332,78.31,1.2,20.48,2019,54653
248,4,65,317,78.23,1.26,20.5,2019,54563
677,14,137,828,81.76,1.69,16.55,2019,54623
346,16,82,444,77.93,3.6,18.47,2019,54628
8675,222,1252,10149,85.48,2.19,12.34,2019,54650
114,4,29,147,77.55,2.72,19.73,2019,54657
373,16,141,530,70.38,3.02,26.6,2019,54670
2777,30,470,3277,84.74,0.92,14.34,2019,54720
381,8,111,500,76.2,1.6,22.2,2019,54723
704,29,176,909,77.45,3.19,19.36,2019,54745
370,29,113,512,72.27,5.66,22.07,2019,54748
404,21,99,524,77.1,4.01,18.89,2019,54749
271,14,52,337,80.42,4.15,15.43,2019,56723
46,0,4,50,92.0,0.0,8.0,2019,56020
380,7,45,432,87.96,1.62,10.42,2019,56021
180,2,54,236,76.27,0.85,22.88,2019,56023
163,0,33,196,83.16,0.0,16.84,2019,56034
261,2,75,338,77.22,0.59,22.19,2019,56039
13041,354,1670,15065,86.56,2.35,11.09,2019,92840
8894,119,553,9566,92.98,1.24,5.78,2019,92881
2506,33,169,2708,92.54,1.22,6.24,2019,92310
4058,67,293,4418,91.85,1.52,6.63,2019,92314
366,28,20,414,88.41,6.76,4.83,2019,92321
13556,363,1462,15381,88.13,2.36,9.51,2019,92054
17215,225,1555,18995,90.63,1.18,8.19,2019,92056
13164,90,656,13910,94.64,0.65,4.72,2019,95129
3888,173,1411,5472,71.05,3.16,25.79,2019,95203
6118,382,4202,10702,57.17,3.57,39.26,2019,95205
454,48,217,719,63.14,6.68,30.18,2019,95641
2822,61,264,3147,89.67,1.94,8.39,2019,95642
17273,744,1570,19587,88.19,3.8,8.02,2019,95648
10763,223,1045,12031,89.46,1.85,8.69,2019,95661
18446,521,1769,20736,88.96,2.51,8.53,2019,95670
2487,16,72,2575,96.58,0.62,2.8,2019,95683
12435,142,654,13231,93.98,1.07,4.94,2019,95688
292,4,51,347,84.15,1.15,14.7,2019,95701
18,7,11,36,50.0,19.44,30.56,2019,95715
0,0,0,0,,,,2019,95721
64,0,0,64,100.0,0.0,0.0,2019,95736
6873,60,662,7595,90.49,0.79,8.72,2019,95776
5254,277,1178,6709,78.31,4.13,17.56,2019,95814
2562,152,433,3147,81.41,4.83,13.76,2019,95832
117,0,2,119,98.32,0.0,1.68,2019,95837
368,22,34,424,86.79,5.19,8.02,2019,95612
1562,16,112,1690,92.43,0.95,6.63,2019,95614
508,0,37,545,93.21,0.0,6.79,2019,95636
127,0,90,217,58.53,0.0,41.47,2019,95675
1569,69,315,1953,80.34,3.53,16.13,2019,95685
20486,265,1469,22220,92.2,1.19,6.61,2019,95687
1852,72,124,2048,90.43,3.52,6.05,2019,95722
2,0,5,7,28.57,0.0,71.43,2019,95735
21750,375,1055,23180,93.83,1.62,4.55,2019,95747
10379,319,2266,12964,80.06,2.46,17.48,2019,95820
6090,239,963,7292,83.52,3.28,13.21,2019,95827
341,0,0,341,100.0,0.0,0.0,2019,95903
365,32,171,568,64.26,5.63,30.11,2019,95916
263,80,18,361,72.85,22.16,4.99,2019,95941
9174,322,1666,11162,82.19,2.88,14.93,2019,95945
4487,63,384,4934,90.94,1.28,7.78,2019,95954
494,0,132,626,78.91,0.0,21.09,2019,95962
8560,213,1188,9961,85.94,2.14,11.93,2019,95969
1903,71,454,2428,78.38,2.92,18.7,2019,95971
494,76,226,796,62.06,9.55,28.39,2019,95975
562,20,132,714,78.71,2.8,18.49,2019,95977
11,0,21,32,34.38,0.0,65.62,2019,95986
582,0,43,625,93.12,0.0,6.88,2019,95002
3747,60,185,3992,93.86,1.5,4.63,2019,95006
1420,91,578,2089,67.98,4.36,27.67,2019,95019
3150,21,38,3209,98.16,0.65,1.18,2019,95119
15028,275,1227,16530,90.91,1.66,7.42,2019,95127
12178,181,1419,13778,88.39,1.31,10.3,2019,95128
0,0,0,0,,,,2019,80939
1504,0,30,1534,98.04,0.0,1.96,2019,80951
1511,186,159,1856,81.41,10.02,8.57,2019,80443
313,30,31,374,83.69,8.02,8.29,2019,80515
0,0,0,0,,,,2019,80290
214,0,42,256,83.59,0.0,16.41,2019,80428
350,19,151,520,67.31,3.65,29.04,2019,81324
52,0,26,78,66.67,0.0,33.33,2019,81325
177,32,387,596,29.7,5.37,64.93,2019,81334
7377,273,1885,9535,77.37,2.86,19.77,2019,81401
671,10,83,764,87.83,1.31,10.86,2019,81527
2813,104,195,3112,90.39,3.34,6.27,2019,81632
0,0,9,9,0.0,0.0,100.0,2019,81653
11,0,0,11,100.0,0.0,0.0,2019,81655
8627,520,2768,11915,72.4,4.36,23.23,2019,81001
3069,140,1021,4230,72.55,3.31,24.14,2019,81050
267,1,47,315,84.76,0.32,14.92,2019,81062
511,38,142,691,73.95,5.5,20.55,2019,81063
75,47,71,193,38.86,24.35,36.79,2019,81040
4196,197,1369,5762,72.82,3.42,23.76,2019,81003
53,2,12,67,79.1,2.99,17.91,2019,81030
683,47,158,888,76.91,5.29,17.79,2019,81069
32,2,3,37,86.49,5.41,8.11,2019,81081
9,34,25,68,13.24,50.0,36.76,2019,81124
1886,68,229,2183,86.39,3.11,10.49,2019,81526
3000,195,251,3446,87.06,5.66,7.28,2019,81620
320,22,102,444,72.07,4.95,22.97,2019,81624
2242,41,296,2579,86.93,1.59,11.48,2019,81635
10,0,0,10,100.0,0.0,0.0,2019,81642
2190,50,246,2486,88.09,2.01,9.9,2019,81647
3974,72,765,4811,82.6,1.5,15.9,2019,81650
1568,26,154,1748,89.7,1.49,8.81,2019,81652
2163,78,141,2382,90.81,3.27,5.92,2019,81657
54,0,57,111,48.65,0.0,51.35,2019,81320
488,42,160,690,70.72,6.09,23.19,2019,81223
1166,14,70,1250,93.28,1.12,5.6,2019,81224
26,0,28,54,48.15,0.0,51.85,2019,81248
99,0,40,139,71.22,0.0,28.78,2019,81331
76,3,32,111,68.47,2.7,28.83,2019,81332
11,0,15,26,42.31,0.0,57.69,2019,81411
3719,152,1245,5116,72.69,2.97,24.34,2019,81416
1143,34,362,1539,74.27,2.21,23.52,2019,81419
596,0,97,693,86.0,0.0,14.0,2019,81423
4973,121,759,5853,84.96,2.07,12.97,2019,81601
61,13,42,116,52.59,11.21,36.21,2019,81610
2316,206,280,2802,82.66,7.35,9.99,2019,81637
28,0,5,33,84.85,0.0,15.15,2019,81638
1114,46,244,1404,79.34,3.28,17.38,2019,81641
77,5,9,91,84.62,5.49,9.89,2019,81646
75,3,23,101,74.26,2.97,22.77,2019,81649
3567,219,797,4583,77.83,4.78,17.39,2019,81006
408,3,67,478,85.36,0.63,14.02,2019,81036
284,3,123,410,69.27,0.73,30.0,2019,81058
628,18,204,850,73.88,2.12,24.0,2019,81073
21,1,44,66,31.82,1.52,66.67,2019,81084
312,16,102,430,72.56,3.72,23.72,2019,81090
333,0,66,399,83.46,0.0,16.54,2019,81123
75,0,29,104,72.12,0.0,27.88,2019,81126
858,74,481,1413,60.72,5.24,34.04,2019,81132
43,0,9,52,82.69,0.0,17.31,2019,88121
14,0,5,19,73.68,0.0,26.32,2019,88125
14,0,8,22,63.64,0.0,36.36,2019,88136
1072,86,478,1636,65.53,5.26,29.22,2019,88230
474,48,242,764,62.04,6.28,31.68,2019,88252
71,6,48,125,56.8,4.8,38.4,2019,88348
11140,706,1481,13327,83.59,5.3,11.11,2019,90230
7311,164,1351,8826,82.83,1.86,15.31,2019,90249
8364,97,263,8724,95.87,1.11,3.01,2019,90272
12702,403,587,13692,92.77,2.94,4.29,2019,90291
5637,210,1201,7048,79.98,2.98,17.04,2019,90303
11736,184,819,12739,92.13,1.44,6.43,2019,90403
5267,53,655,5975,88.15,0.89,10.96,2019,90502
5791,131,739,6661,86.94,1.97,11.09,2019,90603
10467,237,1728,12432,84.19,1.91,13.9,2019,90604
9031,619,2269,11919,75.77,5.19,19.04,2019,90007
7930,342,1998,10270,77.22,3.33,19.45,2019,90015
13179,692,3613,17484,75.38,3.96,20.66,2019,90003
13975,983,1438,16396,85.23,6.0,8.77,2019,90020
7727,620,3344,11691,66.09,5.3,28.6,2019,90023
19168,478,2022,21668,88.46,2.21,9.33,2019,90027
10504,235,946,11685,89.89,2.01,8.1,2019,90039
14224,150,1248,15622,91.05,0.96,7.99,2019,90045
26307,848,1870,29025,90.64,2.92,6.44,2019,90046
3057,67,49,3173,96.34,2.11,1.54,2019,90077
9199,309,1024,10532,87.34,2.93,9.72,2019,90260
11002,1683,2689,15374,71.56,10.95,17.49,2019,90262
0,0,0,0,,,,2019,90263
14162,194,956,15312,92.49,1.27,6.24,2019,90278
3336,50,275,3661,91.12,1.37,7.51,2019,90211
2799,207,406,3412,82.03,6.07,11.9,2019,90056
471,36,199,706,66.71,5.1,28.19,2019,90058
7854,235,1974,10063,78.05,2.34,19.62,2019,90062
9818,1269,2119,13206,74.34,9.61,16.05,2019,90220
5278,1130,1571,7979,66.15,14.16,19.69,2019,90222
14349,620,3608,18577,77.24,3.34,19.42,2019,90255
7067,65,259,7391,95.62,0.88,3.5,2019,90265
12647,215,565,13427,94.19,1.6,4.21,2019,90266
11796,393,417,12606,93.57,3.12,3.31,2019,90292
5477,189,917,6583,83.2,2.87,13.93,2019,90304
12823,240,929,13992,91.65,1.72,6.64,2019,90505
9271,306,789,10366,89.44,2.95,7.61,2019,90621
14615,339,3944,18898,77.34,1.79,20.87,2019,90640
22671,672,3621,26964,84.08,2.49,13.43,2019,90650
8828,351,3738,12917,68.34,2.72,28.94,2019,90002
12437,1014,3330,16781,74.11,6.04,19.84,2019,90005
16963,845,6625,24433,69.43,3.46,27.11,2019,90011
4184,88,1372,5644,74.13,1.56,24.31,2019,90014
22312,632,3101,26045,85.67,2.43,11.91,2019,90026
8964,394,3945,13303,67.38,2.96,29.65,2019,90033
9566,1033,1630,12229,78.22,8.45,13.33,2019,90038
2406,196,859,3461,69.52,5.66,24.82,2019,90040
21307,788,6934,29029,73.4,2.71,23.89,2019,90044
12825,263,828,13916,92.16,1.89,5.95,2019,90808
7806,178,1053,9037,86.38,1.97,11.65,2019,90680
3613,129,726,4468,80.86,2.89,16.25,2019,90701
17717,647,2392,20756,85.36,3.12,11.52,2019,90802
21898,824,4632,27354,80.05,3.01,16.93,2019,90805
17979,1949,2076,22004,81.71,8.86,9.43,2019,90004
13,36,11,60,21.67,60.0,18.33,2019,95514
30,0,10,40,75.0,0.0,25.0,2019,95550
619,18,105,742,83.42,2.43,14.15,2019,95567
6049,126,835,7010,86.29,1.8,11.91,2019,95602
10333,324,1415,12072,85.59,2.68,11.72,2019,95603
14653,230,1207,16090,91.07,1.43,7.5,2019,95628
263,10,41,314,83.76,3.18,13.06,2019,56042
1839,60,440,2339,78.62,2.57,18.81,2019,56362
1608,57,470,2135,75.32,2.67,22.01,2019,56364
6411,495,653,7559,84.81,6.55,8.64,2019,56377
27,2,4,33,81.82,6.06,12.12,2019,56436
1215,43,319,1577,77.05,2.73,20.23,2019,56441
1024,13,127,1164,87.97,1.12,10.91,2019,56442
355,17,87,459,77.34,3.7,18.95,2019,56450
292,13,59,364,80.22,3.57,16.21,2019,56453
16,0,7,23,69.57,0.0,30.43,2019,56456
1376,60,312,1748,78.72,3.43,17.85,2019,56464
29,0,8,37,78.38,0.0,21.62,2019,56525
99,15,17,131,75.57,11.45,12.98,2019,56533
745,28,186,959,77.69,2.92,19.4,2019,56547
127,10,57,194,65.46,5.15,29.38,2019,56566
625,42,135,802,77.93,5.24,16.83,2019,56571
670,30,110,810,82.72,3.7,13.58,2019,56586
567,33,172,772,73.45,4.27,22.28,2019,56589
105,3,20,128,82.03,2.34,15.62,2019,56590
150,2,29,181,82.87,1.1,16.02,2019,56592
79,2,22,103,76.7,1.94,21.36,2019,56162
181,12,38,231,78.35,5.19,16.45,2019,56212
343,15,98,456,75.22,3.29,21.49,2019,56270
356,12,93,461,77.22,2.6,20.17,2019,56339
1125,51,34,1210,92.98,4.21,2.81,2019,56024
3940,46,494,4480,87.95,1.03,11.03,2019,56071
69,2,11,82,84.15,2.44,13.41,2019,56113
72,0,11,83,86.75,0.0,13.25,2019,56147
232,9,53,294,78.91,3.06,18.03,2019,56230
16051,895,1808,18754,85.59,4.77,9.64,2019,56001
13848,743,2405,16996,81.48,4.37,14.15,2019,56560
1583,60,382,2025,78.17,2.96,18.86,2019,56636
27,12,23,62,43.55,19.35,37.1,2019,56724
0,0,0,0,,,,2019,56741
104,13,38,155,67.1,8.39,24.52,2019,56173
3193,130,873,4196,76.1,3.1,20.81,2019,56431
33,0,3,36,91.67,0.0,8.33,2019,56046
47,0,2,49,95.92,0.0,4.08,2019,56047
22,0,7,29,75.86,0.0,24.14,2019,56125
37,0,0,37,100.0,0.0,0.0,2019,56146
1,0,0,1,100.0,0.0,0.0,2019,56210
0,0,0,0,,,,2019,56321
42,6,9,57,73.68,10.53,15.79,2019,56363
31,0,9,40,77.5,0.0,22.5,2019,56389
8,0,0,8,100.0,0.0,0.0,2019,56541
3,0,0,3,100.0,0.0,0.0,2019,56577
41,2,9,52,78.85,3.85,17.31,2019,56591
0,0,0,0,,,,2019,56593
0,0,0,0,,,,2019,56658
35,3,3,41,85.37,7.32,7.32,2019,56668
101,7,21,129,78.29,5.43,16.28,2019,56141
82,1,13,96,85.42,1.04,13.54,2019,56160
8947,394,1511,10852,82.45,3.63,13.92,2019,56303
954,40,114,1108,86.1,3.61,10.29,2019,50240
387,6,136,529,73.16,1.13,25.71,2019,50249
129,0,52,181,71.27,0.0,28.73,2019,50256
311,41,71,423,73.52,9.69,16.78,2019,50258
310,14,113,437,70.94,3.2,25.86,2019,50268
268,8,45,321,83.49,2.49,14.02,2019,50278
81,3,14,98,82.65,3.06,14.29,2019,80824
2436,37,30,2503,97.32,1.48,1.2,2019,80118
4695,11,143,4849,96.82,0.23,2.95,2019,80007
23191,490,1301,24982,92.83,1.96,5.21,2019,80013
1623,77,315,2015,80.55,3.82,15.63,2019,80102
931,8,96,1035,89.95,0.77,9.28,2019,80644
172,7,18,197,87.31,3.55,9.14,2019,80726
3147,44,418,3609,87.2,1.22,11.58,2019,80421
37,6,12,55,67.27,10.91,21.82,2019,80423
13326,560,2857,16743,79.59,3.34,17.06,2019,80011
12153,251,551,12955,93.81,1.94,4.25,2019,80027
11770,297,900,12967,90.77,2.29,6.94,2019,80017
6613,311,406,7330,90.22,4.24,5.54,2019,80121
449,7,18,474,94.73,1.48,3.8,2019,80137
12257,484,790,13531,90.58,3.58,5.84,2019,80206
55,0,0,55,100.0,0.0,0.0,2019,82081
6,0,0,6,100.0,0.0,0.0,2019,82224
917,5,165,1087,84.36,0.46,15.18,2019,82331
107,0,23,130,82.31,0.0,17.69,2019,82421
280,18,80,378,74.07,4.76,21.16,2019,82223
408,2,43,453,90.07,0.44,9.49,2019,82053
500,56,66,622,80.39,9.0,10.61,2019,82082
20,0,26,46,43.48,0.0,56.52,2019,82243
245,9,69,323,75.85,2.79,21.36,2019,82321
382,7,89,478,79.92,1.46,18.62,2019,82325
2357,140,547,3044,77.43,4.6,17.97,2019,82401
8,0,0,8,100.0,0.0,0.0,2019,82422
13206,364,2061,15631,84.49,2.33,13.19,2019,82001
0,0,0,0,,,,2019,82052
0,0,7,7,0.0,0.0,100.0,2019,82084
232,5,36,273,84.98,1.83,13.19,2019,82212
106,3,98,207,51.21,1.45,47.34,2019,82213
73,0,15,88,82.95,0.0,17.05,2019,82336
151,21,6,178,84.83,11.8,3.37,2019,82411
153,8,17,178,85.96,4.49,9.55,2019,82412
313,13,39,365,85.75,3.56,10.68,2019,82523
9424,430,1562,11416,82.55,3.77,13.68,2019,82601
228,14,25,267,85.39,5.24,9.36,2019,82639
1640,153,337,2130,77.0,7.18,15.82,2019,82701
804,74,208,1086,74.03,6.81,19.15,2019,82721
9417,184,1704,11305,83.3,1.63,15.07,2019,82801
191,19,0,210,90.95,9.05,0.0,2019,82933
3977,235,398,4610,86.27,5.1,8.63,2019,82935
0,0,0,0,,,,2019,82936
2692,137,581,3410,78.94,4.02,17.04,2019,82834
13,0,0,13,100.0,0.0,0.0,2019,82845
8818,254,1112,10184,86.59,2.49,10.92,2019,82901
1454,53,154,1661,87.54,3.19,9.27,2019,82941
68,0,0,68,100.0,0.0,0.0,2019,82440
49,0,26,75,65.33,0.0,34.67,2019,82423
52,0,6,58,89.66,0.0,10.34,2019,82434
4333,139,463,4935,87.8,2.82,9.38,2019,82435
5980,98,775,6853,87.26,1.43,11.31,2019,82716
21,0,84,105,20.0,0.0,80.0,2019,87723
188,0,80,268,70.15,0.0,29.85,2019,87742
43,0,35,78,55.13,0.0,44.87,2019,87827
97,0,46,143,67.83,0.0,32.17,2019,87936
79,0,68,147,53.74,0.0,46.26,2019,87752
1740,196,876,2812,61.88,6.97,31.15,2019,87801
114,0,83,197,57.87,0.0,42.13,2019,88350
0,0,0,0,,,,2019,88417
22,0,6,28,78.57,0.0,21.43,2019,88055
138,3,27,168,82.14,1.79,16.07,2019,88318
679,21,422,1122,60.52,1.87,37.61,2019,88415
3670,121,822,4613,79.56,2.62,17.82,2019,88260
2571,260,431,3262,78.82,7.97,13.21,2019,88345
6661,357,1606,8624,77.24,4.14,18.62,2019,88007
89,11,5,105,84.76,10.48,4.76,2019,88028
21,16,98,135,15.56,11.85,72.59,2019,88032
0,0,17,17,0.0,0.0,100.0,2019,88034
288,0,144,432,66.67,0.0,33.33,2019,88046
2668,177,1486,4331,61.6,4.09,34.31,2019,88081
0,0,0,0,,,,2019,88103
7026,649,2966,10641,66.03,6.1,27.87,2019,88203
289,7,161,457,63.24,1.53,35.23,2019,88311
0,0,24,24,0.0,0.0,100.0,2019,88342
12,0,0,12,100.0,0.0,0.0,2019,88349
0,0,0,0,,,,2019,88355
4938,232,1101,6271,78.74,3.7,17.56,2019,88130
63,0,36,99,63.64,0.0,36.36,2019,88250
232,0,21,253,91.7,0.0,8.3,2019,88339
109,0,0,109,100.0,0.0,0.0,2019,88038
341,52,456,849,40.16,6.12,53.71,2019,88048
409,9,76,494,82.79,1.82,15.38,2019,88124
8169,270,2041,10480,77.95,2.58,19.48,2019,88005
83,0,40,123,67.48,0.0,32.52,2019,88118
39,0,14,53,73.58,0.0,26.42,2019,88263
18498,492,1775,20765,89.08,2.37,8.55,2019,83709
8983,395,1078,10456,85.91,3.78,10.31,2019,83713
8097,413,1814,10324,78.43,4.0,17.57,2019,83714
6028,185,412,6625,90.99,2.79,6.22,2019,83716
23,0,10,33,69.7,0.0,30.3,2019,83802
373,49,0,422,88.39,11.61,0.0,2019,83803
559,72,227,858,65.15,8.39,26.46,2019,83822
5813,262,1283,7358,79.0,3.56,17.44,2019,83864
76,3,19,98,77.55,3.06,19.39,2019,83824
480,0,166,646,74.3,0.0,25.7,2019,83839
458,53,146,657,69.71,8.07,22.22,2019,83851
644,1,39,684,94.15,0.15,5.7,2019,83452
513,31,161,705,72.77,4.4,22.84,2019,83522
358,6,83,447,80.09,1.34,18.57,2019,83541
132,70,130,332,39.76,21.08,39.16,2019,83549
4899,229,990,6118,80.08,3.74,16.18,2019,83617
859,46,101,1006,85.39,4.57,10.04,2019,83622
254,12,146,412,61.65,2.91,35.44,2019,83631
927,43,206,1176,78.83,3.66,17.52,2019,83641
9901,366,1628,11895,83.24,3.08,13.69,2019,83651
1358,21,190,1569,86.55,1.34,12.11,2019,83655
6265,156,927,7348,85.26,2.12,12.62,2019,83703
3733,66,712,4511,82.75,1.46,15.78,2019,83350
6,0,0,6,100.0,0.0,0.0,2019,83433
5991,209,530,6730,89.02,3.11,7.88,2019,83442
2871,65,1135,4071,70.52,1.6,27.88,2019,93927
8869,246,814,9929,89.32,2.48,8.2,2019,93035
260,0,0,260,100.0,0.0,0.0,2019,93067
3291,304,1685,5280,62.33,5.76,31.91,2019,93203
7440,149,2033,9622,77.32,1.55,21.13,2019,93060
21828,290,1763,23881,91.4,1.21,7.38,2019,93065
3345,120,722,4187,79.89,2.87,17.24,2019,86322
18,0,12,30,60.0,0.0,40.0,2019,86343
76,8,188,272,27.94,2.94,69.12,2019,86547
132,14,367,513,25.73,2.73,71.54,2019,86556
2503,170,1516,4189,59.75,4.06,36.19,2019,86047
0,0,15,15,0.0,0.0,100.0,2019,86003
58,43,0,101,57.43,42.57,0.0,2019,86011
0,0,0,0,,,,2019,86028
21,0,0,21,100.0,0.0,0.0,2019,86029
24,0,0,24,100.0,0.0,0.0,2019,86038
0,0,0,0,,,,2019,86313
2898,108,85,3091,93.76,3.49,2.75,2019,86315
334,0,89,423,78.96,0.0,21.04,2019,86329
9323,352,2029,11704,79.66,3.01,17.34,2019,86409
74,0,31,105,70.48,0.0,29.52,2019,86411
0,0,0,0,,,,2019,86443
128,0,19,147,87.07,0.0,12.93,2019,86445
65,2,484,551,11.8,0.36,87.84,2019,86020
121,0,0,121,100.0,0.0,0.0,2019,86015
170,3,59,232,73.28,1.29,25.43,2019,86331
1171,131,340,1642,71.32,7.98,20.71,2019,85256
20203,429,2202,22834,88.48,1.88,9.64,2019,85282
12668,164,1988,14820,85.48,1.11,13.41,2019,85746
10312,204,876,11392,90.52,1.79,7.69,2019,85750
175,13,58,246,71.14,5.28,23.58,2019,85920
188,19,42,249,75.5,7.63,16.87,2019,85923
954,16,232,1202,79.37,1.33,19.3,2019,85924
66,0,0,66,100.0,0.0,0.0,2019,85927
133,0,23,156,85.26,0.0,14.74,2019,85934
4014,186,1107,5307,75.64,3.5,20.86,2019,85714
131,11,270,412,31.8,2.67,65.53,2019,85911
326,0,81,407,80.1,0.0,19.9,2019,85928
107,4,155,266,40.23,1.5,58.27,2019,85930
1900,17,532,2449,77.58,0.69,21.72,2019,85937
454,0,68,522,86.97,0.0,13.03,2019,85940
851,36,1662,2549,33.39,1.41,65.2,2019,85941
14550,252,844,15646,93.0,1.61,5.39,2019,85338
12406,198,728,13332,93.05,1.49,5.46,2019,85339
744,102,480,1326,56.11,7.69,36.2,2019,85348
85,17,137,239,35.56,7.11,57.32,2019,85357
35,8,21,64,54.69,12.5,32.81,2019,85360
338,0,65,403,83.87,0.0,16.13,2019,85362
18765,522,2282,21569,87.0,2.42,10.58,2019,85374
13614,136,433,14183,95.99,0.96,3.05,2019,85379
13848,371,1221,15440,89.69,2.4,7.91,2019,85382
896,149,717,1762,50.85,8.46,40.69,2019,85539
876,3,247,1126,77.8,0.27,21.94,2019,85543
4665,114,1317,6096,76.53,1.87,21.6,2019,85546
486,23,416,925,52.54,2.49,44.97,2019,85553
3327,94,726,4147,80.23,2.27,17.51,2019,85602
3579,136,1572,5287,67.69,2.57,29.73,2019,85007
8523,123,1483,10129,84.14,1.21,14.64,2019,85013
13899,482,1405,15786,88.05,3.05,8.9,2019,85027
340,0,0,340,100.0,0.0,0.0,2019,83118
137,2,30,169,81.07,1.18,17.75,2019,83123
764,40,213,1017,75.12,3.93,20.94,2019,83226
1015,31,246,1292,78.56,2.4,19.04,2019,83639
64,0,0,64,100.0,0.0,0.0,2019,83011
1591,45,355,1991,79.91,2.26,17.83,2019,83211
238,8,29,275,86.55,2.91,10.55,2019,50453
244,4,52,300,81.33,1.33,17.33,2019,50476
158,5,46,209,75.6,2.39,22.01,2019,50840
212,4,74,290,73.1,1.38,25.52,2019,50845
315,0,128,443,71.11,0.0,28.89,2019,50846
150,0,46,196,76.53,0.0,23.47,2019,50146
337,34,78,449,75.06,7.57,17.37,2019,50107
1309,43,178,1530,85.56,2.81,11.63,2019,50124
796,64,188,1048,75.95,6.11,17.94,2019,50140
283,10,54,347,81.56,2.88,15.56,2019,50153
6443,140,1558,8141,79.14,1.72,19.14,2019,50208
280,0,33,313,89.46,0.0,10.54,2019,50229
143,4,45,192,74.48,2.08,23.44,2019,50234
328,3,32,363,90.36,0.83,8.82,2019,50482
283,16,28,327,86.54,4.89,8.56,2019,50532
1229,86,370,1685,72.94,5.1,21.96,2019,50533
183,3,37,223,82.06,1.35,16.59,2019,50538
360,7,75,442,81.45,1.58,16.97,2019,50540
167,0,40,207,80.68,0.0,19.32,2019,50843
498,33,151,682,73.02,4.84,22.14,2019,50830
250,9,40,299,83.61,3.01,13.38,2019,50853
840,18,214,1072,78.36,1.68,19.96,2019,50854
483,29,89,601,80.37,4.83,14.81,2019,50135
133,5,44,182,73.08,2.75,24.18,2019,50147
128,2,45,175,73.14,1.14,25.71,2019,50148
438,11,81,530,82.64,2.08,15.28,2019,50162
259,0,56,315,82.22,0.0,17.78,2019,50168
885,9,186,1080,81.94,0.83,17.22,2019,50171
53,0,36,89,59.55,0.0,40.45,2019,50252
2830,107,620,3557,79.56,3.01,17.43,2019,50273
643,42,132,817,78.7,5.14,16.16,2019,50276
118,6,19,143,82.52,4.2,13.29,2019,50277
1018,77,262,1357,75.02,5.67,19.31,2019,50421
857,19,330,1206,71.06,1.58,27.36,2019,50423
298,2,41,341,87.39,0.59,12.02,2019,50001
138,12,17,167,82.63,7.19,10.18,2019,50007
11630,2052,906,14588,79.72,14.07,6.21,2019,50010
8905,2985,553,12443,71.57,23.99,4.44,2019,50014
138,25,10,173,79.77,14.45,5.78,2019,50039
1819,91,357,2267,80.24,4.01,15.75,2019,50047
281,7,87,375,74.93,1.87,23.2,2019,50048
232,10,32,274,84.67,3.65,11.68,2019,50062
366,18,38,422,86.73,4.27,9.0,2019,50073
524,50,98,672,77.98,7.44,14.58,2019,50076
822,122,190,1134,72.49,10.76,16.75,2019,50115
145,0,17,162,89.51,0.0,10.49,2019,50120
235,13,96,344,68.31,3.78,27.91,2019,50123
6632,246,1042,7920,83.74,3.11,13.16,2019,50125
73,0,29,102,71.57,0.0,28.43,2019,50132
239,18,50,307,77.85,5.86,16.29,2019,50435
23,1,1,25,92.0,4.0,4.0,2019,50426
155,5,57,217,71.43,2.3,26.27,2019,50430
61,1,29,91,67.03,1.1,31.87,2019,50431
2149,67,344,2560,83.95,2.62,13.44,2019,52310
165,23,32,220,75.0,10.45,14.55,2019,52326
25,1,9,35,71.43,2.86,25.71,2019,52348
96,0,54,150,64.0,0.0,36.0,2019,52534
315,11,124,450,70.0,2.44,27.56,2019,52536
2309,133,868,3310,69.76,4.02,26.22,2019,52544
7177,167,587,7931,90.49,2.11,7.4,2019,87544
73,0,88,161,45.34,0.0,54.66,2019,87551
83,77,19,179,46.37,43.02,10.61,2019,87565
3339,147,1092,4578,72.94,3.21,23.85,2019,87571
93,0,56,149,62.42,0.0,37.58,2019,87577
151,0,175,326,46.32,0.0,53.68,2019,87582
4382,280,2982,7644,57.33,3.66,39.01,2019,87701
113,0,45,158,71.52,0.0,28.48,2019,87713
93,0,115,208,44.71,0.0,55.29,2019,87715
152,3,42,197,77.16,1.52,21.32,2019,87718
0,0,34,34,0.0,0.0,100.0,2019,87736
0,9,23,32,0.0,28.12,71.88,2019,87824
641,138,948,1727,37.12,7.99,54.89,2019,87313
101,2,396,499,20.24,0.4,79.36,2019,87326
185,27,505,717,25.8,3.77,70.43,2019,87328
3460,56,352,3868,89.45,1.45,9.1,2019,87402
509,0,188,697,73.03,0.0,26.97,2019,87511
55,0,0,55,100.0,0.0,0.0,2019,87543
147,5,35,187,78.61,2.67,18.72,2019,87558
32,0,0,32,100.0,0.0,0.0,2019,87573
181,5,68,254,71.26,1.97,26.77,2019,87579
138,0,87,225,61.33,0.0,38.67,2019,87580
103,0,163,266,38.72,0.0,61.28,2019,87711
108,12,38,158,68.35,7.59,24.05,2019,87728
229,0,214,443,51.69,0.0,48.31,2019,87732
71,0,39,110,64.55,0.0,35.45,2019,87734
16,0,19,35,45.71,0.0,54.29,2019,87753
38,0,0,38,100.0,0.0,0.0,2019,87933
62,3,24,89,69.66,3.37,26.97,2019,87828
220,43,49,312,70.51,13.78,15.71,2019,87829
171,0,135,306,55.88,0.0,44.12,2019,87930
107,38,58,203,52.71,18.72,28.57,2019,87940
425,4,92,521,81.57,0.77,17.66,2019,87010
79,0,58,137,57.66,0.0,42.34,2019,87029
1665,76,910,2651,62.81,2.87,34.33,2019,87035
1701,24,150,1875,90.72,1.28,8.0,2019,87047
136,14,415,565,24.07,2.48,73.45,2019,87052
15,0,34,49,30.61,0.0,69.39,2019,87064
25,0,0,25,100.0,0.0,0.0,2019,87070
74,2,102,178,41.57,1.12,57.3,2019,87072
21134,1080,2135,24349,86.8,4.44,8.77,2019,87111
6713,188,197,7098,94.58,2.65,2.78,2019,87122
5066,341,2450,7857,64.48,4.34,31.18,2019,87301
51,2,119,172,29.65,1.16,69.19,2019,87312
82,10,206,298,27.52,3.36,69.13,2019,87316
146,33,390,569,25.66,5.8,68.54,2019,87319
403,49,872,1324,30.44,3.7,65.86,2019,87323
925,70,903,1898,48.74,3.69,47.58,2019,87327
501,7,205,713,70.27,0.98,28.75,2019,87415
309,0,65,374,82.62,0.0,17.38,2019,87418
11540,243,2220,14003,82.41,1.74,15.85,2019,87505
37,3,5,45,82.22,6.67,11.11,2019,87516
221,0,11,232,95.26,0.0,4.74,2019,87517
17632,190,1139,18961,92.99,1.0,6.01,2019,94553
10554,258,1001,11813,89.34,2.18,8.47,2019,94602
12695,353,1320,14368,88.36,2.46,9.19,2019,94608
8872,172,871,9915,89.48,1.73,8.78,2019,94609
228,0,37,265,86.04,0.0,13.96,2019,94922
3054,78,131,3263,93.59,2.39,4.01,2019,94931
942,20,58,1020,92.35,1.96,5.69,2019,93066
10483,257,915,11655,89.94,2.21,7.85,2019,93105
82,0,3,85,96.47,0.0,3.53,2019,93208
7843,162,4331,12336,63.58,1.31,35.11,2019,93215
1625,3,909,2537,64.05,0.12,35.83,2019,93219
1633,25,284,1942,84.09,1.29,14.62,2019,93225
3900,178,621,4699,83.0,3.79,13.22,2019,93210
418,0,258,676,61.83,0.0,38.17,2019,93243
2238,46,1394,3678,60.85,1.25,37.9,2019,93250
16945,806,4513,22264,76.11,3.62,20.27,2019,93257
0,0,0,0,,,,2019,93262
990,111,448,1549,63.91,7.17,28.92,2019,93615
2146,66,545,2757,77.84,2.39,19.77,2019,93620
1831,191,726,2748,66.63,6.95,26.42,2019,93622
50,0,0,50,100.0,0.0,0.0,2019,93645
897,27,289,1213,73.95,2.23,23.83,2019,93650
101,4,25,130,77.69,3.08,19.23,2019,93512
650,123,193,966,67.29,12.73,19.98,2019,93516
1073,25,63,1161,92.42,2.15,5.43,2019,93523
523,27,130,680,76.91,3.97,19.12,2019,93527
122,0,10,132,92.42,0.0,7.58,2019,93531
9939,692,3530,14161,70.19,4.89,24.93,2019,93534
567,37,66,670,84.63,5.52,9.85,2019,93553
76,0,6,82,92.68,0.0,7.32,2019,93554
120,0,97,217,55.3,0.0,44.7,2019,93666
935,20,344,1299,71.98,1.54,26.48,2019,93675
1309,103,620,2032,64.42,5.07,30.51,2019,93721
21825,492,2971,25288,86.31,1.95,11.75,2019,93722
8232,188,1433,9853,83.55,1.91,14.54,2019,93901
416,19,111,546,76.19,3.48,20.33,2019,93920
6170,193,486,6849,90.09,2.82,7.1,2019,93950
144,40,145,329,43.77,12.16,44.07,2019,93239
2568,232,1222,4022,63.85,5.77,30.38,2019,93241
220,16,167,403,54.59,3.97,41.44,2019,93255
929,8,572,1509,61.56,0.53,37.91,2019,93256
3564,116,2575,6255,56.98,1.85,41.17,2019,93280
3871,112,715,4698,82.4,2.38,15.22,2019,93301
1014,8,0,1022,99.22,0.78,0.0,2019,93437
2164,54,244,2462,87.9,2.19,9.91,2019,93445
4222,179,655,5056,83.5,3.54,12.95,2019,93442
6646,92,508,7246,91.72,1.27,7.01,2019,93444
839,71,263,1173,71.53,6.05,22.42,2019,93453
3037,10,183,3230,94.02,0.31,5.67,2019,93463
5145,129,694,5968,86.21,2.16,11.63,2019,93514
138,49,0,187,73.8,26.2,0.0,2019,93529
139,0,27,166,83.73,0.0,16.27,2019,93541
97,0,37,134,72.39,0.0,27.61,2019,93549
611,33,131,775,78.84,4.26,16.9,2019,93562
4577,275,1568,6420,71.29,4.28,24.42,2019,93268
946,38,142,1126,84.01,3.37,12.61,2019,93271
84,1,31,116,72.41,0.86,26.72,2019,93954
9386,167,1270,10823,86.72,1.54,11.73,2019,93955
3227,22,849,4098,78.75,0.54,20.72,2019,93960
10093,73,278,10444,96.64,0.7,2.66,2019,91354
6580,128,1352,8060,81.64,1.59,16.77,2019,91010
5109,39,962,6110,83.62,0.64,15.74,2019,91203
7039,83,1764,8886,79.21,0.93,19.85,2019,91340
12549,258,712,13519,92.82,1.91,5.27,2019,91362
9910,203,535,10648,93.07,1.91,5.02,2019,91364
1740,22,382,2144,81.16,1.03,17.82,2019,49346
996,40,153,1189,83.77,3.36,12.87,2019,49449
1386,51,343,1780,77.87,2.87,19.27,2019,49454
2954,71,505,3530,83.68,2.01,14.31,2019,49461
224,6,61,291,76.98,2.06,20.96,2019,49618
1156,70,344,1570,73.63,4.46,21.91,2019,49633
632,21,223,876,72.15,2.4,25.46,2019,49639
1111,42,549,1702,65.28,2.47,32.26,2019,49665
638,20,295,953,66.95,2.1,30.95,2019,49644
4396,160,982,5538,79.38,2.89,17.73,2019,49660
992,37,287,1316,75.38,2.81,21.81,2019,49668
744,6,153,903,82.39,0.66,16.94,2019,49670
1950,166,710,2826,69.0,5.87,25.12,2019,49677
1066,51,219,1336,79.79,3.82,16.39,2019,49657
689,5,118,812,84.85,0.62,14.53,2019,49664
1300,36,190,1526,85.19,2.36,12.45,2019,49676
1430,24,222,1676,85.32,1.43,13.25,2019,49682
639,19,152,810,78.89,2.35,18.77,2019,49683
2328,78,406,2812,82.79,2.77,14.44,2019,49690
222,13,100,335,66.27,3.88,29.85,2019,49743
369,3,78,450,82.0,0.67,17.33,2019,49745
66,0,20,86,76.74,0.0,23.26,2019,49748
1367,37,400,1804,75.78,2.05,22.17,2019,49756
653,53,125,831,78.58,6.38,15.04,2019,49777
617,25,182,824,74.88,3.03,22.09,2019,49795
621,14,52,687,90.39,2.04,7.57,2019,51241
208,2,35,245,84.9,0.82,14.29,2019,51357
403,27,120,550,73.27,4.91,21.82,2019,51358
332,20,87,439,75.63,4.56,19.82,2019,51439
30,4,24,58,51.72,6.9,41.38,2019,51451
479,1,113,593,80.78,0.17,19.06,2019,51454
256,10,49,315,81.27,3.17,15.56,2019,51020
302,4,27,333,90.69,1.2,8.11,2019,51036
19,0,14,33,57.58,0.0,42.42,2019,51051
1773,37,163,1973,89.86,1.88,8.26,2019,51054
8460,417,1499,10376,81.53,4.02,14.45,2019,51106
553,39,115,707,78.22,5.52,16.27,2019,51237
2602,31,227,2860,90.98,1.08,7.94,2019,51250
62,2,3,67,92.54,2.99,4.48,2019,51008
148,0,32,180,82.22,0.0,17.78,2019,51014
372,6,86,464,80.17,1.29,18.53,2019,51027
4392,104,559,5055,86.88,2.06,11.06,2019,51031
598,32,151,781,76.57,4.1,19.33,2019,51034
945,48,96,1089,86.78,4.41,8.82,2019,51039
260,1,89,350,74.29,0.29,25.43,2019,51052
133,1,36,170,78.24,0.59,21.18,2019,51056
6877,430,1192,8499,80.92,5.06,14.03,2019,51104
993,34,226,1253,79.25,2.71,18.04,2019,51109
105,2,8,115,91.3,1.74,6.96,2019,51230
1021,35,51,1107,92.23,3.16,4.61,2019,51239
230,12,58,300,76.67,4.0,19.33,2019,51243
464,22,52,538,86.25,4.09,9.67,2019,51245
4508,162,838,5508,81.84,2.94,15.21,2019,51301
0,0,0,0,,,,2019,54010
0,0,0,0,,,,2019,54307
118,0,43,161,73.29,0.0,26.71,2019,54450
31,1,3,35,88.57,2.86,8.57,2019,54458
3379,124,737,4240,79.69,2.92,17.38,2019,54482
0,0,2,2,0.0,0.0,100.0,2019,54641
84,13,86,183,45.9,7.1,46.99,2019,52584
179,0,40,219,81.74,0.0,18.26,2019,52586
304,20,94,418,72.73,4.78,22.49,2019,52728
2811,89,792,3692,76.14,2.41,21.45,2019,52060
276,17,53,346,79.77,4.91,15.32,2019,52064
131,3,24,158,82.91,1.9,15.19,2019,52077
357,26,121,504,70.83,5.16,24.01,2019,52144
804,21,211,1036,77.61,2.03,20.37,2019,52159
257,0,128,385,66.75,0.0,33.25,2019,52160
509,46,100,655,77.71,7.02,15.27,2019,52041
120,7,31,158,75.95,4.43,19.62,2019,52163
1957,76,632,2665,73.43,2.85,23.71,2019,52172
520,8,21,549,94.72,1.46,3.83,2019,52201
823,17,78,918,89.65,1.85,8.5,2019,52206
179,19,57,255,70.2,7.45,22.35,2019,52222
7598,183,627,8408,90.37,2.18,7.46,2019,52241
8941,658,720,10319,86.65,6.38,6.98,2019,52246
1067,63,152,1282,83.23,4.91,11.86,2019,52253
1196,31,291,1518,78.79,2.04,19.17,2019,52301
24,0,55,79,30.38,0.0,69.62,2019,52307
501,6,175,682,73.46,0.88,25.66,2019,52316
22,2,8,32,68.75,6.25,25.0,2019,52066
35,0,19,54,64.81,0.0,35.19,2019,52166
946,50,182,1178,80.31,4.24,15.45,2019,52211
60,0,18,78,76.92,0.0,23.08,2019,52219
1728,51,65,1844,93.71,2.77,3.52,2019,52314
85,0,9,94,90.43,0.0,9.57,2019,52359
83,2,18,103,80.58,1.94,17.48,2019,52560
311,12,50,373,83.38,3.22,13.4,2019,52318
1159,40,61,1260,91.98,3.17,4.84,2019,52338
1059,43,305,1407,75.27,3.06,21.68,2019,52342
155,0,30,185,83.78,0.0,16.22,2019,52354
690,73,197,960,71.88,7.6,20.52,2019,52401
9167,348,2620,12135,75.54,2.87,21.59,2019,52501
505,8,96,609,82.92,1.31,15.76,2019,52306
809,31,148,988,81.88,3.14,14.98,2019,52356
1413,31,344,1788,79.03,1.73,19.24,2019,52655
99,0,29,128,77.34,0.0,22.66,2019,52212
108,3,14,125,86.4,2.4,11.2,2019,52313
112,0,16,128,87.5,0.0,12.5,2019,52355
113,2,28,143,79.02,1.4,19.58,2019,52158
492,14,40,546,90.11,2.56,7.33,2019,52345
2257,112,716,3085,73.16,3.63,23.21,2019,52349
3009,192,581,3782,79.56,5.08,15.36,2019,52353
1544,39,288,1871,82.52,2.08,15.39,2019,52361
9221,222,1202,10645,86.62,2.09,11.29,2019,52405
377,6,88,471,80.04,1.27,18.68,2019,52530
393,4,87,484,81.2,0.83,17.98,2019,52533
1045,14,203,1262,82.81,1.11,16.09,2019,52327
129,0,76,205,62.93,0.0,37.07,2019,52551
176,12,54,242,72.73,4.96,22.31,2019,52739
2583,32,419,3034,85.14,1.05,13.81,2019,52233
678,78,263,1019,66.54,7.65,25.81,2019,52043
940,15,351,1306,71.98,1.15,26.88,2019,54421
516,13,128,657,78.54,1.98,19.48,2019,54202
330,19,58,407,81.08,4.67,14.25,2019,54246
434,7,72,513,84.6,1.36,14.04,2019,54428
622,17,220,859,72.41,1.98,25.61,2019,54435
527,16,240,783,67.31,2.04,30.65,2019,54436
238,24,29,291,81.79,8.25,9.97,2019,94946
51,0,0,51,100.0,0.0,0.0,2019,94950
554,0,98,652,84.97,0.0,15.03,2019,94973
11152,114,417,11683,95.45,0.98,3.57,2019,94555
4565,89,557,5211,87.6,1.71,10.69,2019,94571
47,0,0,47,100.0,0.0,0.0,2019,94576
17193,268,1096,18557,92.65,1.44,5.91,2019,94591
8411,558,792,9761,86.17,5.72,8.11,2019,94595
9095,103,724,9922,91.66,1.04,7.3,2019,94596
9967,162,229,10358,96.23,1.56,2.21,2019,94598
12378,499,2383,15260,81.11,3.27,15.62,2019,94606
14139,336,736,15211,92.95,2.21,4.84,2019,94610
6817,183,156,7156,95.26,2.56,2.18,2019,94618
8142,142,390,8674,93.87,1.64,4.5,2019,94703
5385,147,255,5787,93.05,2.54,4.41,2019,94705
338,0,64,402,84.08,0.0,15.92,2019,94937
77,10,26,113,68.14,8.85,23.01,2019,94940
5409,211,330,5950,90.91,3.55,5.55,2019,94965
21419,471,2034,23924,89.53,1.97,8.5,2019,94558
6168,72,517,6757,91.28,1.07,7.65,2019,94564
18243,383,1669,20295,89.89,1.89,8.22,2019,94015
2223,33,62,2318,95.9,1.42,2.67,2019,94027
1055,0,102,1157,91.18,0.0,8.82,2019,94038
5799,181,258,6238,92.96,2.9,4.14,2019,94041
176,5,39,220,80.0,2.27,17.73,2019,92066
622,16,0,638,97.49,2.51,0.0,2019,92091
16712,243,1318,18273,91.46,1.33,7.21,2019,92103
10033,255,3293,13581,73.88,1.88,24.25,2019,92113
15261,143,913,16317,93.53,0.88,5.6,2019,92116
7665,166,604,8435,90.87,1.97,7.16,2019,92118
69,20,0,89,77.53,22.47,0.0,2019,92060
5007,46,246,5299,94.49,0.87,4.64,2019,92075
9989,244,1041,11274,88.6,2.16,9.23,2019,92083
13341,193,1343,14877,89.68,1.3,9.03,2019,92084
19258,433,1386,21077,91.37,2.05,6.58,2019,92104
2755,168,231,3154,87.35,5.33,7.32,2019,92325
176,19,16,211,83.41,9.0,7.58,2019,92333
23102,696,1281,25079,92.12,2.78,5.11,2019,92336
768,8,306,1082,70.98,0.74,28.28,2019,92365
43,7,52,102,42.16,6.86,50.98,2019,92389
530,32,114,676,78.4,4.73,16.86,2019,92398
8793,195,220,9208,95.49,2.12,2.39,2019,92606
9826,246,1455,11527,85.24,2.13,12.62,2019,92802
5848,176,675,6699,87.3,2.63,10.08,2019,92501
9520,58,432,10010,95.1,0.58,4.32,2019,92508
393,16,74,483,81.37,3.31,15.32,2019,92518
13491,187,1060,14738,91.54,1.27,7.19,2019,92705
9862,106,565,10533,93.63,1.01,5.36,2019,92883
886,48,153,1087,81.51,4.42,14.08,2019,92536
12751,223,927,13901,91.73,1.6,6.67,2019,92557
11283,361,1202,12846,87.83,2.81,9.36,2019,92571
3516,108,395,4019,87.48,2.69,9.83,2019,92582
14159,147,668,14974,94.56,0.98,4.46,2019,92584
4587,124,424,5135,89.33,2.41,8.26,2019,95130
6001,53,91,6145,97.66,0.86,1.48,2019,95138
9814,331,1784,11929,82.27,2.77,14.96,2019,95210
155,0,30,185,83.78,0.0,16.22,2019,95233
1057,42,170,1269,83.29,3.31,13.4,2019,95237
380,0,223,603,63.02,0.0,36.98,2019,95255
7558,86,1259,8903,84.89,0.97,14.14,2019,91202
3583,40,458,4081,87.8,0.98,11.22,2019,91207
5444,44,367,5855,92.98,0.75,6.27,2019,91208
9718,169,470,10357,93.83,1.63,4.54,2019,91214
8023,111,516,8650,92.75,1.28,5.97,2019,91307
13352,197,734,14283,93.48,1.38,5.14,2019,91311
15595,284,1158,17037,91.54,1.67,6.8,2019,91344
21864,545,1606,24015,91.04,2.27,6.69,2019,91730
13789,439,2254,16482,83.66,2.66,13.68,2019,91764
7333,191,589,8113,90.39,2.35,7.26,2019,91775
10920,188,1146,12254,89.11,1.53,9.35,2019,91790
17277,324,1553,19154,90.2,1.69,8.11,2019,91977
3019,125,380,3524,85.67,3.55,10.78,2019,91020
9147,90,578,9815,93.19,0.92,5.89,2019,91030
10844,326,1994,13164,82.38,2.48,15.15,2019,91104
10995,242,3145,14382,76.45,1.68,21.87,2019,91205
10375,118,1164,11657,89.0,1.01,9.99,2019,91007
7789,678,1494,9961,78.19,6.81,15.0,2019,91042
11209,110,2053,13372,83.82,0.82,15.35,2019,91206
8765,107,423,9295,94.3,1.15,4.55,2019,91301
14250,74,647,14971,95.18,0.49,4.32,2019,91320
9205,206,1370,10781,85.38,1.91,12.71,2019,91321
10835,164,403,11402,95.03,1.44,3.53,2019,91350
9284,152,640,10076,92.14,1.51,6.35,2019,91351
8054,133,369,8556,94.13,1.55,4.31,2019,91361
11727,1881,3102,16710,70.18,11.26,18.56,2019,91601
11286,1011,3104,15401,73.28,6.56,20.15,2019,91606
12724,282,3060,16066,79.2,1.76,19.05,2019,91732
7285,95,1285,8665,84.07,1.1,14.83,2019,91755
17512,270,2283,20065,87.28,1.35,11.38,2019,91801
8396,91,1157,9644,87.06,0.94,12.0,2019,91803
15967,437,2703,19107,83.57,2.29,14.15,2019,91786
12682,120,546,13348,95.01,0.9,4.09,2019,91789
8657,91,1332,10080,85.88,0.9,13.21,2019,91791
13494,335,1126,14955,90.23,2.24,7.53,2019,91360
6312,242,785,7339,86.01,3.3,10.7,2019,91040
9921,430,2085,12436,79.78,3.46,16.77,2019,91352
8765,467,1507,10739,81.62,4.35,14.03,2019,91101
13018,223,1443,14684,88.65,1.52,9.83,2019,89506
10069,302,770,11141,90.38,2.71,6.91,2019,89511
181,0,0,181,100.0,0.0,0.0,2019,89828
267,61,160,488,54.71,12.5,32.79,2019,89832
487,0,57,544,89.52,0.0,10.48,2019,89001
9157,194,1101,10452,87.61,1.86,10.53,2019,89011
177,4,140,321,55.14,1.25,43.61,2019,89018
303,22,191,516,58.72,4.26,37.02,2019,89043
20192,559,1230,21981,91.86,2.54,5.6,2019,89052
20964,1369,4707,27040,77.53,5.06,17.41,2019,89108
13828,149,1355,15332,90.19,0.97,8.84,2019,95476
861,24,194,1079,79.8,2.22,17.98,2019,95485
611,10,117,738,82.79,1.36,15.85,2019,95524
8918,176,663,9757,91.4,1.8,6.8,2019,95492
8315,304,1516,10135,82.04,3.0,14.96,2019,95501
199,0,129,328,60.67,0.0,39.33,2019,81143
4664,123,754,5541,84.17,2.22,13.61,2019,81147
2522,70,545,3137,80.4,2.23,17.37,2019,81211
3783,151,607,4541,83.31,3.33,13.37,2019,81008
61,36,42,139,43.88,25.9,30.22,2019,81024
222,5,63,290,76.55,1.72,21.72,2019,81025
1,0,2,3,33.33,0.0,66.67,2019,54643
6,0,0,6,100.0,0.0,0.0,2019,54765
95,0,4,99,95.96,0.0,4.04,2019,54931
13768,513,3011,17292,79.62,2.97,17.41,2019,54220
331,14,93,438,75.57,3.2,21.23,2019,54408
563,7,108,678,83.04,1.03,15.93,2019,54471
628,8,110,746,84.18,1.07,14.75,2019,54610
1863,89,329,2281,81.67,3.9,14.42,2019,54986
0,0,0,0,,,,2019,54946
7805,139,534,8478,92.06,1.64,6.3,2019,54913
110,0,34,144,76.39,0.0,23.61,2019,54928
130,6,23,159,81.76,3.77,14.47,2019,54933
1115,38,259,1412,78.97,2.69,18.34,2019,54949
4727,204,914,5845,80.87,3.49,15.64,2019,54961
487,7,70,564,86.35,1.24,12.41,2019,54979
1390,10,197,1597,87.04,0.63,12.34,2019,54661
472,9,154,635,74.33,1.42,24.25,2019,54664
15227,544,1714,17485,87.09,3.11,9.8,2019,54703
443,4,116,563,78.69,0.71,20.6,2019,54721
11805,277,1475,13557,87.08,2.04,10.88,2019,54729
231,3,45,279,82.8,1.08,16.13,2019,54746
7761,461,1310,9532,81.42,4.84,13.74,2019,54751
2453,57,486,2996,81.88,1.9,16.22,2019,54755
541,8,110,659,82.09,1.21,16.69,2019,54759
2303,149,589,3041,75.73,4.9,19.37,2019,54801
1649,161,398,2208,74.68,7.29,18.03,2019,54829
344,16,48,408,84.31,3.92,11.76,2019,54836
135,0,58,193,69.95,0.0,30.05,2019,54462
202,12,78,292,69.18,4.11,26.71,2019,54465
645,22,179,846,76.24,2.6,21.16,2019,54470
827,18,212,1057,78.24,1.7,20.06,2019,54473
446,8,118,572,77.97,1.4,20.63,2019,54480
10036,236,1270,11542,86.95,2.04,11.0,2019,54481
231,14,102,347,66.57,4.03,29.39,2019,54490
573,17,271,861,66.55,1.97,31.48,2019,54498
390,10,54,454,85.9,2.2,11.89,2019,54512
3001,140,676,3817,78.62,3.67,17.71,2019,54521
357,21,53,431,82.83,4.87,12.3,2019,54545
512,29,140,681,75.18,4.26,20.56,2019,54547
13,0,9,22,59.09,0.0,40.91,2019,54565
406,66,168,640,63.44,10.31,26.25,2019,54566
855,19,213,1087,78.66,1.75,19.6,2019,54614
732,15,112,859,85.22,1.75,13.04,2019,54618
841,21,372,1234,68.15,1.7,30.15,2019,54619
503,14,122,639,78.72,2.19,19.09,2019,54624
1425,42,277,1744,81.71,2.41,15.88,2019,54630
446,8,136,590,75.59,1.36,23.05,2019,54638
31,4,9,44,70.45,9.09,20.45,2019,54645
243,9,136,388,62.63,2.32,35.05,2019,54652
933,23,169,1125,82.93,2.04,15.02,2019,54658
2703,99,802,3604,75.0,2.75,22.25,2019,54665
1922,133,528,2583,74.41,5.15,20.44,2019,54728
348,31,77,456,76.32,6.8,16.89,2019,54733
208,23,76,307,67.75,7.49,24.76,2019,56545
907,21,160,1088,83.36,1.93,14.71,2019,56554
350,7,125,482,72.61,1.45,25.93,2019,56569
588,20,168,776,75.77,2.58,21.65,2019,56628
25,1,1,27,92.59,3.7,3.7,2019,56659
111,7,25,143,77.62,4.9,17.48,2019,56669
310,7,29,346,89.6,2.02,8.38,2019,54441
351,13,103,467,75.16,2.78,22.06,2019,54488
9749,304,1714,11767,82.85,2.58,14.57,2019,54494
152,13,34,199,76.38,6.53,17.09,2019,54537
1936,41,187,2164,89.46,1.89,8.64,2019,54548
1596,120,440,2156,74.03,5.57,20.41,2019,54552
1803,106,487,2396,75.25,4.42,20.33,2019,54555
444,13,130,587,75.64,2.21,22.15,2019,54556
1765,251,400,2416,73.05,10.39,16.56,2019,54568
16693,804,2746,20243,82.46,3.97,13.57,2019,54601
600,23,241,864,69.44,2.66,27.89,2019,54613
1428,42,340,1810,78.9,2.32,18.78,2019,54667
991,24,173,1188,83.42,2.02,14.56,2019,54725
885,33,291,1209,73.2,2.73,24.07,2019,54732
249,21,58,328,75.91,6.4,17.68,2019,54734
1391,37,272,1700,81.82,2.18,16.0,2019,54736
1018,33,184,1235,82.43,2.67,14.9,2019,54738
1708,49,133,1890,90.37,2.59,7.04,2019,54739
440,31,202,673,65.38,4.61,30.01,2019,54741
379,42,79,500,75.8,8.4,15.8,2019,54762
490,18,113,621,78.9,2.9,18.2,2019,54821
781,26,309,1116,69.98,2.33,27.69,2019,54437
3860,71,1048,4979,77.53,1.43,21.05,2019,54451
407,21,111,539,75.51,3.9,20.59,2019,54454
962,27,202,1191,80.77,2.27,16.96,2019,54466
1163,39,299,1501,77.48,2.6,19.92,2019,54479
6905,123,1415,8443,81.78,1.46,16.76,2019,54501
1366,134,357,1857,73.56,7.22,19.22,2019,54520
225,14,41,280,80.36,5.0,14.64,2019,54524
132,20,77,229,57.64,8.73,33.62,2019,54542
366,12,148,526,69.58,2.28,28.14,2019,54546
1952,127,568,2647,73.74,4.8,21.46,2019,54002
989,52,211,1252,78.99,4.15,16.85,2019,54005
876,23,142,1041,84.15,2.21,13.64,2019,54009
139,4,23,166,83.73,2.41,13.86,2019,54827
30,0,10,40,75.0,0.0,25.0,2019,54845
104,1,10,115,90.43,0.87,8.7,2019,54850
19,3,0,22,86.36,13.64,0.0,2019,54857
32,8,28,68,47.06,11.76,41.18,2019,54861
183,6,52,241,75.93,2.49,21.58,2019,54867
5372,375,1083,6830,78.65,5.49,15.86,2019,54868
325,28,122,475,68.42,5.89,25.68,2019,54895
545,9,158,712,76.54,1.26,22.19,2019,54930
917,33,254,1204,76.16,2.74,21.1,2019,54960
447,16,91,554,80.69,2.89,16.43,2019,54965
37,0,13,50,74.0,0.0,26.0,2019,54980
1478,60,308,1846,80.07,3.25,16.68,2019,54983
932,30,135,1097,84.96,2.73,12.31,2019,54101
144,2,56,202,71.29,0.99,27.72,2019,54103
66,5,46,117,56.41,4.27,39.32,2019,54120
996,78,268,1342,74.22,5.81,19.97,2019,54121
546,13,122,681,80.18,1.91,17.91,2019,54128
2188,33,422,2643,82.78,1.25,15.97,2019,54136
247,0,90,337,73.29,0.0,26.71,2019,81091
554,18,85,657,84.32,2.74,12.94,2019,81151
603,27,400,1030,58.54,2.62,38.83,2019,81120
116,5,36,157,73.89,3.18,22.93,2019,81121
2627,371,555,3553,73.94,10.44,15.62,2019,81122
3420,177,563,4160,82.21,4.25,13.53,2019,81201
129,0,26,155,83.23,0.0,16.77,2019,95257
276,0,82,358,77.09,0.0,22.91,2019,95306
10698,262,1629,12589,84.98,2.08,12.94,2019,95307
1967,52,218,2237,87.93,2.32,9.75,2019,95316
0,71,27,98,0.0,72.45,27.55,2019,95335
13480,311,1686,15477,87.1,2.01,10.89,2019,95336
16548,365,2919,19832,83.44,1.84,14.72,2019,95350
7,0,0,7,100.0,0.0,0.0,2019,95430
397,30,56,483,82.19,6.21,11.59,2019,95452
7440,144,747,8331,89.31,1.73,8.97,2019,95521
428,5,66,499,85.77,1.0,13.23,2019,95528
4302,185,915,5402,79.64,3.42,16.94,2019,95540
247,17,120,384,64.32,4.43,31.25,2019,95552
508,47,96,651,78.03,7.22,14.75,2019,95560
43,2,53,98,43.88,2.04,54.08,2019,95606
184,18,148,350,52.57,5.14,42.29,2019,95629
1171,15,190,1376,85.1,1.09,13.81,2019,95633
76,0,21,97,78.35,0.0,21.65,2019,95637
11125,271,851,12247,90.84,2.21,6.95,2019,95662
11995,289,2051,14335,83.68,2.02,14.31,2019,95667
14475,320,1359,16154,89.61,1.98,8.41,2019,95678
10158,110,1041,11309,89.82,0.97,9.21,2019,95682
19713,581,3416,23710,83.14,2.45,14.41,2019,95823
14416,329,1659,16404,87.88,2.01,10.11,2019,95825
13524,485,1205,15214,88.89,3.19,7.92,2019,95826
87,0,44,131,66.41,0.0,33.59,2019,95920
129,0,13,142,90.85,0.0,9.15,2019,95925
204,3,47,254,80.31,1.18,18.5,2019,95674
312,13,66,391,79.8,3.32,16.88,2019,95659
182,11,42,235,77.45,4.68,17.87,2019,95668
773,33,78,884,87.44,3.73,8.82,2019,95669
49,20,18,87,56.32,22.99,20.69,2019,95717
39,0,9,48,81.25,0.0,18.75,2019,95720
15173,477,2202,17852,84.99,2.67,12.33,2019,95828
185,7,66,258,71.71,2.71,25.58,2019,95830
9852,238,1359,11449,86.05,2.08,11.87,2019,95842
9575,330,1829,11734,81.6,2.81,15.59,2019,95901
384,9,91,484,79.34,1.86,18.8,2019,95919
12653,439,1381,14473,87.42,3.03,9.54,2019,95928
276,0,49,325,84.92,0.0,15.08,2019,95943
244,17,52,313,77.96,5.43,16.61,2019,95957
12564,286,1369,14219,88.36,2.01,9.63,2019,95973
26357,377,1102,27836,94.69,1.35,3.96,2019,95630
114,0,0,114,100.0,0.0,0.0,2019,95639
15487,272,2228,17987,86.1,1.51,12.39,2019,91766
11886,248,1931,14065,84.51,1.76,13.73,2019,91767
13907,296,2445,16648,83.54,1.78,14.69,2019,91770
10248,75,1390,11713,87.49,0.64,11.87,2019,91776
20706,473,3505,24684,83.88,1.92,14.2,2019,91911
10587,154,833,11574,91.47,1.33,7.2,2019,91941
182,0,78,260,70.0,0.0,30.0,2019,91963
0,0,0,0,,,,2019,91980
17180,292,961,18433,93.2,1.58,5.21,2019,91367
202,0,0,202,100.0,0.0,0.0,2019,82725
95,0,38,133,71.43,0.0,28.57,2019,82838
75,0,90,165,45.45,0.0,54.55,2019,82922
35,0,0,35,100.0,0.0,0.0,2019,82942
64,0,12,76,84.21,0.0,15.79,2019,82050
34,0,0,34,100.0,0.0,0.0,2019,82944
53,0,22,75,70.67,0.0,29.33,2019,81027
36,0,17,53,67.92,0.0,32.08,2019,81033
111,2,33,146,76.03,1.37,22.6,2019,81044
92,6,16,114,80.7,5.26,14.04,2019,81049
10000,299,2306,12605,79.33,2.37,18.29,2019,81005
342,17,143,502,68.13,3.39,28.49,2019,81023
630,0,72,702,89.74,0.0,10.26,2019,81524
49,0,34,83,59.04,0.0,40.96,2019,81640
195,11,42,248,78.63,4.44,16.94,2019,81643
3921,289,1274,5484,71.5,5.27,23.23,2019,81082
2159,54,321,2534,85.2,2.13,12.67,2019,81226
125,39,49,213,58.69,18.31,23.0,2019,81327
1218,55,100,1373,88.71,4.01,7.28,2019,81432
264,11,22,297,88.89,3.7,7.41,2019,81077
41,0,5,46,89.13,0.0,10.87,2019,81241
19,0,3,22,86.36,0.0,13.64,2019,81043
95,6,22,123,77.24,4.88,17.89,2019,81064
362,18,75,455,79.56,3.96,16.48,2019,81133
625,27,182,834,74.94,3.24,21.82,2019,81140
1934,106,818,2858,67.67,3.71,28.62,2019,81144
85,2,31,118,72.03,1.69,26.27,2019,81221
584,37,216,837,69.77,4.42,25.81,2019,81326
510,10,165,685,74.45,1.46,24.09,2019,81410
1656,102,377,2135,77.56,4.78,17.66,2019,81413
400,31,78,509,78.59,6.09,15.32,2019,81427
389,0,0,389,100.0,0.0,0.0,2019,81523
366,0,75,441,82.99,0.0,17.01,2019,81525
7311,664,2925,10900,67.07,6.09,26.83,2019,81004
208,0,116,324,64.2,0.0,35.8,2019,81041
41,0,18,59,69.49,0.0,30.51,2019,81087
795,112,426,1333,59.64,8.4,31.96,2019,81125
349,13,121,483,72.26,2.69,25.05,2019,81141
9580,367,1456,11403,84.01,3.22,12.77,2019,81212
3517,240,387,4144,84.87,5.79,9.34,2019,81230
262,6,77,345,75.94,1.74,22.32,2019,81235
620,21,57,698,88.83,3.01,8.17,2019,81236
1287,97,121,1505,85.51,6.45,8.04,2019,81240
35,0,5,40,87.5,0.0,12.5,2019,81243
10173,518,1505,12196,83.41,4.25,12.34,2019,81301
4289,321,1389,5999,71.5,5.35,23.15,2019,81321
2022,171,178,2371,85.28,7.21,7.51,2019,81435
8147,299,1487,9933,82.02,3.01,14.97,2019,81501
4339,222,956,5517,78.65,4.02,17.33,2019,81506
486,19,38,543,89.5,3.5,7.0,2019,81654
370,26,125,521,71.02,4.99,23.99,2019,81019
7075,223,791,8089,87.46,2.76,9.78,2019,85132
68,10,96,174,39.08,5.75,55.17,2019,85135
527,98,323,948,55.59,10.34,34.07,2019,85137
11062,339,495,11896,92.99,2.85,4.16,2019,85138
4722,225,681,5628,83.9,4.0,12.1,2019,85139
13543,296,593,14432,93.84,2.05,4.11,2019,85140
66,4,58,128,51.56,3.12,45.31,2019,85141
20060,668,709,21437,93.58,3.12,3.31,2019,85142
2073,72,370,2515,82.43,2.86,14.71,2019,83445
256,7,31,294,87.07,2.38,10.54,2019,83450
180,13,27,220,81.82,5.91,12.27,2019,83462
1540,50,446,2036,75.64,2.46,21.91,2019,83530
39,0,25,64,60.94,0.0,39.06,2019,83542
155,3,43,201,77.11,1.49,21.39,2019,83545
180,0,105,285,63.16,0.0,36.84,2019,56670
79,2,28,109,72.48,1.83,25.69,2019,56684
312,118,77,507,61.54,23.27,15.19,2019,56714
905,37,115,1057,85.62,3.5,10.88,2019,56467
3452,224,756,4432,77.89,5.05,17.06,2019,56470
2706,76,401,3183,85.01,2.39,12.6,2019,56472
1163,42,254,1459,79.71,2.88,17.41,2019,56473
1768,59,351,2178,81.18,2.71,16.12,2019,56479
677,29,124,830,81.57,3.49,14.94,2019,56044
27,8,9,44,61.36,18.18,20.45,2019,56056
460,13,73,546,84.25,2.38,13.37,2019,56115
136,1,24,161,84.47,0.62,14.91,2019,56118
255,11,82,348,73.28,3.16,23.56,2019,56120
1573,66,312,1951,80.63,3.38,15.99,2019,56143
367,34,108,509,72.1,6.68,21.22,2019,56144
151,8,97,256,58.98,3.12,37.89,2019,56145
387,43,91,521,74.28,8.25,17.47,2019,56149
1926,55,411,2392,80.52,2.3,17.18,2019,56156
134,1,21,156,85.9,0.64,13.46,2019,56165
1030,58,287,1375,74.91,4.22,20.87,2019,56172
670,40,102,812,82.51,4.93,12.56,2019,56511
1115,71,163,1349,82.65,5.26,12.08,2019,56515
71,3,35,109,65.14,2.75,32.11,2019,56516
101,13,42,156,64.74,8.33,26.92,2019,56518
1388,58,335,1781,77.93,3.26,18.81,2019,56520
371,35,110,516,71.9,6.78,21.32,2019,56535
28,0,18,46,60.87,0.0,39.13,2019,56729
17,6,11,34,50.0,17.65,32.35,2019,56731
168,12,34,214,78.5,5.61,15.89,2019,56744
195,4,31,230,84.78,1.74,13.48,2019,56754
115,7,17,139,82.73,5.04,12.23,2019,56758
1227,403,259,1889,64.96,21.33,13.71,2019,56763
78,2,27,107,72.9,1.87,25.23,2019,56153
143,0,34,177,80.79,0.0,19.21,2019,56078
241,4,25,270,89.26,1.48,9.26,2019,56080
617,12,179,808,76.36,1.49,22.15,2019,56088
11,2,4,17,64.71,11.76,23.53,2019,56177
316,22,97,435,72.64,5.06,22.3,2019,56219
316,8,93,417,75.78,1.92,22.3,2019,56228
125,7,22,154,81.17,4.55,14.29,2019,56231
168,6,48,222,75.68,2.7,21.62,2019,56237
273,9,133,415,65.78,2.17,32.05,2019,56240
223,4,34,261,85.44,1.53,13.03,2019,56245
343,21,115,479,71.61,4.38,24.01,2019,56253
376,16,80,472,79.66,3.39,16.95,2019,56271
173,9,28,210,82.38,4.29,13.33,2019,56280
414,22,142,578,71.63,3.81,24.57,2019,56316
460,10,84,554,83.03,1.81,15.16,2019,56319
335,14,75,424,79.01,3.3,17.69,2019,56324
69,1,29,99,69.7,1.01,29.29,2019,56325
2002,127,561,2690,74.42,4.72,20.86,2019,56334
63,2,22,87,72.41,2.3,25.29,2019,56335
502,12,137,651,77.11,1.84,21.04,2019,56338
129,0,54,183,70.49,0.0,29.51,2019,50133
394,2,82,478,82.43,0.42,17.15,2019,50139
165,0,36,201,82.09,0.0,17.91,2019,50154
157,3,49,209,75.12,1.44,23.44,2019,50164
1551,50,314,1915,80.99,2.61,16.4,2019,50248
416,5,90,511,81.41,0.98,17.61,2019,50251
178,13,0,191,93.19,6.81,0.0,2019,81210
493,15,12,520,94.81,2.88,2.31,2019,81225
93,16,0,109,85.32,14.68,0.0,2019,81251
261,0,17,278,93.88,0.0,6.12,2019,81253
525,137,90,752,69.81,18.22,11.97,2019,81131
200,3,67,270,74.07,1.11,24.81,2019,81146
157,19,138,314,50.0,6.05,43.95,2019,81422
344,9,99,452,76.11,1.99,21.9,2019,81424
48,0,14,62,77.42,0.0,22.58,2019,81426
4176,54,330,4560,91.58,1.18,7.24,2019,81505
61,0,0,61,100.0,0.0,0.0,2019,81522
11,12,0,23,47.83,52.17,0.0,2019,81335
361,13,27,401,90.02,3.24,6.73,2019,81430
58,0,56,114,50.88,0.0,49.12,2019,81434
1189,38,0,1227,96.9,3.1,0.0,2019,81615
5419,65,367,5851,92.62,1.11,6.27,2019,81623
4132,147,814,5093,81.13,2.89,15.98,2019,81625
333,9,45,387,86.05,2.33,11.63,2019,81630
2506,0,141,2647,94.67,0.0,5.33,2019,81631
366,12,17,395,92.66,3.04,4.3,2019,81645
771,35,84,890,86.63,3.93,9.44,2019,81648
124,0,0,124,100.0,0.0,0.0,2019,81656
362,4,44,410,88.29,0.98,10.73,2019,80928
97,3,19,119,81.51,2.52,15.97,2019,80749
59,3,9,71,83.1,4.23,12.68,2019,80754
91,0,16,107,85.05,0.0,14.95,2019,80757
1089,63,328,1480,73.58,4.26,22.16,2019,80758
72,14,37,123,58.54,11.38,30.08,2019,80804
287,6,71,364,78.85,1.65,19.51,2019,80815
2425,65,113,2603,93.16,2.5,4.34,2019,80816
9463,166,661,10290,91.96,1.61,6.42,2019,80817
278,6,82,366,75.96,1.64,22.4,2019,80835
21,0,0,21,100.0,0.0,0.0,2019,80862
4748,163,261,5172,91.8,3.15,5.05,2019,80863
752,7,24,783,96.04,0.89,3.07,2019,80547
81,0,0,81,100.0,0.0,0.0,2019,80425
1357,19,157,1533,88.52,1.24,10.24,2019,80466
12800,767,1244,14811,86.42,5.18,8.4,2019,80524
2531,111,413,3055,82.85,3.63,13.52,2019,80615
3332,100,848,4280,77.85,2.34,19.81,2019,80621
202,28,65,295,68.47,9.49,22.03,2019,80623
206,3,41,250,82.4,1.2,16.4,2019,80729
49,0,8,57,85.96,0.0,14.04,2019,80740
13587,454,1207,15248,89.11,2.98,7.92,2019,80906
8129,146,280,8555,95.02,1.71,3.27,2019,80921
601,6,67,674,89.17,0.89,9.94,2019,80930
13560,564,847,14971,90.58,3.77,5.66,2019,80021
12177,289,975,13441,90.6,2.15,7.25,2019,80031
177,4,14,195,90.77,2.05,7.18,2019,80101
8135,232,1087,9454,86.05,2.45,11.5,2019,80110
949,13,150,1112,85.34,1.17,13.49,2019,80117
13660,186,389,14235,95.96,1.31,2.73,2019,80128
10583,399,2522,13504,78.37,2.95,18.68,2019,80204
477,30,318,825,57.82,3.64,38.55,2019,87935
332,6,107,445,74.61,1.35,24.04,2019,87942
2159,62,84,2305,93.67,2.69,3.64,2019,87043
95,6,407,508,18.7,1.18,80.12,2019,87045
106,0,224,330,32.12,0.0,67.88,2019,87062
14815,532,2377,17724,83.59,3.0,13.41,2019,87109
70,0,33,103,67.96,0.0,32.04,2019,82945
138,0,0,138,100.0,0.0,0.0,2019,82060
145,6,29,180,80.56,3.33,16.11,2019,82210
9,0,0,9,100.0,0.0,0.0,2019,82217
98,0,20,118,83.05,0.0,16.95,2019,82227
3121,167,820,4108,75.97,4.07,19.96,2019,82240
2723,109,456,3288,82.82,3.32,13.87,2019,82301
19,6,47,72,26.39,8.33,65.28,2019,82323
48,0,21,69,69.57,0.0,30.43,2019,82332
5663,165,751,6579,86.08,2.51,11.42,2019,82414
46,0,33,79,58.23,0.0,41.77,2019,82441
251,30,143,424,59.2,7.08,33.73,2019,82514
111,0,45,156,71.15,0.0,28.85,2019,82516
1189,86,272,1547,76.86,5.56,17.58,2019,82637
29,0,20,49,59.18,0.0,40.82,2019,82642
520,50,211,781,66.58,6.4,27.02,2019,82644
57,0,54,111,51.35,0.0,48.65,2019,82710
65,0,20,85,76.47,0.0,23.53,2019,82731
123,2,19,144,85.42,1.39,13.19,2019,82835
37,0,86,123,30.08,0.0,69.92,2019,82943
66,0,32,98,67.35,0.0,32.65,2019,82059
0,0,0,0,,,,2019,82061
97,0,6,103,94.17,0.0,5.83,2019,82063
148,0,52,200,74.0,0.0,26.0,2019,82190
13,0,6,19,68.42,0.0,31.58,2019,82222
514,35,194,743,69.18,4.71,26.11,2019,82225
20,0,10,30,66.67,0.0,33.33,2019,82335
258,8,26,292,88.36,2.74,8.9,2019,82420
107,2,18,127,84.25,1.57,14.17,2019,82432
314,21,24,359,87.47,5.85,6.69,2019,82442
755,51,92,898,84.08,5.68,10.24,2019,82513
119,0,31,150,79.33,0.0,20.67,2019,82723
572,15,129,716,79.89,2.09,18.02,2019,82730
45,0,0,45,100.0,0.0,0.0,2019,82833
406,7,69,482,84.23,1.45,14.32,2019,82839
49,0,30,79,62.03,0.0,37.97,2019,82938
8,0,0,8,100.0,0.0,0.0,2019,82219
97,8,41,146,66.44,5.48,28.08,2019,82221
156,25,25,206,75.73,12.14,12.14,2019,82244
220,0,80,300,73.33,0.0,26.67,2019,82327
383,22,76,481,79.63,4.57,15.8,2019,82433
64,0,21,85,75.29,0.0,24.71,2019,82512
80,6,8,94,85.11,6.38,8.51,2019,82620
1377,25,222,1624,84.79,1.54,13.67,2019,82636
353,30,85,468,75.43,6.41,18.16,2019,82649
22,0,0,22,100.0,0.0,0.0,2019,82714
884,83,125,1092,80.95,7.6,11.45,2019,82729
347,0,49,396,87.63,0.0,12.37,2019,82842
8,0,17,25,32.0,0.0,68.0,2019,82051
318,0,41,359,88.58,0.0,11.42,2019,82054
171,0,0,171,100.0,0.0,0.0,2019,82055
6065,532,365,6962,87.12,7.64,5.24,2019,82072
88,0,29,117,75.21,0.0,24.79,2019,82083
24,0,0,24,100.0,0.0,0.0,2019,87525
36,0,17,53,67.92,0.0,32.08,2019,87533
0,0,25,25,0.0,0.0,100.0,2019,87539
3189,206,859,4254,74.96,4.84,20.19,2019,87004
129,24,140,293,44.03,8.19,47.78,2019,87007
4254,77,808,5139,82.78,1.5,15.72,2019,87015
33,0,21,54,61.11,0.0,38.89,2019,83548
171,2,36,209,81.82,0.96,17.22,2019,83554
0,6,0,6,0.0,100.0,0.0,2019,83602
11622,631,2175,14428,80.55,4.37,15.07,2019,83605
236,18,47,301,78.41,5.98,15.61,2019,83116
201,0,0,201,100.0,0.0,0.0,2019,83122
1155,203,75,1433,80.6,14.17,5.23,2019,83127
422,7,44,473,89.22,1.48,9.3,2019,83128
97,0,13,110,88.18,0.0,11.82,2019,83218
54,0,0,54,100.0,0.0,0.0,2019,83235
374,7,30,411,91.0,1.7,7.3,2019,83246
2854,24,344,3222,88.58,0.74,10.68,2019,83263
18,0,0,18,100.0,0.0,0.0,2019,83281
27,0,0,27,100.0,0.0,0.0,2019,83285
375,23,20,418,89.71,5.5,4.78,2019,83286
404,24,150,578,69.9,4.15,25.95,2019,83323
1694,68,314,2076,81.6,3.28,15.13,2019,83328
294,3,98,395,74.43,0.76,24.81,2019,83349
0,0,0,0,,,,2019,83354
169,0,88,257,65.76,0.0,34.24,2019,83423
12706,309,1128,14143,89.84,2.18,7.98,2019,83401
8269,215,909,9393,88.03,2.29,9.68,2019,83402
655,4,150,809,80.96,0.49,18.54,2019,83420
183,4,52,239,76.57,1.67,21.76,2019,83431
51,0,0,51,100.0,0.0,0.0,2019,83465
243,12,88,343,70.85,3.5,25.66,2019,83523
156,11,69,236,66.1,4.66,29.24,2019,83555
1236,19,341,1596,77.44,1.19,21.37,2019,83628
66,0,6,72,91.67,0.0,8.33,2019,83637
92,0,13,105,87.62,0.0,12.38,2019,83657
2448,87,777,3312,73.91,2.63,23.46,2019,83672
2513,134,729,3376,74.44,3.97,21.59,2019,83805
6545,141,1015,7701,84.99,1.83,13.18,2019,83202
6190,184,1005,7379,83.89,2.49,13.62,2019,83204
214,1,18,233,91.85,0.43,7.73,2019,83214
47,0,0,47,100.0,0.0,0.0,2019,83223
193,9,47,249,77.51,3.61,18.88,2019,83261
172,1,6,179,96.09,0.56,3.35,2019,83271
1182,40,13,1235,95.71,3.24,1.05,2019,83014
1098,58,179,1335,82.25,4.34,13.41,2019,83101
311,43,24,378,82.28,11.38,6.35,2019,83115
0,0,0,0,,,,2019,83121
111,0,0,111,100.0,0.0,0.0,2019,83126
966,9,169,1144,84.44,0.79,14.77,2019,83210
66,0,4,70,94.29,0.0,5.71,2019,83212
0,0,7,7,0.0,0.0,100.0,2019,83227
338,16,84,438,77.17,3.65,19.18,2019,83251
26,0,17,43,60.47,0.0,39.53,2019,83253
1167,41,172,1380,84.57,2.97,12.46,2019,83276
54,13,32,99,54.55,13.13,32.32,2019,83302
33,0,22,55,60.0,0.0,40.0,2019,83312
229,5,137,371,61.73,1.35,36.93,2019,83314
183,4,21,208,87.98,1.92,10.1,2019,83324
148,0,0,148,100.0,0.0,0.0,2019,93962
748,30,359,1137,65.79,2.64,31.57,2019,93272
16122,591,2775,19488,82.73,3.03,14.24,2019,93308
5859,75,467,6401,91.53,1.17,7.3,2019,93402
47,0,22,69,68.12,0.0,31.88,2019,93429
1266,28,111,1405,90.11,1.99,7.9,2019,93430
134,16,42,192,69.79,8.33,21.88,2019,50264
12212,285,1261,13758,88.76,2.07,9.17,2019,50265
4301,217,500,5018,85.71,4.32,9.96,2019,50309
4823,239,782,5844,82.53,4.09,13.38,2019,50311
3322,84,687,4093,81.16,2.05,16.78,2019,50428
1396,76,230,1702,82.02,4.47,13.51,2019,50438
447,6,77,530,84.34,1.13,14.53,2019,50447
271,21,107,399,67.92,5.26,26.82,2019,50449
130,7,20,157,82.8,4.46,12.74,2019,50457
89,2,28,119,74.79,1.68,23.53,2019,50477
238,11,100,349,68.19,3.15,28.65,2019,50478
145,2,22,169,85.8,1.18,13.02,2019,50484
357,9,100,466,76.61,1.93,21.46,2019,50517
207,12,35,254,81.5,4.72,13.78,2019,50519
287,16,64,367,78.2,4.36,17.44,2019,50529
55,0,24,79,69.62,0.0,30.38,2019,50545
233,14,73,320,72.81,4.38,22.81,2019,50578
822,40,197,1059,77.62,3.78,18.6,2019,50579
2615,50,314,2979,87.78,1.68,10.54,2019,50003
6478,287,502,7267,89.14,3.95,6.91,2019,50009
1099,68,281,1448,75.9,4.7,19.41,2019,50025
146,0,0,146,100.0,0.0,0.0,2019,50032
153,11,31,195,78.46,5.64,15.9,2019,50034
2452,87,156,2695,90.98,3.23,5.79,2019,50035
269,6,73,348,77.3,1.72,20.98,2019,50044
244,21,35,300,81.33,7.0,11.67,2019,50050
794,35,122,951,83.49,3.68,12.83,2019,50063
131,0,16,147,89.12,0.0,10.88,2019,50068
120,11,12,143,83.92,7.69,8.39,2019,50582
369,4,86,459,80.39,0.87,18.74,2019,50597
140,16,0,156,89.74,10.26,0.0,2019,50612
569,14,95,678,83.92,2.06,14.01,2019,50626
780,22,127,929,83.96,2.37,13.67,2019,50629
108,0,44,152,71.05,0.0,28.95,2019,50633
1205,42,190,1437,83.86,2.92,13.22,2019,50638
177,10,27,214,82.71,4.67,12.62,2019,50642
305,5,61,371,82.21,1.35,16.44,2019,50666
141,7,36,184,76.63,3.8,19.57,2019,50681
10644,472,1747,12863,82.75,3.67,13.58,2019,50701
813,69,295,1177,69.07,5.86,25.06,2019,50849
657,48,131,836,78.59,5.74,15.67,2019,50851
79,0,22,101,78.22,0.0,21.78,2019,50857
75,12,18,105,71.43,11.43,17.14,2019,50861
690,34,117,841,82.05,4.04,13.91,2019,50864
349,9,74,432,80.79,2.08,17.13,2019,50238
75,1,21,97,77.32,1.03,21.65,2019,50243
91,7,52,150,60.67,4.67,34.67,2019,50262
12449,611,717,13777,90.36,4.43,5.2,2019,50266
2927,192,868,3987,73.41,4.82,21.77,2019,50314
516,22,92,630,81.9,3.49,14.6,2019,50424
248,6,64,318,77.99,1.89,20.13,2019,50448
87,2,27,116,75.0,1.72,23.28,2019,50470
8813,446,2463,11722,75.18,3.8,21.01,2019,50501
377,26,48,451,83.59,5.76,10.64,2019,51338
198,10,14,222,89.19,4.5,6.31,2019,51463
142,6,14,162,87.65,3.7,8.64,2019,51345
197,5,23,225,87.56,2.22,10.22,2019,51350
85,19,45,149,57.05,12.75,30.2,2019,51366
90,1,9,100,90.0,1.0,9.0,2019,51444
383,0,136,519,73.8,0.0,26.2,2019,87317
57,0,15,72,79.17,0.0,20.83,2019,87322
272,23,572,867,31.37,2.65,65.97,2019,87325
82,6,131,219,37.44,2.74,59.82,2019,87357
48,7,260,315,15.24,2.22,82.54,2019,87364
1231,81,698,2010,61.24,4.03,34.73,2019,87417
31,0,0,31,100.0,0.0,0.0,2019,87512
217,42,73,332,65.36,12.65,21.99,2019,87513
59,0,54,113,52.21,0.0,47.79,2019,87515
65,0,131,196,33.16,0.0,66.84,2019,87531
592,24,357,973,60.84,2.47,36.69,2019,87556
356,19,231,606,58.75,3.14,38.12,2019,87560
347,20,449,816,42.52,2.45,55.02,2019,87566
367,22,134,523,70.17,4.21,25.62,2019,87714
237,26,325,588,40.31,4.42,55.27,2019,87825
201,23,52,276,72.83,8.33,18.84,2019,87006
154,15,149,318,48.43,4.72,46.86,2019,87014
470,46,596,1112,42.27,4.14,53.6,2019,87026
387,35,203,625,61.92,5.6,32.48,2019,87036
38,18,126,182,20.88,9.89,69.23,2019,87037
913,181,167,1261,72.4,14.35,13.24,2019,87042
1029,54,17,1100,93.55,4.91,1.55,2019,87008
2608,120,1108,3836,67.99,3.13,28.88,2019,87020
10589,814,3724,15127,70.0,5.38,24.62,2019,87031
192,1,290,483,39.75,0.21,60.04,2019,87034
194,4,213,411,47.2,0.97,51.82,2019,87053
14184,490,2564,17238,82.28,2.84,14.87,2019,87110
366,40,223,629,58.19,6.36,35.45,2019,87535
0,0,0,0,,,,2019,87518
586,0,517,1103,53.13,0.0,46.87,2019,87522
0,0,35,35,0.0,0.0,100.0,2019,87524
680,7,238,925,73.51,0.76,25.73,2019,87537
334,0,50,384,86.98,0.0,13.02,2019,87540
442,18,414,874,50.57,2.06,47.37,2019,87001
19,0,8,27,70.37,0.0,29.63,2019,87011
43,0,116,159,27.04,0.0,72.96,2019,87018
105,0,75,180,58.33,0.0,41.67,2019,87023
77,0,82,159,48.43,0.0,51.57,2019,87027
83,0,14,97,85.57,0.0,14.43,2019,87044
230,0,156,386,59.59,0.0,40.41,2019,87049
87,25,78,190,45.79,13.16,41.05,2019,87061
6208,423,2497,9128,68.01,4.63,27.36,2019,87102
9434,356,1620,11410,82.68,3.12,14.2,2019,87106
4855,314,630,5799,83.72,5.41,10.86,2019,87113
18078,518,2286,20882,86.57,2.48,10.95,2019,87124
42,2,125,169,24.85,1.18,73.96,2019,87320
392,75,393,860,45.58,8.72,45.7,2019,87321
11857,697,3338,15892,74.61,4.39,21.0,2019,87401
93,0,80,173,53.76,0.0,46.24,2019,87419
67,18,338,423,15.84,4.26,79.91,2019,87461
229,10,154,393,58.27,2.54,39.19,2019,87510
71,0,122,193,36.79,0.0,63.21,2019,87519
396,47,332,775,51.1,6.06,42.84,2019,87528
29,0,64,93,31.18,0.0,68.82,2019,89161
7159,469,232,7860,91.08,5.97,2.95,2019,89166
5971,794,2713,9478,63.0,8.38,28.62,2019,89169
12859,217,490,13566,94.79,1.6,3.61,2019,89178
2169,97,98,2364,91.75,4.1,4.15,2019,89179
12957,404,1102,14463,89.59,2.79,7.62,2019,89183
29,0,60,89,32.58,0.0,67.42,2019,87017
144,14,120,278,51.8,5.04,43.17,2019,87041
312,25,85,422,73.93,5.92,20.14,2019,87056
48,0,43,91,52.75,0.0,47.25,2019,87832
639,47,382,1068,59.83,4.4,35.77,2019,87937
42,0,54,96,43.75,0.0,56.25,2019,87943
3885,88,510,4483,86.66,1.96,11.38,2019,87059
210,6,47,263,79.85,2.28,17.87,2019,87083
4442,124,1256,5822,76.3,2.13,21.57,2019,87104
14127,1028,4988,20143,70.13,5.1,24.76,2019,87105
14608,649,2824,18081,80.79,3.59,15.62,2019,87112
1249,0,15,1264,98.81,0.0,1.19,2019,87116
21134,561,2476,24171,87.44,2.32,10.24,2019,87120
552,47,970,1569,35.18,3.0,61.82,2019,87013
708,9,408,1125,62.93,0.8,36.27,2019,87016
154,6,134,294,52.38,2.04,45.58,2019,87022
215,0,296,511,42.07,0.0,57.93,2019,87024
475,17,127,619,76.74,2.75,20.52,2019,87025
57,9,100,166,34.34,5.42,60.24,2019,87038
3605,43,252,3900,92.44,1.1,6.46,2019,87048
9093,589,2932,12614,72.09,4.67,23.24,2019,87107
11276,790,4573,16639,67.77,4.75,27.48,2019,87108
21968,928,2696,25592,85.84,3.63,10.53,2019,87114
15,0,62,77,19.48,0.0,80.52,2019,87315
4949,359,1160,6468,76.52,5.55,17.93,2019,87410
587,81,837,1505,39.0,5.38,55.61,2019,87416
122,4,206,332,36.75,1.2,62.05,2019,87521
1165,46,323,1534,75.95,3.0,21.06,2019,87529
122,20,101,243,50.21,8.23,41.56,2019,87569
19,0,0,19,100.0,0.0,0.0,2019,87581
45,0,0,45,100.0,0.0,0.0,2019,88254
347,22,50,419,82.82,5.25,11.93,2019,88267
30,0,43,73,41.1,0.0,58.9,2019,88321
10948,644,1177,12769,85.74,5.04,9.22,2019,88011
199,23,32,254,78.35,9.06,12.6,2019,88020
5397,234,2804,8435,63.98,2.77,33.24,2019,88030
483,0,273,756,63.89,0.0,36.11,2019,88047
8458,354,1421,10233,82.65,3.46,13.89,2019,88012
235,8,226,469,50.11,1.71,48.19,2019,88029
0,0,0,0,,,,2019,88033
659,56,475,1190,55.38,4.71,39.92,2019,88044
63,0,18,81,77.78,0.0,22.22,2019,88112
2145,179,693,3017,71.1,5.93,22.97,2019,85004
6700,362,2293,9355,71.62,3.87,24.51,2019,85006
12948,545,2353,15846,81.71,3.44,14.85,2019,85020
13440,418,2237,16095,83.5,2.6,13.9,2019,85033
8576,251,704,9531,89.98,2.63,7.39,2019,85304
1584,89,347,2020,78.42,4.41,17.18,2019,85356
2007,41,443,2491,80.57,1.65,17.78,2019,85363
7646,249,1015,8910,85.81,2.79,11.39,2019,85373
8089,131,862,9082,89.07,1.44,9.49,2019,85381
145,3,98,246,58.94,1.22,39.84,2019,85605
370,2,128,500,74.0,0.4,25.6,2019,85606
5377,112,351,5840,92.07,1.92,6.01,2019,92587
1362,174,126,1662,81.95,10.47,7.58,2019,92590
18092,80,805,18977,95.34,0.42,4.24,2019,92620
19224,248,1334,20806,92.4,1.19,6.41,2019,92630
3905,0,0,3905,100.0,0.0,0.0,2019,92657
14186,129,747,15062,94.18,0.86,4.96,2019,92660
17262,284,1434,18980,90.95,1.5,7.56,2019,93063
603,19,280,902,66.85,2.11,31.04,2019,93205
91,3,62,156,58.33,1.92,39.74,2019,93224
31,3,39,73,42.47,4.11,53.42,2019,93226
2042,82,552,2676,76.31,3.06,20.63,2019,93240
25,0,43,68,36.76,0.0,63.24,2019,93251
1255,225,256,1736,72.29,12.96,14.75,2019,93265
27,0,1,28,96.43,0.0,3.57,2019,93287
18262,746,2423,21431,85.21,3.48,11.31,2019,93309
13156,334,1034,14524,90.58,2.3,7.12,2019,93311
2071,58,151,2280,90.83,2.54,6.62,2019,93427
14994,398,2108,17500,85.68,2.27,12.05,2019,93446
1176,45,191,1412,83.29,3.19,13.53,2019,93451
243,9,54,306,79.41,2.94,17.65,2019,93254
978,0,263,1241,78.81,0.0,21.19,2019,93285
2077,120,664,2861,72.6,4.19,23.21,2019,93286
18449,248,919,19616,94.05,1.26,4.68,2019,93312
4212,62,269,4543,92.71,1.36,5.92,2019,93109
5680,164,322,6166,92.12,2.66,5.22,2019,93111
178,0,232,410,43.41,0.0,56.59,2019,93201
3756,103,966,4825,77.84,2.13,20.02,2019,93221
18307,615,3282,22204,82.45,2.77,14.78,2019,93230
11015,375,871,12261,89.84,3.06,7.1,2019,93401
83,2,29,114,72.81,1.75,25.44,2019,93207
366,43,145,554,66.06,7.76,26.17,2019,93544
20683,624,3438,24745,83.58,2.52,13.89,2019,93727
1819,67,603,2489,73.08,2.69,24.23,2019,93204
243,53,96,392,61.99,13.52,24.49,2019,93238
232,0,75,307,75.57,0.0,24.43,2019,93266
2586,50,204,2840,91.06,1.76,7.18,2019,93428
1731,31,268,2030,85.27,1.53,13.2,2019,93434
445,0,122,567,78.48,0.0,21.52,2019,93440
16314,844,4176,21334,76.47,3.96,19.57,2019,93535
2392,33,183,2608,91.72,1.27,7.02,2019,93510
619,35,82,736,84.1,4.76,11.14,2019,93513
213,0,54,267,79.78,0.0,20.22,2019,93517
3060,132,506,3698,82.75,3.57,13.68,2019,93543
10755,380,1851,12986,82.82,2.93,14.25,2019,93555
224,0,45,269,83.27,0.0,16.73,2019,93604
4060,277,410,4747,85.53,5.84,8.64,2019,93614
1939,125,443,2507,77.34,4.99,17.67,2019,93625
4266,108,999,5373,79.4,2.01,18.59,2019,93630
4612,95,680,5387,85.61,1.76,12.62,2019,93631
10157,155,2048,12360,82.18,1.25,16.57,2019,93637
44,0,84,128,34.38,0.0,65.62,2019,93641
1064,11,168,1243,85.6,0.88,13.52,2019,93643
1740,66,471,2277,76.42,2.9,20.69,2019,93926
10907,367,1051,12325,88.49,2.98,8.53,2019,90242
11996,238,908,13142,91.28,1.81,6.91,2019,90620
4515,15,315,4845,93.19,0.31,6.5,2019,90623
14556,420,828,15804,92.1,2.66,5.24,2019,90630
8309,66,736,9111,91.2,0.72,8.08,2019,90713
5280,174,564,6018,87.74,2.89,9.37,2019,90715
16217,289,1026,17532,92.5,1.65,5.85,2019,92078
19063,346,1637,21046,90.58,1.64,7.78,2019,92117
11751,109,578,12438,94.48,0.88,4.65,2019,92123
9241,111,998,10350,89.29,1.07,9.64,2019,92139
6214,333,1400,7947,78.19,4.19,17.62,2019,92173
14865,628,1375,16868,88.13,3.72,8.15,2019,92223
343,3,67,413,83.05,0.73,16.22,2019,51466
1135,92,186,1413,80.33,6.51,13.16,2019,51510
637,15,125,777,81.98,1.93,16.09,2019,51521
384,17,76,477,80.5,3.56,15.93,2019,51525
145,7,46,198,73.23,3.54,23.23,2019,51527
253,20,38,311,81.35,6.43,12.22,2019,51532
351,22,40,413,84.99,5.33,9.69,2019,51542
151,5,38,194,77.84,2.58,19.59,2019,51548
83,15,31,129,64.34,11.63,24.03,2019,51552
527,21,110,658,80.09,3.19,16.72,2019,51559
671,13,98,782,85.81,1.66,12.53,2019,51560
1973,55,399,2427,81.29,2.27,16.44,2019,51601
285,10,79,374,76.2,2.67,21.12,2019,51646
134,2,42,178,75.28,1.12,23.6,2019,51010
2968,65,366,3399,87.32,1.91,10.77,2019,51534
149,1,53,203,73.4,0.49,26.11,2019,51558
225,31,33,289,77.85,10.73,11.42,2019,51544
77,0,11,88,87.5,0.0,12.5,2019,51554
137,18,40,195,70.26,9.23,20.51,2019,51556
2273,106,565,2944,77.21,3.6,19.19,2019,51566
364,20,60,444,81.98,4.5,13.51,2019,51570
325,5,93,423,76.83,1.18,21.99,2019,51004
546,9,70,625,87.36,1.44,11.2,2019,51526
208,4,23,235,88.51,1.7,9.79,2019,51549
230,8,36,274,83.94,2.92,13.14,2019,51563
509,16,58,583,87.31,2.74,9.95,2019,51575
627,35,80,742,84.5,4.72,10.78,2019,51576
1260,23,125,1408,89.49,1.63,8.88,2019,51246
1548,23,193,1764,87.76,1.3,10.94,2019,51247
165,3,29,197,83.76,1.52,14.72,2019,51433
285,19,33,337,84.57,5.64,9.79,2019,51436
105,4,61,170,61.76,2.35,35.88,2019,51441
588,6,129,723,81.33,0.83,17.84,2019,51450
247,4,50,301,82.06,1.33,16.61,2019,51453
711,61,219,991,71.75,6.16,22.1,2019,51455
404,22,61,487,82.96,4.52,12.53,2019,51462
11893,672,2069,14634,81.27,4.59,14.14,2019,51503
153,0,12,165,92.73,0.0,7.27,2019,51523
266,5,64,335,79.4,1.49,19.1,2019,51528
552,32,189,773,71.41,4.14,24.45,2019,51529
606,23,154,783,77.39,2.94,19.67,2019,51535
594,39,51,684,86.84,5.7,7.46,2019,51551
417,12,72,501,83.23,2.4,14.37,2019,51238
2265,35,567,2867,79.0,1.22,19.78,2019,51012
693,27,63,783,88.51,3.45,8.05,2019,51024
700,35,106,841,83.23,4.16,12.6,2019,51025
644,20,143,807,79.8,2.48,17.72,2019,51035
319,16,60,395,80.76,4.05,15.19,2019,51058
4516,329,1035,5880,76.8,5.6,17.6,2019,51103
1628,67,288,1983,82.1,3.38,14.52,2019,51108
124,4,18,146,84.93,2.74,12.33,2019,51231
283,6,41,330,85.76,1.82,12.42,2019,51232
468,8,37,513,91.23,1.56,7.21,2019,51234
726,23,287,1036,70.08,2.22,27.7,2019,54747
1074,24,282,1380,77.83,1.74,20.43,2019,54757
1033,52,425,1510,68.41,3.44,28.15,2019,54771
194,20,46,260,74.62,7.69,17.69,2019,54813
2323,39,337,2699,86.07,1.44,12.49,2019,54011
998,75,255,1328,75.15,5.65,19.2,2019,54013
69,0,11,80,86.25,0.0,13.75,2019,89319
8,0,0,8,100.0,0.0,0.0,2019,89402
0,17,27,44,0.0,38.64,61.36,2019,89412
10,0,33,43,23.26,0.0,76.74,2019,89438
4157,171,223,4551,91.34,3.76,4.9,2019,89441
0,0,0,0,,,,2019,89446
24,0,0,24,100.0,0.0,0.0,2019,89450
4760,96,604,5460,87.18,1.76,11.06,2019,89460
4294,92,330,4716,91.05,1.95,7.0,2019,89508
3485,107,132,3724,93.58,2.87,3.54,2019,89519
11723,266,672,12661,92.59,2.1,5.31,2019,89521
0,0,0,0,,,,2019,89702
259,0,212,471,54.99,0.0,45.01,2019,89003
371,25,47,443,83.75,5.64,10.61,2019,89042
227,48,64,339,66.96,14.16,18.88,2019,94933
12515,243,532,13290,94.17,1.83,4.0,2019,94941
116,0,0,116,100.0,0.0,0.0,2019,94971
0,0,13,13,0.0,0.0,100.0,2019,94972
501,14,20,535,93.64,2.62,3.74,2019,94924
5026,129,204,5359,93.79,2.41,3.81,2019,94920
6897,165,471,7533,91.56,2.19,6.25,2019,94949
449,25,169,643,69.83,3.89,26.28,2019,94956
9560,104,659,10323,92.61,1.01,6.38,2019,94002
13372,352,668,14392,92.91,2.45,4.64,2019,94107
28218,989,4325,33532,84.15,2.95,12.9,2019,94109
15045,352,1665,17062,88.18,2.06,9.76,2019,94115
9543,199,1477,11219,85.06,1.77,13.17,2019,94124
501,37,68,606,82.67,6.11,11.22,2019,94130
9636,456,2889,12981,74.23,3.51,22.26,2019,94133
4657,113,196,4966,93.78,2.28,3.95,2019,94502
4966,18,257,5241,94.75,0.34,4.9,2019,94507
390,17,44,451,86.47,3.77,9.76,2019,94514
13126,147,687,13960,94.03,1.05,4.92,2019,94523
16198,156,468,16822,96.29,0.93,2.78,2019,94539
20040,340,2540,22920,87.43,1.48,11.08,2019,94544
1621,0,271,1892,85.68,0.0,14.32,2019,94005
6893,99,460,7452,92.5,1.33,6.17,2019,94019
7498,57,260,7815,95.94,0.73,3.33,2019,94024
7170,152,654,7976,89.89,1.91,8.2,2019,94030
860,0,168,1028,83.66,0.0,16.34,2019,94037
12229,868,2617,15714,77.82,5.52,16.65,2019,94103
104,43,73,220,47.27,19.55,33.18,2019,94104
7194,93,316,7603,94.62,1.22,4.16,2019,94127
0,0,0,0,,,,2019,94128
1248,15,30,1293,96.52,1.16,2.32,2019,94129
22918,561,1973,25452,90.04,2.2,7.75,2019,94501
1294,90,75,1459,88.69,6.17,5.14,2019,94525
10359,17,476,10852,95.46,0.16,4.39,2019,94549
13069,104,874,14047,93.04,0.74,6.22,2019,94560
17811,163,686,18660,95.45,0.87,3.68,2019,94568
8017,260,818,9095,88.15,2.86,8.99,2019,94619
12245,420,1727,14392,85.08,2.92,12.0,2019,94804
3671,37,222,3930,93.41,0.94,5.65,2019,94925
5655,174,1090,6919,81.73,2.51,15.75,2019,89146
0,0,0,0,,,,2019,89404
44,0,0,44,100.0,0.0,0.0,2019,89405
278,0,7,285,97.54,0.0,2.46,2019,89411
77,0,0,77,100.0,0.0,0.0,2019,89414
61,14,50,125,48.8,11.2,40.0,2019,89422
8270,705,73,9048,91.4,7.79,0.81,2019,92694
17237,411,2370,20018,86.11,2.05,11.84,2019,92704
12172,93,679,12944,94.04,0.72,5.25,2019,92867
16822,30,532,17384,96.77,0.17,3.06,2019,92880
15941,248,627,16816,94.8,1.47,3.73,2019,92886
18074,443,1097,19614,92.15,2.26,5.59,2019,92562
13303,246,963,14512,91.67,1.7,6.64,2019,92019
17269,284,2058,19611,88.06,1.45,10.49,2019,92805
7876,49,253,8178,96.31,0.6,3.09,2019,92596
16537,575,1435,18547,89.16,3.1,7.74,2019,92780
5977,35,223,6235,95.86,0.56,3.58,2019,92010
9042,100,283,9425,95.94,1.06,3.0,2019,92011
292,0,0,292,100.0,0.0,0.0,2019,92055
12927,307,803,14037,92.09,2.19,5.72,2019,92058
9775,32,473,10280,95.09,0.31,4.6,2019,92081
0,0,0,0,,,,2019,92132
0,0,0,0,,,,2019,92134
0,0,0,0,,,,2019,92135
0,0,0,0,,,,2019,92140
563,0,0,563,100.0,0.0,0.0,2019,92145
0,0,0,0,,,,2019,92147
0,0,0,0,,,,2019,92155
0,0,0,0,,,,2019,92222
316,0,15,331,95.47,0.0,4.53,2019,92322
5198,176,629,6003,86.59,2.93,10.48,2019,92344
94,0,0,94,100.0,0.0,0.0,2019,92378
71,17,0,88,80.68,19.32,0.0,2019,92385
671,76,62,809,82.94,9.39,7.66,2019,92391
11446,517,1483,13446,85.13,3.85,11.03,2019,92395
7086,72,43,7201,98.4,1.0,0.6,2019,92603
2400,1482,89,3971,60.44,37.32,2.24,2019,92617
8803,338,1862,11003,80.01,3.07,16.92,2019,92637
192,0,15,207,92.75,0.0,7.25,2019,92678
7431,159,530,8120,91.51,1.96,6.53,2019,92394
12392,501,2515,15408,80.43,3.25,16.32,2019,92544
2629,31,23,2683,97.99,1.16,0.86,2019,92067
1808,147,394,2349,76.97,6.26,16.77,2019,92250
0,0,6,6,0.0,0.0,100.0,2019,92364
11761,486,2395,14642,80.32,3.32,16.36,2019,92545
17766,283,898,18947,93.77,1.49,4.74,2019,92626
10894,221,1579,12694,85.82,1.74,12.44,2019,93001
5701,60,452,6213,91.76,0.97,7.28,2019,93013
6283,144,684,7111,88.36,2.03,9.62,2019,93041
11161,418,1521,13100,85.2,3.19,11.61,2019,93101
237,18,230,485,48.87,3.71,47.42,2019,93206
9834,140,1056,11030,89.16,1.27,9.57,2019,93004
11206,116,819,12141,92.3,0.96,6.75,2019,93021
2149,108,231,2488,86.37,4.34,9.28,2019,93022
702,25,107,834,84.17,3.0,12.83,2019,93222
941,119,740,1800,52.28,6.61,41.11,2019,93234
707,4,307,1018,69.45,0.39,30.16,2019,93242
3668,285,1460,5413,67.76,5.27,26.97,2019,93247
154,0,360,514,29.96,0.0,70.04,2019,93249
9824,134,617,10575,92.9,1.27,5.83,2019,91006
6139,34,261,6434,95.41,0.53,4.06,2019,91011
6644,57,1608,8309,79.96,0.69,19.35,2019,91201
9030,172,286,9488,95.17,1.81,3.01,2019,91302
5863,67,390,6320,92.77,1.06,6.17,2019,91901
5599,70,339,6008,93.19,1.17,5.64,2019,91902
598,0,234,832,71.88,0.0,28.12,2019,92230
9697,353,2684,12734,76.15,2.77,21.08,2019,92240
1904,10,983,2897,65.72,0.35,33.93,2019,92254
0,0,0,0,,,,2019,92280
3947,66,364,4377,90.18,1.51,8.32,2019,92313
5784,288,1433,7505,77.07,3.84,19.09,2019,92316
15169,456,2700,18325,82.78,2.49,14.73,2019,92324
6743,341,953,8037,83.9,4.24,11.86,2019,92354
4918,300,312,5530,88.93,5.42,5.64,2019,92377
14714,551,1781,17046,86.32,3.23,10.45,2019,92507
1816,40,400,2256,80.5,1.77,17.73,2019,92548
7056,159,722,7937,88.9,2.0,9.1,2019,92551
16163,339,1883,18385,87.91,1.84,10.24,2019,92553
2252,24,360,2636,85.43,0.91,13.66,2019,92567
11416,264,2103,13783,82.83,1.92,15.26,2019,92570
8916,252,517,9685,92.06,2.6,5.34,2019,92604
19586,371,1248,21205,92.37,1.75,5.89,2019,92646
1235,20,40,1295,95.37,1.54,3.09,2019,92662
24123,339,1088,25550,94.41,1.33,4.26,2019,92677
21880,432,2642,24954,87.68,1.73,10.59,2019,92804
12828,111,811,13750,93.29,0.81,5.9,2019,92821
6472,133,515,7120,90.9,1.87,7.23,2019,92860
4715,63,640,5418,87.02,1.16,11.81,2019,92866
12253,327,1675,14255,85.96,2.29,11.75,2019,92879
9062,497,463,10022,90.42,4.96,4.62,2019,92337
2410,4,184,2598,92.76,0.15,7.08,2019,92342
21332,502,2112,23946,89.08,2.1,8.82,2019,92345
14497,1085,2165,17747,81.69,6.11,12.2,2019,92346
188,0,100,288,65.28,0.0,34.72,2019,92347
2639,156,302,3097,85.21,5.04,9.75,2019,92359
15958,3092,2365,21415,74.52,14.44,11.04,2019,92376
15640,494,2313,18447,84.78,2.68,12.54,2019,92399
6445,1094,1200,8739,73.75,12.52,13.73,2019,92405
8292,1450,2917,12659,65.5,11.45,23.04,2019,92410
21758,385,2913,25056,86.84,1.54,11.63,2019,92503
6644,155,342,7141,93.04,2.17,4.79,2019,92532
10256,135,482,10873,94.33,1.24,4.43,2019,92555
10610,85,813,11508,92.2,0.74,7.06,2019,92869
10722,228,198,11148,96.18,2.05,1.78,2019,92124
4288,128,1534,5950,72.07,2.15,25.78,2019,92225
6798,239,1996,9033,75.26,2.65,22.1,2019,92231
15592,408,2816,18816,82.87,2.17,14.97,2019,92234
14399,303,1113,15815,91.05,1.92,7.04,2019,92253
50,0,21,71,70.42,0.0,29.58,2019,92259
11672,351,1435,13458,86.73,2.61,10.66,2019,92262
332,50,122,504,65.87,9.92,24.21,2019,92273
618,34,293,945,65.4,3.6,31.01,2019,92275
9018,165,1390,10573,85.29,1.56,13.15,2019,92284
869,24,185,1078,80.61,2.23,17.16,2019,92285
44,0,0,44,100.0,0.0,0.0,2019,92332
14944,372,1632,16948,88.18,2.19,9.63,2019,92026
43,0,17,60,71.67,0.0,28.33,2019,95595
14224,330,1831,16385,86.81,2.01,11.17,2019,95621
11543,369,600,12512,92.26,2.95,4.8,2019,85143
1100,76,23,1199,91.74,6.34,1.92,2019,85145
389,47,734,1170,33.25,4.02,62.74,2019,85147
370,42,75,487,75.98,8.62,15.4,2019,85172
760,55,481,1296,58.64,4.24,37.11,2019,85173
466,96,254,816,57.11,11.76,31.13,2019,85192
535,32,34,601,89.02,5.32,5.66,2019,54082
1062,26,306,1394,76.18,1.87,21.95,2019,54126
371,4,112,487,76.18,0.82,23.0,2019,54137
990,54,220,1264,78.32,4.27,17.41,2019,54139
422,14,149,585,72.14,2.39,25.47,2019,54149
1297,21,51,1369,94.74,1.53,3.73,2019,54171
1712,0,19,1731,98.9,0.0,1.1,2019,54173
969,61,319,1349,71.83,4.52,23.65,2019,54177
531,6,119,656,80.95,0.91,18.14,2019,54227
889,40,232,1161,76.57,3.45,19.98,2019,54228
711,37,116,864,82.29,4.28,13.43,2019,54234
1327,21,294,1642,80.82,1.28,17.9,2019,54426
505,27,209,741,68.15,3.64,28.21,2019,54433
873,30,202,1105,79.0,2.71,18.28,2019,54446
146,2,67,215,67.91,0.93,31.16,2019,54447
409,36,155,600,68.17,6.0,25.83,2019,54648
666,32,232,930,71.61,3.44,24.95,2019,54004
2241,43,314,2598,86.26,1.66,12.09,2019,54025
737,14,68,819,89.99,1.71,8.3,2019,54026
984,65,165,1214,81.05,5.35,13.59,2019,54814
351,20,64,435,80.69,4.6,14.71,2019,54820
1211,58,278,1547,78.28,3.75,17.97,2019,54830
4276,185,957,5418,78.92,3.41,17.66,2019,54843
317,11,39,367,86.38,3.0,10.63,2019,54854
934,52,258,1244,75.08,4.18,20.74,2019,54872
522,23,89,634,82.33,3.63,14.04,2019,54888
805,67,262,1134,70.99,5.91,23.1,2019,54889
1280,45,187,1512,84.66,2.98,12.37,2019,54891
545,39,204,788,69.16,4.95,25.89,2019,54896
795,11,241,1047,75.93,1.05,23.02,2019,54135
3552,67,484,4103,86.57,1.63,11.8,2019,54140
5622,250,1050,6922,81.22,3.61,15.17,2019,54143
1154,60,258,1472,78.4,4.08,17.53,2019,54151
2758,82,230,3070,89.84,2.67,7.49,2019,54155
2970,41,460,3471,85.57,1.18,13.25,2019,54162
2017,39,375,2431,82.97,1.6,15.43,2019,54208
540,18,73,631,85.58,2.85,11.57,2019,54209
94,7,23,124,75.81,5.65,18.55,2019,54214
10325,278,2056,12659,81.56,2.2,16.24,2019,54302
12307,578,1245,14130,87.1,4.09,8.81,2019,54311
8592,237,1581,10410,82.54,2.28,15.19,2019,54403
1200,32,181,1413,84.93,2.26,12.81,2019,54406
1338,49,565,1952,68.55,2.51,28.94,2019,54411
508,21,146,675,75.26,3.11,21.63,2019,54416
356,10,108,474,75.11,2.11,22.78,2019,54420
341,9,86,436,78.21,2.06,19.72,2019,54442
6201,223,849,7273,85.26,3.07,11.67,2019,54455
628,17,326,971,64.68,1.75,33.57,2019,54460
135,8,22,165,81.82,4.85,13.33,2019,54485
580,17,181,778,74.55,2.19,23.26,2019,54491
416,28,92,536,77.61,5.22,17.16,2019,54511
159,5,31,195,81.54,2.56,15.9,2019,54513
170,4,55,229,74.24,1.75,24.02,2019,54515
4656,134,1292,6082,76.55,2.2,21.24,2019,56345
1889,83,785,2757,68.52,3.01,28.47,2019,56347
161,5,45,211,76.3,2.37,21.33,2019,56350
86,8,50,144,59.72,5.56,34.72,2019,56641
53,5,9,67,79.1,7.46,13.43,2019,56654
122,0,32,154,79.22,0.0,20.78,2019,56657
2328,82,533,2943,79.1,2.79,18.11,2019,89429
1747,307,364,2418,72.25,12.7,15.05,2019,89501
130,28,43,201,64.68,13.93,21.39,2019,92309
8072,822,2535,11429,70.63,7.19,22.18,2019,92311
335,6,72,413,81.11,1.45,17.43,2019,92339
95,10,11,116,81.9,8.62,9.48,2019,92341
281,7,96,384,73.18,1.82,25.0,2019,92358
13638,1303,2907,17848,76.41,7.3,16.29,2019,92404
14566,1566,1276,17408,83.67,9.0,7.33,2019,92407
558,2,68,628,88.85,0.32,10.83,2019,92561
10089,250,565,10904,92.53,2.29,5.18,2019,92651
9532,130,646,10308,92.47,1.26,6.27,2019,92653
18485,149,610,19244,96.06,0.77,3.17,2019,92656
16400,191,830,17421,94.14,1.1,4.76,2019,92692
11198,291,2086,13575,82.49,2.14,15.37,2019,92703
7793,77,110,7980,97.66,0.96,1.38,2019,92782
16017,306,1598,17921,89.38,1.71,8.92,2019,92801
11730,178,529,12437,94.32,1.43,4.25,2019,92807
11668,133,637,12438,93.81,1.07,5.12,2019,92831
7329,184,809,8322,88.07,2.21,9.72,2019,92832
14911,335,1064,16310,91.42,2.05,6.52,2019,92833
5075,94,395,5564,91.21,1.69,7.1,2019,92845
12073,167,759,12999,92.88,1.28,5.84,2019,92612
9735,152,210,10097,96.41,1.51,2.08,2019,92614
19891,460,1908,22259,89.36,2.07,8.57,2019,92627
18599,476,2377,21452,86.7,2.22,11.08,2019,92647
17452,349,1739,19540,89.31,1.79,8.9,2019,92648
1950,46,426,2422,80.51,1.9,17.59,2019,92655
9160,230,682,10072,90.95,2.28,6.77,2019,92663
786,11,30,827,95.04,1.33,3.63,2019,92676
11904,377,1520,13801,86.25,2.73,11.01,2019,92707
8139,131,1114,9384,86.73,1.4,11.87,2019,92841
5955,101,657,6713,88.71,1.5,9.79,2019,92844
1928,0,47,1975,97.62,0.0,2.38,2019,92861
5887,206,313,6406,91.9,3.22,4.89,2019,92865
7230,125,706,8061,89.69,1.55,8.76,2019,92868
15944,216,404,16564,96.26,1.3,2.44,2019,92009
5572,80,99,5751,96.89,1.39,1.72,2019,92014
6605,150,251,7006,94.28,2.14,3.58,2019,92029
18155,275,1130,19560,92.82,1.41,5.78,2019,92057
562,2,208,772,72.8,0.26,26.94,2019,92061
5278,162,552,5992,88.08,2.7,9.21,2019,92082
12261,476,2020,14757,83.09,3.23,13.69,2019,92102
11747,93,140,11980,98.06,0.78,1.17,2019,92131
11121,213,568,11902,93.44,1.79,4.77,2019,92203
94,0,0,94,100.0,0.0,0.0,2019,92239
116,0,100,216,53.7,0.0,46.3,2019,92258
165,19,73,257,64.2,7.39,28.4,2019,92268
516,7,169,692,74.57,1.01,24.42,2019,92281
1975,99,107,2181,90.55,4.54,4.91,2019,92352
173,8,109,290,59.66,2.76,37.59,2019,92368
11017,421,1274,12712,86.67,3.31,10.02,2019,92373
11735,306,1880,13921,84.3,2.2,13.5,2019,92374
15060,398,1198,16656,90.42,2.39,7.19,2019,80401
782,0,232,1014,77.12,0.0,22.88,2019,80459
14079,521,2312,16912,83.25,3.08,13.67,2019,80501
1726,54,148,1928,89.52,2.8,7.68,2019,80514
1535,34,105,1674,91.7,2.03,6.27,2019,80530
20004,490,2138,22632,88.39,2.17,9.45,2019,80634
176,0,33,209,84.21,0.0,15.79,2019,91934
4423,25,173,4621,95.72,0.54,3.74,2019,91914
538,49,79,666,80.78,7.36,11.86,2019,91916
8188,242,1117,9547,85.77,2.53,11.7,2019,91932
2652,101,195,2948,89.96,3.43,6.61,2019,91935
12919,299,3745,16963,76.16,1.76,22.08,2019,91950
6287,45,222,6554,95.93,0.69,3.39,2019,91381
6805,67,219,7091,95.97,0.94,3.09,2019,91384
15245,874,2127,18246,83.55,4.79,11.66,2019,91405
11193,695,1014,12902,86.75,5.39,7.86,2019,91505
12016,427,1164,13607,88.31,3.14,8.55,2019,91607
12028,161,871,13060,92.1,1.23,6.67,2019,91701
8577,155,1109,9841,87.16,1.58,11.27,2019,91722
12383,179,996,13558,91.33,1.32,7.35,2019,91748
14993,634,1708,17335,86.49,3.66,9.85,2019,91761
9660,134,1593,11387,84.83,1.18,13.99,2019,91773
8562,137,324,9023,94.89,1.52,3.59,2019,91784
364,87,134,585,62.22,14.87,22.91,2019,91905
20903,552,3487,24942,83.81,2.21,13.98,2019,91910
15736,442,1330,17508,89.88,2.52,7.6,2019,91304
8902,208,902,10012,88.91,2.08,9.01,2019,91324
21280,686,2425,24391,87.25,2.81,9.94,2019,91335
21580,301,3240,25121,85.9,1.2,12.9,2019,91342
15577,214,2244,18035,86.37,1.19,12.44,2019,91343
5197,96,212,5505,94.41,1.74,3.85,2019,91105
12320,248,1750,14318,86.05,1.73,12.22,2019,91016
4310,32,240,4582,94.06,0.7,5.24,2019,91108
5073,39,1373,6485,78.23,0.6,21.17,2019,91204
8705,436,956,10097,86.21,4.32,9.47,2019,91303
13190,300,1164,14654,90.01,2.05,7.94,2019,91306
18722,545,4180,23447,79.85,2.32,17.83,2019,91331
13849,191,601,14641,94.59,1.3,4.1,2019,91604
10,0,0,10,100.0,0.0,0.0,2019,91608
12595,412,2495,15502,81.25,2.66,16.09,2019,91702
4070,219,375,4664,87.26,4.7,8.04,2019,91024
9237,435,993,10665,86.61,4.08,9.31,2019,91106
11345,230,891,12466,91.01,1.85,7.15,2019,91107
10884,161,664,11709,92.95,1.38,5.67,2019,91355
12701,258,1974,14933,85.05,1.73,13.22,2019,91401
15653,774,1971,18398,85.08,4.21,10.71,2019,91406
14244,188,653,15085,94.42,1.25,4.33,2019,91423
3606,265,1200,5071,71.11,5.23,23.66,2019,91502
9078,259,476,9813,92.51,2.64,4.85,2019,91602
15608,270,2450,18328,85.16,1.47,13.37,2019,91706
20387,397,1974,22758,89.58,1.74,8.67,2019,91710
11065,176,756,11997,92.23,1.47,6.3,2019,91711
973,25,313,1311,74.22,1.91,23.87,2019,91906
14600,118,470,15188,96.13,0.78,3.09,2019,91913
14752,171,1382,16305,90.48,1.05,8.48,2019,91942
37,0,0,37,100.0,0.0,0.0,2019,91948
575,72,50,697,82.5,10.33,7.17,2019,91962
3188,20,161,3369,94.63,0.59,4.78,2019,91978
11156,285,1228,12669,88.06,2.25,9.69,2019,91001
2257,43,833,3133,72.04,1.37,26.59,2019,82201
377,15,129,521,72.36,2.88,24.76,2019,82214
56,1,59,116,48.28,0.86,50.86,2019,82324
1631,78,372,2081,78.38,3.75,17.88,2019,82443
158,0,0,158,100.0,0.0,0.0,2019,82925
9007,447,1462,10916,82.51,4.09,13.39,2019,82604
1685,77,93,1855,90.84,4.15,5.01,2019,94951
17857,322,1764,19943,89.54,1.61,8.85,2019,94806
11013,312,1023,12348,89.19,2.53,8.28,2019,94903
3425,21,320,3766,90.95,0.56,8.5,2019,94930
12498,266,1017,13781,90.69,1.93,7.38,2019,94954
175,15,82,272,64.34,5.51,30.15,2019,93932
1582,62,98,1742,90.82,3.56,5.63,2019,93953
17270,406,1571,19247,89.73,2.11,8.16,2019,93003
6745,259,761,7765,86.86,3.34,9.8,2019,93023
6828,172,749,7749,88.11,2.22,9.67,2019,93103
3652,210,190,4052,90.13,5.18,4.69,2019,93108
509,16,71,596,85.4,2.68,11.91,2019,93601
69,0,16,85,81.18,0.0,18.82,2019,93603
16,0,0,16,100.0,0.0,0.0,2019,93928
10761,229,1223,12213,88.11,1.88,10.01,2019,93245
3876,66,271,4213,92.0,1.57,6.43,2019,93449
69,0,0,69,100.0,0.0,0.0,2019,93628
68,0,74,142,47.89,0.0,52.11,2019,93652
13220,225,3772,17217,76.78,1.31,21.91,2019,93033
11237,174,1663,13074,85.95,1.33,12.72,2019,93036
0,0,0,0,,,,2019,93042
12,0,0,12,100.0,0.0,0.0,2019,93043
0,0,0,0,,,,2019,93064
0,0,65,65,0.0,0.0,100.0,2019,93220
393,15,142,550,71.45,2.73,25.82,2019,93258
8538,239,440,9217,92.63,2.59,4.77,2019,93314
0,0,0,0,,,,2019,93410
0,0,0,0,,,,2019,93519
0,0,0,0,,,,2019,93524
0,0,16,16,0.0,0.0,100.0,2019,93558
37,0,34,71,52.11,0.0,47.89,2019,93592
12080,167,784,13031,92.7,1.28,6.02,2019,93619
0,0,0,0,,,,2019,93633
3747,83,455,4285,87.44,1.94,10.62,2019,93636
3172,78,656,3906,81.21,2.0,16.79,2019,93723
4055,92,307,4454,91.04,2.07,6.89,2019,93730
0,0,0,0,,,,2019,93943
882,14,292,1188,74.24,1.18,24.58,2019,93235
629,66,291,986,63.79,6.69,29.51,2019,93283
405,17,57,479,84.55,3.55,11.9,2019,93426
529,0,243,772,68.52,0.0,31.48,2019,93545
52,0,0,52,100.0,0.0,0.0,2019,93623
14480,257,1086,15823,91.51,1.62,6.86,2019,93611
15568,218,2295,18081,86.1,1.21,12.69,2019,92114
18444,568,2191,21203,86.99,2.68,10.33,2019,92115
11021,193,541,11755,93.76,1.64,4.6,2019,92120
19077,187,693,19957,95.59,0.94,3.47,2019,92122
19542,410,2497,22449,87.05,1.83,11.12,2019,92154
9158,640,2121,11919,76.84,5.37,17.8,2019,92220
606,48,273,927,65.37,5.18,29.45,2019,92233
2684,73,2279,5036,53.3,1.45,45.25,2019,92274
12265,319,1541,14125,86.83,2.26,10.91,2019,92308
9247,207,1193,10647,86.85,1.94,11.21,2019,94063
296,7,26,329,89.97,2.13,7.9,2019,80653
936,31,207,1174,79.73,2.64,17.63,2019,80734
79,2,14,95,83.16,2.11,14.74,2019,80742
131,1,29,161,81.37,0.62,18.01,2019,80825
128,2,47,177,72.32,1.13,26.55,2019,80744
19,0,14,33,57.58,0.0,42.42,2019,80755
80,8,44,132,60.61,6.06,33.33,2019,73761
106,8,38,152,69.74,5.26,25.0,2019,73771
310,12,101,423,73.29,2.84,23.88,2019,73832
222,20,96,338,65.68,5.92,28.4,2019,73843
621,8,143,772,80.44,1.04,18.52,2019,73852
146,4,31,181,80.66,2.21,17.13,2019,73853
443,36,157,636,69.65,5.66,24.69,2019,73858
367,21,123,511,71.82,4.11,24.07,2019,73860
929,36,201,1166,79.67,3.09,17.24,2019,77831
507,3,234,744,68.15,0.4,31.45,2019,77837
15252,3755,1402,20409,74.73,18.4,6.87,2019,77840
56,9,8,73,76.71,12.33,10.96,2019,77969
222,9,80,311,71.38,2.89,25.72,2019,77990
6950,303,2426,9679,71.8,3.13,25.06,2019,77016
9074,141,1719,10934,82.99,1.29,15.72,2019,77018
3916,149,1582,5647,69.35,2.64,28.01,2019,77029
13007,316,971,14294,91.0,2.21,6.79,2019,77044
4588,166,1287,6041,75.95,2.75,21.3,2019,77048
4111,262,2006,6379,64.45,4.11,31.45,2019,77051
11941,344,812,13097,91.17,2.63,6.2,2019,77054
5711,46,142,5899,96.81,0.78,2.41,2019,77059
8763,217,565,9545,91.81,2.27,5.92,2019,77062
9491,237,1076,10804,87.85,2.19,9.96,2019,77066
10567,257,2129,12953,81.58,1.98,16.44,2019,77075
3674,77,889,4640,79.18,1.66,19.16,2019,77078
4136,82,1056,5274,78.42,1.55,20.02,2019,77085
54,0,28,82,65.85,0.0,34.15,2019,77950
2127,33,787,2947,72.18,1.12,26.71,2019,77957
474,11,158,643,73.72,1.71,24.57,2019,77975
4905,101,1214,6220,78.86,1.62,19.52,2019,77979
104,14,38,156,66.67,8.97,24.36,2019,77988
440,64,331,835,52.69,7.66,39.64,2019,77482
2655,56,870,3581,74.14,1.56,24.29,2019,77484
2204,37,395,2636,83.61,1.4,14.98,2019,77486
8541,265,1892,10698,79.84,2.48,17.69,2019,77506
3082,33,431,3546,86.91,0.93,12.15,2019,77518
8839,717,2613,12169,72.64,5.89,21.47,2019,77520
8648,213,1785,10646,81.23,2.0,16.77,2019,77532
286,0,61,347,82.42,0.0,17.58,2019,77533
4933,331,1188,6452,76.46,5.13,18.41,2019,77541
41,0,2,43,95.35,0.0,4.65,2019,77561
3354,101,341,3796,88.36,2.66,8.98,2019,77565
408,2,128,538,75.84,0.37,23.79,2019,77577
8403,87,262,8752,96.01,0.99,2.99,2019,77586
9637,529,1078,11244,85.71,4.7,9.59,2019,77598
2367,192,808,3367,70.3,5.7,24.0,2019,77612
4739,76,886,5701,83.13,1.33,15.54,2019,77619
4038,192,448,4678,86.32,4.1,9.58,2019,77002
7260,112,2539,9911,73.25,1.13,25.62,2019,77091
14313,314,591,15218,94.05,2.06,3.88,2019,77024
17326,757,8417,26500,65.38,2.86,31.76,2019,77036
689,55,65,809,85.17,6.8,8.03,2019,77046
9620,143,1046,10809,89.0,1.32,9.68,2019,77049
6784,90,1826,8700,77.98,1.03,20.99,2019,77061
11489,383,1873,13745,83.59,2.79,13.63,2019,77073
6021,277,4084,10382,57.99,2.67,39.34,2019,77076
11503,126,646,12275,93.71,1.03,5.26,2019,77079
12899,240,2086,15225,84.72,1.58,13.7,2019,77080
8646,450,2013,11109,77.83,4.05,18.12,2019,77087
33,0,29,62,53.23,0.0,46.77,2019,62610
72,0,23,95,75.79,0.0,24.21,2019,62928
545,8,367,920,59.24,0.87,39.89,2019,62914
612,43,239,894,68.46,4.81,26.73,2019,62917
995,25,139,1159,85.85,2.16,11.99,2019,62924
377,20,179,576,65.45,3.47,31.08,2019,62931
4837,189,388,5414,89.34,3.49,7.17,2019,62034
1942,125,526,2593,74.89,4.82,20.29,2019,62049
2811,123,825,3759,74.78,3.27,21.95,2019,62056
32,0,13,45,71.11,0.0,28.89,2019,62065
647,12,262,921,70.25,1.3,28.45,2019,62080
56,0,9,65,86.15,0.0,13.85,2019,62083
286,27,247,560,51.07,4.82,44.11,2019,62090
1548,285,1141,2974,52.05,9.58,38.37,2019,62203
253,23,55,331,76.44,6.95,16.62,2019,62217
478,8,93,579,82.56,1.38,16.06,2019,62218
113,22,57,192,58.85,11.46,29.69,2019,75421
743,31,352,1126,65.99,2.75,31.26,2019,75453
3871,208,1313,5392,71.79,3.86,24.35,2019,75474
233,34,119,386,60.36,8.81,30.83,2019,75477
120,11,64,195,61.54,5.64,32.82,2019,75492
1332,92,542,1966,67.75,4.68,27.57,2019,75561
60,0,25,85,70.59,0.0,29.41,2019,75565
1158,48,448,1654,70.01,2.9,27.09,2019,75572
10607,173,1616,12396,85.57,1.4,13.04,2019,75605
630,15,449,1094,57.59,1.37,41.04,2019,75639
3318,192,2271,5781,57.39,3.32,39.28,2019,75670
1578,82,875,2535,62.25,3.23,34.52,2019,75684
1032,88,343,1463,70.54,6.02,23.44,2019,75692
1667,24,539,2230,74.75,1.08,24.17,2019,75708
844,163,348,1355,62.29,12.03,25.68,2019,75750
4,0,19,23,17.39,0.0,82.61,2019,75759
897,87,230,1214,73.89,7.17,18.95,2019,75778
23286,450,484,24220,96.14,1.86,2.0,2019,75035
10414,418,1549,12381,84.11,3.38,12.51,2019,75038
8643,356,3755,12754,67.77,2.79,29.44,2019,75051
11071,260,2487,13818,80.12,1.88,18.0,2019,75060
78,0,0,78,100.0,0.0,0.0,2019,75856
17287,176,328,17791,97.17,0.99,1.84,2019,75024
15763,163,336,16262,96.93,1.0,2.07,2019,75028
9640,92,428,10160,94.88,0.91,4.21,2019,75039
7639,274,1286,9199,83.04,2.98,13.98,2019,75041
18989,457,1642,21088,90.05,2.17,7.79,2019,75043
21165,414,958,22537,93.91,1.84,4.25,2019,75056
2839,181,302,3322,85.46,5.45,9.09,2019,75076
339,6,163,508,66.73,1.18,32.09,2019,75102
8207,56,147,8410,97.59,0.67,1.75,2019,75082
17930,172,700,18802,95.36,0.91,3.72,2019,75093
3933,331,1200,5464,71.98,6.06,21.96,2019,75103
5155,225,1194,6574,78.41,3.42,18.16,2019,75116
1153,26,308,1487,77.54,1.75,20.71,2019,75117
13466,290,524,14280,94.3,2.03,3.67,2019,75126
5467,145,347,5959,91.74,2.43,5.82,2019,79765
15702,312,2221,18235,86.11,1.71,12.18,2019,79109
286,10,80,376,76.06,2.66,21.28,2019,79225
712,35,374,1121,63.51,3.12,33.36,2019,79226
390,20,139,549,71.04,3.64,25.32,2019,79227
14,0,0,14,100.0,0.0,0.0,2019,79234
450,13,224,687,65.5,1.89,32.61,2019,79248
2,1,5,8,25.0,12.5,62.5,2019,79251
84,0,62,146,57.53,0.0,42.47,2019,79256
242,13,88,343,70.55,3.79,25.66,2019,79257
112,9,42,163,68.71,5.52,25.77,2019,79261
4658,169,1223,6050,76.99,2.79,20.21,2019,79336
1601,91,606,2298,69.67,3.96,26.37,2019,79339
22,0,10,32,68.75,0.0,31.25,2019,79344
60,13,19,92,65.22,14.13,20.65,2019,79781
20,0,15,35,57.14,0.0,42.86,2019,79785
4,0,0,4,100.0,0.0,0.0,2019,79831
694,27,233,954,72.75,2.83,24.42,2019,79843
3170,134,140,3444,92.04,3.89,4.07,2019,79124
44,0,14,58,75.86,0.0,24.14,2019,79062
21,0,0,21,100.0,0.0,0.0,2019,79091
128,4,71,203,63.05,1.97,34.98,2019,79237
220,26,57,303,72.61,8.58,18.81,2019,79244
523,35,252,810,64.57,4.32,31.11,2019,79346
425,23,94,542,78.41,4.24,17.34,2019,79351
76,10,14,100,76.0,10.0,14.0,2019,79749
38,0,23,61,62.3,0.0,37.7,2019,79755
5541,113,1360,7014,79.0,1.61,19.39,2019,79764
122,14,104,240,50.83,5.83,43.33,2019,79788
207,8,39,254,81.5,3.15,15.35,2019,79789
2666,37,660,3363,79.27,1.1,19.63,2019,79849
820,114,413,1347,60.88,8.46,30.66,2019,79782
164,4,49,217,75.58,1.84,22.58,2019,79851
118,11,41,170,69.41,6.47,24.12,2019,79010
1437,48,242,1727,83.21,2.78,14.01,2019,79036
494,7,119,620,79.68,1.13,19.19,2019,79355
1180,9,309,1498,78.77,0.6,20.63,2019,79356
1559,83,346,1988,78.42,4.18,17.4,2019,79363
5,0,9,14,35.71,0.0,64.29,2019,79376
6567,129,1006,7702,85.26,1.67,13.06,2019,79414
952,31,200,1183,80.47,2.62,16.91,2019,62288
1371,46,319,1736,78.97,2.65,18.38,2019,62293
606,4,202,812,74.63,0.49,24.88,2019,62312
70,1,34,105,66.67,0.95,32.38,2019,62319
714,26,154,894,79.87,2.91,17.23,2019,62691
351,12,62,425,82.59,2.82,14.59,2019,62803
639,13,116,768,83.2,1.69,15.1,2019,62814
629,22,177,828,75.97,2.66,21.38,2019,62824
54,2,29,85,63.53,2.35,34.12,2019,62825
2219,89,401,2709,81.91,3.29,14.8,2019,62839
218,19,51,288,75.69,6.6,17.71,2019,62848
487,25,132,644,75.62,3.88,20.5,2019,62854
150,5,71,226,66.37,2.21,31.42,2019,62860
186,36,54,276,67.39,13.04,19.57,2019,62871
799,23,184,1006,79.42,2.29,18.29,2019,62882
1983,56,184,2223,89.2,2.52,8.28,2019,62549
197,69,22,288,68.4,23.96,7.64,2019,62536
177,5,50,232,76.29,2.16,21.55,2019,62543
367,29,103,499,73.55,5.81,20.64,2019,62545
320,0,59,379,84.43,0.0,15.57,2019,80821
87,0,15,102,85.29,0.0,14.71,2019,80861
6101,230,1140,7471,81.66,3.08,15.26,2019,80905
12604,193,1235,14032,89.82,1.38,8.8,2019,80916
157,7,30,194,80.93,3.61,15.46,2019,80736
1472,18,286,1776,82.88,1.01,16.1,2019,80807
318,13,56,387,82.17,3.36,14.47,2019,80819
201,7,89,297,67.68,2.36,29.97,2019,80832
11394,266,1174,12834,88.78,2.07,9.15,2019,80907
10877,99,935,11911,91.32,0.83,7.85,2019,80911
426,34,94,554,76.9,6.14,16.97,2019,80926
10281,397,439,11117,92.48,3.57,3.95,2019,80303
342,8,92,442,77.38,1.81,20.81,2019,80427
71,0,29,100,71.0,0.0,29.0,2019,80432
664,3,44,711,93.39,0.42,6.19,2019,80442
488,25,58,571,85.46,4.38,10.16,2019,80444
510,26,0,536,95.15,4.85,0.0,2019,80454
163,18,55,236,69.07,7.63,23.31,2019,80455
223,0,79,302,73.84,0.0,26.16,2019,80456
83,0,11,94,88.3,0.0,11.7,2019,80457
71,3,10,84,84.52,3.57,11.9,2019,80476
4,0,0,4,100.0,0.0,0.0,2019,80479
430,0,12,442,97.29,0.0,2.71,2019,80482
222,0,31,253,87.75,0.0,12.25,2019,80483
6341,69,350,6760,93.8,1.02,5.18,2019,80487
2401,132,329,2862,83.89,4.61,11.5,2019,80498
693,9,88,790,87.72,1.14,11.14,2019,80512
20524,762,1335,22621,90.73,3.37,5.9,2019,80525
17101,512,1032,18645,91.72,2.75,5.53,2019,80526
910,30,218,1158,78.58,2.59,18.83,2019,80535
16151,443,1736,18330,88.11,2.42,9.47,2019,80537
17523,669,1518,19710,88.9,3.39,7.7,2019,80538
10807,368,1621,12796,84.46,2.88,12.67,2019,80601
291,13,29,333,87.39,3.9,8.71,2019,80611
1536,44,216,1796,85.52,2.45,12.03,2019,80642
202,0,73,275,73.45,0.0,26.55,2019,80652
110,84,77,271,40.59,31.0,28.41,2019,80727
305,14,78,397,76.83,3.53,19.65,2019,80728
402,6,80,488,82.38,1.23,16.39,2019,80743
78,0,11,89,87.64,0.0,12.36,2019,80801
77,0,10,87,88.51,0.0,11.49,2019,80802
528,0,27,555,95.14,0.0,4.86,2019,80809
87,4,16,107,81.31,3.74,14.95,2019,80812
1446,32,85,1563,92.51,2.05,5.44,2019,80814
87,4,26,117,74.36,3.42,22.22,2019,80822
2522,75,161,2758,91.44,2.72,5.84,2019,80829
50,9,20,79,63.29,11.39,25.32,2019,80830
10204,283,1546,12033,84.8,2.35,12.85,2019,80910
10420,149,509,11078,94.06,1.35,4.59,2019,80005
15663,602,1730,17995,87.04,3.35,9.61,2019,80014
898,54,0,952,94.33,5.67,0.0,2019,80019
18504,408,855,19767,93.61,2.06,4.33,2019,80020
13207,146,498,13851,95.35,1.05,3.6,2019,80112
1182,24,0,1206,98.01,1.99,0.0,2019,85708
375,10,233,618,60.68,1.62,37.7,2019,85617
412,3,82,497,82.9,0.6,16.5,2019,85627
0,0,0,0,,,,2019,85654
1339,24,392,1755,76.3,1.37,22.34,2019,85736
126,0,21,147,85.71,0.0,14.29,2019,85932
11300,370,2284,13954,80.98,2.65,16.37,2019,77092
22752,267,1095,24114,94.35,1.11,4.54,2019,77095
16,0,47,63,25.4,0.0,74.6,2019,77448
605,8,115,728,83.1,1.1,15.8,2019,77455
118,0,35,153,77.12,0.0,22.88,2019,77470
11712,163,1059,12934,90.55,1.26,8.19,2019,77477
8977,156,470,9603,93.48,1.62,4.89,2019,77478
548,0,166,714,76.75,0.0,23.25,2019,77564
5419,297,2220,7936,68.28,3.74,27.97,2019,75702
1717,186,625,2528,67.92,7.36,24.72,2019,75754
1738,59,544,2341,74.24,2.52,23.24,2019,75763
15265,253,3062,18580,82.16,1.36,16.48,2019,75006
15487,167,558,16212,95.53,1.03,3.44,2019,75019
2350,139,823,3312,70.95,4.2,24.85,2019,75021
17924,293,445,18662,96.05,1.57,2.38,2019,75025
6403,547,1363,8313,77.02,6.58,16.4,2019,75160
9879,235,221,10335,95.59,2.27,2.14,2019,75201
1484,190,1194,2868,51.74,6.62,41.63,2019,75210
5113,259,2551,7923,64.53,3.27,32.2,2019,75212
7956,216,1943,10115,78.66,2.14,19.21,2019,75240
23061,765,4481,28307,81.47,2.7,15.83,2019,75243
744,120,479,1343,55.4,8.94,35.67,2019,75246
4675,86,625,5386,86.8,1.6,11.6,2019,75249
77,19,18,114,67.54,16.67,15.79,2019,75413
595,89,310,994,59.86,8.95,31.19,2019,75417
874,8,247,1129,77.41,0.71,21.88,2019,75423
1203,174,548,1925,62.49,9.04,28.47,2019,75426
630,11,237,878,71.75,1.25,26.99,2019,75436
299,6,93,398,75.13,1.51,23.37,2019,75439
1870,59,386,2315,80.78,2.55,16.67,2019,75457
21394,238,782,22414,95.45,1.06,3.49,2019,75002
11272,149,413,11834,95.25,1.26,3.49,2019,75010
17296,141,759,18196,95.05,0.77,4.17,2019,75023
9373,453,1486,11312,82.86,4.0,13.14,2019,75042
13354,215,852,14421,92.6,1.49,5.91,2019,75075
1644,170,199,2013,81.67,8.45,9.89,2019,75114
1971,57,330,2358,83.59,2.42,13.99,2019,75135
3941,162,1236,5339,73.82,3.03,23.15,2019,75143
969,70,322,1361,71.2,5.14,23.66,2019,75144
1444,46,146,1636,88.26,2.81,8.92,2019,75152
822,65,277,1164,70.62,5.58,23.8,2019,75163
13535,446,1478,15459,87.55,2.89,9.56,2019,75165
1228,23,170,1421,86.42,1.62,11.96,2019,75173
1727,14,119,1860,92.85,0.75,6.4,2019,75182
16121,255,1252,17628,91.45,1.45,7.1,2019,75204
8396,895,9191,18482,45.43,4.84,49.73,2019,75216
14029,507,9839,24375,57.55,2.08,40.37,2019,75217
9945,1534,2923,14402,69.05,10.65,20.3,2019,75220
8379,275,2620,11274,74.32,2.44,23.24,2019,75224
10364,301,2090,12755,81.25,2.36,16.39,2019,75238
958,17,188,1163,82.37,1.46,16.17,2019,75422
2665,158,812,3635,73.31,4.35,22.34,2019,75428
806,37,208,1051,76.69,3.52,19.79,2019,75433
5652,502,1120,7274,77.7,6.9,15.4,2019,75134
1391,213,329,1933,71.96,11.02,17.02,2019,75226
1050,0,353,1403,74.84,0.0,25.16,2019,75969
1642,65,356,2063,79.59,3.15,17.26,2019,75125
5906,115,112,6133,96.3,1.88,1.83,2019,75094
11617,553,5727,17897,64.91,3.09,32.0,2019,75227
602,0,0,602,100.0,0.0,0.0,2019,75132
6173,160,599,6932,89.05,2.31,8.64,2019,75137
15838,467,1833,18138,87.32,2.57,10.11,2019,75149
17358,650,3078,21086,82.32,3.08,14.6,2019,75150
1372,67,58,1497,91.65,4.48,3.87,2019,75202
8785,134,397,9316,94.3,1.44,4.26,2019,75205
14375,438,1430,16243,88.5,2.7,8.8,2019,75214
1366,196,178,1740,78.51,11.26,10.23,2019,75251
63,0,0,63,100.0,0.0,0.0,2019,75562
2166,97,1035,3298,65.68,2.94,31.38,2019,75570
4397,77,1183,5657,77.73,1.36,20.91,2019,75601
1815,11,477,2303,78.81,0.48,20.71,2019,75638
596,52,195,843,70.7,6.17,23.13,2019,75651
2957,477,1280,4714,62.73,10.12,27.15,2019,75654
2195,27,812,3034,72.35,0.89,26.76,2019,75704
1228,74,228,1530,80.26,4.84,14.9,2019,75756
3805,53,513,4371,87.05,1.21,11.74,2019,75757
671,20,241,932,72.0,2.15,25.86,2019,75760
2279,150,541,2970,76.73,5.05,18.22,2019,75765
6277,168,1016,7461,84.13,2.25,13.62,2019,75771
3845,166,942,4953,77.63,3.35,19.02,2019,75773
1008,96,354,1458,69.14,6.58,24.28,2019,75790
1343,101,529,1973,68.07,5.12,26.81,2019,75831
9091,249,1264,10604,85.73,2.35,11.92,2019,77904
141,111,331,583,24.19,19.04,56.78,2019,77951
2286,107,1223,3616,63.22,2.96,33.82,2019,77954
8,0,0,8,100.0,0.0,0.0,2019,77973
529,31,155,715,73.99,4.34,21.68,2019,77983
19388,699,2251,22338,86.79,3.13,10.08,2019,77083
14,0,32,46,30.43,0.0,69.57,2019,77367
11607,158,562,12327,94.16,1.28,4.56,2019,77354
1431,15,497,1943,73.65,0.77,25.58,2019,77358
771,2,509,1282,60.14,0.16,39.7,2019,77363
94,15,123,232,40.52,6.47,53.02,2019,77369
11168,280,538,11986,93.18,2.34,4.49,2019,77380
6735,51,283,7069,95.28,0.72,4.0,2019,77401
7,0,0,7,100.0,0.0,0.0,2019,77412
678,3,71,752,90.16,0.4,9.44,2019,77430
24812,1014,1396,27222,91.15,3.72,5.13,2019,77433
240,22,61,323,74.3,6.81,18.89,2019,77442
91,31,113,235,38.72,13.19,48.09,2019,77457
50,24,56,130,38.46,18.46,43.08,2019,77458
3223,195,471,3889,82.87,5.01,12.11,2019,77461
0,17,0,17,0.0,100.0,0.0,2019,77467
9644,259,3196,13099,73.62,1.98,24.4,2019,77471
92,0,15,107,85.98,0.0,14.02,2019,77483
7861,69,948,8878,88.54,0.78,10.68,2019,77504
6411,83,619,7113,90.13,1.17,8.7,2019,77545
9859,373,1006,11238,87.73,3.32,8.95,2019,77566
4965,55,1153,6173,80.43,0.89,18.68,2019,77575
6425,83,632,7140,89.99,1.16,8.85,2019,77578
2615,52,388,3055,85.6,1.7,12.7,2019,77611
116,11,55,182,63.74,6.04,30.22,2019,62553
148,8,19,175,84.57,4.57,10.86,2019,62555
2399,40,683,3122,76.84,1.28,21.88,2019,62557
2343,69,795,3207,73.06,2.15,24.79,2019,62565
94,0,36,130,72.31,0.0,27.69,2019,62601
97,0,18,115,84.35,0.0,15.65,2019,62438
539,12,66,617,87.36,1.94,10.7,2019,62360
360,17,55,432,83.33,3.94,12.73,2019,62410
411,13,102,526,78.14,2.47,19.39,2019,61375
84,2,25,111,75.68,1.8,22.52,2019,61431
143,8,28,179,79.89,4.47,15.64,2019,61337
390,38,66,494,78.95,7.69,13.36,2019,61488
3763,210,1557,5530,68.05,3.8,28.16,2019,61443
447,5,57,509,87.82,0.98,11.2,2019,61465
170,2,8,180,94.44,1.11,4.44,2019,61476
606,8,222,836,72.49,0.96,26.56,2019,61483
237,3,58,298,79.53,1.01,19.46,2019,61516
3532,90,689,4311,81.93,2.09,15.98,2019,61523
84,0,37,121,69.42,0.0,30.58,2019,61524
539,6,122,667,80.81,0.9,18.29,2019,61534
976,21,151,1148,85.02,1.83,13.15,2019,61559
4374,220,1649,6243,70.06,3.52,26.41,2019,61603
170,2,21,193,88.08,1.04,10.88,2019,61013
9062,321,539,9922,91.33,3.24,5.43,2019,61822
49,0,13,62,79.03,0.0,20.97,2019,61831
435,9,97,541,80.41,1.66,17.93,2019,61870
180,0,59,239,75.31,0.0,24.69,2019,61840
303,0,0,303,100.0,0.0,0.0,2019,63073
27,0,0,27,100.0,0.0,0.0,2019,63079
0,0,0,0,,,,2019,63155
14250,296,1232,15778,90.32,1.88,7.81,2019,63368
5,0,8,13,38.46,0.0,61.54,2019,63467
5,0,22,27,18.52,0.0,81.48,2019,63666
23,0,14,37,62.16,0.0,37.84,2019,63744
4,0,0,4,100.0,0.0,0.0,2019,63745
11,0,4,15,73.33,0.0,26.67,2019,63746
0,0,0,0,,,,2019,63902
35,0,16,51,68.63,0.0,31.37,2019,63962
8181,170,1171,9522,85.92,1.79,12.3,2019,63104
6352,153,1419,7924,80.16,1.93,17.91,2019,63020
17,0,15,32,53.12,0.0,46.88,2019,76685
495,65,146,706,70.11,9.21,20.68,2019,76701
8909,355,743,10007,89.03,3.55,7.42,2019,76712
840,69,256,1165,72.1,5.92,21.97,2019,76823
638,48,264,950,67.16,5.05,27.79,2019,76859
485,11,121,617,78.61,1.78,19.61,2019,76861
189,3,109,301,62.79,1.0,36.21,2019,76864
38,0,3,41,92.68,0.0,7.32,2019,76884
71,0,15,86,82.56,0.0,17.44,2019,76888
720,28,327,1075,66.98,2.6,30.42,2019,76936
11483,212,473,12168,94.37,1.74,3.89,2019,76065
5233,193,1477,6903,75.81,2.8,21.4,2019,76067
132,1,36,169,78.11,0.59,21.3,2019,76660
2474,157,1183,3814,64.87,4.12,31.02,2019,76667
7324,420,1996,9740,75.2,4.31,20.49,2019,76708
23,0,8,31,74.19,0.0,25.81,2019,76848
125,0,38,163,76.69,0.0,23.31,2019,76854
43,0,0,43,100.0,0.0,0.0,2019,76869
61,0,34,95,64.21,0.0,35.79,2019,76870
1284,17,249,1550,82.84,1.1,16.06,2019,85939
1173,133,1079,2385,49.18,5.58,45.24,2019,85346
20369,693,5234,26296,77.46,2.64,19.9,2019,85364
784,15,208,1007,77.86,1.49,20.66,2019,85534
323,81,301,705,45.82,11.49,42.7,2019,85542
1644,99,233,1976,83.2,5.01,11.79,2019,85935
276,12,105,393,70.23,3.05,26.72,2019,83524
93,13,7,113,82.3,11.5,6.19,2019,83533
1190,82,565,1837,64.78,4.46,30.76,2019,83536
371,8,81,460,80.65,1.74,17.61,2019,83537
198,13,46,257,77.04,5.06,17.9,2019,83546
87,6,86,179,48.6,3.35,48.04,2019,83547
2501,179,414,3094,80.83,5.79,13.38,2019,83619
366,16,62,444,82.43,3.6,13.96,2019,83626
174,0,80,254,68.5,0.0,31.5,2019,83633
6625,112,642,7379,89.78,1.52,8.7,2019,83634
580,54,196,830,69.88,6.51,23.61,2019,83612
18,68,0,86,20.93,79.07,0.0,2019,83012
250,0,12,262,95.42,0.0,4.58,2019,83111
61,0,10,71,85.92,0.0,14.08,2019,83124
27,0,0,27,100.0,0.0,0.0,2019,83215
72,4,0,76,94.74,5.26,0.0,2019,83220
7591,140,942,8673,87.52,1.61,10.86,2019,83835
1007,82,205,1294,77.82,6.34,15.84,2019,83837
511,0,78,589,86.76,0.0,13.24,2019,83845
65,0,26,91,71.43,0.0,28.57,2019,83848
4954,349,526,5829,84.99,5.99,9.02,2019,83858
1940,65,362,2367,81.96,2.75,15.29,2019,83860
1568,95,285,1948,80.49,4.88,14.63,2019,83869
1149,98,397,1644,69.89,5.96,24.15,2019,83676
12689,363,2920,15972,79.45,2.27,18.28,2019,83704
7742,365,892,8999,86.03,4.06,9.91,2019,83404
156,0,0,156,100.0,0.0,0.0,2019,83424
173,10,8,191,90.58,5.24,4.19,2019,83435
262,18,62,342,76.61,5.26,18.13,2019,83443
69,0,21,90,76.67,0.0,23.33,2019,83449
13,0,0,13,100.0,0.0,0.0,2019,83469
111,0,37,148,75.0,0.0,25.0,2019,83525
80,3,36,119,67.23,2.52,30.25,2019,83526
235,8,53,296,79.39,2.7,17.91,2019,83543
339,31,56,426,79.58,7.28,13.15,2019,83615
136,11,111,258,52.71,4.26,43.02,2019,83627
183,0,32,215,85.12,0.0,14.88,2019,83656
3057,218,587,3862,79.16,5.64,15.2,2019,83661
6425,164,169,6758,95.07,2.43,2.5,2019,84025
160,34,0,194,82.47,17.53,0.0,2019,84028
7127,35,739,7901,90.2,0.44,9.35,2019,84044
994,8,0,1002,99.2,0.8,0.0,2019,84056
451,8,47,506,89.13,1.58,9.29,2019,84328
291,3,33,327,88.99,0.92,10.09,2019,84314
2219,12,120,2351,94.39,0.51,5.1,2019,84319
12792,950,1208,14950,85.57,6.35,8.08,2019,84321
2223,65,99,2387,93.13,2.72,4.15,2019,84332
278,8,20,306,90.85,2.61,6.54,2019,83311
765,25,275,1065,71.83,2.35,25.82,2019,83332
449,6,139,594,75.59,1.01,23.4,2019,83335
2240,24,119,2383,94.0,1.01,4.99,2019,83341
327,0,69,396,82.58,0.0,17.42,2019,83342
882,31,213,1126,78.33,2.75,18.92,2019,83347
872,62,234,1168,74.66,5.31,20.03,2019,75414
1750,189,550,2489,70.31,7.59,22.1,2019,75440
338,0,163,501,67.47,0.0,32.53,2019,75558
4131,113,1231,5475,75.45,2.06,22.48,2019,75751
590,0,114,704,83.81,0.0,16.19,2019,75929
1620,11,596,2227,72.74,0.49,26.76,2019,75148
13273,732,3121,17126,77.5,4.27,18.22,2019,75231
199,0,29,228,87.28,0.0,12.72,2019,75448
51,0,76,127,40.16,0.0,59.84,2019,63443
28,6,15,49,57.14,12.24,30.61,2019,63458
17824,335,1887,20046,88.92,1.67,9.41,2019,63303
406,30,82,518,78.38,5.79,15.83,2019,63332
257,9,74,340,75.59,2.65,21.76,2019,63339
13847,145,1152,15144,91.44,0.96,7.61,2019,63385
145,4,44,193,75.13,2.07,22.8,2019,63386
3112,110,866,4088,76.13,2.69,21.18,2019,63390
359,12,82,453,79.25,2.65,18.1,2019,63447
449,31,124,604,74.34,5.13,20.53,2019,63448
298,27,40,365,81.64,7.4,10.96,2019,63454
1313,34,488,1835,71.55,1.85,26.59,2019,63456
80,0,19,99,80.81,0.0,19.19,2019,63457
1161,19,275,1455,79.79,1.31,18.9,2019,63459
5,0,0,5,100.0,0.0,0.0,2019,63464
206,13,52,271,76.01,4.8,19.19,2019,63544
231,16,119,366,63.11,4.37,32.51,2019,63545
327,9,79,415,78.8,2.17,19.04,2019,63631
731,11,293,1035,70.63,1.06,28.31,2019,63638
9266,216,1592,11074,83.67,1.95,14.38,2019,63640
355,10,102,467,76.02,2.14,21.84,2019,63648
0,0,0,0,,,,2019,63674
2625,50,913,3588,73.16,1.39,25.45,2019,63703
309,7,40,356,86.8,1.97,11.24,2019,63732
233,11,52,296,78.72,3.72,17.57,2019,63735
99,8,44,151,65.56,5.3,29.14,2019,63747
156,6,77,239,65.27,2.51,32.22,2019,63760
5359,93,1224,6676,80.27,1.39,18.33,2019,63775
241,8,87,336,71.73,2.38,25.89,2019,63827
511,4,161,676,75.59,0.59,23.82,2019,63837
4138,104,1076,5318,77.81,1.96,20.23,2019,63841
124,0,50,174,71.26,0.0,28.74,2019,63866
15330,249,978,16557,92.59,1.5,5.91,2019,63017
8166,174,1710,10050,81.25,1.73,17.01,2019,63028
604,23,190,817,73.93,2.82,23.26,2019,63056
3093,8,122,3223,95.97,0.25,3.79,2019,63040
7551,215,938,8704,86.75,2.47,10.78,2019,63042
874,19,43,936,93.38,2.03,4.59,2019,63055
380,6,141,527,72.11,1.14,26.76,2019,63336
463,13,65,541,85.58,2.4,12.01,2019,63344
559,56,112,727,76.89,7.7,15.41,2019,63349
616,24,163,803,76.71,2.99,20.3,2019,63351
1411,78,507,1996,70.69,3.91,25.4,2019,63361
16606,490,1402,18498,89.77,2.65,7.58,2019,63366
391,18,156,565,69.2,3.19,27.61,2019,63437
171,5,52,228,75.0,2.19,22.81,2019,63446
164,7,31,202,81.19,3.47,15.35,2019,63453
229,24,34,287,79.79,8.36,11.85,2019,63463
91,0,32,123,73.98,0.0,26.02,2019,63465
236,13,117,366,64.48,3.55,31.97,2019,63548
353,20,214,587,60.14,3.41,36.46,2019,63621
49,0,0,49,100.0,0.0,0.0,2019,77617
352,13,106,471,74.73,2.76,22.51,2019,77622
70,0,44,114,61.4,0.0,38.6,2019,77655
13040,310,1712,15062,86.58,2.06,11.37,2019,77338
14665,569,501,15735,93.2,3.62,3.18,2019,77339
1670,19,184,1873,89.16,1.01,9.82,2019,77362
700,60,209,969,72.24,6.19,21.57,2019,77364
10205,127,1123,11455,89.09,1.11,9.8,2019,77365
1830,164,538,2532,72.27,6.48,21.25,2019,77371
25836,1730,1125,28691,90.05,6.03,3.92,2019,77429
132,13,62,207,63.77,6.28,29.95,2019,77444
0,0,0,0,,,,2019,77454
20,0,0,20,100.0,0.0,0.0,2019,77468
0,12,33,45,0.0,26.67,73.33,2019,77473
178,26,83,287,62.02,9.06,28.92,2019,77475
11672,196,520,12388,94.22,1.58,4.2,2019,77489
182,0,0,182,100.0,0.0,0.0,2019,77507
13323,537,2343,16203,82.23,3.31,14.46,2019,77511
1596,50,261,1907,83.69,2.62,13.69,2019,77517
8065,145,1667,9877,81.65,1.47,16.88,2019,77535
13558,1010,2108,16676,81.3,6.06,12.64,2019,77539
6857,187,1312,8356,82.06,2.24,15.7,2019,77551
3424,91,229,3744,91.45,2.43,6.12,2019,77554
171,0,0,171,100.0,0.0,0.0,2019,77560
3171,107,485,3763,84.27,2.84,12.89,2019,77562
9062,226,2078,11366,79.73,1.99,18.28,2019,77590
227,7,88,322,70.5,2.17,27.33,2019,77660
5225,95,853,6173,84.64,1.54,13.82,2019,77713
2964,151,403,3518,84.25,4.29,11.46,2019,77807
749,3,391,1143,65.53,0.26,34.21,2019,77835
0,0,0,0,,,,2019,81633
967,6,384,1357,71.26,0.44,28.3,2019,81054
62,0,7,69,89.86,0.0,10.14,2019,79001
518,13,66,597,86.77,2.18,11.06,2019,79005
634,0,319,953,66.53,0.0,33.47,2019,79013
1002,55,228,1285,77.98,4.28,17.74,2019,79014
4439,118,449,5006,88.67,2.36,8.97,2019,79029
188,16,39,243,77.37,6.58,16.05,2019,79046
375,18,100,493,76.06,3.65,20.28,2019,79057
209,10,44,263,79.47,3.8,16.73,2019,79059
678,88,315,1081,62.72,8.14,29.14,2019,79501
36,4,18,58,62.07,6.9,31.03,2019,79503
2108,89,699,2896,72.79,3.07,24.14,2019,79510
288,11,73,372,77.42,2.96,19.62,2019,79526
559,26,211,796,70.23,3.27,26.51,2019,79546
61,5,18,84,72.62,5.95,21.43,2019,79548
8588,157,2430,11175,76.85,1.4,21.74,2019,79605
8766,241,1216,10223,85.75,2.36,11.89,2019,79606
6891,169,827,7887,87.37,2.14,10.49,2019,79703
7863,301,2373,10537,74.62,2.86,22.52,2019,79720
928,10,477,1415,65.58,0.71,33.71,2019,79731
111,0,68,179,62.01,0.0,37.99,2019,79742
236,32,68,336,70.24,9.52,20.24,2019,76872
388,45,123,556,69.78,8.09,22.12,2019,76933
0,0,5,5,0.0,0.0,100.0,2019,76949
9641,237,1430,11308,85.26,2.1,12.65,2019,76040
7793,385,1309,9487,82.14,4.06,13.8,2019,76048
76,0,22,98,77.55,0.0,22.45,2019,76077
584,34,68,686,85.13,4.96,9.91,2019,76093
3723,312,2235,6270,59.38,4.98,35.65,2019,76104
8542,382,764,9688,88.17,3.94,7.89,2019,76109
8180,445,1253,9878,82.81,4.5,12.68,2019,76117
6811,389,1170,8370,81.37,4.65,13.98,2019,76134
18510,372,944,19826,93.36,1.88,4.76,2019,76137
19698,223,946,20867,94.4,1.07,4.53,2019,76179
12928,461,1440,14829,87.18,3.11,9.71,2019,76180
7991,509,2329,10829,73.79,4.7,21.51,2019,76240
1279,79,271,1629,78.51,4.85,16.64,2019,76272
624,12,222,858,72.73,1.4,25.87,2019,76443
1918,43,563,2524,75.99,1.7,22.31,2019,76446
370,19,281,670,55.22,2.84,41.94,2019,76454
76,12,22,110,69.09,10.91,20.0,2019,76459
102,5,69,176,57.95,2.84,39.2,2019,76463
106,0,0,106,100.0,0.0,0.0,2019,76466
227,6,115,348,65.23,1.72,33.05,2019,76475
334,10,112,456,73.25,2.19,24.56,2019,76486
11663,373,1633,13669,85.32,2.73,11.95,2019,76513
341,0,220,561,60.78,0.0,39.22,2019,76518
93,31,21,145,64.14,21.38,14.48,2019,76519
476,106,286,868,54.84,12.21,32.95,2019,76570
2645,47,241,2933,90.18,1.6,8.22,2019,76571
937,17,268,1222,76.68,1.39,21.93,2019,76640
1532,212,784,2528,60.6,8.39,31.01,2019,76642
502,41,168,711,70.6,5.77,23.63,2019,76671
7192,286,1846,9324,77.13,3.07,19.8,2019,76801
1026,59,245,1330,77.14,4.44,18.42,2019,76689
1772,60,528,2360,75.08,2.54,22.37,2019,76691
76,7,17,100,76.0,7.0,17.0,2019,73021
59,20,52,131,45.04,15.27,39.69,2019,73011
7533,209,858,8600,87.59,2.43,9.98,2019,73020
3554,142,848,4544,78.21,3.12,18.66,2019,73045
1055,33,312,1400,75.36,2.36,22.29,2019,73047
4037,22,0,4059,99.46,0.54,0.0,2019,78730
2910,0,22,2932,99.25,0.0,0.75,2019,78733
7199,311,401,7911,91.0,3.93,5.07,2019,78751
24,9,50,83,28.92,10.84,60.24,2019,78828
17607,595,6328,24530,71.78,2.43,25.8,2019,78572
6123,525,3988,10636,57.57,4.94,37.5,2019,78582
71,9,129,209,33.97,4.31,61.72,2019,78592
1314,222,109,1645,79.88,13.5,6.63,2019,78597
637,20,168,825,77.21,2.42,20.36,2019,78609
11497,127,960,12584,91.36,1.01,7.63,2019,78610
3537,0,356,3893,90.86,0.0,9.14,2019,78612
1721,57,855,2633,65.36,2.16,32.47,2019,78616
40,0,0,40,100.0,0.0,0.0,2019,78879
150,0,39,189,79.37,0.0,20.63,2019,78886
652,11,221,884,73.76,1.24,25.0,2019,78940
4462,51,154,4667,95.61,1.09,3.3,2019,78669
6065,127,203,6395,94.84,1.99,3.17,2019,78701
7183,70,356,7609,94.4,0.92,4.68,2019,78735
6893,281,1310,8484,81.25,3.31,15.44,2019,78752
118,0,0,118,100.0,0.0,0.0,2019,83348
473,7,53,533,88.74,1.31,9.94,2019,83353
127,0,36,163,77.91,0.0,22.09,2019,83425
548,26,34,608,90.13,4.28,5.59,2019,83427
283,18,108,409,69.19,4.4,26.41,2019,83444
1577,35,152,1764,89.4,1.98,8.62,2019,83455
43,0,12,55,78.18,0.0,21.82,2019,83463
1059,32,241,1332,79.5,2.4,18.09,2019,84021
231,10,6,247,93.52,4.05,2.43,2019,84039
14714,446,1421,16581,88.74,2.69,8.57,2019,84041
8573,253,339,9165,93.54,2.76,3.7,2019,84092
7090,194,211,7495,94.6,2.59,2.82,2019,84093
2392,133,436,2961,80.78,4.49,14.72,2019,84101
9631,477,673,10781,89.33,4.42,6.24,2019,84103
6281,524,933,7738,81.17,6.77,12.06,2019,84104
4905,378,1476,6759,72.57,5.59,21.84,2019,84111
641,38,69,748,85.7,5.08,9.22,2019,84320
590,13,47,650,90.77,2.0,7.23,2019,84325
229,6,11,246,93.09,2.44,4.47,2019,84327
94,1,32,127,74.02,0.79,25.2,2019,84330
990,31,136,1157,85.57,2.68,11.75,2019,84340
11260,435,1231,12926,87.11,3.37,9.52,2019,84403
267,0,35,302,88.41,0.0,11.59,2019,84518
326,3,135,464,70.26,0.65,29.09,2019,84520
61,0,50,111,54.95,0.0,45.05,2019,84623
442,9,75,526,84.03,1.71,14.26,2019,84646
218,12,13,243,89.71,4.94,5.35,2019,84649
2611,89,321,3021,86.43,2.95,10.63,2019,84701
274,6,66,346,79.19,1.73,19.08,2019,84752
0,0,8,8,0.0,0.0,100.0,2019,84753
262,4,20,286,91.61,1.4,6.99,2019,84013
78,0,0,78,100.0,0.0,0.0,2019,84018
38,0,0,38,100.0,0.0,0.0,2019,84113
14393,623,946,15962,90.17,3.9,5.93,2019,84121
228,2,37,267,85.39,0.75,13.86,2019,84301
305,11,53,369,82.66,2.98,14.36,2019,84307
1345,7,178,1530,87.91,0.46,11.63,2019,84312
3459,75,201,3735,92.61,2.01,5.38,2019,84335
17248,450,2760,20458,84.31,2.2,13.49,2019,84404
9922,185,1120,11227,88.38,1.65,9.98,2019,84405
228,6,104,338,67.46,1.78,30.77,2019,84525
98,0,0,98,100.0,0.0,0.0,2019,84533
6317,266,635,7218,87.52,3.69,8.8,2019,84651
231,12,57,300,77.0,4.0,19.0,2019,84652
10208,250,653,11111,91.87,2.25,5.88,2019,84660
132,11,9,152,86.84,7.24,5.92,2019,84716
8,7,19,34,23.53,20.59,55.88,2019,84719
316,30,98,444,71.17,6.76,22.07,2019,84722
56,0,0,56,100.0,0.0,0.0,2019,84733
75,8,11,94,79.79,8.51,11.7,2019,84735
156,3,14,173,90.17,1.73,8.09,2019,84739
1158,99,120,1377,84.1,7.19,8.71,2019,84754
419,59,120,598,70.07,9.87,20.07,2019,84757
1030,0,5,1035,99.52,0.0,0.48,2019,94535
10976,314,900,12190,90.04,2.58,7.38,2019,94561
184,11,36,231,79.65,4.76,15.58,2019,94567
8174,251,875,9300,87.89,2.7,9.41,2019,94585
12500,206,326,13032,95.92,1.58,2.5,2019,94588
291,0,0,291,100.0,0.0,0.0,2019,94592
4041,162,786,4989,81.0,3.25,15.75,2019,63628
20,0,5,25,80.0,0.0,20.0,2019,63535
477,14,254,745,64.03,1.88,34.09,2019,63537
414,19,171,604,68.54,3.15,28.31,2019,63546
217,16,151,384,56.51,4.17,39.32,2019,63561
875,82,357,1314,66.59,6.24,27.17,2019,63565
197,10,107,314,62.74,3.18,34.08,2019,63623
1062,33,296,1391,76.35,2.37,21.28,2019,63630
2304,99,1062,3465,66.49,2.86,30.65,2019,73005
5957,177,1737,7871,75.68,2.25,22.07,2019,73008
410,6,147,563,72.82,1.07,26.11,2019,73014
552,0,84,636,86.79,0.0,13.21,2019,73016
5471,762,1534,7767,70.44,9.81,19.75,2019,73018
57,8,32,97,58.76,8.25,32.99,2019,73032
546,28,168,742,73.58,3.77,22.64,2019,73040
673,42,188,903,74.53,4.65,20.82,2019,73057
70,2,35,107,65.42,1.87,32.71,2019,73622
289,4,100,393,73.54,1.02,25.45,2019,73626
50,0,36,86,58.14,0.0,41.86,2019,73638
50,0,32,82,60.98,0.0,39.02,2019,73642
87,4,64,155,56.13,2.58,41.29,2019,73660
116,4,39,159,72.96,2.52,24.53,2019,73661
339,1,80,420,80.71,0.24,19.05,2019,73663
90,0,29,119,75.63,0.0,24.37,2019,73673
593,6,172,771,76.91,0.78,22.31,2019,73728
205,0,61,266,77.07,0.0,22.93,2019,73735
31,2,4,37,83.78,5.41,10.81,2019,73743
10,0,4,14,71.43,0.0,28.57,2019,73746
1959,167,488,2614,74.94,6.39,18.67,2019,73750
7405,382,1158,8945,82.78,4.27,12.95,2019,73507
170,5,33,208,81.73,2.4,15.87,2019,73528
186,1,23,210,88.57,0.48,10.95,2019,73532
8307,333,1990,10630,78.15,3.13,18.72,2019,73533
549,19,101,669,82.06,2.84,15.1,2019,73543
201,17,39,257,78.21,6.61,15.18,2019,73567
276,31,123,430,64.19,7.21,28.6,2019,73570
658,29,254,941,69.93,3.08,26.99,2019,73573
191,0,59,250,76.4,0.0,23.6,2019,73627
4068,161,875,5104,79.7,3.15,17.14,2019,73644
51,2,10,63,80.95,3.17,15.87,2019,73659
167,5,60,232,71.98,2.16,25.86,2019,73729
52,0,12,64,81.25,0.0,18.75,2019,73731
1099,21,280,1400,78.5,1.5,20.0,2019,73737
101,8,10,119,84.87,6.72,8.4,2019,73757
49,0,6,55,89.09,0.0,10.91,2019,73758
4525,285,1077,5887,76.86,4.84,18.29,2019,73801
117,2,47,166,70.48,1.2,28.31,2019,73838
194,3,31,228,85.09,1.32,13.6,2019,73842
49,4,23,76,64.47,5.26,30.26,2019,73937
332,16,73,421,78.86,3.8,17.34,2019,73074
1979,105,657,2741,72.2,3.83,23.97,2019,73077
3477,430,563,4470,77.79,9.62,12.6,2019,73089
4304,135,618,5057,85.11,2.67,12.22,2019,73096
942,19,180,1141,82.56,1.67,15.78,2019,73102
10692,280,2832,13804,77.46,2.03,20.52,2019,73110
887,75,306,1268,69.95,5.91,24.13,2019,73121
4186,110,804,5100,82.08,2.16,15.76,2019,73122
1898,207,964,3069,61.84,6.74,31.41,2019,73439
1031,118,313,1462,70.52,8.07,21.41,2019,73443
1713,186,440,2339,73.24,7.95,18.81,2019,79745
1013,69,209,1291,78.47,5.34,16.19,2019,79068
130,20,47,197,65.99,10.15,23.86,2019,79080
69,0,28,97,71.13,0.0,28.87,2019,79082
189,13,40,242,78.1,5.37,16.53,2019,79087
574,34,174,782,73.4,4.35,22.25,2019,79096
65,2,7,74,87.84,2.7,9.46,2019,79236
14,0,8,22,63.64,0.0,36.36,2019,79240
0,0,15,15,0.0,0.0,100.0,2019,79259
240,16,98,354,67.8,4.52,27.68,2019,79312
10,0,4,14,71.43,0.0,28.57,2019,79324
900,30,187,1117,80.57,2.69,16.74,2019,79329
130,0,17,147,88.44,0.0,11.56,2019,79342
193,12,47,252,76.59,4.76,18.65,2019,79367
483,16,127,626,77.16,2.56,20.29,2019,79370
341,21,186,548,62.23,3.83,33.94,2019,79371
411,80,379,870,47.24,9.2,43.56,2019,79752
667,52,119,838,79.59,6.21,14.2,2019,79758
1913,91,1054,3058,62.56,2.98,34.47,2019,79772
5748,220,724,6692,85.89,3.29,10.82,2019,79110
441,24,44,509,86.64,4.72,8.64,2019,79111
6417,134,259,6810,94.23,1.97,3.8,2019,79119
1779,16,635,2430,73.21,0.66,26.13,2019,79201
52,8,15,75,69.33,10.67,20.0,2019,79220
23,0,5,28,82.14,0.0,17.86,2019,79247
925,60,251,1236,74.84,4.85,20.31,2019,79311
1586,0,566,2152,73.7,0.0,26.3,2019,79323
13,0,10,23,56.52,0.0,43.48,2019,79326
559,24,224,807,69.27,2.97,27.76,2019,79359
27,0,7,34,79.41,0.0,20.59,2019,79380
215,26,148,389,55.27,6.68,38.05,2019,79778
1521,70,534,2125,71.58,3.29,25.13,2019,79347
125,10,35,170,73.53,5.88,20.59,2019,79379
3678,80,931,4689,78.44,1.71,19.85,2019,79360
373,28,31,432,86.34,6.48,7.18,2019,79366
71,2,12,85,83.53,2.35,14.12,2019,79377
393,9,117,519,75.72,1.73,22.54,2019,79381
10645,371,1311,12327,86.36,3.01,10.64,2019,62221
2026,155,336,2517,80.49,6.16,13.35,2019,62232
1906,121,625,2652,71.87,4.56,23.57,2019,62233
444,47,80,571,77.76,8.23,14.01,2019,62240
358,13,72,443,80.81,2.93,16.25,2019,62244
595,13,154,762,78.08,1.71,20.21,2019,62245
1962,101,430,2493,78.7,4.05,17.25,2019,62254
0,0,0,0,,,,2019,62279
5511,266,1060,6837,80.61,3.89,15.5,2019,62298
10417,472,3018,13907,74.9,3.39,21.7,2019,62301
90,21,59,170,52.94,12.35,34.71,2019,62313
64,0,28,92,69.57,0.0,30.43,2019,62346
225,0,65,290,77.59,0.0,22.41,2019,62355
1731,123,468,2322,74.55,5.3,20.16,2019,62363
119,2,72,193,61.66,1.04,37.31,2019,62365
340,13,86,439,77.45,2.96,19.59,2019,62376
1349,49,307,1705,79.12,2.87,18.01,2019,62411
601,23,207,831,72.32,2.77,24.91,2019,62418
718,31,104,853,84.17,3.63,12.19,2019,62424
17240,402,3202,20844,82.71,1.93,15.36,2019,78758
4890,410,1923,7223,67.7,5.68,26.62,2019,78801
221,26,131,378,58.47,6.88,34.66,2019,78850
450,44,158,652,69.02,6.75,24.23,2019,78873
2263,54,648,2965,76.32,1.82,21.85,2019,78942
1248,54,626,1928,64.73,2.8,32.47,2019,78956
211,0,156,367,57.49,0.0,42.51,2019,78005
1810,26,321,2157,83.91,1.21,14.88,2019,78013
10517,1126,4664,16307,64.49,6.91,28.6,2019,78201
2255,326,1231,3812,59.16,8.55,32.29,2019,78202
5963,596,2397,8956,66.58,6.65,26.76,2019,78211
16411,248,1564,18223,90.06,1.36,8.58,2019,78230
9406,2958,5709,18073,52.04,16.37,31.59,2019,78520
1058,18,740,1816,58.26,0.99,40.75,2019,78401
668,12,141,821,81.36,1.46,17.17,2019,78407
4404,957,4091,9452,46.59,10.12,43.28,2019,78516
122,0,166,288,42.36,0.0,57.64,2019,78549
8916,522,3089,12527,71.17,4.17,24.66,2019,78552
141,0,78,219,64.38,0.0,35.62,2019,78558
2245,94,1609,3948,56.86,2.38,40.75,2019,78559
171,16,93,280,61.07,5.71,33.21,2019,78161
1193,195,596,1984,60.13,9.83,30.04,2019,78203
8511,805,3112,12428,68.48,6.48,25.04,2019,78210
12083,812,3381,16276,74.24,4.99,20.77,2019,78213
5502,545,1344,7391,74.44,7.37,18.18,2019,78222
932,16,0,948,98.31,1.69,0.0,2019,78234
16802,504,1597,18903,88.89,2.67,8.45,2019,78250
3200,46,370,3616,88.5,1.27,10.23,2019,78257
7,0,6,13,53.85,0.0,46.15,2019,78338
1208,141,245,1594,75.78,8.85,15.37,2019,78343
1285,121,668,2074,61.96,5.83,32.21,2019,78355
5277,409,2204,7890,66.88,5.18,27.93,2019,78380
968,53,789,1810,53.48,2.93,43.59,2019,78390
124,25,7,156,79.49,16.03,4.49,2019,78402
3037,27,2179,5243,57.92,0.51,41.56,2019,78405
7798,207,1944,9949,78.38,2.08,19.54,2019,78411
10585,239,1298,12122,87.32,1.97,10.71,2019,78418
992,10,1506,2508,39.55,0.4,60.05,2019,78576
2907,412,1065,4384,66.31,9.4,24.29,2019,78578
7972,1299,6409,15680,50.84,8.28,40.87,2019,78586
2100,80,1135,3315,63.35,2.41,34.24,2019,79835
233,23,126,382,60.99,6.02,32.98,2019,79848
6040,433,1594,8067,74.87,5.37,19.76,2019,79902
8171,359,2428,10958,74.57,3.28,22.16,2019,79904
57,0,4,61,93.44,0.0,6.56,2019,79847
522,19,176,717,72.8,2.65,24.55,2019,79853
972,16,0,988,98.38,1.62,0.0,2019,79908
6911,782,2521,10214,67.66,7.66,24.68,2019,79930
57,0,17,74,77.03,0.0,22.97,2019,79003
334,57,192,583,57.29,9.78,32.93,2019,79009
6737,199,538,7474,90.14,2.66,7.2,2019,79015
537,10,99,646,83.13,1.55,15.33,2019,79019
124,0,22,146,84.93,0.0,15.07,2019,79024
154,9,32,195,78.97,4.62,16.41,2019,79034
1177,110,442,1729,68.07,6.36,25.56,2019,79035
17,0,3,20,85.0,0.0,15.0,2019,79056
555,38,310,903,61.46,4.21,34.33,2019,79064
2515,223,590,3328,75.57,6.7,17.73,2019,79070
64,0,22,86,74.42,0.0,25.58,2019,79078
8836,309,2358,11503,76.81,2.69,20.5,2019,94607
15769,313,1175,17257,91.38,1.81,6.81,2019,94611
4590,125,269,4984,92.09,2.51,5.4,2019,94709
4800,87,367,5254,91.36,1.66,6.99,2019,94805
91,0,0,91,100.0,0.0,0.0,2019,94021
6970,89,143,7202,96.78,1.24,1.99,2019,94022
12963,191,615,13769,94.15,1.39,4.47,2019,94123
14705,220,1007,15932,92.3,1.38,6.32,2019,94521
20160,323,1369,21852,92.26,1.48,6.26,2019,94587
238,12,50,300,79.33,4.0,16.67,2019,94060
13785,412,909,15106,91.26,2.73,6.02,2019,94025
122,7,0,129,94.57,5.43,0.0,2019,94963
7398,342,678,8418,87.88,4.06,8.05,2019,94085
3603,301,557,4461,80.77,6.75,12.49,2019,94158
4851,125,327,5303,91.48,2.36,6.17,2019,94503
5367,28,128,5523,97.18,0.51,2.32,2019,94505
38,5,5,48,79.17,10.42,10.42,2019,94516
145,0,56,201,72.14,0.0,27.86,2019,94528
11531,180,768,12479,92.4,1.44,6.15,2019,94531
12478,137,482,13097,95.27,1.05,3.68,2019,94534
134,0,16,150,89.33,0.0,10.67,2019,94548
15009,248,731,15988,93.88,1.55,4.57,2019,94551
14,0,0,14,100.0,0.0,0.0,2019,94573
0,0,0,0,,,,2019,94575
13736,100,200,14036,97.86,0.71,1.42,2019,94582
9864,43,590,10497,93.97,0.41,5.62,2019,94597
4,0,0,4,100.0,0.0,0.0,2019,94613
26,0,0,26,100.0,0.0,0.0,2019,94720
0,0,0,0,,,,2019,94850
391,15,13,419,93.32,3.58,3.1,2019,94957
3543,112,287,3942,89.88,2.84,7.28,2019,95010
1496,0,202,1698,88.1,0.0,11.9,2019,95046
19051,465,4340,23856,79.86,1.95,18.19,2019,95076
9465,372,984,10821,87.47,3.44,9.09,2019,95117
10152,229,766,11147,91.07,2.05,6.87,2019,95118
11234,150,1280,12664,88.71,1.18,10.11,2019,95122
1861,10,158,2029,91.72,0.49,7.79,2019,90010
14228,1226,1061,16515,86.15,7.42,6.42,2019,90024
20313,413,1289,22015,92.27,1.88,5.86,2019,90025
10994,364,2639,13997,78.55,2.6,18.85,2019,90029
18215,1449,4800,24464,74.46,5.92,19.62,2019,90201
9507,246,1986,11739,80.99,2.1,16.92,2019,90031
10815,138,863,11816,91.53,1.17,7.3,2019,90035
9561,912,3213,13686,69.86,6.66,23.48,2019,90063
133,5,72,210,63.33,2.38,34.29,2019,89010
268,25,119,412,65.05,6.07,28.88,2019,89020
303,11,53,367,82.56,3.0,14.44,2019,89025
444,0,70,514,86.38,0.0,13.62,2019,89124
11678,1162,1969,14809,78.86,7.85,13.3,2019,89128
15902,281,609,16792,94.7,1.67,3.63,2019,89131
3789,299,125,4213,89.94,7.1,2.97,2019,89143
17175,358,1181,18714,91.78,1.91,6.31,2019,89148
13038,1128,659,14825,87.95,7.61,4.45,2019,89149
16266,252,346,16864,96.45,1.49,2.05,2019,80127
6893,142,175,7210,95.6,1.97,2.43,2019,80132
8530,513,726,9769,87.32,5.25,7.43,2019,80202
12376,332,1593,14301,86.54,2.32,11.14,2019,80003
15596,669,2479,18744,83.21,3.57,13.23,2019,80012
3413,151,772,4336,78.71,3.48,17.8,2019,80216
314,13,145,472,66.53,2.75,30.72,2019,73450
117,14,102,233,50.21,6.01,43.78,2019,73455
158,10,101,269,58.74,3.72,37.55,2019,73461
236,33,85,354,66.67,9.32,24.01,2019,73481
41,1,28,70,58.57,1.43,40.0,2019,73520
102,11,14,127,80.31,8.66,11.02,2019,73531
182,4,26,212,85.85,1.89,12.26,2019,73559
156,2,53,211,73.93,0.95,25.12,2019,73564
1055,50,455,1560,67.63,3.21,29.17,2019,77485
9177,240,1392,10809,84.9,2.22,12.88,2019,77502
2039,152,389,2580,79.03,5.89,15.08,2019,77547
173,0,95,268,64.55,0.0,35.45,2019,77597
212,3,129,344,61.63,0.87,37.5,2019,77629
7149,270,1172,8591,83.21,3.14,13.64,2019,77632
8553,139,5034,13726,62.31,1.01,36.67,2019,77642
794,31,195,1020,77.84,3.04,19.12,2019,77664
2384,81,2252,4717,50.54,1.72,47.74,2019,77701
590,10,0,600,98.33,1.67,0.0,2019,77010
6121,201,2348,8670,70.6,2.32,27.08,2019,77020
7659,492,2569,10720,71.45,4.59,23.96,2019,77021
4636,169,253,5058,91.66,3.34,5.0,2019,77030
2807,94,2235,5136,54.65,1.83,43.52,2019,77037
7990,173,2228,10391,76.89,1.66,21.44,2019,77045
19572,416,2320,22308,87.74,1.86,10.4,2019,77082
30346,749,3987,35082,86.5,2.13,11.36,2019,77084
8359,193,1951,10503,79.59,1.84,18.58,2019,77301
7677,272,479,8428,91.09,3.23,5.68,2019,77316
5404,122,750,6276,86.11,1.94,11.95,2019,77318
9358,453,1457,11268,83.05,4.02,12.93,2019,77340
20344,299,801,21444,94.87,1.39,3.74,2019,77346
8908,251,475,9634,92.46,2.61,4.93,2019,77355
18237,730,1621,20588,88.58,3.55,7.87,2019,77373
1200,10,392,1602,74.91,0.62,24.47,2019,77434
466,41,303,810,57.53,5.06,37.41,2019,77446
141,0,88,229,61.57,0.0,38.43,2019,77466
15251,169,1796,17216,88.59,0.98,10.43,2019,77469
3906,13,650,4569,85.49,0.28,14.23,2019,77336
3317,6,47,3370,98.43,0.18,1.39,2019,77094
10494,509,1992,12995,80.75,3.92,15.33,2019,77096
26108,394,1151,27653,94.41,1.42,4.16,2019,77379
17274,210,697,18181,95.01,1.16,3.83,2019,77386
11575,68,391,12034,96.19,0.57,3.25,2019,77389
4490,175,1502,6167,72.81,2.84,24.36,2019,77437
14,0,6,20,70.0,0.0,30.0,2019,77451
2032,40,560,2632,77.2,1.52,21.28,2019,77465
28579,228,668,29475,96.96,0.77,2.27,2019,77479
5,0,25,30,16.67,0.0,83.33,2019,77481
257,17,165,439,58.54,3.87,37.59,2019,77853
4362,44,530,4936,88.37,0.89,10.74,2019,77651
6877,391,2422,9690,70.97,4.04,24.99,2019,77803
908,12,266,1186,76.56,1.01,22.43,2019,77830
1780,61,630,2471,72.04,2.47,25.5,2019,77859
1893,156,720,2769,68.36,5.63,26.0,2019,77864
26,0,21,47,55.32,0.0,44.68,2019,77867
3616,78,854,4548,79.51,1.72,18.78,2019,77474
3459,180,1726,5365,64.47,3.36,32.17,2019,77488
6662,116,974,7752,85.94,1.5,12.56,2019,77503
4541,54,642,5237,86.71,1.03,12.26,2019,77510
17178,418,2419,20015,85.83,2.09,12.09,2019,77521
94,10,70,174,54.02,5.75,40.23,2019,62444
3240,79,759,4078,79.45,1.94,18.61,2019,62454
95,0,15,110,86.36,0.0,13.64,2019,62459
270,4,43,317,85.17,1.26,13.56,2019,62461
407,19,85,511,79.65,3.72,16.63,2019,62463
4822,206,1158,6186,77.95,3.33,18.72,2019,62522
234,0,152,386,60.62,0.0,39.38,2019,62523
10596,440,3230,14266,74.27,3.08,22.64,2019,62526
116,1,43,160,72.5,0.62,26.88,2019,62556
648,39,118,805,80.5,4.84,14.66,2019,62612
1725,65,360,2150,80.23,3.02,16.74,2019,62644
7987,449,2050,10486,76.17,4.28,19.55,2019,62650
326,7,55,388,84.02,1.8,14.18,2019,62682
1922,86,101,2109,91.13,4.08,4.79,2019,62684
254,9,42,305,83.28,2.95,13.77,2019,62688
490,15,129,634,77.29,2.37,20.35,2019,62808
51,3,8,62,82.26,4.84,12.9,2019,62820
2820,105,1079,4004,70.43,2.62,26.95,2019,62837
99,8,28,135,73.33,5.93,20.74,2019,62850
3226,181,761,4168,77.4,4.34,18.26,2019,62863
144,2,58,204,70.59,0.98,28.43,2019,62874
132,3,102,237,55.7,1.27,43.04,2019,62954
360,2,34,396,90.91,0.51,8.59,2019,62894
3541,91,662,4294,82.46,2.12,15.42,2019,62918
121,0,52,173,69.94,0.0,30.06,2019,62943
523,21,109,653,80.09,3.22,16.69,2019,62974
338,1,208,547,61.79,0.18,38.03,2019,62987
449,0,137,586,76.62,0.0,23.38,2019,62830
155,8,22,185,83.78,4.32,11.89,2019,62833
598,20,240,858,69.7,2.33,27.97,2019,62849
980,36,230,1246,78.65,2.89,18.46,2019,62939
652,29,323,1004,64.94,2.89,32.17,2019,62910
523,7,339,869,60.18,0.81,39.01,2019,62926
711,19,381,1111,64.0,1.71,34.29,2019,62938
134,33,77,244,54.92,13.52,31.56,2019,62941
140,13,25,178,78.65,7.3,14.04,2019,62996
5953,211,907,7071,84.19,2.98,12.83,2019,62208
427,1,111,539,79.22,0.19,20.59,2019,62214
10744,495,2329,13568,79.19,3.65,17.17,2019,62002
496,26,161,683,72.62,3.81,23.57,2019,62009
1473,79,704,2256,65.29,3.5,31.21,2019,75839
40,0,15,55,72.73,0.0,27.27,2019,75848
14,0,13,27,51.85,0.0,48.15,2019,75849
0,0,0,0,,,,2019,75858
10686,203,1641,12530,85.28,1.62,13.1,2019,75904
471,26,155,652,72.24,3.99,23.77,2019,75932
240,18,81,339,70.8,5.31,23.89,2019,75937
1921,175,1098,3194,60.14,5.48,34.38,2019,75956
694,60,329,1083,64.08,5.54,30.38,2019,75973
14636,466,6618,21720,67.38,2.15,30.47,2019,75211
368,28,147,543,67.77,5.16,27.07,2019,75449
493,46,85,624,79.01,7.37,13.62,2019,75480
1615,50,238,1903,84.87,2.63,12.51,2019,75459
180,38,117,335,53.73,11.34,34.93,2019,75468
29,5,26,60,48.33,8.33,43.33,2019,75475
560,44,122,726,77.13,6.06,16.8,2019,75487
762,23,170,955,79.79,2.41,17.8,2019,75490
7915,257,1393,9565,82.75,2.69,14.56,2019,75503
499,23,200,722,69.11,3.19,27.7,2019,75555
1357,40,414,1811,74.93,2.21,22.86,2019,79088
68,0,0,68,100.0,0.0,0.0,2019,79093
268,12,31,311,86.17,3.86,9.97,2019,79097
3566,110,853,4529,78.74,2.43,18.83,2019,79007
4,0,10,14,28.57,0.0,71.43,2019,79025
1108,39,410,1557,71.16,2.5,26.33,2019,79027
263,13,102,378,69.58,3.44,26.98,2019,79039
195,3,71,269,72.49,1.12,26.39,2019,79044
20,0,7,27,74.07,0.0,25.93,2019,79053
589,12,141,742,79.38,1.62,19.0,2019,79084
536,113,441,1090,49.17,10.37,40.46,2019,79101
8086,770,2705,11561,69.94,6.66,23.4,2019,79107
6849,337,807,7993,85.69,4.22,10.1,2019,79118
2288,16,234,2538,90.15,0.63,9.22,2019,79121
130,6,24,160,81.25,3.75,15.0,2019,79229
0,0,28,28,0.0,0.0,100.0,2019,79231
400,5,131,536,74.63,0.93,24.44,2019,79250
8674,516,2466,11656,74.42,4.43,21.16,2019,79106
29,0,14,43,67.44,0.0,32.56,2019,79230
39,3,25,67,58.21,4.48,37.31,2019,79233
915,24,382,1321,69.27,1.82,28.92,2019,79235
18,0,0,18,100.0,0.0,0.0,2019,79243
592,40,311,943,62.78,4.24,32.98,2019,79245
204,15,41,260,78.46,5.77,15.77,2019,79255
372,19,143,534,69.66,3.56,26.78,2019,79313
12,0,6,18,66.67,0.0,33.33,2019,79314
398,51,105,554,71.84,9.21,18.95,2019,79343
2537,117,351,3005,84.43,3.89,11.68,2019,79364
335,8,97,440,76.14,1.82,22.05,2019,79372
753,4,339,1096,68.7,0.36,30.93,2019,79373
1799,1176,327,3302,54.48,35.61,9.9,2019,79401
0,0,0,0,,,,2019,79406
71,2,15,88,80.68,2.27,17.05,2019,79535
18,0,4,22,81.82,0.0,18.18,2019,79537
159,3,85,247,64.37,1.21,34.41,2019,79544
6879,118,1352,8349,82.39,1.41,16.19,2019,79602
142,0,42,184,77.17,0.0,22.83,2019,79713
45,17,6,68,66.18,25.0,8.82,2019,79733
63,0,15,78,80.77,0.0,19.23,2019,79738
313,0,244,557,56.19,0.0,43.81,2019,79855
651,38,104,793,82.09,4.79,13.11,2019,61849
504,12,81,597,84.42,2.01,13.57,2019,61865
482,25,66,573,84.12,4.36,11.52,2019,61878
217,15,71,303,71.62,4.95,23.43,2019,61882
1371,48,272,1691,81.08,2.84,16.09,2019,61883
165,1,45,211,78.2,0.47,21.33,2019,61932
559,17,176,752,74.34,2.26,23.4,2019,61957
2931,12,129,3072,95.41,0.39,4.2,2019,61525
938,52,51,1041,90.11,5.0,4.9,2019,61528
781,25,240,1046,74.67,2.39,22.94,2019,61540
47,1,15,63,74.6,1.59,23.81,2019,61543
1275,31,170,1476,86.38,2.1,11.52,2019,61547
327,7,44,378,86.51,1.85,11.64,2019,61564
9414,292,1156,10862,86.67,2.69,10.64,2019,80222
6622,254,1184,8060,82.16,3.15,14.69,2019,80223
9403,199,904,10506,89.5,1.89,8.6,2019,80234
3442,47,253,3742,91.98,1.26,6.76,2019,80235
10229,204,2068,12501,81.83,1.63,16.54,2019,80239
0,0,0,0,,,,2019,80294
2080,84,166,2330,89.27,3.61,7.12,2019,80435
873,13,93,979,89.17,1.33,9.5,2019,80467
191,0,21,212,90.09,0.0,9.91,2019,80469
113,0,13,126,89.68,0.0,10.32,2019,80510
9277,108,256,9641,96.22,1.12,2.66,2019,80516
26,0,36,62,41.94,0.0,58.06,2019,80929
1141,20,86,1247,91.5,1.6,6.9,2019,80643
40,0,30,70,57.14,0.0,42.86,2019,80532
13182,880,3347,17409,75.72,5.05,19.23,2019,80631
3293,38,241,3572,92.19,1.06,6.75,2019,80640
464,14,87,565,82.12,2.48,15.4,2019,80650
353,6,96,455,77.58,1.32,21.1,2019,80705
504,42,125,671,75.11,6.26,18.63,2019,80737
286,14,64,364,78.57,3.85,17.58,2019,80741
1476,40,285,1801,81.95,2.22,15.82,2019,80759
494,29,204,727,67.95,3.99,28.06,2019,80813
48,0,9,57,84.21,0.0,15.79,2019,80823
224,14,33,271,82.66,5.17,12.18,2019,80833
347,24,66,437,79.41,5.49,15.1,2019,80836
603,6,20,629,95.87,0.95,3.18,2019,80840
21744,348,587,22679,95.88,1.53,2.59,2019,80015
18496,313,394,19203,96.32,1.63,2.05,2019,80016
37,8,29,74,50.0,10.81,39.19,2019,80024
68,0,0,68,100.0,0.0,0.0,2019,80025
4710,132,1179,6021,78.23,2.19,19.58,2019,80030
10589,117,406,11112,95.29,1.05,3.65,2019,80104
1610,54,125,1789,89.99,3.02,6.99,2019,80136
390,27,77,494,78.95,5.47,15.59,2019,80105
12117,291,397,12805,94.63,2.27,3.1,2019,80111
18370,314,1071,19755,92.99,1.59,5.42,2019,80123
14786,198,408,15392,96.06,1.29,2.65,2019,80126
931,17,108,1056,88.16,1.61,10.23,2019,80133
7350,245,715,8310,88.45,2.95,8.6,2019,80215
1457,21,62,1540,94.61,1.36,4.03,2019,80116
12291,474,1171,13936,88.2,3.4,8.4,2019,80120
13407,242,1568,15217,88.11,1.59,10.3,2019,80205
18105,535,3261,21901,82.67,2.44,14.89,2019,80219
14228,494,1239,15961,89.14,3.1,7.76,2019,80220
13477,291,626,14394,93.63,2.02,4.35,2019,80228
3833,44,355,4232,90.57,1.04,8.39,2019,80230
5817,43,662,6522,89.19,0.66,10.15,2019,80236
9958,198,659,10815,92.08,1.83,6.09,2019,80237
10822,210,478,11510,94.02,1.82,4.15,2019,80241
9292,208,803,10303,90.19,2.02,7.79,2019,80249
9229,283,2325,11837,77.97,2.39,19.64,2019,80260
0,0,0,0,,,,2019,80264
0,0,0,0,,,,2019,80293
42,0,0,42,100.0,0.0,0.0,2019,84334
29,0,13,42,69.05,0.0,30.95,2019,84336
3568,115,324,4007,89.04,2.87,8.09,2019,84337
133,6,7,146,91.1,4.11,4.79,2019,84338
553,11,75,639,86.54,1.72,11.74,2019,84523
67,0,23,90,74.44,0.0,25.56,2019,84539
400,4,15,419,95.47,0.95,3.58,2019,76250
935,118,299,1352,69.16,8.73,22.12,2019,76943
13706,370,1305,15381,89.11,2.41,8.48,2019,76108
19,0,0,19,100.0,0.0,0.0,2019,76061
2046,124,299,2469,82.87,5.02,12.11,2019,76084
7877,281,949,9107,86.49,3.09,10.42,2019,76114
5643,244,1056,6943,81.28,3.51,15.21,2019,76120
16457,410,1028,17895,91.96,2.29,5.74,2019,76549
94,1,76,171,54.97,0.58,44.44,2019,75493
1434,27,375,1836,78.1,1.47,20.42,2019,75640
908,38,178,1124,80.78,3.38,15.84,2019,75770
3907,307,266,4480,87.21,6.85,5.94,2019,75762
1672,71,800,2543,65.75,2.79,31.46,2019,75844
293,18,72,383,76.5,4.7,18.8,2019,75959
3793,122,1939,5854,64.79,2.08,33.12,2019,75801
2320,89,558,2967,78.19,3.0,18.81,2019,75783
190,12,65,267,71.16,4.49,24.34,2019,75784
782,2,214,998,78.36,0.2,21.44,2019,75792
773,60,320,1153,67.04,5.2,27.75,2019,75846
1240,28,531,1799,68.93,1.56,29.52,2019,75860
678,25,247,950,71.37,2.63,26.0,2019,75931
3360,159,1180,4699,71.5,3.38,25.11,2019,75935
47,4,0,51,92.16,7.84,0.0,2019,75942
3865,282,1551,5698,67.83,4.95,27.22,2019,75951
42,0,6,48,87.5,0.0,12.5,2019,75978
2417,268,990,3675,65.77,7.29,26.94,2019,75979
728,26,243,997,73.02,2.61,24.37,2019,75938
649,31,243,923,70.31,3.36,26.33,2019,75851
2274,178,651,3103,73.28,5.74,20.98,2019,75949
3444,17,25,3486,98.8,0.49,0.72,2019,75054
16709,305,800,17814,93.8,1.71,4.49,2019,75071
1460,9,234,1703,85.73,0.53,13.74,2019,75109
4978,255,1497,6730,73.97,3.79,22.24,2019,75156
54,2,42,98,55.1,2.04,42.86,2019,75157
9922,234,1681,11837,83.82,1.98,14.2,2019,75254
0,0,0,0,,,,2019,75390
4,0,15,19,21.05,0.0,78.95,2019,75642
3113,87,501,3701,84.11,2.35,13.54,2019,75645
116,15,40,171,67.84,8.77,23.39,2019,75682
2261,147,399,2807,80.55,5.24,14.21,2019,75752
16,13,6,35,45.71,37.14,17.14,2019,75779
54,0,0,54,100.0,0.0,0.0,2019,75780
4371,96,1563,6030,72.49,1.59,25.92,2019,75803
0,0,9,9,0.0,0.0,100.0,2019,75832
0,0,0,0,,,,2019,75962
295,13,65,373,79.09,3.49,17.43,2019,75438
881,52,417,1350,65.26,3.85,30.89,2019,75974
202,0,65,267,75.66,0.0,24.34,2019,75976
6397,121,1086,7604,84.13,1.59,14.28,2019,75965
2403,36,536,2975,80.77,1.21,18.02,2019,77480
7710,57,410,8177,94.29,0.7,5.01,2019,77505
8841,596,1394,10831,81.63,5.5,12.87,2019,77515
247,19,138,404,61.14,4.7,34.16,2019,77519
4822,336,950,6108,78.95,5.5,15.55,2019,77531
748,5,63,816,91.67,0.61,7.72,2019,77534
9806,261,596,10663,91.96,2.45,5.59,2019,77536
235,4,107,346,67.92,1.16,30.92,2019,77538
16895,126,639,17660,95.67,0.71,3.62,2019,77546
3481,128,675,4284,81.26,2.99,15.76,2019,77563
725,9,295,1029,70.46,0.87,28.67,2019,75568
1033,41,415,1489,69.38,2.75,27.87,2019,75975
8908,230,1409,10547,84.46,2.18,13.36,2019,75901
311,24,35,370,84.05,6.49,9.46,2019,75928
1991,77,575,2643,75.33,2.91,21.76,2019,75948
737,2,225,964,76.45,0.21,23.34,2019,75954
142,0,115,257,55.25,0.0,44.75,2019,75960
7490,119,520,8129,92.14,1.46,6.4,2019,75001
14067,57,445,14569,96.55,0.39,3.05,2019,75013
8172,103,97,8372,97.61,1.23,1.16,2019,75022
36572,794,806,38172,95.81,2.08,2.11,2019,75034
16298,284,1713,18295,89.08,1.55,9.36,2019,75040
11624,432,2637,14693,79.11,2.94,17.95,2019,75050
26924,330,2421,29675,90.73,1.11,8.16,2019,75052
13328,347,3570,17245,77.29,2.01,20.7,2019,75061
15383,251,485,16119,95.43,1.56,3.01,2019,75063
8162,72,252,8486,96.18,0.85,2.97,2019,75078
14145,153,731,15029,94.12,1.02,4.86,2019,75081
7726,256,1527,9509,81.25,2.69,16.06,2019,75119
1198,24,495,1717,69.77,1.4,28.83,2019,75124
5739,230,904,6873,83.5,3.35,13.15,2019,75146
898,152,334,1384,64.88,10.98,24.13,2019,75172
7802,52,186,8040,97.04,0.65,2.31,2019,75181
19227,372,1320,20919,91.91,1.78,6.31,2019,75206
17765,233,1467,19465,91.27,1.2,7.54,2019,75007
3873,72,262,4207,92.06,1.71,6.23,2019,75009
6788,236,1871,8895,76.31,2.65,21.03,2019,75020
22545,579,1688,24812,90.86,2.33,6.8,2019,75067
16957,724,1175,18856,89.93,3.84,6.23,2019,75080
5934,551,1908,8393,70.7,6.56,22.73,2019,75090
14438,257,926,15621,92.43,1.65,5.93,2019,75104
7653,102,2180,9935,77.03,1.03,21.94,2019,75110
1674,138,525,2337,71.63,5.91,22.46,2019,75140
103,0,25,128,80.47,0.0,19.53,2019,75153
4123,340,896,5359,76.94,6.34,16.72,2019,75159
1479,112,515,2106,70.23,5.32,24.45,2019,75161
1231,48,110,1389,88.62,3.46,7.92,2019,75166
3922,202,1255,5379,72.91,3.76,23.33,2019,75169
8614,273,371,9258,93.04,2.95,4.01,2019,75189
1686,22,23,1731,97.4,1.27,1.33,2019,75207
163,57,111,331,49.24,17.22,33.53,2019,77857
716,21,111,848,84.43,2.48,13.09,2019,77861
3462,158,1039,4659,74.31,3.39,22.3,2019,77868
33,0,0,33,100.0,0.0,0.0,2019,77876
344,0,157,501,68.66,0.0,31.34,2019,77880
3858,280,1346,5484,70.35,5.11,24.54,2019,77905
37,0,28,65,56.92,0.0,43.08,2019,77960
1286,122,601,2009,64.01,6.07,29.92,2019,77963
208,7,53,268,77.61,2.61,19.78,2019,77978
6961,109,661,7731,90.04,1.41,8.55,2019,77657
3707,86,1159,4952,74.86,1.74,23.4,2019,77708
7578,260,2325,10163,74.56,2.56,22.88,2019,77833
22607,630,1106,24343,92.87,2.59,4.54,2019,77845
867,56,204,1127,76.93,4.97,18.1,2019,77871
135,0,35,170,79.41,0.0,20.59,2019,77878
2886,149,867,3902,73.96,3.82,22.22,2019,77995
10539,399,2480,13418,78.54,2.97,18.48,2019,77004
14436,323,1578,16337,88.36,1.98,9.66,2019,77008
11661,464,847,12972,89.89,3.58,6.53,2019,77006
2816,103,341,3260,86.38,3.16,10.46,2019,78722
19235,349,1022,20606,93.35,1.69,4.96,2019,78664
14942,226,610,15778,94.7,1.43,3.87,2019,78232
412,167,61,640,64.38,26.09,9.53,2019,78235
6805,786,1536,9127,74.56,8.61,16.83,2019,78238
19969,229,1507,21705,92.0,1.06,6.94,2019,78245
15767,909,747,17423,90.5,5.22,4.29,2019,78247
11735,219,398,12352,95.0,1.77,3.22,2019,78253
3980,181,110,4271,93.19,4.24,2.58,2019,78256
8898,243,308,9449,94.17,2.57,3.26,2019,78259
7878,107,355,8340,94.46,1.28,4.26,2019,78260
118,0,39,157,75.16,0.0,24.84,2019,78339
317,8,305,630,50.32,1.27,48.41,2019,78359
940,12,697,1649,57.0,0.73,42.27,2019,78361
37,12,79,128,28.91,9.38,61.72,2019,78369
1036,29,463,1528,67.8,1.9,30.3,2019,78370
1806,101,268,2175,83.03,4.64,12.32,2019,78373
891,18,312,1221,72.97,1.47,25.55,2019,78377
7047,182,1099,8328,84.62,2.19,13.2,2019,78382
77,0,96,173,44.51,0.0,55.49,2019,78385
1220,20,525,1765,69.12,1.13,29.75,2019,78002
665,0,355,1020,65.2,0.0,34.8,2019,78017
0,0,0,0,,,,2019,78001
37,5,18,60,61.67,8.33,30.0,2019,78007
379,0,199,578,65.57,0.0,34.43,2019,78011
2407,197,1002,3606,66.75,5.46,27.79,2019,78016
2488,113,1511,4112,60.51,2.75,36.75,2019,78076
1478,43,211,1732,85.33,2.48,12.18,2019,78947
198,0,70,268,73.88,0.0,26.12,2019,78948
2444,132,889,3465,70.53,3.81,25.66,2019,78957
1345,46,504,1895,70.98,2.43,26.6,2019,78962
23,0,63,86,26.74,0.0,73.26,2019,78075
143,6,58,207,69.08,2.9,28.02,2019,78117
3728,134,404,4266,87.39,3.14,9.47,2019,78121
13548,322,3489,17359,78.05,1.85,20.1,2019,78155
28940,563,1382,30885,93.7,1.82,4.47,2019,78660
8944,348,253,9545,93.7,3.65,2.65,2019,78703
3292,141,775,4208,78.23,3.35,18.42,2019,78721
5535,128,214,5877,94.18,2.18,3.64,2019,78726
21905,1193,1973,25071,87.37,4.76,7.87,2019,78704
2561,89,125,2775,92.29,3.21,4.5,2019,78725
6637,22,36,6695,99.13,0.33,0.54,2019,78739
149,7,115,271,54.98,2.58,42.44,2019,78742
1518,160,731,2409,63.01,6.64,30.34,2019,78834
10842,478,845,12165,89.12,3.93,6.95,2019,78006
96,0,156,252,38.1,0.0,61.9,2019,78008
610,17,306,933,65.38,1.82,32.8,2019,78375
108,2,39,149,72.48,1.34,26.17,2019,78340
48,0,27,75,64.0,0.0,36.0,2019,78371
689,14,846,1549,44.48,0.9,54.62,2019,78372
126,0,70,196,64.29,0.0,35.71,2019,78376
369,16,149,534,69.1,3.0,27.9,2019,78379
1168,27,409,1604,72.82,1.68,25.5,2019,78383
53,0,12,65,81.54,0.0,18.46,2019,62359
793,39,177,1009,78.59,3.87,17.54,2019,62548
387,9,80,476,81.3,1.89,16.81,2019,62567
4947,181,1435,6563,75.38,2.76,21.87,2019,62568
324,2,36,362,89.5,0.55,9.94,2019,62627
153,10,43,206,74.27,4.85,20.87,2019,62643
18,0,0,18,100.0,0.0,0.0,2019,84540
9012,2542,329,11883,75.84,21.39,2.77,2019,84604
54,0,0,54,100.0,0.0,0.0,2019,84621
11054,616,685,12355,89.47,4.99,5.54,2019,84057
48,0,5,53,90.57,0.0,9.43,2019,84063
3495,101,493,4089,85.47,2.47,12.06,2019,84066
456,8,24,488,93.44,1.64,4.92,2019,84071
82,0,6,88,93.18,0.0,6.82,2019,84073
14559,225,1128,15912,91.5,1.41,7.09,2019,84074
90,0,7,97,92.78,0.0,7.22,2019,84080
10992,396,665,12053,91.2,3.29,5.52,2019,84084
12512,743,1069,14324,87.35,5.19,7.46,2019,84106
7643,203,853,8699,87.86,2.33,9.81,2019,84302
89,1,21,111,80.18,0.9,18.92,2019,84734
955,55,235,1245,76.71,4.42,18.88,2019,84713
65,0,21,86,75.58,0.0,24.42,2019,84718
6573,398,569,7540,87.18,5.28,7.55,2019,84720
91,0,6,97,93.81,0.0,6.19,2019,84730
17,3,0,20,85.0,15.0,0.0,2019,84732
1205,23,109,1337,90.13,1.72,8.15,2019,84745
63,5,23,91,69.23,5.49,25.27,2019,84764
13105,492,1521,15118,86.68,3.25,10.06,2019,84770
185,11,9,205,90.24,5.37,4.39,2019,84636
114,0,6,120,95.0,0.0,5.0,2019,84638
215,8,77,300,71.67,2.67,25.67,2019,84639
1025,45,131,1201,85.35,3.75,10.91,2019,84642
619,32,105,756,81.88,4.23,13.89,2019,84645
3033,95,247,3375,89.87,2.81,7.32,2019,84655
93,1,33,127,73.23,0.79,25.98,2019,84656
483,2,39,524,92.18,0.38,7.44,2019,84662
246,0,95,341,72.14,0.0,27.86,2019,84714
70,0,15,85,82.35,0.0,17.65,2019,84736
260,12,109,381,68.24,3.15,28.61,2019,84747
2096,86,13,2195,95.49,3.92,0.59,2019,84765
445,4,21,470,94.68,0.85,4.47,2019,84774
7498,290,835,8623,86.95,3.36,9.68,2019,84780
310,8,28,346,89.6,2.31,8.09,2019,84783
183,2,29,214,85.51,0.93,13.55,2019,84001
12739,432,518,13689,93.06,3.16,3.78,2019,84003
5204,166,247,5617,92.65,2.96,4.4,2019,84014
238,15,88,341,69.79,4.4,25.81,2019,84026
168,5,42,215,78.14,2.33,19.53,2019,84027
58,5,22,85,68.24,5.88,25.88,2019,84031
101,6,7,114,88.6,5.26,6.14,2019,84038
2042,29,126,2197,92.94,1.32,5.74,2019,84049
2786,96,121,3003,92.77,3.2,4.03,2019,84060
189,15,0,204,92.65,7.35,0.0,2019,84061
80,0,0,80,100.0,0.0,0.0,2019,84076
7662,250,1091,9003,85.1,2.78,12.12,2019,84078
10393,298,677,11368,91.42,2.62,5.96,2019,84088
7580,560,1078,9218,82.23,6.08,11.69,2019,84102
8528,489,2284,11301,75.46,4.33,20.21,2019,84115
12170,410,1123,13703,88.81,2.99,8.2,2019,84120
175,5,9,189,92.59,2.65,4.76,2019,84758
917,52,220,1189,77.12,4.37,18.5,2019,84761
117,0,6,123,95.12,0.0,4.88,2019,84773
239,2,12,253,94.47,0.79,4.74,2019,84779
353,0,0,353,100.0,0.0,0.0,2019,84782
290,11,39,340,85.29,3.24,11.47,2019,84633
15718,192,1161,17071,92.07,1.12,6.8,2019,77581
8387,287,1246,9920,84.55,2.89,12.56,2019,77583
3088,426,1223,4737,65.19,8.99,25.82,2019,77587
166,0,91,257,64.59,0.0,35.41,2019,77616
130,9,143,282,46.1,3.19,50.71,2019,77624
3760,144,2276,6180,60.84,2.33,36.83,2019,77640
8002,317,1513,9832,81.39,3.22,15.39,2019,77662
1790,0,350,2140,83.64,0.0,16.36,2019,77665
443,6,120,569,77.86,1.05,21.09,2019,63655
3585,137,790,4512,79.45,3.04,17.51,2019,63670
12535,152,1668,14355,87.32,1.06,11.62,2019,63701
1092,6,386,1484,73.58,0.4,26.01,2019,63730
130,0,24,154,84.42,0.0,15.58,2019,63739
430,0,140,570,75.44,0.0,24.56,2019,63751
197,0,98,295,66.78,0.0,33.22,2019,63767
35,0,13,48,72.92,0.0,27.08,2019,63770
7124,215,2021,9360,76.11,2.3,21.59,2019,63801
745,30,222,997,74.72,3.01,22.27,2019,63822
338,40,117,495,68.28,8.08,23.64,2019,63823
21,0,4,25,84.0,0.0,16.0,2019,63743
336,4,106,446,75.34,0.9,23.77,2019,63748
398,1,69,468,85.04,0.21,14.74,2019,63769
205,4,86,295,69.49,1.36,29.15,2019,63787
34,2,27,63,53.97,3.17,42.86,2019,63820
202,5,147,354,57.06,1.41,41.53,2019,63821
56,0,36,92,60.87,0.0,39.13,2019,63833
115,0,37,152,75.66,0.0,24.34,2019,63839
74,0,19,93,79.57,0.0,20.43,2019,63860
274,13,87,374,73.26,3.48,23.26,2019,63870
21,3,5,29,72.41,10.34,17.24,2019,63878
2514,133,1019,3666,68.58,3.63,27.8,2019,63935
29,0,97,126,23.02,0.0,76.98,2019,63951
739,13,275,1027,71.96,1.27,26.78,2019,63966
14940,399,1364,16703,89.45,2.39,8.17,2019,63026
3337,104,504,3945,84.59,2.64,12.78,2019,63044
5981,58,525,6564,91.12,0.88,8.0,2019,63049
9158,97,593,9848,92.99,0.98,6.02,2019,63052
871,43,68,982,88.7,4.38,6.92,2019,63102
288,2,98,388,74.23,0.52,25.26,2019,63014
1133,13,211,1357,83.49,0.96,15.55,2019,63048
101,6,57,164,61.59,3.66,34.76,2019,63625
1122,58,502,1682,66.71,3.45,29.85,2019,63650
331,8,248,587,56.39,1.36,42.25,2019,63662
1517,22,341,1880,80.69,1.17,18.14,2019,63740
8009,162,1168,9339,85.76,1.73,12.51,2019,63755
71,0,14,85,83.53,0.0,16.47,2019,63758
1933,37,431,2401,80.51,1.54,17.95,2019,63780
1955,67,829,2851,68.57,2.35,29.08,2019,63830
1654,71,703,2428,68.12,2.92,28.95,2019,63845
493,15,125,633,77.88,2.37,19.75,2019,63846
292,10,103,405,72.1,2.47,25.43,2019,63855
42,0,37,79,53.16,0.0,46.84,2019,63784
37,0,5,42,88.1,0.0,11.9,2019,63824
758,53,101,912,83.11,5.81,11.07,2019,63015
2659,44,381,3084,86.22,1.43,12.35,2019,63016
11208,298,2617,14123,79.36,2.11,18.53,2019,77009
9478,558,1765,11801,80.32,4.73,14.96,2019,77014
4918,281,1097,6296,78.11,4.46,17.42,2019,77031
10610,467,1171,12248,86.63,3.81,9.56,2019,77034
13044,399,2015,15458,84.38,2.58,13.04,2019,77055
14214,558,3182,17954,79.17,3.11,17.72,2019,77072
9701,804,3259,13764,70.48,5.84,23.68,2019,77035
10030,219,1101,11350,88.37,1.93,9.7,2019,77041
1187,0,267,1454,81.64,0.0,18.36,2019,77050
15494,364,2895,18753,82.62,1.94,15.44,2019,77063
8477,357,1276,10110,83.85,3.53,12.62,2019,77071
8339,242,4259,12840,64.95,1.88,33.17,2019,77074
260,17,144,421,61.76,4.04,34.2,2019,74570
166,22,61,249,66.67,8.84,24.5,2019,74472
822,55,346,1223,67.21,4.5,28.29,2019,74435
1164,247,368,1779,65.43,13.88,20.69,2019,74436
27,0,23,50,54.0,0.0,46.0,2019,74459
59,0,28,87,67.82,0.0,32.18,2019,74521
109,0,21,130,83.85,0.0,16.15,2019,74522
63,0,18,81,77.78,0.0,22.22,2019,74528
196,4,144,344,56.98,1.16,41.86,2019,74531
224,20,96,340,65.88,5.88,28.24,2019,74533
444,15,194,653,67.99,2.3,29.71,2019,74536
218,11,63,292,74.66,3.77,21.58,2019,74546
904,50,464,1418,63.75,3.53,32.72,2019,74571
3871,320,804,4995,77.5,6.41,16.1,2019,74604
220,29,59,308,71.43,9.42,19.16,2019,74652
370,42,224,636,58.18,6.6,35.22,2019,74731
67,16,79,162,41.36,9.88,48.77,2019,74754
326,15,285,626,52.08,2.4,45.53,2019,74766
36,12,31,79,45.57,15.19,39.24,2019,74830
176,4,132,312,56.41,1.28,42.31,2019,74832
32,0,48,80,40.0,0.0,60.0,2019,74836
31,0,15,46,67.39,0.0,32.61,2019,74842
392,26,135,553,70.89,4.7,24.41,2019,74852
1299,63,429,1791,72.53,3.52,23.95,2019,74864
351,25,236,612,57.35,4.08,38.56,2019,74865
455,9,261,725,62.76,1.24,36.0,2019,74880
1058,81,750,1889,56.01,4.29,39.7,2019,74937
473,81,140,694,68.16,11.67,20.17,2019,74450
13422,461,1246,15129,88.72,3.05,8.24,2019,79423
17301,529,1026,18856,91.75,2.81,5.44,2019,79424
287,42,157,486,59.05,8.64,32.3,2019,79511
66,0,11,77,85.71,0.0,14.29,2019,79517
738,24,505,1267,58.25,1.89,39.86,2019,79521
137,6,71,214,64.02,2.8,33.18,2019,79530
1396,84,490,1970,70.86,4.26,24.87,2019,79536
146,12,83,241,60.58,4.98,34.44,2019,79561
360,31,126,517,69.63,6.0,24.37,2019,79043
26,0,7,33,78.79,0.0,21.21,2019,79032
12,0,17,29,41.38,0.0,58.62,2019,79033
349,16,84,449,77.73,3.56,18.71,2019,79042
79,0,26,105,75.24,0.0,24.76,2019,79011
443,0,76,519,85.36,0.0,14.64,2019,79012
2679,119,600,3398,78.84,3.5,17.66,2019,79022
348,13,121,482,72.2,2.7,25.1,2019,79031
517,45,148,710,72.82,6.34,20.85,2019,79083
48,0,47,95,50.53,0.0,49.47,2019,79239
751,28,101,880,85.34,3.18,11.48,2019,79241
897,6,72,975,92.0,0.62,7.38,2019,61748
672,25,166,863,77.87,2.9,19.24,2019,61756
9093,1532,992,11617,78.27,13.19,8.54,2019,61801
100,5,9,114,87.72,4.39,7.89,2019,61810
216,0,35,251,86.06,0.0,13.94,2019,61453
988,84,284,1356,72.86,6.19,20.94,2019,61434
500,25,210,735,68.03,3.4,28.57,2019,61450
86,0,25,111,77.48,0.0,22.52,2019,61452
1241,50,287,1578,78.64,3.17,18.19,2019,61738
456,23,104,583,78.22,3.95,17.84,2019,61740
955,41,180,1176,81.21,3.49,15.31,2019,61753
1655,15,195,1865,88.74,0.8,10.46,2019,61755
170,0,71,241,70.54,0.0,29.46,2019,61778
526,14,118,658,79.94,2.13,17.93,2019,61813
10573,264,3373,14210,74.41,1.86,23.74,2019,61832
663,56,284,1003,66.1,5.58,28.32,2019,61833
69,0,11,80,86.25,0.0,13.75,2019,61848
437,4,53,494,88.46,0.81,10.73,2019,61859
119,2,18,139,85.61,1.44,12.95,2019,61871
174,12,63,249,69.88,4.82,25.3,2019,61872
393,9,16,418,94.02,2.15,3.83,2019,61884
226,0,35,261,86.59,0.0,13.41,2019,61925
7,0,41,48,14.58,0.0,85.42,2019,61941
445,3,47,495,89.9,0.61,9.49,2019,61001
804,33,130,967,83.14,3.41,13.44,2019,61024
749,36,135,920,81.41,3.91,14.67,2019,61030
541,9,138,688,78.63,1.31,20.06,2019,61047
39,0,0,39,100.0,0.0,0.0,2019,61057
54,2,17,73,73.97,2.74,23.29,2019,61059
2310,97,588,2995,77.13,3.24,19.63,2019,61061
305,2,47,354,86.16,0.56,13.28,2019,61067
4533,250,955,5738,79.0,4.36,16.64,2019,61068
176,0,36,212,83.02,0.0,16.98,2019,61007
10099,237,1696,12032,83.93,1.97,14.1,2019,61008
2740,49,191,2980,91.95,1.64,6.41,2019,61010
292,0,49,341,85.63,0.0,14.37,2019,61015
2650,50,328,3028,87.52,1.65,10.83,2019,61036
305,11,35,351,86.89,3.13,9.97,2019,61039
90,0,27,117,76.92,0.0,23.08,2019,61044
857,14,162,1033,82.96,1.36,15.68,2019,61046
7009,194,1448,8651,81.02,2.24,16.74,2019,61081
522,47,137,706,73.94,6.66,19.41,2019,61087
31,0,0,31,100.0,0.0,0.0,2019,61091
5769,229,669,6667,86.53,3.43,10.03,2019,61114
1800,39,392,2231,80.68,1.75,17.57,2019,61231
979,75,181,1235,79.27,6.07,14.66,2019,61238
2312,110,427,2849,81.15,3.86,14.99,2019,61241
7236,257,1538,9031,80.12,2.85,17.03,2019,61244
122,0,25,147,82.99,0.0,17.01,2019,61251
15976,398,2800,19174,83.32,2.08,14.6,2019,61265
418,8,91,517,80.85,1.55,17.6,2019,61272
857,7,132,996,86.04,0.7,13.25,2019,61281
3342,93,624,4059,82.34,2.29,15.37,2019,61301
37,0,18,55,67.27,0.0,32.73,2019,84640
95,2,19,116,81.9,1.72,16.38,2019,84667
51,0,3,54,94.44,0.0,5.56,2019,84712
416,18,53,487,85.42,3.7,10.88,2019,84725
77,7,5,89,86.52,7.87,5.62,2019,84729
77,0,10,87,88.51,0.0,11.49,2019,84744
451,32,191,674,66.91,4.75,28.34,2019,84751
17,0,7,24,70.83,0.0,29.17,2019,84755
78,0,13,91,85.71,0.0,14.29,2019,84766
272,0,148,420,64.76,0.0,35.24,2019,84083
122,4,0,126,96.83,3.17,0.0,2019,84086
6631,111,246,6988,94.89,1.59,3.52,2019,84098
8506,247,645,9398,90.51,2.63,6.86,2019,84105
7175,146,549,7870,91.17,1.86,6.98,2019,84124
2425,53,76,2554,94.95,2.08,2.98,2019,84315
100,0,8,108,92.59,0.0,7.41,2019,84002
63,0,6,69,91.3,0.0,8.7,2019,84023
84,0,10,94,89.36,0.0,10.64,2019,84046
128,0,27,155,82.58,0.0,17.42,2019,84072
7288,277,266,7831,93.07,3.54,3.4,2019,84075
299,10,27,336,88.99,2.98,8.04,2019,84006
1175,11,154,1340,87.69,0.82,11.49,2019,84017
17519,486,1622,19627,89.26,2.48,8.26,2019,84015
215,33,203,451,47.67,7.32,45.01,2019,85530
3501,217,551,4269,82.01,5.08,12.91,2019,85735
14389,415,2333,17137,83.96,2.42,13.61,2019,85018
16258,413,1508,18179,89.43,2.27,8.3,2019,85207
7625,350,1821,9796,77.84,3.57,18.59,2019,85043
11909,231,560,12700,93.77,1.82,4.41,2019,85233
76,0,60,136,55.88,0.0,44.12,2019,85328
3803,45,1416,5264,72.25,0.85,26.9,2019,85607
2511,78,573,3162,79.41,2.47,18.12,2019,85929
12770,432,1569,14771,86.45,2.92,10.62,2019,85042
6297,88,82,6467,97.37,1.36,1.27,2019,85083
5862,156,387,6405,91.52,2.44,6.04,2019,85118
8480,434,1694,10608,79.94,4.09,15.97,2019,85119
10665,517,2959,14141,75.42,3.66,20.92,2019,85120
182,0,318,500,36.4,0.0,63.6,2019,85121
16175,576,2329,19080,84.77,3.02,12.21,2019,85122
3513,194,830,4537,77.43,4.28,18.29,2019,85123
3463,223,853,4539,76.29,4.91,18.79,2019,85128
2520,172,843,3535,71.29,4.87,23.85,2019,85131
7554,129,397,8080,93.49,1.6,4.91,2019,85028
14057,348,4018,18423,76.3,1.89,21.81,2019,89115
11117,384,988,12489,89.01,3.07,7.91,2019,89130
10901,207,495,11603,93.95,1.78,4.27,2019,89141
17720,404,2435,20559,86.19,1.97,11.84,2019,89147
1228,20,345,1593,77.09,1.26,21.66,2019,89419
133,4,93,230,57.83,1.74,40.43,2019,89421
29,0,67,96,30.21,0.0,69.79,2019,89425
11679,517,2741,14937,78.19,3.46,18.35,2019,89431
5170,172,910,6252,82.69,2.75,14.56,2019,89445
3901,47,651,4599,84.82,1.02,14.16,2019,89703
0,0,0,0,,,,2019,89191
4265,37,536,4838,88.16,0.76,11.08,2019,89410
0,0,7,7,0.0,0.0,100.0,2019,89420
51,0,37,88,57.95,0.0,42.05,2019,89428
546,13,73,632,86.39,2.06,11.55,2019,89439
1361,0,69,1430,95.17,0.0,4.83,2019,89449
1647,72,401,2120,77.69,3.4,18.92,2019,63023
1015,17,216,1248,81.33,1.36,17.31,2019,63037
203,0,81,284,71.48,0.0,28.52,2019,63039
117,0,19,136,86.03,0.0,13.97,2019,63041
4735,113,819,5667,83.55,1.99,14.45,2019,63069
4416,130,1163,5709,77.35,2.28,20.37,2019,63080
126,10,172,308,40.91,3.25,55.84,2019,63087
19609,451,1906,21966,89.27,2.05,8.68,2019,63129
1719,295,1149,3163,54.35,9.33,36.33,2019,63133
5832,204,1369,7405,78.76,2.75,18.49,2019,63137
16985,566,2310,19861,85.52,2.85,11.63,2019,63301
2056,106,826,2988,68.81,3.55,27.64,2019,63552
524,62,123,709,73.91,8.74,17.35,2019,73566
257,0,40,297,86.53,0.0,13.47,2019,73654
81,0,4,85,95.29,0.0,4.71,2019,73658
346,11,95,452,76.55,2.43,21.02,2019,73664
167,3,54,224,74.55,1.34,24.11,2019,73718
330,8,111,449,73.5,1.78,24.72,2019,73724
214,10,59,283,75.62,3.53,20.85,2019,73730
310,2,100,412,75.24,0.49,24.27,2019,73754
341,21,140,502,67.93,4.18,27.89,2019,73766
519,24,176,719,72.18,3.34,24.48,2019,73773
67,0,35,102,65.69,0.0,34.31,2019,73844
3077,187,821,4085,75.32,4.58,20.1,2019,73942
114,11,47,172,66.28,6.4,27.33,2019,73947
3529,42,533,4104,85.99,1.02,12.99,2019,73026
1038,54,318,1410,73.62,3.83,22.55,2019,73028
15415,282,940,16637,92.65,1.7,5.65,2019,73034
2050,43,391,2484,82.53,1.73,15.74,2019,73052
27,7,29,63,42.86,11.11,46.03,2019,73058
185,5,44,234,79.06,2.14,18.8,2019,73063
7097,152,849,8098,87.64,1.88,10.48,2019,73064
730,173,275,1178,61.97,14.69,23.34,2019,73082
1156,59,147,1362,84.88,4.33,10.79,2019,73104
5520,174,632,6326,87.26,2.75,9.99,2019,73118
1353,63,112,1528,88.55,4.12,7.33,2019,73128
2132,164,475,2771,76.94,5.92,17.14,2019,73134
7221,207,946,8374,86.23,2.47,11.3,2019,73135
937,18,117,1072,87.41,1.68,10.91,2019,73141
20758,379,1745,22882,90.72,1.66,7.63,2019,73160
176,16,39,231,76.19,6.93,16.88,2019,73434
118,17,40,175,67.43,9.71,22.86,2019,73440
109,6,37,152,71.71,3.95,24.34,2019,73442
282,31,160,473,59.62,6.55,33.83,2019,73447
11985,254,968,13207,90.75,1.92,7.33,2019,75230
4051,252,1843,6146,65.91,4.1,29.99,2019,75236
1581,73,291,1945,81.29,3.75,14.96,2019,75410
263,25,124,412,63.83,6.07,30.1,2019,75435
386,15,79,480,80.42,3.12,16.46,2019,75437
3316,87,253,3656,90.7,2.38,6.92,2019,75167
5335,214,823,6372,83.73,3.36,12.92,2019,75180
4756,250,1419,6425,74.02,3.89,22.09,2019,75203
2600,196,876,3672,70.81,5.34,23.86,2019,79316
2875,214,1102,4191,68.6,5.11,26.29,2019,79331
101,0,33,134,75.37,0.0,24.63,2019,79350
543,20,192,755,71.92,2.65,25.43,2019,79357
26,0,14,40,65.0,0.0,35.0,2019,79369
3410,106,413,3929,86.79,2.7,10.51,2019,79410
10199,1233,1507,12939,78.82,9.53,11.65,2019,79416
27,0,2,29,93.1,0.0,6.9,2019,79519
697,0,218,915,76.17,0.0,23.83,2019,79520
391,12,129,532,73.5,2.26,24.25,2019,79529
59,0,12,71,83.1,0.0,16.9,2019,79534
82,0,26,108,75.93,0.0,24.07,2019,79538
1099,14,317,1430,76.85,0.98,22.17,2019,79553
271,3,100,374,72.46,0.8,26.74,2019,79563
62,7,22,91,68.13,7.69,24.18,2019,79565
5639,301,1579,7519,75.0,4.0,21.0,2019,79601
5593,240,2656,8489,65.89,2.83,31.29,2019,79603
606,155,244,1005,60.3,15.42,24.28,2019,79734
78,7,21,106,73.58,6.6,19.81,2019,79743
9107,150,2171,11428,79.69,1.31,19.0,2019,79761
33,0,0,33,100.0,0.0,0.0,2019,79330
810,8,422,1240,65.32,0.65,34.03,2019,79252
498,30,220,748,66.58,4.01,29.41,2019,79322
506,46,203,755,67.02,6.09,26.89,2019,79325
4,0,2,6,66.67,0.0,33.33,2019,79353
291,15,104,410,70.98,3.66,25.37,2019,79358
57,3,8,68,83.82,4.41,11.76,2019,79378
3637,174,1902,5713,63.66,3.05,33.29,2019,79403
1932,55,1297,3284,58.83,1.67,39.49,2019,79404
7509,610,1356,9475,79.25,6.44,14.31,2019,79407
3717,157,1766,5640,65.9,2.78,31.31,2019,79412
7289,273,899,8461,86.15,3.23,10.63,2019,79413
396,14,110,520,76.15,2.69,21.15,2019,79502
839,22,346,1207,69.51,1.82,28.67,2019,79504
49,5,27,81,60.49,6.17,33.33,2019,79505
687,0,0,687,100.0,0.0,0.0,2019,79607
12955,217,1635,14807,87.49,1.47,11.04,2019,79705
5998,274,1322,7594,78.98,3.61,17.41,2019,79706
246,14,78,338,72.78,4.14,23.08,2019,79739
1455,94,485,2034,71.53,4.62,23.84,2019,79766
3933,58,585,4576,85.95,1.27,12.78,2019,62010
174,3,72,249,69.88,1.2,28.92,2019,62015
14409,393,2918,17720,81.31,2.22,16.47,2019,62040
91,1,30,122,74.59,0.82,24.59,2019,62050
807,30,42,879,91.81,3.41,4.78,2019,62067
366,10,50,426,85.92,2.35,11.74,2019,62074
89,0,29,118,75.42,0.0,24.58,2019,62079
164,2,41,207,79.23,0.97,19.81,2019,62089
335,4,102,441,75.96,0.91,23.13,2019,62094
359,16,154,529,67.86,3.02,29.11,2019,62242
2522,121,327,2970,84.92,4.07,11.01,2019,62260
1668,120,356,2144,77.8,5.6,16.6,2019,62263
1246,55,328,1629,76.49,3.38,20.14,2019,62265
2128,47,404,2579,82.51,1.82,15.66,2019,62278
193,0,53,246,78.46,0.0,21.54,2019,62284
1505,16,177,1698,88.63,0.94,10.42,2019,62285
85,17,20,122,69.67,13.93,16.39,2019,62289
492,10,44,546,90.11,1.83,8.06,2019,62295
229,11,94,334,68.56,3.29,28.14,2019,62311
487,8,147,642,75.86,1.25,22.9,2019,61565
1666,40,321,2027,82.19,1.97,15.84,2019,61610
130,9,22,161,80.75,5.59,13.66,2019,61812
88,0,31,119,73.95,0.0,26.05,2019,61815
11410,1530,1429,14369,79.41,10.65,9.95,2019,61820
740,6,156,902,82.04,0.67,17.29,2019,61843
277,6,42,325,85.23,1.85,12.92,2019,61844
148,4,34,186,79.57,2.15,18.28,2019,61850
64,0,7,71,90.14,0.0,9.86,2019,61857
968,17,177,1162,83.3,1.46,15.23,2019,61858
250,11,71,332,75.3,3.31,21.39,2019,61863
3845,175,1274,5294,72.63,3.31,24.06,2019,61866
1076,31,429,1536,70.05,2.02,27.93,2019,61910
450,4,138,592,76.01,0.68,23.31,2019,61913
500,17,95,612,81.7,2.78,15.52,2019,61741
409,14,62,485,84.33,2.89,12.78,2019,61742
50,0,7,57,87.72,0.0,12.28,2019,61750
505,4,103,612,82.52,0.65,16.83,2019,61759
349,30,55,434,80.41,6.91,12.67,2019,61814
2259,26,463,2748,82.21,0.95,16.85,2019,61834
129,0,19,148,87.16,0.0,12.84,2019,61845
1653,26,439,2118,78.05,1.23,20.73,2019,61846
134,1,28,163,82.21,0.61,17.18,2019,61851
2025,26,111,2162,93.66,1.2,5.13,2019,61873
2653,291,337,3281,80.86,8.87,10.27,2019,61874
349,0,0,349,100.0,0.0,0.0,2019,61875
740,63,175,978,75.66,6.44,17.89,2019,61924
248,5,50,303,81.85,1.65,16.5,2019,61930
324,2,109,435,74.48,0.46,25.06,2019,61931
106,0,9,115,92.17,0.0,7.83,2019,61936
343,3,71,417,82.25,0.72,17.03,2019,61942
6351,236,1780,8367,75.91,2.82,21.27,2019,61364
378,16,164,558,67.74,2.87,29.39,2019,61322
40,2,10,52,76.92,3.85,19.23,2019,61332
319,8,88,415,76.87,1.93,21.2,2019,61349
209,0,59,268,77.99,0.0,22.01,2019,61418
35,10,19,64,54.69,15.62,29.69,2019,61419
35,0,0,35,100.0,0.0,0.0,2019,61424
673,16,153,842,79.93,1.9,18.17,2019,61427
0,8,4,12,0.0,66.67,33.33,2019,61435
197,6,40,243,81.07,2.47,16.46,2019,61477
111,0,7,118,94.07,0.0,5.93,2019,61478
635,0,54,689,92.16,0.0,7.84,2019,61535
49,4,18,71,69.01,5.63,25.35,2019,61539
205,1,40,246,83.33,0.41,16.26,2019,61567
12937,623,1199,14759,87.65,4.22,8.12,2019,61704
112,16,19,147,76.19,10.88,12.93,2019,73056
506,90,189,785,64.46,11.46,24.08,2019,73067
982,29,462,1473,66.67,1.97,31.36,2019,73651
1300,69,430,1799,72.26,3.84,23.9,2019,73662
503,44,104,651,77.27,6.76,15.98,2019,73669
218,4,109,331,65.86,1.21,32.93,2019,73734
14586,780,3582,18948,76.98,4.12,18.9,2019,89502
7772,781,2017,10570,73.53,7.39,19.08,2019,89512
1927,24,231,2182,88.31,1.1,10.59,2019,89705
6672,418,1387,8477,78.71,4.93,16.36,2019,89706
85,0,18,103,82.52,0.0,17.48,2019,89830
230,0,14,244,94.26,0.0,5.74,2019,89821
61,0,8,69,88.41,0.0,11.59,2019,89823
264,22,170,456,57.89,4.82,37.28,2019,89825
51,5,115,171,29.82,2.92,67.25,2019,89314
6545,181,844,7570,86.46,2.39,11.15,2019,89408
39,5,60,104,37.5,4.81,57.69,2019,89424
52,0,20,72,72.22,0.0,27.78,2019,89426
13275,478,949,14702,90.29,3.25,6.45,2019,89523
1795,24,256,2075,86.51,1.16,12.34,2019,89820
0,0,0,0,,,,2019,89826
0,0,11,11,0.0,0.0,100.0,2019,89831
1085,43,137,1265,85.77,3.4,10.83,2019,89883
95,0,58,153,62.09,0.0,37.91,2019,89013
931,28,12,971,95.88,2.88,1.24,2019,89021
6616,245,1181,8042,82.27,3.05,14.69,2019,89027
9335,532,4306,14173,65.86,3.75,30.38,2019,89030
18546,584,1566,20696,89.61,2.82,7.57,2019,89031
7848,286,1225,9359,83.86,3.06,13.09,2019,89120
317,6,106,429,73.89,1.4,24.71,2019,89442
17033,905,5759,23697,71.88,3.82,24.3,2019,89121
62,0,49,111,55.86,0.0,44.14,2019,89317
235,13,138,386,60.88,3.37,35.75,2019,89427
1127,34,154,1315,85.7,2.59,11.71,2019,89444
757,0,71,828,91.43,0.0,8.57,2019,89448
9986,448,1476,11910,83.85,3.76,12.39,2019,89503
532,14,62,608,87.5,2.3,10.2,2019,89510
531,67,252,850,62.47,7.88,29.65,2019,89019
6684,314,1963,8961,74.59,3.5,21.91,2019,89048
789,30,421,1240,63.63,2.42,33.95,2019,89049
9973,326,3926,14225,70.11,2.29,27.6,2019,89104
19946,417,2526,22889,87.14,1.82,11.04,2019,89117
7090,211,915,8216,86.3,2.57,11.14,2019,89118
15712,1134,4969,21815,72.02,5.2,22.78,2019,89119
14169,748,3071,17988,78.77,4.16,17.07,2019,89122
21050,791,1881,23722,88.74,3.33,7.93,2019,89123
8777,189,1942,10908,80.46,1.73,17.8,2019,89142
8702,363,1273,10338,84.17,3.51,12.31,2019,89701
4393,170,192,4755,92.39,3.58,4.04,2019,89815
642,15,100,757,84.81,1.98,13.21,2019,89822
104,4,21,129,80.62,3.1,16.28,2019,89004
14234,351,1549,16134,88.22,2.18,9.6,2019,89014
3112,140,951,4203,74.04,3.33,22.63,2019,89029
1238,47,155,1440,85.97,3.26,10.76,2019,89040
16603,1025,4260,21888,75.85,4.68,19.46,2019,89103
10877,533,470,11880,91.56,4.49,3.96,2019,89135
12201,226,519,12946,94.25,1.75,4.01,2019,89139
6221,66,361,6648,93.58,0.99,5.43,2019,75209
3719,400,2690,6809,54.62,5.87,39.51,2019,75215
8881,231,1292,10404,85.36,2.22,12.42,2019,75218
17420,789,7461,25670,67.86,3.07,29.07,2019,75228
10445,273,2066,12784,81.7,2.14,16.16,2019,75234
4938,467,3754,9159,53.91,5.1,40.99,2019,75237
189,0,20,209,90.43,0.0,9.57,2019,75247
5303,221,1364,6888,76.99,3.21,19.8,2019,75401
5555,256,933,6744,82.37,3.8,13.83,2019,75402
4183,304,1245,5732,72.98,5.3,21.72,2019,75407
3477,261,1153,4891,71.09,5.34,23.57,2019,75418
546,10,146,702,77.78,1.42,20.8,2019,75431
24,21,10,55,43.64,38.18,18.18,2019,75450
346,11,179,536,64.55,2.05,33.4,2019,75451
1233,35,280,1548,79.65,2.26,18.09,2019,75452
319,32,45,396,80.56,8.08,11.36,2019,75471
264,51,73,388,68.04,13.14,18.81,2019,75489
2425,61,332,2818,86.05,2.16,11.78,2019,75495
3110,101,959,4170,74.58,2.42,23.0,2019,75551
376,17,79,472,79.66,3.6,16.74,2019,76630
4163,0,110,4273,97.43,0.0,2.57,2019,76177
7300,40,551,7891,92.51,0.51,6.98,2019,76208
131,0,9,140,93.57,0.0,6.43,2019,76041
5004,143,1095,6242,80.17,2.29,17.54,2019,76082
16044,651,1953,18648,86.04,3.49,10.47,2019,76133
2036,225,475,2736,74.42,8.22,17.36,2019,76258
5690,81,184,5955,95.55,1.36,3.09,2019,76008
10297,386,870,11553,89.13,3.34,7.53,2019,76006
7916,454,1332,9702,81.59,4.68,13.73,2019,76011
13847,269,813,14929,92.75,1.8,5.45,2019,76021
14222,201,659,15082,94.3,1.33,4.37,2019,76039
2055,202,373,2630,78.14,7.68,14.18,2019,76043
6854,82,121,7057,97.12,1.16,1.71,2019,76052
9242,75,136,9453,97.77,0.79,1.44,2019,76092
3090,110,471,3671,84.17,3.0,12.83,2019,76102
12452,347,1528,14327,86.91,2.42,10.67,2019,76107
12593,241,527,13361,94.25,1.8,3.94,2019,76131
8138,181,1283,9602,84.75,1.89,13.36,2019,76140
2735,54,234,3023,90.47,1.79,7.74,2019,76155
4850,161,935,5946,81.57,2.71,15.72,2019,76234
1644,38,245,1927,85.31,1.97,12.71,2019,76259
12238,228,453,12919,94.73,1.76,3.51,2019,76262
2711,190,643,3544,76.5,5.36,18.14,2019,76273
1385,83,543,2011,68.87,4.13,27.0,2019,76458
8467,328,1094,9889,85.62,3.32,11.06,2019,76033
3014,69,270,3353,89.89,2.06,8.05,2019,76085
0,0,0,0,,,,2019,76129
3009,283,1136,4428,67.95,6.39,25.65,2019,76164
10554,86,459,11099,95.09,0.77,4.14,2019,76182
7925,358,935,9218,85.97,3.88,10.14,2019,76209
13782,298,874,14954,92.16,1.99,5.84,2019,76210
23613,322,823,24758,95.38,1.3,3.32,2019,76244
430,11,128,569,75.57,1.93,22.5,2019,62932
239,28,96,363,65.84,7.71,26.45,2019,62934
4054,103,1071,5228,77.54,1.97,20.49,2019,62948
8456,152,2475,11083,76.3,1.37,22.33,2019,62959
187,6,97,290,64.48,2.07,33.45,2019,62985
66,34,38,138,47.83,24.64,27.54,2019,62998
10116,323,1868,12307,82.2,2.62,15.18,2019,62226
214,9,51,274,78.1,3.28,18.61,2019,62885
56,5,5,66,84.85,7.58,7.58,2019,62851
25,0,7,32,78.12,0.0,21.88,2019,62852
134,27,35,196,68.37,13.78,17.86,2019,62878
610,11,262,883,69.08,1.25,29.67,2019,62888
775,69,249,1093,70.91,6.31,22.78,2019,62890
191,7,66,264,72.35,2.65,25.0,2019,62891
1681,107,779,2567,65.49,4.17,30.35,2019,62906
2118,25,416,2559,82.77,0.98,16.26,2019,62012
216,2,95,313,69.01,0.64,30.35,2019,62032
1129,27,296,1452,77.75,1.86,20.39,2019,62075
644,12,140,796,80.9,1.51,17.59,2019,62087
1224,109,1282,2615,46.81,4.17,49.02,2019,62201
1565,242,1714,3521,44.45,6.87,48.68,2019,62204
320,9,122,451,70.95,2.0,27.05,2019,62219
10809,511,752,12072,89.54,4.23,6.23,2019,62025
165,0,91,256,64.45,0.0,35.55,2019,62027
46,0,21,67,68.66,0.0,31.34,2019,62030
202,0,122,324,62.35,0.0,37.65,2019,62031
5529,132,1120,6781,81.54,1.95,16.52,2019,62035
125,0,23,148,84.46,0.0,15.54,2019,62045
237,1,37,275,86.18,0.36,13.45,2019,62046
589,18,103,710,82.96,2.54,14.51,2019,62048
3769,99,975,4843,77.82,2.04,20.13,2019,62052
1126,36,229,1391,80.95,2.59,16.46,2019,62069
2372,22,498,2892,82.02,0.76,17.22,2019,62088
82,0,41,123,66.67,0.0,33.33,2019,62915
113,0,22,135,83.7,0.0,16.3,2019,62887
119,3,33,155,76.77,1.94,21.29,2019,62897
204,12,144,360,56.67,3.33,40.0,2019,62916
911,32,406,1349,67.53,2.37,30.1,2019,62920
1745,84,671,2500,69.8,3.36,26.84,2019,62930
427,19,79,525,81.33,3.62,15.05,2019,62933
9083,167,1466,10716,84.76,1.56,13.68,2019,75208
13760,704,983,15447,89.08,4.56,6.36,2019,75219
6458,312,4097,10867,59.43,2.87,37.7,2019,75232
4044,129,1082,5255,76.96,2.45,20.59,2019,75233
14826,291,1343,16460,90.07,1.77,8.16,2019,75248
0,0,0,0,,,,2019,75270
197,0,56,253,77.87,0.0,22.13,2019,75412
319,4,62,385,82.86,1.04,16.1,2019,75420
935,27,164,1126,83.04,2.4,14.56,2019,75424
905,40,315,1260,71.83,3.17,25.0,2019,75432
2304,46,695,3045,75.67,1.51,22.82,2019,75442
5775,652,3490,9917,58.23,6.57,35.19,2019,75460
31,22,66,119,26.05,18.49,55.46,2019,75470
284,23,128,435,65.29,5.29,29.43,2019,75476
7549,503,1429,9481,79.62,5.31,15.07,2019,75482
14438,159,736,15333,94.16,1.04,4.8,2019,75044
5926,743,2215,8884,66.7,8.36,24.93,2019,75662
9570,435,2190,12195,78.47,3.57,17.96,2019,75701
1464,28,264,1756,83.37,1.59,15.03,2019,75709
132,15,44,191,69.11,7.85,23.04,2019,62655
863,30,172,1065,81.03,2.82,16.15,2019,62670
744,35,174,953,78.07,3.67,18.26,2019,62677
1317,36,292,1645,80.06,2.19,17.75,2019,62690
78,0,23,101,77.23,0.0,22.77,2019,62695
1191,60,250,1501,79.35,4.0,16.66,2019,62806
361,22,135,518,69.69,4.25,26.06,2019,62828
131,3,85,219,59.82,1.37,38.81,2019,62867
327,23,102,452,72.35,5.09,22.57,2019,62875
19,5,6,30,63.33,16.67,20.0,2019,62879
203,2,74,279,72.76,0.72,26.52,2019,62880
872,72,252,1196,72.91,6.02,21.07,2019,62884
270,5,82,357,75.63,1.4,22.97,2019,62889
151,0,53,204,74.02,0.0,25.98,2019,62908
357,7,117,481,74.22,1.46,24.32,2019,62367
85,0,24,109,77.98,0.0,22.02,2019,62373
112,0,27,139,80.58,0.0,19.42,2019,62375
134,36,33,203,66.01,17.73,16.26,2019,62425
356,3,121,480,74.17,0.62,25.21,2019,62433
443,0,155,598,74.08,0.0,25.92,2019,62443
279,39,164,482,57.88,8.09,34.02,2019,62445
622,28,169,819,75.95,3.42,20.63,2019,62458
408,28,119,555,73.51,5.05,21.44,2019,62460
11749,620,2471,14840,79.17,4.18,16.65,2019,62521
47,0,0,47,100.0,0.0,0.0,2019,62537
371,19,95,485,76.49,3.92,19.59,2019,62539
528,44,85,657,80.37,6.7,12.94,2019,62540
610,14,64,688,88.66,2.03,9.3,2019,62546
149,15,22,186,80.11,8.06,11.83,2019,62325
7,0,5,12,58.33,0.0,41.67,2019,62336
605,16,110,731,82.76,2.19,15.05,2019,62347
426,37,108,571,74.61,6.48,18.91,2019,62354
127,12,30,169,75.15,7.1,17.75,2019,62357
129,10,64,203,63.55,4.93,31.53,2019,62374
326,14,141,481,67.78,2.91,29.31,2019,62378
296,13,127,436,67.89,2.98,29.13,2019,62422
252,2,114,368,68.48,0.54,30.98,2019,62426
269,36,95,400,67.25,9.0,23.75,2019,62431
121,0,47,168,72.02,0.0,27.98,2019,62434
150,7,115,272,55.15,2.57,42.28,2019,62436
337,10,52,399,84.46,2.51,13.03,2019,62241
53,1,7,61,86.89,1.64,11.48,2019,62348
209,2,50,261,80.08,0.77,19.16,2019,62349
108,0,44,152,71.05,0.0,28.95,2019,62362
1830,82,216,2128,86.0,3.85,10.15,2019,62615
2459,91,422,2972,82.74,3.06,14.2,2019,62626
260,4,39,303,85.81,1.32,12.87,2019,62628
4896,251,247,5394,90.77,4.65,4.58,2019,62629
150,7,57,214,70.09,3.27,26.64,2019,62649
1057,20,292,1369,77.21,1.46,21.33,2019,62664
174,0,63,237,73.42,0.0,26.58,2019,62667
16134,713,2211,19058,84.66,3.74,11.6,2019,62704
6490,310,1568,8368,77.56,3.7,18.74,2019,62801
52,3,14,69,75.36,4.35,20.29,2019,61720
896,22,71,989,90.6,2.22,7.18,2019,61726
7022,88,442,7552,92.98,1.17,5.85,2019,89144
8614,232,1101,9947,86.6,2.33,11.07,2019,89145
10414,299,364,11077,94.01,2.7,3.29,2019,80304
6811,232,1303,8346,81.61,2.78,15.61,2019,80002
13083,425,1355,14863,88.02,2.86,9.12,2019,80004
12097,304,2518,14919,81.08,2.04,16.88,2019,80022
11738,292,596,12626,92.97,2.31,4.72,2019,80026
9599,475,1628,11702,82.03,4.06,13.91,2019,80033
204,22,94,320,63.75,6.88,29.38,2019,80860
7573,58,607,8238,91.93,0.7,7.37,2019,80915
11603,323,930,12856,90.25,2.51,7.23,2019,80917
234,0,69,303,77.23,0.0,22.77,2019,79547
3019,111,1086,4216,71.61,2.63,25.76,2019,79102
2717,232,449,3398,79.96,6.83,13.21,2019,79830
50,17,115,182,27.47,9.34,63.19,2019,79837
181,44,217,442,40.95,9.95,49.1,2019,79839
522,109,925,1556,33.55,7.01,59.45,2019,79845
48,0,0,48,100.0,0.0,0.0,2019,79854
8309,374,523,9206,90.26,4.06,5.68,2019,79934
21444,566,1632,23642,90.7,2.39,6.9,2019,79938
2185,132,698,3015,72.47,4.38,23.15,2019,79411
271,12,75,358,75.7,3.35,20.95,2019,79506
1314,18,573,1905,68.98,0.94,30.08,2019,79838
219,8,143,370,59.19,2.16,38.65,2019,79852
3993,202,3370,7565,52.78,2.67,44.55,2019,79905
1271,13,9,1293,98.3,1.01,0.7,2019,79906
4970,237,1009,6216,79.95,3.81,16.23,2019,79935
30571,873,3993,35437,86.27,2.46,11.27,2019,79936
338,21,318,677,49.93,3.1,46.97,2019,81152
1560,61,282,1903,81.98,3.21,14.82,2019,81252
1553,55,309,1917,81.01,2.87,16.12,2019,81323
504,14,177,695,72.52,2.01,25.47,2019,81039
600,38,113,751,79.89,5.06,15.05,2019,81055
1441,51,598,2090,68.95,2.44,28.61,2019,81067
317,7,63,387,81.91,1.81,16.28,2019,81092
54,5,34,93,58.06,5.38,36.56,2019,81136
1295,132,757,2184,59.29,6.04,34.66,2019,81137
71,0,40,111,63.96,0.0,36.04,2019,81148
238,38,136,412,57.77,9.22,33.01,2019,81149
400,17,60,477,83.86,3.56,12.58,2019,81154
76,0,0,76,100.0,0.0,0.0,2019,81220
26,0,30,56,46.43,0.0,53.57,2019,81239
1115,38,302,1455,76.63,2.61,20.76,2019,81428
212,13,45,270,78.52,4.81,16.67,2019,81433
5695,41,600,6336,89.88,0.65,9.47,2019,81503
4553,83,741,5377,84.68,1.54,13.78,2019,81520
4340,92,169,4601,94.33,2.0,3.67,2019,81611
2345,56,87,2488,94.25,2.25,3.5,2019,81621
878,34,96,1008,87.1,3.37,9.52,2019,81639
99,5,18,122,81.15,4.1,14.75,2019,81071
167,4,51,222,75.23,1.8,22.97,2019,81076
4436,197,1166,5799,76.5,3.4,20.11,2019,81101
10061,285,1097,11443,87.92,2.49,9.59,2019,81007
24,0,0,24,100.0,0.0,0.0,2019,76263
0,0,0,0,,,,2019,76402
0,0,0,0,,,,2019,76508
0,0,9,9,0.0,0.0,100.0,2019,76573
0,0,0,0,,,,2019,76596
0,0,0,0,,,,2019,76597
0,0,0,0,,,,2019,76598
0,0,0,0,,,,2019,76599
67,3,11,81,82.72,3.7,13.58,2019,76623
43,0,21,64,67.19,0.0,32.81,2019,76650
22,3,32,57,38.6,5.26,56.14,2019,76654
44,0,6,50,88.0,0.0,12.0,2019,76820
0,0,0,0,,,,2019,76836
0,0,0,0,,,,2019,76908
0,0,0,0,,,,2019,76939
31,0,0,31,100.0,0.0,0.0,2019,76957
1038,62,500,1600,64.88,3.88,31.25,2019,76360
288,17,128,433,66.51,3.93,29.56,2019,76372
1237,76,343,1656,74.7,4.59,20.71,2019,76374
246,14,90,350,70.29,4.0,25.71,2019,76427
87,0,0,87,100.0,0.0,0.0,2019,76429
4572,134,1587,6293,72.65,2.13,25.22,2019,76501
13546,398,1425,15369,88.14,2.59,9.27,2019,76502
89,2,25,116,76.72,1.72,21.55,2019,76261
273,16,78,367,74.39,4.36,21.25,2019,76228
12542,199,466,13207,94.96,1.51,3.53,2019,76248
984,0,311,1295,75.98,0.0,24.02,2019,77702
6698,254,3499,10451,64.09,2.43,33.48,2019,77705
10323,259,2020,12602,81.92,2.06,16.03,2019,77706
9323,490,1075,10888,85.63,4.5,9.87,2019,77802
3348,112,1066,4526,73.97,2.47,23.55,2019,77836
1542,78,357,1977,78.0,3.95,18.06,2019,77856
1507,36,541,2084,72.31,1.73,25.96,2019,77879
64,0,39,103,62.14,0.0,37.86,2019,77961
879,66,234,1179,74.55,5.6,19.85,2019,77962
795,71,183,1049,75.79,6.77,17.45,2019,77968
161,0,70,231,69.7,0.0,30.3,2019,77971
303,0,3,306,99.02,0.0,0.98,2019,77982
6236,226,1460,7922,78.72,2.85,18.43,2019,77086
22,6,25,53,41.51,11.32,47.17,2019,77464
10401,92,581,11074,93.92,0.83,5.25,2019,77493
35308,461,806,36575,96.54,1.26,2.2,2019,77494
573,33,150,756,75.79,4.37,19.84,2019,77872
2496,43,761,3300,75.64,1.3,23.06,2019,77964
104,7,45,156,66.67,4.49,28.85,2019,77970
91,10,24,125,72.8,8.0,19.2,2019,77974
66,40,123,229,28.82,17.47,53.71,2019,77977
1237,42,272,1551,79.75,2.71,17.54,2019,77984
57,0,14,71,80.28,0.0,19.72,2019,77991
64,0,85,149,42.95,0.0,57.05,2019,77994
13341,640,3403,17384,76.74,3.68,19.58,2019,77015
4986,392,3877,9255,53.87,4.24,41.89,2019,77022
1456,54,334,1844,78.96,2.93,18.11,2019,75755
7530,60,525,8115,92.79,0.74,6.47,2019,75048
19700,129,761,20590,95.68,0.63,3.7,2019,75068
35113,269,1467,36849,95.29,0.73,3.98,2019,75070
11490,224,701,12415,92.55,1.8,5.65,2019,75087
7686,800,1482,9968,77.11,8.03,14.87,2019,75092
16519,346,2318,19183,86.11,1.8,12.08,2019,75115
367,51,188,606,60.56,8.42,31.02,2019,75127
3895,443,1304,5642,69.04,7.85,23.11,2019,75142
711,23,213,947,75.08,2.43,22.49,2019,75155
167,0,98,265,63.02,0.0,36.98,2019,75164
2837,99,108,3044,93.2,3.25,3.55,2019,75454
7028,202,2175,9405,74.73,2.15,23.13,2019,75455
311,14,78,403,77.17,3.47,19.35,2019,75478
77,5,32,114,67.54,4.39,28.07,2019,75481
182,3,66,251,72.51,1.2,26.29,2019,75488
2811,97,656,3564,78.87,2.72,18.41,2019,75494
1353,22,290,1665,81.26,1.32,17.42,2019,75497
621,4,202,827,75.09,0.48,24.43,2019,75554
240,31,137,408,58.82,7.6,33.58,2019,75556
168,0,142,310,54.19,0.0,45.81,2019,75566
1300,76,249,1625,80.0,4.68,15.32,2019,75567
34,0,9,43,79.07,0.0,20.93,2019,75641
54,5,9,68,79.41,7.35,13.24,2019,76865
1146,36,302,1484,77.22,2.43,20.35,2019,76877
584,47,245,876,66.67,5.37,27.97,2019,76945
392,10,56,458,85.59,2.18,12.23,2019,76951
571,11,130,712,80.2,1.54,18.26,2019,76656
201,6,87,294,68.37,2.04,29.59,2019,76681
1198,127,756,2081,57.57,6.1,36.33,2019,76661
73,1,17,91,80.22,1.1,18.68,2019,76666
65,6,27,98,66.33,6.12,27.55,2019,76676
57,0,27,84,67.86,0.0,32.14,2019,76678
51,8,25,84,60.71,9.52,29.76,2019,76686
9847,129,513,10489,93.88,1.23,4.89,2019,76001
12757,872,4105,17734,71.94,4.92,23.15,2019,76010
8682,605,1690,10977,79.09,5.51,15.4,2019,76014
8668,119,413,9200,94.22,1.29,4.49,2019,76018
1376,37,237,1650,83.39,2.24,14.36,2019,76044
451,13,81,545,82.75,2.39,14.86,2019,76064
104,0,27,131,79.39,0.0,20.61,2019,74452
109,6,43,158,68.99,3.8,27.22,2019,74457
15,20,40,75,20.0,26.67,53.33,2019,74463
217,0,100,317,68.45,0.0,31.55,2019,74431
2630,65,1039,3734,70.43,1.74,27.83,2019,74525
5,0,24,29,17.24,0.0,82.76,2019,74535
18,0,13,31,58.06,0.0,41.94,2019,74549
532,16,205,753,70.65,2.12,27.22,2019,74554
202,6,116,324,62.35,1.85,35.8,2019,74555
188,8,77,273,68.86,2.93,28.21,2019,74569
286,21,142,449,63.7,4.68,31.63,2019,74574
458,21,184,663,69.08,3.17,27.75,2019,74637
134,23,93,250,53.6,9.2,37.2,2019,74650
527,53,366,946,55.71,5.6,38.69,2019,74726
291,12,171,474,61.39,2.53,36.08,2019,74734
130,6,115,251,51.79,2.39,45.82,2019,74738
599,31,300,930,64.41,3.33,32.26,2019,74871
212,2,44,258,82.17,0.78,17.05,2019,74565
30,3,20,53,56.6,5.66,37.74,2019,74576
98,7,15,120,81.67,5.83,12.5,2019,61316
518,26,191,735,70.48,3.54,25.99,2019,61006
890,37,66,993,89.63,3.73,6.65,2019,61020
718,38,270,1026,69.98,3.7,26.32,2019,61028
1870,83,880,2833,66.01,2.93,31.06,2019,76520
12040,190,1421,13651,88.2,1.39,10.41,2019,76522
1213,50,480,1743,69.59,2.87,27.54,2019,76531
768,48,198,1014,75.74,4.73,19.53,2019,76534
9806,455,1586,11847,82.77,3.84,13.39,2019,76543
8991,290,953,10234,87.85,2.83,9.31,2019,76548
262,2,91,355,73.8,0.56,25.63,2019,76621
19,0,8,27,70.37,0.0,29.63,2019,76628
4927,263,235,5425,90.82,4.85,4.33,2019,76643
768,25,262,1055,72.8,2.37,24.83,2019,76648
2913,105,361,3379,86.21,3.11,10.68,2019,76657
8822,275,1198,10295,85.69,2.67,11.64,2019,76012
10896,477,1504,12877,84.62,3.7,11.68,2019,76013
15273,322,1434,17029,89.69,1.89,8.42,2019,76017
8484,379,1472,10335,82.09,3.67,14.24,2019,76020
4221,64,96,4381,96.35,1.46,2.19,2019,76054
1364,108,268,1740,78.39,6.21,15.4,2019,76059
1077,44,318,1439,74.84,3.06,22.1,2019,76457
54,0,30,84,64.29,0.0,35.71,2019,76436
1412,19,469,1900,74.32,1.0,24.68,2019,76448
4,0,28,32,12.5,0.0,87.5,2019,76452
418,52,224,694,60.23,7.49,32.28,2019,76471
765,8,218,991,77.19,0.81,22.0,2019,76487
919,44,150,1113,82.57,3.95,13.48,2019,76524
5339,314,1911,7564,70.58,4.15,25.26,2019,76541
554,38,157,749,73.97,5.07,20.96,2019,76554
412,22,157,591,69.71,3.72,26.57,2019,76556
40,0,11,51,78.43,0.0,21.57,2019,76887
232,23,104,359,64.62,6.41,28.97,2019,76934
749,94,578,1421,52.71,6.62,40.68,2019,76950
1152,60,153,1365,84.4,4.4,11.21,2019,76071
3926,181,2441,6548,59.96,2.76,37.28,2019,76105
7990,391,1968,10349,77.21,3.78,19.02,2019,76110
4058,41,283,4382,92.61,0.94,6.46,2019,74033
72,17,43,132,54.55,12.88,32.58,2019,74045
2195,42,349,2586,84.88,1.62,13.5,2019,74047
771,66,233,1070,72.06,6.17,21.78,2019,74080
249,18,120,387,64.34,4.65,31.01,2019,74083
105,11,14,130,80.77,8.46,10.77,2019,74001
9867,65,561,10493,94.03,0.62,5.35,2019,74008
1160,40,348,1548,74.94,2.58,22.48,2019,74030
614,33,250,897,68.45,3.68,27.87,2019,74032
24,8,21,53,45.28,15.09,39.62,2019,74034
70,3,77,150,46.67,2.0,51.33,2019,74042
2112,70,582,2764,76.41,2.53,21.06,2019,74044
1519,87,563,2169,70.03,4.01,25.96,2019,74056
606,51,137,794,76.32,6.42,17.25,2019,74061
268,15,91,374,71.66,4.01,24.33,2019,74062
2093,98,523,2714,77.12,3.61,19.27,2019,74108
5519,244,2221,7984,69.13,3.06,27.82,2019,74115
8307,315,2457,11079,74.98,2.84,22.18,2019,74017
220,5,107,332,66.27,1.51,32.23,2019,74026
435,16,149,600,72.5,2.67,24.83,2019,74028
6673,92,574,7339,90.93,1.25,7.82,2019,74114
2557,98,1090,3745,68.28,2.62,29.11,2019,74126
299,31,110,440,67.95,7.05,25.0,2019,81020
366,4,194,564,64.89,0.71,34.4,2019,81022
94,8,35,137,68.61,5.84,25.55,2019,81029
21,0,5,26,80.77,0.0,19.23,2019,81045
408,2,155,565,72.21,0.35,27.43,2019,81047
2895,60,734,3689,78.48,1.63,19.9,2019,81052
145,6,17,168,86.31,3.57,10.12,2019,81057
1334,144,686,2164,61.65,6.65,31.7,2019,81089
12224,897,1508,14629,83.56,6.13,10.31,2019,84123
1375,62,55,1492,92.16,4.16,3.69,2019,84339
4024,113,694,4831,83.3,2.34,14.37,2019,84501
3130,38,119,3287,95.22,1.16,3.62,2019,84050
13716,296,1219,15231,90.05,1.94,8.0,2019,84010
2890,21,180,3091,93.5,0.68,5.82,2019,84029
321,0,43,364,88.19,0.0,11.81,2019,84033
304,18,45,367,82.83,4.9,12.26,2019,84053
10468,850,715,12033,86.99,7.06,5.94,2019,84058
12042,1109,517,13668,88.1,8.11,3.78,2019,84062
163,6,25,194,84.02,3.09,12.89,2019,84064
149,0,25,174,85.63,0.0,14.37,2019,84069
6215,216,252,6683,93.0,3.23,3.77,2019,84097
8223,202,657,9082,90.54,2.22,7.23,2019,84109
8770,448,657,9875,88.81,4.54,6.65,2019,84117
36,10,0,46,78.26,21.74,0.0,2019,84313
11820,468,1956,14244,82.98,3.29,13.73,2019,84401
83,5,129,217,38.25,2.3,59.45,2019,84512
1363,90,235,1688,80.75,5.33,13.92,2019,84526
5388,76,802,6266,85.99,1.21,12.8,2019,84737
153,7,28,188,81.38,3.72,14.89,2019,84776
197,0,11,208,94.71,0.0,5.29,2019,84007
12373,982,343,13698,90.33,7.17,2.5,2019,84020
11,0,0,11,100.0,0.0,0.0,2019,84024
6160,135,496,6791,90.71,1.99,7.3,2019,84032
41,5,32,78,52.56,6.41,41.03,2019,84034
2248,47,162,2457,91.49,1.91,6.59,2019,84036
6910,260,306,7476,92.43,3.48,4.09,2019,84040
2648,140,95,2883,91.85,4.86,3.3,2019,84042
11388,522,1334,13244,85.99,3.94,10.07,2019,84047
160,0,7,167,95.81,0.0,4.19,2019,84051
11751,302,810,12863,91.36,2.35,6.3,2019,84067
8448,772,1119,10339,81.71,7.47,10.82,2019,84070
67,5,46,118,56.78,4.24,38.98,2019,84085
4444,75,233,4752,93.52,1.58,4.9,2019,84087
8815,402,360,9577,92.04,4.2,3.76,2019,84094
11566,494,1677,13737,84.2,3.6,12.21,2019,84107
7054,384,384,7822,90.18,4.91,4.91,2019,84108
95,59,25,179,53.07,32.96,13.97,2019,84112
6459,95,336,6890,93.74,1.38,4.88,2019,84128
0,0,0,0,,,,2019,84180
26,0,0,26,100.0,0.0,0.0,2019,84304
77,0,13,90,85.56,0.0,14.44,2019,84306
141,8,7,156,90.38,5.13,4.49,2019,84775
51,0,0,51,100.0,0.0,0.0,2019,84762
65,0,26,91,71.43,0.0,28.57,2019,84772
56,0,12,68,82.35,0.0,17.65,2019,84781
1006,16,358,1380,72.9,1.16,25.94,2019,84511
419,0,117,536,78.17,0.0,21.83,2019,84513
49,2,10,61,80.33,3.28,16.39,2019,84516
117,0,13,130,90.0,0.0,10.0,2019,84522
4451,212,3297,7960,55.92,2.66,41.42,2019,77026
9066,321,346,9733,93.15,3.3,3.55,2019,77027
9454,109,970,10533,89.76,1.03,9.21,2019,77047
9597,62,448,10107,94.95,0.61,4.43,2019,77005
19334,119,941,20394,94.8,0.58,4.61,2019,77007
7710,163,2214,10087,76.44,1.62,21.95,2019,77017
10369,194,670,11233,92.31,1.73,5.96,2019,77019
4540,21,1116,5677,79.97,0.37,19.66,2019,77378
10723,295,657,11675,91.85,2.53,5.63,2019,77356
6554,222,1286,8062,81.29,2.75,15.95,2019,77357
125,0,0,125,100.0,0.0,0.0,2019,77359
12876,190,314,13380,96.23,1.42,2.35,2019,77382
15951,540,2184,18675,85.41,2.89,11.69,2019,77396
287,27,146,460,62.39,5.87,31.74,2019,77419
0,0,0,0,,,,2019,77428
19,0,0,19,100.0,0.0,0.0,2019,77432
1304,32,237,1573,82.9,2.03,15.07,2019,77435
3802,10,130,3942,96.45,0.25,3.3,2019,77441
4424,95,525,5044,87.71,1.88,10.41,2019,77447
10705,420,1465,12590,85.03,3.34,11.64,2019,77025
6514,279,2282,9075,71.78,3.07,25.15,2019,77038
4454,139,3014,7607,58.55,1.83,39.62,2019,77039
14749,542,2494,17785,82.93,3.05,14.02,2019,77040
17170,424,2575,20169,85.13,2.1,12.77,2019,77057
9393,533,4239,14165,66.31,3.76,29.93,2019,77060
8035,184,1998,10217,78.64,1.8,19.56,2019,77067
3477,32,477,3986,87.23,0.8,11.97,2019,77068
24892,498,1707,27097,91.86,1.84,6.3,2019,77077
5818,156,715,6689,86.98,2.33,10.69,2019,77303
872,56,274,1202,72.55,4.66,22.8,2019,77335
79,0,24,103,76.7,0.0,23.3,2019,77368
12862,142,734,13738,93.62,1.03,5.34,2019,77381
7820,131,629,8580,91.14,1.53,7.33,2019,77385
202,4,63,269,75.09,1.49,23.42,2019,63558
25,0,61,86,29.07,0.0,70.93,2019,63560
1032,76,409,1517,68.03,5.01,26.96,2019,63624
45,0,28,73,61.64,0.0,38.36,2019,63675
0,0,0,0,,,,2019,63738
59,0,23,82,71.95,0.0,28.05,2019,63763
1406,30,487,1923,73.11,1.56,25.33,2019,63764
52,0,6,58,89.66,0.0,10.34,2019,63783
972,37,310,1319,73.69,2.81,23.5,2019,63933
169,27,60,256,66.02,10.55,23.44,2019,63936
327,13,169,509,64.24,2.55,33.2,2019,63939
411,11,260,682,60.26,1.61,38.12,2019,63944
123,0,16,139,88.49,0.0,11.51,2019,63952
1821,94,186,2101,86.67,4.47,8.85,2019,63089
2356,277,1847,4480,52.59,6.18,41.23,2019,63106
6994,405,841,8240,84.88,4.92,10.21,2019,63110
1035,12,271,1318,78.53,0.91,20.56,2019,63877
431,0,174,605,71.24,0.0,28.76,2019,63940
4754,155,281,5190,91.6,2.99,5.41,2019,63025
39,6,43,88,44.32,6.82,48.86,2019,74577
22127,3060,3867,29054,76.16,10.53,13.31,2019,78666
187,79,57,323,57.89,24.46,17.65,2019,78671
102,25,23,150,68.0,16.67,15.33,2019,78675
4966,97,249,5312,93.49,1.83,4.69,2019,78676
10197,69,286,10552,96.64,0.65,2.71,2019,78717
5328,185,108,5621,94.79,3.29,1.92,2019,78737
6359,137,475,6971,91.22,1.97,6.81,2019,78747
14468,366,594,15428,93.78,2.37,3.85,2019,78749
9837,117,983,10937,89.94,1.07,8.99,2019,78757
15,0,53,68,22.06,0.0,77.94,2019,78836
3383,522,1521,5426,62.35,9.62,28.03,2019,78220
4649,176,1123,5948,78.16,2.96,18.88,2019,78224
10480,1128,2588,14196,73.82,7.95,18.23,2019,78229
2046,113,665,2824,72.45,4.0,23.55,2019,78264
2662,112,1277,4051,65.71,2.76,31.52,2019,78336
49,0,57,106,46.23,0.0,53.77,2019,78352
1971,92,1245,3308,59.58,2.78,37.64,2019,78368
1019,0,702,1721,59.21,0.0,40.79,2019,78384
13288,368,1516,15172,87.58,2.43,9.99,2019,78412
13484,327,1191,15002,89.88,2.18,7.94,2019,78413
2140,135,880,3155,67.83,4.28,27.89,2019,78538
9798,297,2108,12203,80.29,2.43,17.27,2019,78539
11259,604,4950,16813,66.97,3.59,29.44,2019,78550
2387,812,256,3455,69.09,23.5,7.41,2019,78575
5326,1135,4132,10593,50.28,10.71,39.01,2019,78589
1681,43,307,2031,82.77,2.12,15.12,2019,78606
2883,32,541,3456,83.42,0.93,15.65,2019,78065
17027,746,1365,19138,88.97,3.9,7.13,2019,78045
1698,44,320,2062,82.35,2.13,15.52,2019,78052
4416,118,655,5189,85.1,2.27,12.62,2019,78064
11575,145,526,12246,94.52,1.18,4.3,2019,78108
24294,607,3253,28154,86.29,2.16,11.55,2019,78130
135,0,69,204,66.18,0.0,33.82,2019,78146
5052,137,85,5274,95.79,2.6,1.61,2019,78015
143,9,124,276,51.81,3.26,44.93,2019,78019
778,92,520,1390,55.97,6.62,37.41,2019,78022
1607,27,407,2041,78.74,1.32,19.94,2019,78026
75,13,0,88,85.23,14.77,0.0,2019,78027
5119,546,5847,11512,44.47,4.74,50.79,2019,78040
3839,188,1857,5884,65.24,3.2,31.56,2019,79903
24009,1165,3316,28490,84.27,4.09,11.64,2019,79912
8174,390,3901,12465,65.58,3.13,31.3,2019,79915
8464,593,2199,11256,75.2,5.27,19.54,2019,79927
7213,418,1268,8899,81.05,4.7,14.25,2019,79932
9330,298,1367,10995,84.86,2.71,12.43,2019,83702
134,0,0,134,100.0,0.0,0.0,2019,83112
319,35,30,384,83.07,9.11,7.81,2019,83262
144,0,135,279,51.61,0.0,48.39,2019,83025
53,59,20,132,40.15,44.7,15.15,2019,83209
24,0,0,24,100.0,0.0,0.0,2019,83233
159,46,3,208,76.44,22.12,1.44,2019,83414
177,0,9,186,95.16,0.0,4.84,2019,83454
0,0,0,0,,,,2019,83460
46,0,0,46,100.0,0.0,0.0,2019,83636
19369,841,2299,22509,86.05,3.74,10.21,2019,83646
76,0,21,97,78.35,0.0,21.65,2019,83825
65,0,38,103,63.11,0.0,36.89,2019,83840
0,0,0,0,,,,2019,83844
326,4,93,423,77.07,0.95,21.99,2019,73738
123,19,35,177,69.49,10.73,19.77,2019,73753
123,9,50,182,67.58,4.95,27.47,2019,73760
547,17,185,749,73.03,2.27,24.7,2019,73762
573,17,178,768,74.61,2.21,23.18,2019,73763
54,0,24,78,69.23,0.0,30.77,2019,73764
442,77,191,710,62.25,10.85,26.9,2019,73933
404,0,94,498,81.12,0.0,18.88,2019,73950
297,9,68,374,79.41,2.41,18.18,2019,73951
548,17,212,777,70.53,2.19,27.28,2019,73038
941,18,146,1105,85.16,1.63,13.21,2019,73093
29,3,30,62,46.77,4.84,48.39,2019,73441
151,27,61,239,63.18,11.3,25.52,2019,73491
246,11,83,340,72.35,3.24,24.41,2019,73650
52,5,7,64,81.25,7.81,10.94,2019,73720
1612,16,23,1651,97.64,0.97,1.39,2019,73503
905,46,307,1258,71.94,3.66,24.4,2019,73554
199,13,82,294,67.69,4.42,27.89,2019,73625
114,11,28,153,74.51,7.19,18.3,2019,73739
15,3,8,26,57.69,11.54,30.77,2019,73851
912,45,281,1238,73.67,3.63,22.7,2019,73006
850,20,168,1038,81.89,1.93,16.18,2019,73007
5672,298,633,6603,85.9,4.51,9.59,2019,73010
751,24,310,1085,69.22,2.21,28.57,2019,73015
100,4,38,142,70.42,2.82,26.76,2019,73033
2161,84,474,2719,79.48,3.09,17.43,2019,73051
172,4,70,246,69.92,1.63,28.46,2019,73053
534,10,123,667,80.06,1.5,18.44,2019,73061
3601,414,1210,5225,68.92,7.92,23.16,2019,76707
113,5,53,171,66.08,2.92,30.99,2019,76827
0,0,0,0,,,,2019,76831
1571,191,461,2223,70.67,8.59,20.74,2019,76834
404,0,158,562,71.89,0.0,28.11,2019,76837
83,0,26,109,76.15,0.0,23.85,2019,76845
1071,89,341,1501,71.35,5.93,22.72,2019,76856
82,1,44,127,64.57,0.79,34.65,2019,76858
5736,140,833,6709,85.5,2.09,12.42,2019,76009
4847,176,980,6003,80.74,2.93,16.33,2019,76031
8146,258,581,8985,90.66,2.87,6.47,2019,76036
3969,218,878,5065,78.36,4.3,17.33,2019,76302
7170,461,659,8290,86.49,5.56,7.95,2019,76308
70,6,42,118,59.32,5.08,35.59,2019,76370
1165,36,351,1552,75.06,2.32,22.62,2019,76380
2283,81,579,2943,77.57,2.75,19.67,2019,76424
2379,8,773,3160,75.28,0.25,24.46,2019,76442
1056,27,352,1435,73.59,1.88,24.53,2019,76444
64,0,67,131,48.85,0.0,51.15,2019,76445
768,50,170,988,77.73,5.06,17.21,2019,76449
4024,296,974,5294,76.01,5.59,18.4,2019,76450
999,7,218,1224,81.62,0.57,17.81,2019,76462
151,13,92,256,58.98,5.08,35.94,2019,76464
734,60,184,978,75.05,6.13,18.81,2019,76476
407,27,207,641,63.49,4.21,32.29,2019,76511
232,0,16,248,93.55,0.0,6.45,2019,78614
5942,166,682,6790,87.51,2.44,10.04,2019,78617
806,35,220,1061,75.97,3.3,20.74,2019,78631
132,0,18,150,88.0,0.0,12.0,2019,78635
521,15,175,711,73.28,2.11,24.61,2019,78656
345,2,7,354,97.46,0.56,1.98,2019,78663
3879,154,310,4343,89.32,3.55,7.14,2019,84532
7488,2559,686,10733,69.77,23.84,6.39,2019,84601
5605,401,2312,8318,67.38,4.82,27.8,2019,87002
15,5,66,86,17.44,5.81,76.74,2019,87012
165,29,132,326,50.61,8.9,40.49,2019,87412
3927,215,1619,5761,68.17,3.73,28.1,2019,87413
182,0,94,276,65.94,0.0,34.06,2019,87514
49,0,0,49,100.0,0.0,0.0,2019,87939
31,0,10,41,75.61,0.0,24.39,2019,89834
478,62,104,644,74.22,9.63,16.15,2019,89835
1620,22,182,1824,88.82,1.21,9.98,2019,89704
7838,476,1051,9365,83.69,5.08,11.22,2019,89801
11684,337,2755,14776,79.07,2.28,18.65,2019,89015
11553,501,1903,13957,82.78,3.59,13.63,2019,89032
64,0,155,219,29.22,0.0,70.78,2019,89046
49,5,33,87,56.32,5.75,37.93,2019,89047
8291,945,5902,15138,54.77,6.24,38.99,2019,89101
10106,455,4391,14952,67.59,3.04,29.37,2019,89102
5585,549,2730,8864,63.01,6.19,30.8,2019,89106
2216,84,498,2798,79.2,3.0,17.8,2019,89301
45,0,10,55,81.82,0.0,18.18,2019,89311
347,24,93,464,74.78,5.17,20.04,2019,89316
5433,119,501,6053,89.76,1.97,8.28,2019,89403
8510,249,1153,9912,85.86,2.51,11.63,2019,89406
341,0,10,351,97.15,0.0,2.85,2019,89413
9532,165,969,10666,89.37,1.55,9.08,2019,89434
8010,185,1332,9527,84.08,1.94,13.98,2019,89156
306,0,159,465,65.81,0.0,34.19,2019,89318
40,0,26,66,60.61,0.0,39.39,2019,89409
1079,21,412,1512,71.36,1.39,27.25,2019,89415
4238,67,309,4614,91.85,1.45,6.7,2019,89423
95,21,0,116,81.9,18.1,0.0,2019,89430
5577,128,1101,6806,81.94,1.88,16.18,2019,89433
15250,335,805,16390,93.04,2.04,4.91,2019,89436
218,31,66,315,69.21,9.84,20.95,2019,89440
2756,40,634,3430,80.35,1.17,18.48,2019,89447
3653,69,135,3857,94.71,1.79,3.5,2019,89451
262,0,75,337,77.74,0.0,22.26,2019,89007
345,29,102,476,72.48,6.09,21.43,2019,89008
13111,309,1022,14442,90.78,2.14,7.08,2019,89012
39,0,0,39,100.0,0.0,0.0,2019,89017
0,0,0,0,,,,2019,89022
3015,187,902,4104,73.46,4.56,21.98,2019,89109
15961,580,4640,21181,75.36,2.74,21.91,2019,89110
10900,291,717,11908,91.54,2.44,6.02,2019,89113
9670,730,1107,11507,84.04,6.34,9.62,2019,89134
55,0,51,106,51.89,0.0,48.11,2019,89039
115,0,53,168,68.45,0.0,31.55,2019,89310
42,0,60,102,41.18,0.0,58.82,2019,89418
14216,463,2258,16937,83.93,2.73,13.33,2019,89509
29,6,17,52,55.77,11.54,32.69,2019,89833
5504,152,959,6615,83.2,2.3,14.5,2019,89005
9611,382,2696,12689,75.74,3.01,21.25,2019,89107
17867,1033,1437,20337,87.85,5.08,7.07,2019,89129
11029,239,871,12139,90.86,1.97,7.18,2019,89002
0,0,0,0,,,,2019,89026
8743,93,509,9345,93.56,1.0,5.45,2019,89044
705,0,164,869,81.13,0.0,18.87,2019,89045
30,0,0,30,100.0,0.0,0.0,2019,89054
15526,498,1609,17633,88.05,2.82,9.12,2019,63031
412,0,67,479,86.01,0.0,13.99,2019,63036
652,5,142,799,81.6,0.63,17.77,2019,63060
2761,97,271,3129,88.24,3.1,8.66,2019,63070
483,2,60,545,88.62,0.37,11.01,2019,63091
6176,194,292,6662,92.7,2.91,4.38,2019,63105
5895,372,1970,8237,71.57,4.52,23.92,2019,63112
12015,488,2172,14675,81.87,3.33,14.8,2019,63114
12517,467,1213,14197,88.17,3.29,8.54,2019,63119
11267,318,2436,14021,80.36,2.27,17.37,2019,63125
10372,244,1401,12017,86.31,2.03,11.66,2019,63130
6894,181,1388,8463,81.46,2.14,16.4,2019,63135
4160,20,747,4927,84.43,0.41,15.16,2019,63143
12978,228,1318,14524,89.36,1.57,9.07,2019,63146
14246,206,832,15284,93.21,1.35,5.44,2019,63304
2461,82,167,2710,90.81,3.03,6.16,2019,63348
1713,68,255,2036,84.14,3.34,12.52,2019,63357
982,95,285,1362,72.1,6.98,20.93,2019,63382
82,0,36,118,69.49,0.0,30.51,2019,63431
351,24,103,478,73.43,5.02,21.55,2019,63469
244,17,107,368,66.3,4.62,29.08,2019,63530
101,2,35,138,73.19,1.45,25.36,2019,63531
2076,241,1839,4156,49.95,5.8,44.25,2019,63107
2925,134,1633,4692,62.34,2.86,34.8,2019,63113
4030,54,402,4486,89.84,1.2,8.96,2019,63117
1645,235,1304,3184,51.66,7.38,40.95,2019,63120
9761,262,962,10985,88.86,2.39,8.76,2019,63139
1870,417,1351,3638,51.4,11.46,37.14,2019,63147
44,0,27,71,61.97,0.0,38.03,2019,63330
188,3,148,339,55.46,0.88,43.66,2019,63333
1202,5,157,1364,88.12,0.37,11.51,2019,63341
1165,72,438,1675,69.55,4.3,26.15,2019,63343
182,25,33,240,75.83,10.42,13.75,2019,63345
440,5,92,537,81.94,0.93,17.13,2019,63359
124,2,46,172,72.09,1.16,26.74,2019,63381
444,48,227,719,61.75,6.68,31.57,2019,63384
202,8,117,327,61.77,2.45,35.78,2019,63534
242,2,109,353,68.56,0.57,30.88,2019,63536
53,9,42,104,50.96,8.65,40.38,2019,63538
42,0,24,66,63.64,0.0,36.36,2019,63539
11297,179,934,12410,91.03,1.44,7.53,2019,75252
5101,323,1037,6461,78.95,5.0,16.05,2019,75253
24092,477,3518,28087,85.78,1.7,12.53,2019,75287
4121,87,623,4831,85.3,1.8,12.9,2019,75409
142,8,192,342,41.52,2.34,56.14,2019,75411
770,111,232,1113,69.18,9.97,20.84,2019,75416
63,0,8,71,88.73,0.0,11.27,2019,75441
772,30,379,1181,65.37,2.54,32.09,2019,75446
311,15,114,440,70.68,3.41,25.91,2019,75447
3589,139,823,4551,78.86,3.05,18.08,2019,75462
63,12,33,108,58.33,11.11,30.56,2019,75469
1123,39,248,1410,79.65,2.77,17.59,2019,75473
11192,902,1676,13770,81.28,6.55,12.17,2019,83706
9256,481,1412,11149,83.02,4.31,12.66,2019,83814
504,55,113,672,75.0,8.18,16.82,2019,83876
163,14,19,196,83.16,7.14,9.69,2019,83228
1193,4,235,1432,83.31,0.28,16.41,2019,83313
5516,178,364,6058,91.05,2.94,6.01,2019,83406
84,6,13,103,81.55,5.83,12.62,2019,83520
3603,82,521,4206,85.66,1.95,12.39,2019,83644
3014,100,829,3943,76.44,2.54,21.02,2019,83316
161,5,14,180,89.44,2.78,7.78,2019,83436
38,0,0,38,100.0,0.0,0.0,2019,83238
1079,73,703,1855,58.17,3.94,37.9,2019,79821
1318,29,376,1723,76.49,1.68,21.82,2019,79836
798,23,228,1049,76.07,2.19,21.73,2019,79041
4861,155,1159,6175,78.72,2.51,18.77,2019,79045
325,13,98,436,74.54,2.98,22.48,2019,79052
2286,0,234,2520,90.71,0.0,9.29,2019,79922
15369,825,3883,20077,76.55,4.11,19.34,2019,79924
50,0,6,56,89.29,0.0,10.71,2019,79021
0,0,0,0,,,,2019,79051
184,12,54,250,73.6,4.8,21.6,2019,79054
196,3,79,278,70.5,1.08,28.42,2019,79063
5291,205,1706,7202,73.47,2.85,23.69,2019,79065
6508,230,1630,8368,77.77,2.75,19.48,2019,79072
843,45,243,1131,74.54,3.98,21.49,2019,79079
624,10,146,780,80.0,1.28,18.72,2019,79086
3055,125,747,3927,77.79,3.18,19.02,2019,79103
1822,69,561,2452,74.31,2.81,22.88,2019,79104
234,10,66,310,75.48,3.23,21.29,2019,79345
16,0,3,19,84.21,0.0,15.79,2019,79518
50,0,24,74,67.57,0.0,32.43,2019,79560
2464,212,1289,3965,62.14,5.35,32.51,2019,79735
1049,33,251,1333,78.69,2.48,18.83,2019,79081
124,2,28,154,80.52,1.3,18.18,2019,79098
3455,166,769,4390,78.7,3.78,17.52,2019,79108
25,19,41,85,29.41,22.35,48.24,2019,79780
1442,66,2161,3669,39.3,1.8,58.9,2019,79901
12974,304,1219,14497,89.49,2.1,8.41,2019,79707
13878,393,1466,15737,88.19,2.5,9.32,2019,79762
326,30,48,404,80.69,7.43,11.88,2019,79092
596,19,164,779,76.51,2.44,21.05,2019,62935
267,0,228,495,53.94,0.0,46.06,2019,62964
126,4,143,273,46.15,1.47,52.38,2019,62970
418,32,171,621,67.31,5.15,27.54,2019,62983
209,18,44,271,77.12,6.64,16.24,2019,62994
1443,121,406,1970,73.25,6.14,20.61,2019,62060
376,0,94,470,80.0,0.0,20.0,2019,62022
192,7,106,305,62.95,2.3,34.75,2019,62036
132,2,48,182,72.53,1.1,26.37,2019,62054
117,0,15,132,88.64,0.0,11.36,2019,62081
126,0,15,141,89.36,0.0,10.64,2019,62091
842,25,282,1149,73.28,2.18,24.54,2019,62092
189,4,153,346,54.62,1.16,44.22,2019,62956
153,3,135,291,52.58,1.03,46.39,2019,62957
3106,102,1297,4505,68.95,2.26,28.79,2019,62960
0,0,0,0,,,,2019,62962
99,2,146,247,40.08,0.81,59.11,2019,62963
461,21,222,704,65.48,2.98,31.53,2019,62984
258,7,197,462,55.84,1.52,42.64,2019,62988
5439,57,391,5887,92.39,0.97,6.64,2019,90212
6024,105,288,6417,93.88,1.64,4.49,2019,90245
14881,187,776,15844,93.92,1.18,4.9,2019,90277
2147,14,114,2275,94.37,0.62,5.01,2019,90290
9351,261,1024,10636,87.92,2.45,9.63,2019,90302
15222,349,1076,16647,91.44,2.1,6.46,2019,90503
8760,269,1353,10382,84.38,2.59,13.03,2019,90605
7807,229,960,8996,86.78,2.55,10.67,2019,90606
14474,191,850,15515,93.29,1.23,5.48,2019,90703
8044,192,574,8810,91.31,2.18,6.52,2019,90732
10592,210,1748,12550,84.4,1.67,13.93,2019,90740
346,5,28,379,91.29,1.32,7.39,2019,90742
1086,73,575,1734,62.63,4.21,33.16,2019,90021
7519,772,2615,10906,68.94,7.08,23.98,2019,90059
20193,626,3252,24071,83.89,2.6,13.51,2019,90280
95,0,15,110,86.36,0.0,13.64,2019,90743
12916,274,753,13943,92.63,1.97,5.4,2019,90405
18756,647,3837,23240,80.71,2.78,16.51,2019,90706
13080,365,3123,16568,78.95,2.2,18.85,2019,90018
26862,780,4263,31905,84.19,2.44,13.36,2019,90250
9444,311,1226,10981,86.0,2.83,11.16,2019,90601
8455,98,403,8956,94.41,1.09,4.5,2019,90254
7796,82,1352,9230,84.46,0.89,14.65,2019,90710
0,0,0,0,,,,2019,90073
0,0,0,0,,,,2019,90079
0,9,0,9,0.0,100.0,0.0,2019,90089
0,0,0,0,,,,2019,90090
4044,251,66,4361,92.73,5.76,1.51,2019,90094
0,0,0,0,,,,2019,90095
0,0,0,0,,,,2019,90506
0,0,0,0,,,,2019,90747
4163,94,486,4743,87.77,1.98,10.25,2019,90755
0,0,0,0,,,,2019,90831
12082,364,600,13046,92.61,2.79,4.6,2019,94043
18799,242,1000,20041,93.8,1.21,4.99,2019,94087
7718,63,450,8231,93.77,0.77,5.47,2019,94089
5734,186,1880,7800,73.51,2.38,24.1,2019,94108
14572,194,1458,16224,89.82,1.2,8.99,2019,94116
16113,220,1521,17854,90.25,1.23,8.52,2019,94118
21148,339,1449,22936,92.2,1.48,6.32,2019,94122
10064,157,459,10680,94.23,1.47,4.3,2019,94306
11027,174,1196,12397,88.95,1.4,9.65,2019,94401
889,26,82,997,89.17,2.61,8.22,2019,94508
2621,131,249,3001,87.34,4.37,8.3,2019,94515
9718,226,644,10588,91.78,2.13,6.08,2019,94518
9473,207,633,10313,91.85,2.01,6.14,2019,94530
22964,142,1867,24973,91.96,0.57,7.48,2019,94536
19229,443,2136,21808,88.17,2.03,9.79,2019,94541
14730,305,1328,16363,90.02,1.86,8.12,2019,94546
8007,59,336,8402,95.3,0.7,4.0,2019,94547
4780,3,160,4943,96.7,0.06,3.24,2019,94552
25628,481,2259,28368,90.34,1.7,7.96,2019,94565
15575,219,681,16475,94.54,1.33,4.13,2019,94566
0,0,0,0,,,,2019,79016
0,0,0,0,,,,2019,79058
1,0,6,7,14.29,0.0,85.71,2019,79085
11,0,0,11,100.0,0.0,0.0,2019,79094
0,0,0,0,,,,2019,79105
18,0,0,18,100.0,0.0,0.0,2019,79258
2916,95,1204,4215,69.18,2.25,28.56,2019,89060
2192,109,365,2666,82.22,4.09,13.69,2019,89061
18168,532,1467,20167,90.09,2.64,7.27,2019,89074
10089,311,692,11092,90.96,2.8,6.24,2019,89081
8653,220,489,9362,92.43,2.35,5.22,2019,89084
1133,88,28,1249,90.71,7.05,2.24,2019,89085
1697,68,162,1927,88.06,3.53,8.41,2019,89086
5566,406,123,6095,91.32,6.66,2.02,2019,89138
0,0,10,10,0.0,0.0,100.0,2019,76841
975,14,317,1306,74.66,1.07,24.27,2019,76844
0,0,0,0,,,,2019,76874
177,2,60,239,74.06,0.84,25.1,2019,76875
459,34,129,622,73.79,5.47,20.74,2019,76878
505,4,56,565,89.38,0.71,9.91,2019,76935
396,45,161,602,65.78,7.48,26.74,2019,76941
39,0,14,53,73.58,0.0,26.42,2019,76955
8659,76,200,8935,96.91,0.85,2.24,2019,76226
10387,512,513,11412,91.02,4.49,4.5,2019,76227
983,41,223,1247,78.83,3.29,17.88,2019,76651
70,0,38,108,64.81,0.0,35.19,2019,76680
2485,49,286,2820,88.12,1.74,10.14,2019,76060
7420,99,366,7885,94.1,1.26,4.64,2019,76148
1173,121,436,1730,67.8,6.99,25.2,2019,76305
4593,282,1079,5954,77.14,4.74,18.12,2019,76306
1468,60,413,1941,75.63,3.09,21.28,2019,76365
3055,9,520,3584,85.24,0.25,14.51,2019,76367
39,0,24,63,61.9,0.0,38.1,2019,76373
83,2,22,107,77.57,1.87,20.56,2019,76388
8228,639,1182,10049,81.88,6.36,11.76,2019,76401
154,4,48,206,74.76,1.94,23.3,2019,76435
248,4,109,361,68.7,1.11,30.19,2019,76455
463,63,117,643,72.01,9.8,18.2,2019,76472
278,23,55,356,78.09,6.46,15.45,2019,76484
4640,105,781,5526,83.97,1.9,14.13,2019,76022
1334,34,532,1900,70.21,1.79,28.0,2019,76073
2625,73,223,2921,89.87,2.5,7.63,2019,76655
0,0,0,0,,,,2019,76798
71,0,0,71,100.0,0.0,0.0,2019,76885
7809,643,3230,11682,66.85,5.5,27.65,2019,76903
133,4,41,178,74.72,2.25,23.03,2019,76379
201,99,5,305,65.9,32.46,1.64,2019,76070
7994,156,393,8543,93.57,1.83,4.6,2019,76126
7559,115,205,7879,95.94,1.46,2.6,2019,77384
2734,99,775,3608,75.78,2.74,21.48,2019,77423
4555,86,1030,5671,80.32,1.52,18.16,2019,77568
1287,6,615,1908,67.45,0.31,32.23,2019,77514
28511,615,1134,30260,94.22,2.03,3.75,2019,77573
236,0,102,338,69.82,0.0,30.18,2019,77585
387,18,84,489,79.14,3.68,17.18,2019,77613
185,20,111,316,58.54,6.33,35.13,2019,77615
7386,160,1163,8709,84.81,1.84,13.35,2019,77627
8631,400,2302,11333,76.16,3.53,20.31,2019,77630
303,43,142,488,62.09,8.81,29.1,2019,77663
5465,103,1210,6778,80.63,1.52,17.85,2019,77707
4381,673,973,6027,72.69,11.17,16.14,2019,77801
81,0,0,81,100.0,0.0,0.0,2019,77443
3973,146,579,4698,84.57,3.11,12.32,2019,77003
8909,613,2618,12140,73.39,5.05,21.57,2019,77351
3789,160,471,4420,85.72,3.62,10.66,2019,77372
514,29,166,709,72.5,4.09,23.41,2019,75479
724,49,97,870,83.22,5.63,11.15,2019,75486
1024,39,195,1258,81.4,3.1,15.5,2019,75496
179,6,123,308,58.12,1.95,39.94,2019,75550
301,5,146,452,66.59,1.11,32.3,2019,75560
454,39,214,707,64.21,5.52,30.27,2019,75574
842,14,275,1131,74.45,1.24,24.31,2019,75631
11923,326,418,12667,94.13,2.57,3.3,2019,75077
1001,11,317,1329,75.32,0.83,23.85,2019,75569
41,0,0,41,100.0,0.0,0.0,2019,75573
1290,78,515,1883,68.51,4.14,27.35,2019,75966
597,11,179,787,75.86,1.4,22.74,2019,75643
704,56,205,965,72.95,5.8,21.24,2019,75681
987,61,396,1444,68.35,4.22,27.42,2019,75683
913,145,498,1556,58.68,9.32,32.01,2019,75691
2648,125,663,3436,77.07,3.64,19.3,2019,75785
4155,34,503,4692,88.55,0.72,10.72,2019,75791
939,21,199,1159,81.02,1.81,17.17,2019,75833
2787,14,1601,4402,63.31,0.32,36.37,2019,75835
572,47,99,718,79.67,6.55,13.79,2019,75861
1193,37,260,1490,80.07,2.48,17.45,2019,75925
286,8,64,358,79.89,2.23,17.88,2019,75936
383,13,99,495,77.37,2.63,20.0,2019,75943
23,0,0,23,100.0,0.0,0.0,2019,75788
140,13,96,249,56.22,5.22,38.55,2019,75838
458,30,293,781,58.64,3.84,37.52,2019,75847
291,30,140,461,63.12,6.51,30.37,2019,75852
2794,114,1346,4254,65.68,2.68,31.64,2019,75862
316,20,130,466,67.81,4.29,27.9,2019,75926
1283,106,499,1888,67.96,5.61,26.43,2019,75939
903,61,411,1375,65.67,4.44,29.89,2019,75946
483,24,134,641,75.35,3.74,20.9,2019,75968
13479,375,2323,16177,83.32,2.32,14.36,2019,75062
10142,390,3284,13816,73.41,2.82,23.77,2019,75069
15950,341,1076,17367,91.84,1.96,6.2,2019,75098
33,0,18,51,64.71,0.0,35.29,2019,75105
925,41,165,1131,81.79,3.63,14.59,2019,75141
1704,0,776,2480,68.71,0.0,31.29,2019,75147
11569,358,972,12899,89.69,2.78,7.54,2019,75154
1069,61,243,1373,77.86,4.44,17.7,2019,75158
3338,108,1109,4555,73.28,2.37,24.35,2019,75223
8401,153,378,8932,94.06,1.71,4.23,2019,75225
9472,516,1097,11085,85.45,4.65,9.9,2019,75229
6478,533,926,7937,81.62,6.72,11.67,2019,75235
5436,513,5072,11021,49.32,4.65,46.02,2019,75241
5595,50,219,5864,95.41,0.85,3.73,2019,75244
90,0,0,90,100.0,0.0,0.0,2019,75415
212,4,42,258,82.17,1.55,16.28,2019,76251
53,2,30,85,62.35,2.35,35.29,2019,76268
612,13,14,639,95.77,2.03,2.19,2019,76311
39,2,28,69,56.52,2.9,40.58,2019,76364
545,52,188,785,69.43,6.62,23.95,2019,76366
92,0,16,108,85.19,0.0,14.81,2019,62011
1082,28,257,1367,79.15,2.05,18.8,2019,62016
407,19,79,505,80.59,3.76,15.64,2019,62017
402,0,77,479,83.92,0.0,16.08,2019,62021
160,10,107,277,57.76,3.61,38.63,2019,62028
504,26,191,721,69.9,3.61,26.49,2019,62838
81,3,33,117,69.23,2.56,28.21,2019,62818
143,2,37,182,78.57,1.1,20.33,2019,62819
2383,101,670,3154,75.55,3.2,21.24,2019,62821
60,4,8,72,83.33,5.56,11.11,2019,62843
1773,65,583,2421,73.23,2.68,24.08,2019,62859
605,16,212,833,72.63,1.92,25.45,2019,62865
3707,87,805,4599,80.6,1.89,17.5,2019,62881
247,6,66,319,77.43,1.88,20.69,2019,62883
3769,117,1308,5194,72.56,2.25,25.18,2019,62896
501,25,182,708,70.76,3.53,25.71,2019,62899
8546,834,1475,10855,78.73,7.68,13.59,2019,62901
179,0,43,222,80.63,0.0,19.37,2019,62905
51,0,58,109,46.79,0.0,53.21,2019,62953
2260,96,606,2962,76.3,3.24,20.46,2019,62231
179,22,55,256,69.92,8.59,21.48,2019,62238
5353,189,641,6183,86.58,3.06,10.37,2019,62249
33,0,0,33,100.0,0.0,0.0,2019,62266
689,47,143,879,78.38,5.35,16.27,2019,62271
4787,113,502,5402,88.62,2.09,9.29,2019,62294
184,1,48,233,78.97,0.43,20.6,2019,62316
1272,26,387,1685,75.49,1.54,22.97,2019,62321
541,13,223,777,69.63,1.67,28.7,2019,62330
3,0,0,3,100.0,0.0,0.0,2019,62344
276,0,85,361,76.45,0.0,23.55,2019,62051
65,13,104,182,35.71,7.14,57.14,2019,62059
23,0,10,33,69.7,0.0,30.3,2019,62078
3573,43,760,4376,81.65,0.98,17.37,2019,62095
970,10,101,1081,89.73,0.93,9.34,2019,62097
603,0,117,720,83.75,0.0,16.25,2019,62215
4909,74,421,5404,90.84,1.37,7.79,2019,62236
133,6,53,192,69.27,3.12,27.6,2019,62250
1069,93,271,1433,74.6,6.49,18.91,2019,62264
165,0,34,199,82.91,0.0,17.09,2019,62280
946,5,61,1012,93.48,0.49,6.03,2019,62281
3323,198,530,4051,82.03,4.89,13.08,2019,76088
3590,257,1345,5192,69.14,4.95,25.91,2019,76103
9578,582,4472,14632,65.46,3.98,30.56,2019,76119
48,0,0,48,100.0,0.0,0.0,2019,76127
152,7,38,197,77.16,3.55,19.29,2019,76357
108,0,34,142,76.06,0.0,23.94,2019,76238
3911,42,258,4211,92.88,1.0,6.13,2019,76247
439,12,127,578,75.95,2.08,21.97,2019,76265
3145,162,924,4231,74.33,3.83,21.84,2019,76426
1409,10,608,2027,69.51,0.49,30.0,2019,76437
315,8,37,360,87.5,2.22,10.28,2019,76538
3113,114,92,3319,93.79,3.43,2.77,2019,76544
689,8,115,812,84.85,0.99,14.16,2019,76569
330,7,96,433,76.21,1.62,22.17,2019,76578
506,81,140,727,69.6,11.14,19.26,2019,76624
429,10,92,531,80.79,1.88,17.33,2019,76627
2210,148,572,2930,75.43,5.05,19.52,2019,76634
389,41,129,559,69.59,7.33,23.08,2019,76639
418,23,78,519,80.54,4.43,15.03,2019,76652
0,0,0,0,,,,2019,79699
0,0,0,0,,,,2019,79770
1781,90,133,2004,88.87,4.49,6.64,2019,79911
0,0,0,0,,,,2019,79916
0,0,0,0,,,,2019,79920
13241,840,1448,15529,85.27,5.41,9.32,2019,79928
15,0,0,15,100.0,0.0,0.0,2019,79942
394,27,146,567,69.49,4.76,25.75,2019,79040
95,0,40,135,70.37,0.0,29.63,2019,79018
346,45,63,454,76.21,9.91,13.88,2019,79744
0,0,19,19,0.0,0.0,100.0,2019,79846
216,7,117,340,63.53,2.06,34.41,2019,79718
76,7,23,106,71.7,6.6,21.7,2019,79834
118,3,25,146,80.82,2.05,17.12,2019,79061
620,58,239,917,67.61,6.32,26.06,2019,79095
11813,665,2190,14668,80.54,4.53,14.93,2019,79925
983,6,154,1143,86.0,0.52,13.47,2019,79525
186,12,48,246,75.61,4.88,19.51,2019,79528
107,9,56,172,62.21,5.23,32.56,2019,79533
66,3,26,95,69.47,3.16,27.37,2019,79539
311,14,132,457,68.05,3.06,28.88,2019,79543
512,22,122,656,78.05,3.35,18.6,2019,79545
4022,159,1277,5458,73.69,2.91,23.4,2019,79549
3321,171,1079,4571,72.65,3.74,23.61,2019,79556
1027,9,220,1256,81.77,0.72,17.52,2019,79562
71,3,32,106,66.98,2.83,30.19,2019,79566
4816,99,658,5573,86.42,1.78,11.81,2019,79714
65,2,46,113,57.52,1.77,40.71,2019,79741
8964,263,2405,11632,77.06,2.26,20.68,2019,79763
68,0,26,94,72.34,0.0,27.66,2019,79777
8189,215,160,8564,95.62,2.51,1.87,2019,80124
3767,0,78,3845,97.97,0.0,2.03,2019,80125
12482,1166,1234,14882,83.87,7.83,8.29,2019,80203
14146,373,887,15406,91.82,2.42,5.76,2019,80210
14612,413,1851,16876,86.58,2.45,10.97,2019,80211
9919,865,725,11509,86.18,7.52,6.3,2019,80218
10692,501,2671,13864,77.12,3.61,19.27,2019,80221
7039,265,767,8071,87.21,3.28,9.5,2019,80224
8191,127,896,9214,88.9,1.38,9.72,2019,80232
6623,188,657,7468,88.69,2.52,8.8,2019,80246
1630,38,97,1765,92.35,2.15,5.5,2019,80540
1469,23,73,1565,93.87,1.47,4.66,2019,80542
2378,44,149,2571,92.49,1.71,5.8,2019,80543
10588,201,3000,13789,76.79,1.46,21.76,2019,80010
4023,0,75,4098,98.17,0.0,1.83,2019,80018
2032,35,82,2149,94.56,1.63,3.82,2019,80106
4332,128,182,4642,93.32,2.76,3.92,2019,80107
23800,269,503,24572,96.86,1.09,2.05,2019,80134
1447,21,60,1528,94.7,1.37,3.93,2019,80135
11199,213,301,11713,95.61,1.82,2.57,2019,80138
12034,271,1428,13733,87.63,1.97,10.4,2019,80226
14587,406,1920,16913,86.25,2.4,11.35,2019,80231
5236,278,1011,6525,80.25,4.26,15.49,2019,80620
1588,29,377,1994,79.64,1.45,18.91,2019,85034
12364,817,2213,15394,80.32,5.31,14.38,2019,85051
14537,342,903,15782,92.11,2.17,5.72,2019,85202
6432,303,603,7338,87.65,4.13,8.22,2019,85215
21826,755,2859,25440,85.79,2.97,11.24,2019,85225
13647,342,513,14502,94.1,2.36,3.54,2019,85226
188,0,45,233,80.69,0.0,19.31,2019,77374
17117,227,809,18153,94.29,1.25,4.46,2019,77375
84,0,171,255,32.94,0.0,67.06,2019,77376
5592,417,2845,8854,63.16,4.71,32.13,2019,77414
0,13,0,13,0.0,100.0,0.0,2019,77415
3096,125,969,4190,73.89,2.98,23.13,2019,77418
0,0,27,27,0.0,0.0,100.0,2019,77440
3788,146,645,4579,82.73,3.19,14.09,2019,77808
587,58,359,1004,58.47,5.78,35.76,2019,75661
843,13,140,996,84.64,1.31,14.06,2019,75668
263,0,16,279,94.27,0.0,5.73,2019,75669
2222,12,196,2430,91.44,0.49,8.07,2019,75693
14324,358,1945,16627,86.15,2.15,11.7,2019,75703
521,18,268,807,64.56,2.23,33.21,2019,75705
4840,87,446,5373,90.08,1.62,8.3,2019,75707
2660,59,725,3444,77.24,1.71,21.05,2019,75758
1094,48,312,1454,75.24,3.3,21.46,2019,75472
1323,85,391,1799,73.54,4.72,21.73,2019,75491
9110,404,3777,13291,68.54,3.04,28.42,2019,75501
907,18,163,1088,83.36,1.65,14.98,2019,75571
1634,93,568,2295,71.2,4.05,24.75,2019,75603
2961,287,1133,4381,67.59,6.55,25.86,2019,75652
3162,296,1276,4734,66.79,6.25,26.95,2019,75686
2207,61,868,3136,70.38,1.95,27.68,2019,75706
6510,551,2577,9638,67.55,5.72,26.74,2019,75766
2168,109,484,2761,78.52,3.95,17.53,2019,75789
735,62,366,1163,63.2,5.33,31.47,2019,75845
206,17,66,289,71.28,5.88,22.84,2019,75850
741,18,379,1138,65.11,1.58,33.3,2019,75855
536,0,196,732,73.22,0.0,26.78,2019,75930
439,23,56,518,84.75,4.44,10.81,2019,75944
5048,126,1520,6694,75.41,1.88,22.71,2019,75964
94,7,71,172,54.65,4.07,41.28,2019,75977
717,6,255,978,73.31,0.61,26.07,2019,75980
56,12,12,80,70.0,15.0,15.0,2019,75764
1702,108,572,2382,71.45,4.53,24.01,2019,75840
164,0,116,280,58.57,0.0,41.43,2019,75853
649,23,272,944,68.75,2.44,28.81,2019,75859
270,71,128,469,57.57,15.14,27.29,2019,75933
63,0,2,65,96.92,0.0,3.08,2019,75934
2130,93,393,2616,81.42,3.56,15.02,2019,75941
4949,353,843,6145,80.54,5.74,13.72,2019,75961
1593,18,941,2552,62.42,0.71,36.87,2019,75972
15663,266,1978,17907,87.47,1.49,11.05,2019,75074
8731,89,357,9177,95.14,0.97,3.89,2019,75088
10970,125,397,11492,95.46,1.09,3.45,2019,75089
98,9,63,170,57.65,5.29,37.06,2019,75101
12954,522,3903,17379,74.54,3.0,22.46,2019,77088
12757,638,2532,15927,80.1,4.01,15.9,2019,77090
7399,421,426,8246,89.73,5.11,5.17,2019,77098
15,0,22,37,40.54,0.0,59.46,2019,77326
5846,183,1773,7802,74.93,2.35,22.72,2019,77327
65,29,29,123,52.85,23.58,23.58,2019,77334
11631,262,1256,13149,88.46,1.99,9.55,2019,77304
3331,13,908,4252,78.34,0.31,21.35,2019,77306
2339,120,689,3148,74.3,3.81,21.89,2019,77331
3884,174,1864,5922,65.59,2.94,31.48,2019,77011
3344,455,2182,5981,55.91,7.61,36.48,2019,77012
3767,144,1912,5823,64.69,2.47,32.84,2019,77013
742,20,161,923,80.39,2.17,17.44,2019,76430
1021,44,349,1414,72.21,3.11,24.68,2019,74116
4334,215,2419,6968,62.2,3.09,34.72,2019,74106
1249,47,440,1736,71.95,2.71,25.35,2019,74365
384,36,335,755,50.86,4.77,44.37,2019,74727
144,10,73,227,63.44,4.41,32.16,2019,74748
33,3,72,108,30.56,2.78,66.67,2019,74747
1033,14,265,1312,78.73,1.07,20.2,2019,74039
10222,195,532,10949,93.36,1.78,4.86,2019,74137
5748,154,1086,6988,82.26,2.2,15.54,2019,74019
30,0,20,50,60.0,0.0,40.0,2019,74046
0,0,0,0,,,,2019,74078
20,0,4,24,83.33,0.0,16.67,2019,74082
163,3,70,236,69.07,1.27,29.66,2019,74359
17,2,6,25,68.0,8.0,24.0,2019,74458
9,0,0,9,100.0,0.0,0.0,2019,74477
4187,205,1209,5601,74.75,3.66,21.59,2019,74146
3114,97,1094,4305,72.33,2.25,25.41,2019,74301
853,45,184,1082,78.84,4.16,17.01,2019,74330
526,104,275,905,58.12,11.49,30.39,2019,74339
78,1,29,108,72.22,0.93,26.85,2019,74340
5052,294,1241,6587,76.7,4.46,18.84,2019,74344
647,40,247,934,69.27,4.28,26.45,2019,74347
1697,137,621,2455,69.12,5.58,25.3,2019,74352
12,0,5,17,70.59,0.0,29.41,2019,74360
5370,238,1007,6615,81.18,3.6,15.22,2019,74361
536,6,190,732,73.22,0.82,25.96,2019,74364
203,20,79,302,67.22,6.62,26.16,2019,74422
2619,305,1071,3995,65.56,7.63,26.81,2019,74426
44,2,41,87,50.57,2.3,47.13,2019,74460
546,12,279,837,65.23,1.43,33.33,2019,74469
420,5,202,627,66.99,0.8,32.22,2019,74470
299,18,170,487,61.4,3.7,34.91,2019,74552
139,8,68,215,64.65,3.72,31.63,2019,74557
99,2,69,170,58.24,1.18,40.59,2019,74558
21,0,54,75,28.0,0.0,72.0,2019,74567
121,16,29,166,72.89,9.64,17.47,2019,74633
235,12,62,309,76.05,3.88,20.06,2019,74641
7076,406,1899,9381,75.43,4.33,20.24,2019,74701
1367,147,302,1816,75.28,8.09,16.63,2019,74730
7894,345,1176,9415,83.84,3.66,12.49,2019,77530
7738,315,1691,9744,79.41,3.23,17.35,2019,77550
11584,434,1199,13217,87.64,3.28,9.07,2019,77571
29504,154,1144,30802,95.79,0.5,3.71,2019,77584
92,0,48,140,65.71,0.0,34.29,2019,77614
176,25,23,224,78.57,11.16,10.27,2019,77623
2578,40,795,3413,75.53,1.17,23.29,2019,77625
640,34,80,754,84.88,4.51,10.61,2019,77650
4946,306,953,6205,79.71,4.93,15.36,2019,77656
1451,81,203,1735,83.63,4.67,11.7,2019,77659
50,0,0,50,100.0,0.0,0.0,2019,77855
650,40,175,865,75.14,4.62,20.23,2019,77865
387,34,109,530,73.02,6.42,20.57,2019,76679
1572,52,361,1985,79.19,2.62,18.19,2019,76802
70,0,25,95,73.68,0.0,26.32,2019,76828
1033,45,389,1467,70.42,3.07,26.52,2019,76849
88,4,29,121,72.73,3.31,23.97,2019,76852
169,0,37,206,82.04,0.0,17.96,2019,76866
8882,73,714,9669,91.86,0.75,7.38,2019,76002
10259,364,655,11278,90.96,3.23,5.81,2019,76016
1760,58,513,2331,75.5,2.49,22.01,2019,76023
573,10,138,721,79.47,1.39,19.14,2019,76035
9959,379,899,11237,88.63,3.37,8.0,2019,76049
19586,231,827,20644,94.88,1.12,4.01,2019,76051
773,0,248,1021,75.71,0.0,24.29,2019,76055
22197,278,1204,23679,93.74,1.17,5.08,2019,76063
764,76,250,1090,70.09,6.97,22.94,2019,76066
6721,273,1354,8348,80.51,3.27,16.22,2019,76086
8833,266,589,9688,91.17,2.75,6.08,2019,76087
4013,234,1744,5991,66.98,3.91,29.11,2019,76115
10317,262,629,11208,92.05,2.34,5.61,2019,76123
6917,321,691,7929,87.24,4.05,8.71,2019,76135
7761,913,1071,9745,79.64,9.37,10.99,2019,76201
5039,52,424,5515,91.37,0.94,7.69,2019,76207
813,27,166,1006,80.82,2.68,16.5,2019,76252
476,27,150,653,72.89,4.13,22.97,2019,76264
4313,168,645,5126,84.14,3.28,12.58,2019,76309
5968,186,1195,7349,81.21,2.53,16.26,2019,76310
120,0,49,169,71.01,0.0,28.99,2019,76363
475,15,80,570,83.33,2.63,14.04,2019,76453
30,0,19,49,61.22,0.0,38.78,2019,76469
754,37,391,1182,63.79,3.13,33.08,2019,76470
51,0,0,51,100.0,0.0,0.0,2019,76481
0,0,0,0,,,,2019,76523
384,2,52,438,87.67,0.46,11.87,2019,76525
5059,99,1098,6256,80.87,1.58,17.55,2019,76528
3737,507,2236,6480,57.67,7.82,34.51,2019,76301
80,0,23,103,77.67,0.0,22.33,2019,76882
154,7,32,193,79.79,3.63,16.58,2019,76631
246,34,170,450,54.67,7.56,37.78,2019,76635
869,22,145,1036,83.88,2.12,14.0,2019,76638
380,17,63,460,82.61,3.7,13.7,2019,76673
10062,313,4161,14536,69.22,2.15,28.63,2019,78041
745,14,35,794,93.83,1.76,4.41,2019,78056
1046,6,761,1813,57.69,0.33,41.97,2019,78059
660,15,427,1102,59.89,1.36,38.75,2019,78071
79,19,57,155,50.97,12.26,36.77,2019,78107
1623,71,585,2279,71.22,3.12,25.67,2019,78112
6312,276,1053,7641,82.61,3.61,13.78,2019,78114
707,13,358,1078,65.58,1.21,33.21,2019,78118
2016,36,381,2433,82.86,1.48,15.66,2019,78124
32,0,21,53,60.38,0.0,39.62,2019,78142
309,17,64,390,79.23,4.36,16.41,2019,78159
24,0,13,37,64.86,0.0,35.14,2019,78145
474,0,117,591,80.2,0.0,19.8,2019,78147
335,10,209,554,60.47,1.81,37.73,2019,78151
5261,323,2247,7831,67.18,4.12,28.69,2019,78214
8094,346,673,9113,88.82,3.8,7.39,2019,78244
2237,77,342,2656,84.22,2.9,12.88,2019,78252
86,0,60,146,58.9,0.0,41.1,2019,78344
121,0,44,165,73.33,0.0,26.67,2019,78349
14601,398,1254,16253,89.84,2.45,7.72,2019,85248
7886,133,695,8714,90.5,1.53,7.98,2019,85250
12743,386,1738,14867,85.71,2.6,11.69,2019,85257
7052,84,170,7306,96.52,1.15,2.33,2019,85284
10694,440,3060,14194,75.34,3.1,21.56,2019,85302
7659,267,749,8675,88.29,3.08,8.63,2019,85306
179,11,121,311,57.56,3.54,38.91,2019,85320
939,64,577,1580,59.43,4.05,36.52,2019,85321
10174,400,2225,12799,79.49,3.13,17.38,2019,85323
14534,387,1292,16213,89.64,2.39,7.97,2019,85326
145,2,84,231,62.77,0.87,36.36,2019,85333
9119,326,1093,10538,86.53,3.09,10.37,2019,85335
82,12,51,145,56.55,8.28,35.17,2019,85336
1822,91,306,2219,82.11,4.1,13.79,2019,85361
8897,273,1746,10916,81.5,2.5,15.99,2019,85367
14322,511,2133,16966,84.42,3.01,12.57,2019,85375
836,18,202,1056,79.17,1.7,19.13,2019,85533
1163,8,260,1431,81.27,0.56,18.17,2019,85544
305,18,113,436,69.95,4.13,25.92,2019,85611
853,0,0,853,100.0,0.0,0.0,2019,85613
739,10,266,1015,72.81,0.99,26.21,2019,85625
724,22,902,1648,43.93,1.33,54.73,2019,85634
12290,484,1988,14762,83.25,3.28,13.47,2019,85635
8567,82,492,9141,93.72,0.9,5.38,2019,85641
629,12,139,780,80.64,1.54,17.82,2019,85646
4995,249,999,6243,80.01,3.99,16.0,2019,85648
20690,820,3510,25020,82.69,3.28,14.03,2019,85710
111,0,7,118,94.07,0.0,5.93,2019,85531
242,40,131,413,58.6,9.69,31.72,2019,85601
2297,117,839,3253,70.61,3.6,25.79,2019,85603
162,0,0,162,100.0,0.0,0.0,2019,85609
32,0,0,32,100.0,0.0,0.0,2019,85619
1551,195,482,2228,69.61,8.75,21.63,2019,85623
830,97,441,1368,60.67,7.09,32.24,2019,85631
425,27,60,512,83.01,5.27,11.72,2019,85637
2397,94,844,3335,71.87,2.82,25.31,2019,85643
12954,468,1482,14904,86.92,3.14,9.94,2019,85704
16452,1109,6026,23587,69.75,4.7,25.55,2019,85705
11433,220,974,12627,90.54,1.74,7.71,2019,85718
14849,1009,1482,17340,85.63,5.82,8.55,2019,85719
10145,178,276,10599,95.72,1.68,2.6,2019,85742
10624,252,698,11574,91.79,2.18,6.03,2019,85743
13876,717,1480,16073,86.33,4.46,9.21,2019,85745
8593,96,170,8859,97.0,1.08,1.92,2019,85747
7177,119,431,7727,92.88,1.54,5.58,2019,85749
995,4,325,1324,75.15,0.3,24.55,2019,85933
643,12,419,1074,59.87,1.12,39.01,2019,85936
567,11,233,811,69.91,1.36,28.73,2019,85938
5,0,23,28,17.86,0.0,82.14,2019,85942
13082,316,2528,15926,82.14,1.98,15.87,2019,85712
8334,234,498,9066,91.93,2.58,5.49,2019,85739
47,12,41,100,47.0,12.0,41.0,2019,85926
47,0,26,73,64.38,0.0,35.62,2019,85931
14654,436,2160,17250,84.95,2.53,12.52,2019,83642
7224,148,1187,8559,84.4,1.73,13.87,2019,83647
180,0,34,214,84.11,0.0,15.89,2019,83650
16,2,2,20,80.0,10.0,10.0,2019,83666
5,0,0,5,100.0,0.0,0.0,2019,83671
10032,322,1516,11870,84.52,2.71,12.77,2019,83687
34323,706,2099,37128,92.45,1.9,5.65,2019,77449
23614,322,1002,24938,94.69,1.29,4.02,2019,77450
292,32,205,529,55.2,6.05,38.75,2019,77456
21847,369,408,22624,96.57,1.63,1.8,2019,77459
51,0,11,62,82.26,0.0,17.74,2019,77476
1060,14,613,1687,62.83,0.83,36.34,2019,75656
257,33,163,453,56.73,7.28,35.98,2019,75667
4137,336,1497,5970,69.3,5.63,25.08,2019,75672
474,12,171,657,72.15,1.83,26.03,2019,63862
106,0,0,106,100.0,0.0,0.0,2019,63934
114,5,53,172,66.28,2.91,30.81,2019,63874
624,37,203,864,72.22,4.28,23.5,2019,63876
218,3,79,300,72.67,1.0,26.33,2019,63879
87,10,62,159,54.72,6.29,38.99,2019,63882
10023,342,3111,13476,74.38,2.54,23.09,2019,63901
278,0,132,410,67.8,0.0,32.2,2019,63945
28,0,39,67,41.79,0.0,58.21,2019,63955
776,16,318,1110,69.91,1.44,28.65,2019,63960
1522,100,252,1874,81.22,5.34,13.45,2019,63019
20964,255,1110,22329,93.89,1.14,4.97,2019,63021
60,12,39,111,54.05,10.81,35.14,2019,63030
14144,456,2003,16603,85.19,2.75,12.06,2019,63033
6074,133,335,6542,92.85,2.03,5.12,2019,63034
8577,108,763,9448,90.78,1.14,8.08,2019,63043
4773,193,904,5870,81.31,3.29,15.4,2019,63050
1438,88,404,1930,74.51,4.56,20.93,2019,63068
257,30,161,448,57.37,6.7,35.94,2019,63071
5192,124,1079,6395,81.19,1.94,16.87,2019,63074
3450,67,1060,4577,75.38,1.46,23.16,2019,63077
7493,250,1184,8927,83.94,2.8,13.26,2019,63090
1883,99,378,2360,79.79,4.19,16.02,2019,63101
8731,799,1731,11261,77.53,7.1,15.37,2019,63108
11969,280,1547,13796,86.76,2.03,11.21,2019,63109
15059,696,3621,19376,77.72,3.59,18.69,2019,63116
7004,496,2756,10256,68.29,4.84,26.87,2019,63121
14625,289,1167,16081,90.95,1.8,7.26,2019,63122
19479,476,2811,22766,85.56,2.09,12.35,2019,63123
5460,41,596,6097,89.55,0.67,9.78,2019,63126
1717,140,274,2131,80.57,6.57,12.86,2019,63127
6249,47,199,6495,96.21,0.72,3.06,2019,63131
1811,59,390,2260,80.13,2.61,17.26,2019,63461
766,14,195,975,78.56,1.44,20.0,2019,63468
195,0,59,254,76.77,0.0,23.23,2019,63471
358,18,164,540,66.3,3.33,30.37,2019,63532
107,3,63,173,61.85,1.73,36.42,2019,63541
3301,124,1369,4794,68.86,2.59,28.56,2019,63645
480,14,207,701,68.47,2.0,29.53,2019,63673
26,0,0,26,100.0,0.0,0.0,2019,63742
317,34,122,473,67.02,7.19,25.79,2019,63766
227,3,129,359,63.23,0.84,35.93,2019,63785
1455,66,504,2025,71.85,3.26,24.89,2019,63834
342,20,146,508,67.32,3.94,28.74,2019,63848
33,0,32,65,50.77,0.0,49.23,2019,63849
1120,23,353,1496,74.87,1.54,23.6,2019,63851
83,24,30,137,60.58,17.52,21.9,2019,63140
4147,31,289,4467,92.84,0.69,6.47,2019,63144
142,1,74,217,65.44,0.46,34.1,2019,63350
8385,143,600,9128,91.86,1.57,6.57,2019,63367
667,0,138,805,82.86,0.0,17.14,2019,63369
374,5,189,568,65.85,0.88,33.27,2019,77873
9022,1301,3957,14280,63.18,9.11,27.71,2019,77901
3722,202,658,4582,81.23,4.41,14.36,2019,77422
675,14,228,917,73.61,1.53,24.86,2019,77426
3038,60,1750,4848,62.67,1.24,36.1,2019,77445
10404,267,8175,18846,55.21,1.42,43.38,2019,77081
3878,219,1750,5847,66.32,3.75,29.93,2019,77028
6775,370,544,7689,88.11,4.81,7.08,2019,77058
7191,295,2351,9837,73.1,3.0,23.9,2019,77023
6708,361,5762,12831,52.28,2.81,44.91,2019,77093
1759,126,443,2328,75.56,5.41,19.03,2019,77360
17176,338,1737,19251,89.22,1.76,9.02,2019,77042
5650,299,334,6283,89.93,4.76,5.32,2019,77302
609,9,290,908,67.07,0.99,31.94,2019,77420
15924,190,772,16886,94.3,1.13,4.57,2019,77388
546,4,350,900,60.67,0.44,38.89,2019,77417
7762,111,1401,9274,83.7,1.2,15.11,2019,77043
15678,427,1257,17362,90.3,2.46,7.24,2019,77089
4466,106,1000,5572,80.15,1.9,17.95,2019,77591
2857,224,1760,4841,59.02,4.63,36.36,2019,77703
6409,293,2463,9165,69.93,3.2,26.87,2019,77033
14183,644,1312,16139,87.88,3.99,8.13,2019,77064
13226,679,3112,17017,77.72,3.99,18.29,2019,77099
0,0,0,0,,,,2019,77201
3664,161,734,4559,80.37,3.53,16.1,2019,77328
0,0,0,0,,,,2019,77342
40,4,8,52,76.92,7.69,15.38,2019,77350
11585,18,899,12502,92.67,0.14,7.19,2019,77377
14824,205,393,15422,96.12,1.33,2.55,2019,77406
16546,210,259,17015,97.24,1.23,1.52,2019,77407
14,0,0,14,100.0,0.0,0.0,2019,77436
80,0,19,99,80.81,0.0,19.19,2019,77453
0,0,7,7,0.0,0.0,100.0,2019,77460
14314,106,866,15286,93.64,0.69,5.67,2019,77498
6792,118,684,7594,89.44,1.55,9.01,2019,77523
299,32,0,331,90.33,9.67,0.0,2019,77580
189,0,69,258,73.26,0.0,26.74,2019,77661
14,12,18,44,31.82,27.27,40.91,2019,77976
74,0,14,88,84.09,0.0,15.91,2019,77987
14,0,21,35,40.0,0.0,60.0,2019,77993
3129,47,1139,4315,72.51,1.09,26.4,2019,77032
7474,252,1114,8840,84.55,2.85,12.6,2019,77053
10540,356,474,11370,92.7,3.13,4.17,2019,77056
12229,951,1667,14847,82.37,6.41,11.23,2019,77065
7469,101,705,8275,90.26,1.22,8.52,2019,77069
18815,266,1183,20264,92.85,1.31,5.84,2019,77070
7403,31,1643,9077,81.56,0.34,18.1,2019,77320
8979,136,232,9347,96.06,1.46,2.48,2019,77345
0,0,0,0,,,,2019,81038
9,0,39,48,18.75,0.0,81.25,2019,81129
26,0,12,38,68.42,0.0,31.58,2019,81138
0,0,0,0,,,,2019,81227
2843,69,551,3463,82.1,1.99,15.91,2019,78362
8545,301,3674,12520,68.25,2.4,29.35,2019,78537
871,36,437,1344,64.81,2.68,32.51,2019,78560
518,34,225,777,66.67,4.38,28.96,2019,78562
671,65,454,1190,56.39,5.46,38.15,2019,78569
996,0,420,1416,70.34,0.0,29.66,2019,78579
2677,220,2091,4988,53.67,4.41,41.92,2019,78584
15057,387,3346,18790,80.13,2.06,17.81,2019,78596
20520,248,1161,21929,93.57,1.13,5.29,2019,78641
823,24,140,987,83.38,2.43,14.18,2019,78655
87,10,28,125,69.6,8.0,22.4,2019,78661
1523,4,439,1966,77.47,0.2,22.33,2019,78605
3628,32,808,4468,81.2,0.72,18.08,2019,78611
1522,0,10,1532,99.35,0.0,0.65,2019,78619
2207,125,845,3177,69.47,3.93,26.6,2019,78648
6764,107,399,7270,93.04,1.47,5.49,2019,78653
11218,238,442,11898,94.28,2.0,3.71,2019,78729
670,24,192,886,75.62,2.71,21.67,2019,78638
93,1,36,130,71.54,0.77,27.69,2019,78618
5723,124,260,6107,93.71,2.03,4.26,2019,78620
3412,67,923,4402,77.51,1.52,20.97,2019,78629
4120,40,390,4550,90.55,0.88,8.57,2019,78645
418,6,111,535,78.13,1.12,20.75,2019,78650
569,19,184,772,73.7,2.46,23.83,2019,78662
288,5,135,428,67.29,1.17,31.54,2019,78719
10681,746,2100,13527,78.96,5.51,15.52,2019,78723
994,97,210,1301,76.4,7.46,16.14,2019,78010
1075,23,886,1984,54.18,1.16,44.66,2019,78014
8544,135,221,8900,96.0,1.52,2.48,2019,78023
1567,73,288,1928,81.28,3.79,14.94,2019,78025
1905,38,1133,3076,61.93,1.24,36.83,2019,78061
1577,152,431,2160,73.01,7.04,19.95,2019,78073
5976,55,185,6216,96.14,0.88,2.98,2019,78738
96,0,178,274,35.04,0.0,64.96,2019,78067
162,0,27,189,85.71,0.0,14.29,2019,78072
88,0,9,97,90.72,0.0,9.28,2019,78116
6806,162,748,7716,88.21,2.1,9.69,2019,78148
522,5,52,579,90.16,0.86,8.98,2019,78024
5389,173,1214,6776,79.53,2.55,17.92,2019,78724
12538,275,744,13557,92.48,2.03,5.49,2019,78727
2551,52,175,2778,91.83,1.87,6.3,2019,79382
4008,747,1824,6579,60.92,11.35,27.72,2019,79415
297,48,166,511,58.12,9.39,32.49,2019,79508
1396,13,602,2011,69.42,0.65,29.94,2019,79512
71,9,17,97,73.2,9.28,17.53,2019,79527
179,30,83,292,61.3,10.27,28.42,2019,79532
37,0,5,42,88.1,0.0,11.9,2019,79540
275,0,39,314,87.58,0.0,12.42,2019,79541
7263,341,2402,10006,72.59,3.41,24.01,2019,79701
53,0,28,81,65.43,0.0,34.57,2019,79748
22,0,8,30,73.33,0.0,26.67,2019,79754
60,4,23,87,68.97,4.6,26.44,2019,79783
113,41,56,210,53.81,19.52,26.67,2019,79842
11895,744,3879,16518,72.01,4.5,23.48,2019,79907
851,39,401,1291,65.92,3.02,31.06,2019,79567
76,0,113,189,40.21,0.0,59.79,2019,79719
45,0,26,71,63.38,0.0,36.62,2019,79730
2492,187,597,3276,76.07,5.71,18.22,2019,79756
0,0,0,0,,,,2019,79759
3843,94,270,4207,91.35,2.23,6.42,2019,83712
682,7,162,851,80.14,0.82,19.04,2019,83855
306,0,62,368,83.15,0.0,16.85,2019,83857
15,0,0,15,100.0,0.0,0.0,2019,83874
7678,207,1047,8932,85.96,2.32,11.72,2019,83221
701,10,85,796,88.07,1.26,10.68,2019,83236
9,0,0,9,100.0,0.0,0.0,2019,83243
114,0,0,114,100.0,0.0,0.0,2019,83244
2810,34,230,3074,91.41,1.11,7.48,2019,83274
1951,131,346,2428,80.35,5.4,14.25,2019,83330
5436,319,1375,7130,76.24,4.47,19.28,2019,83338
352,6,70,428,82.24,1.4,16.36,2019,83344
756,67,335,1158,65.28,5.79,28.93,2019,83352
659,15,109,783,84.16,1.92,13.92,2019,83871
290,11,67,368,78.8,2.99,18.21,2019,83852
1676,111,736,2523,66.43,4.4,29.17,2019,83856
0,16,21,37,0.0,43.24,56.76,2019,83866
53,0,60,113,46.9,0.0,53.1,2019,83013
703,7,89,799,87.98,0.88,11.14,2019,83113
79,0,0,79,100.0,0.0,0.0,2019,83119
186,0,58,244,76.23,0.0,23.77,2019,83120
285,1,10,296,96.28,0.34,3.38,2019,83217
434,5,123,562,77.22,0.89,21.89,2019,83234
1254,8,219,1481,84.67,0.54,14.79,2019,83254
98,0,14,112,87.5,0.0,12.5,2019,83272
65,0,9,74,87.84,0.0,12.16,2019,83277
115,5,2,122,94.26,4.1,1.64,2019,83278
131,11,62,204,64.22,5.39,30.39,2019,83321
1,0,13,14,7.14,0.0,92.86,2019,83322
21,0,0,21,100.0,0.0,0.0,2019,83337
1088,66,419,1573,69.17,4.2,26.64,2019,83355
233,1,38,272,85.66,0.37,13.97,2019,83429
7969,2083,448,10500,75.9,19.84,4.27,2019,83440
2215,63,576,2854,77.61,2.21,20.18,2019,83467
71,7,3,81,87.65,8.64,3.7,2019,83468
519,20,180,719,72.18,2.78,25.03,2019,83540
1795,120,481,2396,74.92,5.01,20.08,2019,83544
155,7,75,237,65.4,2.95,31.65,2019,83604
283,14,93,390,72.56,3.59,23.85,2019,83610
638,33,91,762,83.73,4.33,11.94,2019,83611
9602,72,1000,10674,89.96,0.67,9.37,2019,83616
386,4,133,523,73.8,0.76,25.43,2019,83624
113,18,26,157,71.97,11.46,16.56,2019,83632
2345,143,178,2666,87.96,5.36,6.68,2019,83638
65,0,0,65,100.0,0.0,0.0,2019,83643
1204,97,236,1537,78.33,6.31,15.35,2019,83110
12015,286,1670,13971,86.0,2.05,11.95,2019,83201
77,0,43,120,64.17,0.0,35.83,2019,83203
370,15,82,467,79.23,3.21,17.56,2019,83213
150,5,26,181,82.87,2.76,14.36,2019,83232
287,5,28,320,89.69,1.56,8.75,2019,83237
750,24,105,879,85.32,2.73,11.95,2019,83245
536,11,43,590,90.85,1.86,7.29,2019,83250
14972,323,1837,17132,87.39,1.89,10.72,2019,94577
12195,417,1977,14589,83.59,2.86,13.55,2019,94590
1220,25,201,1446,84.37,1.73,13.9,2019,94599
44,0,30,74,59.46,0.0,40.54,2019,94074
12391,179,442,13012,95.23,1.38,3.4,2019,94131
11468,190,732,12390,92.56,1.53,5.91,2019,94526
13,0,29,42,30.95,0.0,69.05,2019,63387
7080,286,1435,8801,80.45,3.25,16.3,2019,63401
130,8,79,217,59.91,3.69,36.41,2019,63430
170,11,15,196,86.73,5.61,7.65,2019,63432
215,4,29,248,86.69,1.61,11.69,2019,63434
356,6,133,495,71.92,1.21,26.87,2019,63452
507,30,121,658,77.05,4.56,18.39,2019,63436
58,6,36,100,58.0,6.0,36.0,2019,63439
6305,70,248,6623,95.2,1.06,3.74,2019,73142
726,0,42,768,94.53,0.0,5.47,2019,73169
1802,204,945,2951,61.06,6.91,32.02,2019,73446
815,1,270,1086,75.05,0.09,24.86,2019,73449
132,15,55,202,65.35,7.43,27.23,2019,73453
801,84,272,1157,69.23,7.26,23.51,2019,73463
1483,93,380,1956,75.82,4.75,19.43,2019,73529
1657,26,187,1870,88.61,1.39,10.0,2019,73538
61,7,8,76,80.26,9.21,10.53,2019,73549
712,66,184,962,74.01,6.86,19.13,2019,73550
19,0,0,19,100.0,0.0,0.0,2019,73050
1298,35,368,1701,76.31,2.06,21.63,2019,73098
1251,42,310,1603,78.04,2.62,19.34,2019,73054
794,26,295,1115,71.21,2.33,26.46,2019,73059
2685,120,809,3614,74.29,3.32,22.39,2019,73075
2205,68,373,2646,83.33,2.57,14.1,2019,73103
270,20,67,357,75.63,5.6,18.77,2019,73090
2239,15,540,2794,80.14,0.54,19.33,2019,73105
8147,233,2157,10537,77.32,2.21,20.47,2019,73107
253,8,124,385,65.71,2.08,32.21,2019,73565
24,0,0,24,100.0,0.0,0.0,2019,73571
154,0,39,193,79.79,0.0,20.21,2019,73647
267,10,72,349,76.5,2.87,20.63,2019,73655
66,0,24,90,73.33,0.0,26.67,2019,73666
175,6,62,243,72.02,2.47,25.51,2019,73667
6478,259,2074,8811,73.52,2.94,23.54,2019,73701
891,46,371,1308,68.12,3.52,28.36,2019,73772
408,12,190,610,66.89,1.97,31.15,2019,73834
386,14,123,523,73.8,2.68,23.52,2019,73859
138,3,45,186,74.19,1.61,24.19,2019,73931
227,3,46,276,82.25,1.09,16.67,2019,73938
406,57,56,519,78.23,10.98,10.79,2019,73939
115,21,40,176,65.34,11.93,22.73,2019,73944
384,12,231,627,61.24,1.91,36.84,2019,73949
42,4,10,56,75.0,7.14,17.86,2019,73555
216,7,18,241,89.63,2.9,7.47,2019,73736
131,16,9,156,83.97,10.26,5.77,2019,73747
246,35,80,361,68.14,9.7,22.16,2019,73004
444,22,147,613,72.43,3.59,23.98,2019,73029
988,132,445,1565,63.13,8.43,28.43,2019,73030
4946,149,1481,6576,75.21,2.27,22.52,2019,73036
109,11,34,154,70.78,7.14,22.08,2019,73041
1788,5,338,2131,83.9,0.23,15.86,2019,73049
381,27,177,585,65.13,4.62,30.26,2019,73062
2862,59,615,3536,80.94,1.67,17.39,2019,73080
128,5,97,230,55.65,2.17,42.17,2019,73569
2688,39,989,3716,72.34,1.05,26.61,2019,73601
547,30,162,739,74.02,4.06,21.92,2019,73624
165,1,39,205,80.49,0.49,19.02,2019,73641
9739,483,1524,11746,82.91,4.11,12.97,2019,73703
70,0,6,76,92.11,0.0,7.89,2019,73727
0,0,0,0,,,,2019,81231
9,0,0,9,100.0,0.0,0.0,2019,81232
17,0,0,17,100.0,0.0,0.0,2019,81237
208,0,28,236,88.14,0.0,11.86,2019,81242
2471,165,563,3199,77.24,5.16,17.6,2019,81303
3878,42,604,4524,85.72,0.93,13.35,2019,81403
20,0,0,20,100.0,0.0,0.0,2019,81429
5684,57,436,6177,92.02,0.92,7.06,2019,81507
0,0,0,0,,,,2019,81612
6267,42,160,6469,96.88,0.65,2.47,2019,63005
12043,293,1588,13924,86.49,2.1,11.4,2019,63010
13440,215,862,14517,92.58,1.48,5.94,2019,63011
3389,101,319,3809,88.97,2.65,8.37,2019,63012
546,23,41,610,89.51,3.77,6.72,2019,63013
49,0,9,58,84.48,0.0,15.52,2019,63061
5837,146,1297,7280,80.18,2.01,17.82,2019,63084
3635,426,3305,7366,49.35,5.78,44.87,2019,63115
11274,220,1541,13035,86.49,1.69,11.82,2019,63128
14030,748,3755,18533,75.7,4.04,20.26,2019,63136
8221,78,430,8729,94.18,0.89,4.93,2019,63141
1906,53,695,2654,71.82,2.0,26.19,2019,63334
369,0,153,522,70.69,0.0,29.31,2019,63352
1617,5,374,1996,81.01,0.25,18.74,2019,63353
2769,93,646,3508,78.93,2.65,18.42,2019,62246
553,4,183,740,74.73,0.54,24.73,2019,62262
1851,63,533,2447,75.64,2.57,21.78,2019,62274
187,34,0,221,84.62,15.38,0.0,2019,62297
113,0,57,170,66.47,0.0,33.53,2019,62314
131,13,35,179,73.18,7.26,19.55,2019,62356
83,6,61,150,55.33,4.0,40.67,2019,62361
567,14,204,785,72.23,1.78,25.99,2019,62379
529,15,189,733,72.17,2.05,25.78,2019,62414
1015,54,211,1280,79.3,4.22,16.48,2019,62417
549,18,170,737,74.49,2.44,23.07,2019,62427
2482,96,773,3351,74.07,2.86,23.07,2019,62439
3932,207,958,5097,77.14,4.06,18.8,2019,62450
546,0,101,647,84.39,0.0,15.61,2019,62510
6549,221,1144,7914,82.75,2.79,14.46,2019,62401
880,10,244,1134,77.6,0.88,21.52,2019,62428
856,23,212,1091,78.46,2.11,19.43,2019,62468
302,7,69,378,79.89,1.85,18.25,2019,62474
506,19,116,641,78.94,2.96,18.1,2019,62476
142,6,62,210,67.62,2.86,29.52,2019,62480
537,23,110,670,80.15,3.43,16.42,2019,62520
495,10,123,628,78.82,1.59,19.59,2019,62530
194,6,62,262,74.05,2.29,23.66,2019,62942
140,0,86,226,61.95,0.0,38.05,2019,62947
1415,74,415,1904,74.32,3.89,21.8,2019,62951
709,31,126,866,81.87,3.58,14.55,2019,62958
281,15,84,380,73.95,3.95,22.11,2019,62972
53,0,8,61,86.89,0.0,13.11,2019,62975
138,19,61,218,63.3,8.72,27.98,2019,62997
1396,24,205,1625,85.91,1.48,12.62,2019,11804
262,37,116,415,63.13,8.92,27.95,2019,11930
559,10,92,661,84.57,1.51,13.92,2019,11941
70,7,61,138,50.72,5.07,44.2,2019,11962
4706,77,318,5101,92.26,1.51,6.23,2019,11702
10744,101,589,11434,93.97,0.88,5.15,2019,11710
8751,338,411,9500,92.12,3.56,4.33,2019,11530
10448,162,575,11185,93.41,1.45,5.14,2019,11566
2455,75,168,2698,90.99,2.78,6.23,2019,11705
2443,54,54,2551,95.77,2.12,2.12,2019,11709
7099,115,729,7943,89.37,1.45,9.18,2019,11714
7695,343,1292,9330,82.48,3.68,13.85,2019,11722
8474,630,590,9694,87.41,6.5,6.09,2019,11725
9842,318,927,11087,88.77,2.87,8.36,2019,11727
4256,49,231,4536,93.83,1.08,5.09,2019,11730
19004,796,1205,21005,90.47,3.79,5.74,2019,11746
238,6,6,250,95.2,2.4,2.4,2019,11765
4541,64,384,4989,91.02,1.28,7.7,2019,11767
2812,24,462,3298,85.26,0.73,14.01,2019,11769
7625,485,1586,9696,78.64,5.0,16.36,2019,11901
3985,268,379,4632,86.03,5.79,8.18,2019,11950
1863,172,94,2129,87.51,8.08,4.42,2019,11952
11235,609,1941,13785,81.5,4.42,14.08,2019,11717
1013,10,59,1082,93.62,0.92,5.45,2019,11718
5249,23,184,5456,96.21,0.42,3.37,2019,11733
4006,94,258,4358,91.92,2.16,5.92,2019,11742
4255,23,116,4394,96.84,0.52,2.64,2019,11753
12577,194,800,13571,92.68,1.43,5.89,2019,11756
8437,250,757,9444,89.34,2.65,8.02,2019,11763
3703,38,373,4114,90.01,0.92,9.07,2019,11766
3159,64,377,3600,87.75,1.78,10.47,2019,11771
3815,61,370,4246,89.85,1.44,8.71,2019,11778
14777,408,2261,17446,84.7,2.34,12.96,2019,11222
22946,1022,6599,30567,75.07,3.34,21.59,2019,11233
26336,757,5245,32338,81.44,2.34,16.22,2019,11235
5747,83,448,6278,91.54,1.32,7.14,2019,11426
6642,149,805,7596,87.44,1.96,10.6,2019,11427
0,0,0,0,,,,2019,11042
12045,164,1687,13896,86.68,1.18,12.14,2019,11101
13044,344,3071,16459,79.25,2.09,18.66,2019,11205
26199,441,1805,28445,92.1,1.55,6.35,2019,11215
14699,1126,8400,24225,60.68,4.65,34.67,2019,11219
28309,748,8134,37191,76.12,2.01,21.87,2019,11226
13139,277,1708,15124,86.88,1.83,11.29,2019,11228
28828,551,4373,33752,85.41,1.63,12.96,2019,11236
2250,49,348,2647,85.0,1.85,13.15,2019,14706
460,11,101,572,80.42,1.92,17.66,2019,14709
1165,16,166,1347,86.49,1.19,12.32,2019,14710
471,29,174,674,69.88,4.3,25.82,2019,14711
225,44,147,416,54.09,10.58,35.34,2019,14729
2256,141,386,2783,81.06,5.07,13.87,2019,14011
7632,317,1709,9658,79.02,3.28,17.7,2019,14020
545,37,156,738,73.85,5.01,21.14,2019,14030
1836,15,420,2271,80.85,0.66,18.49,2019,14132
4022,309,1261,5592,71.92,5.53,22.55,2019,14201
6582,315,2060,8957,73.48,3.52,23.0,2019,14206
4280,351,1457,6088,70.3,5.77,23.93,2019,14210
5575,359,622,6556,85.04,5.48,9.49,2019,14222
3478,258,1838,5574,62.4,4.63,32.97,2019,14301
605,15,97,717,84.38,2.09,13.53,2019,12737
101,13,0,114,88.6,11.4,0.0,2019,12738
524,10,208,742,70.62,1.35,28.03,2019,12740
1834,92,609,2535,72.35,3.63,24.02,2019,12754
1396,15,240,1651,84.55,0.91,14.54,2019,12758
425,8,50,483,87.99,1.66,10.35,2019,12815
1892,64,353,2309,81.94,2.77,15.29,2019,12822
1136,19,237,1392,81.61,1.36,17.03,2019,12827
78,8,26,112,69.64,7.14,23.21,2019,12841
161,37,69,267,60.3,13.86,25.84,2019,12842
1651,55,254,1960,84.23,2.81,12.96,2019,12845
166,3,38,207,80.19,1.45,18.36,2019,12852
56,4,6,66,84.85,6.06,9.09,2019,12858
249,3,6,258,96.51,1.16,2.33,2019,12860
241,0,22,263,91.63,0.0,8.37,2019,12863
1086,41,310,1437,75.57,2.85,21.57,2019,12865
63,0,29,92,68.48,0.0,31.52,2019,12169
101,0,33,134,75.37,0.0,24.63,2019,12176
607,18,137,762,79.66,2.36,17.98,2019,12185
2962,160,992,4114,72.0,3.89,24.11,2019,12202
141,8,68,217,64.98,3.69,31.34,2019,12008
251,6,65,322,77.95,1.86,20.19,2019,12028
189,0,78,267,70.79,0.0,29.21,2019,12035
3475,248,148,3871,89.77,6.41,3.82,2019,12061
282,22,92,396,71.21,5.56,23.23,2019,12092
6373,140,732,7245,87.96,1.93,10.1,2019,12110
164,13,39,216,75.93,6.02,18.06,2019,12147
247,8,103,358,68.99,2.23,28.77,2019,12160
17744,809,2775,21328,83.2,3.79,13.01,2019,12180
2189,34,363,2586,84.65,1.31,14.04,2019,12184
1254,0,25,1279,98.05,0.0,1.95,2019,12196
2742,31,315,3088,88.8,1.0,10.2,2019,12198
8390,189,1322,9901,84.74,1.91,13.35,2019,12208
4451,156,666,5273,84.41,2.96,12.63,2019,12210
153,0,40,193,79.27,0.0,20.73,2019,12412
348,0,68,416,83.65,0.0,16.35,2019,12423
99,0,18,117,84.62,0.0,15.38,2019,12427
281,0,95,376,74.73,0.0,25.27,2019,12434
300,0,80,380,78.95,0.0,21.05,2019,12442
184,13,0,197,93.4,6.6,0.0,2019,12448
1116,9,108,1233,90.51,0.73,8.76,2019,12449
682,37,198,917,74.37,4.03,21.59,2019,12458
87,0,48,135,64.44,0.0,35.56,2019,12459
584,64,96,744,78.49,8.6,12.9,2019,12461
123,0,0,123,100.0,0.0,0.0,2019,12471
419,35,150,604,69.37,5.79,24.83,2019,14024
15824,558,2081,18463,85.71,3.02,11.27,2019,14075
801,140,387,1328,60.32,10.54,29.14,2019,14081
270,38,97,405,66.67,9.38,23.95,2019,14091
10851,174,1133,12158,89.25,1.43,9.32,2019,14127
264,12,61,337,78.34,3.56,18.1,2019,14836
21819,1743,1655,25217,86.52,6.91,6.56,2019,14850
804,92,232,1128,71.28,8.16,20.57,2019,14865
232,8,26,266,87.22,3.01,9.77,2019,14872
761,28,188,977,77.89,2.87,19.24,2019,14873
56,18,15,89,62.92,20.22,16.85,2019,14881
2015,111,512,2638,76.38,4.21,19.41,2019,14569
9217,262,2076,11555,79.77,2.27,17.97,2019,14606
8324,171,1063,9558,87.09,1.79,11.12,2019,14617
194,9,81,284,68.31,3.17,28.52,2019,61544
391,9,65,465,84.09,1.94,13.98,2019,61569
300,46,175,521,57.58,8.83,33.59,2019,61602
9349,415,2580,12344,75.74,3.36,20.9,2019,61604
342,20,51,413,82.81,4.84,12.35,2019,61018
1340,18,390,1748,76.66,1.03,22.31,2019,61054
393,0,77,470,83.62,0.0,16.38,2019,61230
7902,89,128,8119,97.33,1.1,1.58,2019,60175
13259,375,1411,15045,88.13,2.49,9.38,2019,60201
17128,765,2507,20400,83.96,3.75,12.29,2019,60402
5892,682,1987,8561,68.82,7.97,23.21,2019,60406
4064,25,297,4386,92.66,0.57,6.77,2019,60410
6309,268,1228,7805,80.83,3.43,15.73,2019,60419
4727,98,1093,5918,79.87,1.66,18.47,2019,60436
53,6,11,70,75.71,8.57,15.71,2019,60437
9316,295,1535,11146,83.58,2.65,13.77,2019,60438
14945,140,1758,16843,88.73,0.83,10.44,2019,60440
7040,198,959,8197,85.89,2.42,11.7,2019,60443
597,54,66,717,83.26,7.53,9.21,2019,60444
8777,225,1498,10500,83.59,2.14,14.27,2019,60445
4238,114,607,4959,85.46,2.3,12.24,2019,60457
600,37,162,799,75.09,4.63,20.28,2019,60941
20783,887,2038,23708,87.66,3.74,8.6,2019,60610
21162,520,2128,23810,88.88,2.18,8.94,2019,60622
16976,1622,2486,21084,80.52,7.69,11.79,2019,60660
6448,325,2044,8817,73.13,3.69,23.18,2019,60706
3463,68,767,4298,80.57,1.58,17.85,2019,60712
3011,55,744,3810,79.03,1.44,19.53,2019,60915
249,0,100,349,71.35,0.0,28.65,2019,60918
170,2,46,218,77.98,0.92,21.1,2019,60931
94,13,32,139,67.63,9.35,23.02,2019,60933
51,18,48,117,43.59,15.38,41.03,2019,60934
284,14,25,323,87.93,4.33,7.74,2019,60951
171,4,13,188,90.96,2.13,6.91,2019,60530
430,11,88,529,81.29,2.08,16.64,2019,60460
10057,127,1390,11574,86.89,1.1,12.01,2019,60515
285,4,21,310,91.94,1.29,6.77,2019,60553
13460,107,215,13782,97.66,0.78,1.56,2019,60565
537,60,0,597,89.95,10.05,0.0,2019,60602
9285,257,1138,10680,86.94,2.41,10.66,2019,60076
12562,227,1652,14441,86.99,1.57,11.44,2019,60090
11099,179,964,12242,90.66,1.46,7.87,2019,60098
11173,288,1784,13245,84.36,2.17,13.47,2019,60101
12716,157,1093,13966,91.05,1.12,7.83,2019,60103
15533,305,1215,17053,91.09,1.79,7.12,2019,60126
2211,135,596,2942,75.15,4.59,20.26,2019,60155
4004,264,840,5108,78.39,5.17,16.44,2019,60064
14230,169,965,15364,92.62,1.1,6.28,2019,60067
3508,30,61,3599,97.47,0.83,1.69,2019,60083
8209,161,1046,9416,87.18,1.71,11.11,2019,60087
9485,62,779,10326,91.86,0.6,7.54,2019,60048
13627,231,1314,15172,89.82,1.52,8.66,2019,60025
11243,329,728,12300,91.41,2.67,5.92,2019,60046
14630,249,1264,16143,90.63,1.54,7.83,2019,60062
12888,153,1532,14573,88.44,1.05,10.51,2019,60074
19028,535,3672,23235,81.89,2.3,15.8,2019,60085
4118,69,222,4409,93.4,1.56,5.04,2019,60097
4915,212,1085,6212,79.12,3.41,17.47,2019,60104
99,5,17,121,81.82,4.13,14.05,2019,60113
4752,110,691,5553,85.58,1.98,12.44,2019,11428
8175,288,2136,10599,77.13,2.72,20.15,2019,11433
2187,34,214,2435,89.82,1.4,8.79,2019,11507
9475,338,915,10728,88.32,3.15,8.53,2019,11510
2468,53,243,2764,89.29,1.92,8.79,2019,11557
995,12,35,1042,95.49,1.15,3.36,2019,11568
3728,140,658,4526,82.37,3.09,14.54,2019,11575
4418,162,668,5248,84.18,3.09,12.73,2019,11004
1048,55,212,1315,79.7,4.18,16.12,2019,11005
2663,91,172,2926,91.01,3.11,5.88,2019,11023
202,0,53,255,79.22,0.0,20.78,2019,11965
2382,85,99,2566,92.83,3.31,3.86,2019,11934
30467,888,9080,40435,75.35,2.2,22.46,2019,11211
19429,793,3564,23786,81.68,3.33,14.98,2019,11372
1795,79,164,2038,88.08,3.88,8.05,2019,11980
3134,86,278,3498,89.59,2.46,7.95,2019,11596
16319,523,1232,18074,90.29,2.89,6.82,2019,11217
2071,13,236,2320,89.27,0.56,10.17,2019,11516
11153,239,962,12354,90.28,1.93,7.79,2019,11779
4115,46,244,4405,93.42,1.04,5.54,2019,11790
8738,136,857,9731,89.8,1.4,8.81,2019,11803
1664,69,155,1888,88.14,3.65,8.21,2019,11940
274,0,0,274,100.0,0.0,0.0,2019,11948
3846,115,459,4420,87.01,2.6,10.38,2019,11951
2777,153,364,3294,84.3,4.64,11.05,2019,11740
22534,766,7863,31163,72.31,2.46,25.23,2019,11206
2532,37,235,2804,90.3,1.32,8.38,2019,11363
6968,155,611,7734,90.1,2.0,7.9,2019,11501
1544,65,62,1671,92.4,3.89,3.71,2019,11514
10501,174,1051,11726,89.55,1.48,8.96,2019,11735
2304,50,267,2621,87.91,1.91,10.19,2019,11792
3223,173,943,4339,74.28,3.99,21.73,2019,11968
38,0,14,52,73.08,0.0,26.92,2019,13364
34,0,24,58,58.62,0.0,41.38,2019,13404
80,10,8,98,81.63,10.2,8.16,2019,13410
27,0,0,27,100.0,0.0,0.0,2019,13415
94,2,9,105,89.52,1.9,8.57,2019,13435
103,0,0,103,100.0,0.0,0.0,2019,13441
43,0,0,43,100.0,0.0,0.0,2019,13472
32,0,53,85,37.65,0.0,62.35,2019,13484
46,0,10,56,82.14,0.0,17.86,2019,13488
121,0,4,125,96.8,0.0,3.2,2019,13494
8,0,7,15,53.33,0.0,46.67,2019,13623
86,0,6,92,93.48,0.0,6.52,2019,13628
63,3,8,74,85.14,4.05,10.81,2019,13636
12,0,11,23,52.17,0.0,47.83,2019,13641
13,0,0,13,100.0,0.0,0.0,2019,13643
34,0,0,34,100.0,0.0,0.0,2019,13647
46,0,12,58,79.31,0.0,20.69,2019,13651
74,0,8,82,90.24,0.0,9.76,2019,13666
1043,72,126,1241,84.05,5.8,10.15,2019,13167
152,4,43,199,76.38,2.01,21.61,2019,13312
1245,57,229,1531,81.32,3.72,14.96,2019,13317
3504,102,522,4128,84.88,2.47,12.65,2019,13323
18,2,10,30,60.0,6.67,33.33,2019,13436
201,11,76,288,69.79,3.82,26.39,2019,13454
750,53,206,1009,74.33,5.25,20.42,2019,13459
1078,24,58,1160,92.93,2.07,5.0,2019,13478
102,2,32,136,75.0,1.47,23.53,2019,13483
10612,394,2013,13019,81.51,3.03,15.46,2019,14304
2731,85,364,3180,85.88,2.67,11.45,2019,14454
640,7,8,655,97.71,1.07,1.22,2019,14466
2183,65,296,2544,85.81,2.56,11.64,2019,14469
3090,53,158,3301,93.61,1.61,4.79,2019,14472
608,47,119,774,78.55,6.07,15.37,2019,14504
335,15,70,420,79.76,3.57,16.67,2019,14507
2317,94,265,2676,86.58,3.51,9.9,2019,14514
1395,60,231,1686,82.74,3.56,13.7,2019,14532
715,51,113,879,81.34,5.8,12.86,2019,14533
483,6,59,548,88.14,1.09,10.77,2019,14555
377,10,43,430,87.67,2.33,10.0,2019,14769
417,2,118,537,77.65,0.37,21.97,2019,14731
372,9,89,470,79.15,1.91,18.94,2019,14740
577,50,140,767,75.23,6.52,18.25,2019,14743
6107,495,1470,8072,75.66,6.13,18.21,2019,14760
1853,87,753,2693,68.81,3.23,27.96,2019,14779
467,21,102,590,79.15,3.56,17.29,2019,14804
688,43,139,870,79.08,4.94,15.98,2019,14806
948,41,249,1238,76.58,3.31,20.11,2019,14807
128,5,93,226,56.64,2.21,41.15,2019,14819
1568,16,243,1827,85.82,0.88,13.3,2019,14105
735,57,312,1104,66.58,5.16,28.26,2019,14203
2704,292,1150,4146,65.22,7.04,27.74,2019,14204
20128,645,2472,23245,86.59,2.77,10.63,2019,14221
12115,439,2706,15260,79.39,2.88,17.73,2019,14225
953,76,281,1310,72.75,5.8,21.45,2019,14062
4034,151,619,4804,83.97,3.14,12.89,2019,14092
941,29,328,1298,72.5,2.23,25.27,2019,14098
1804,28,395,2227,81.01,1.26,17.74,2019,14108
1587,66,302,1955,81.18,3.38,15.45,2019,14136
349,4,80,433,80.6,0.92,18.48,2019,14143
16976,315,3000,20291,83.66,1.55,14.78,2019,14094
3810,77,731,4618,82.5,1.67,15.83,2019,14103
1701,56,329,2086,81.54,2.68,15.77,2019,14131
517,42,167,726,71.21,5.79,23.0,2019,14034
1140,49,441,1630,69.94,3.01,27.06,2019,14042
2098,90,335,2523,83.15,3.57,13.28,2019,14047
4795,280,1236,6311,75.98,4.44,19.58,2019,14048
6013,135,668,6816,88.22,1.98,9.8,2019,14052
433,0,160,593,73.02,0.0,26.98,2019,14055
3656,91,408,4155,87.99,2.19,9.82,2019,14059
1662,52,461,2175,76.41,2.39,21.2,2019,14837
604,16,154,774,78.04,2.07,19.9,2019,14838
179,3,102,284,63.03,1.06,35.92,2019,14855
1318,45,254,1617,81.51,2.78,15.71,2019,16743
1281,56,294,1631,78.54,3.43,18.03,2019,16749
8951,1157,299,10407,86.01,11.12,2.87,2019,16803
30,0,17,47,63.83,0.0,36.17,2019,16035
304,5,98,407,74.69,1.23,24.08,2019,16040
861,26,159,1046,82.31,2.49,15.2,2019,16061
118,0,27,145,81.38,0.0,18.62,2019,16110
189,2,47,238,79.41,0.84,19.75,2019,16114
151,0,26,177,85.31,0.0,14.69,2019,16840
124,4,10,138,89.86,2.9,7.25,2019,16849
87,9,43,139,62.59,6.47,30.94,2019,16852
78,3,32,113,69.03,2.65,28.32,2019,16876
97,0,78,175,55.43,0.0,44.57,2019,16879
130,5,60,195,66.67,2.56,30.77,2019,16921
7576,195,506,8277,91.53,2.36,6.11,2019,14618
8917,392,1612,10921,81.65,3.59,14.76,2019,14217
594,52,201,847,70.13,6.14,23.73,2019,14716
530,32,99,661,80.18,4.84,14.98,2019,14005
3580,117,490,4187,85.5,2.79,11.7,2019,14031
23,3,9,35,65.71,8.57,25.71,2019,14039
508,6,108,622,81.67,0.96,17.36,2019,14054
641,9,103,753,85.13,1.2,13.68,2019,14058
1528,135,572,2235,68.37,6.04,25.59,2019,14070
180,4,35,219,82.19,1.83,15.98,2019,14082
2395,80,153,2628,91.13,3.04,5.82,2019,14085
279,0,41,320,87.19,0.0,12.81,2019,14026
1102,18,194,1314,83.87,1.37,14.76,2019,14111
8777,327,1274,10378,84.57,3.15,12.28,2019,14216
327,20,115,462,70.78,4.33,24.89,2019,14728
165,13,81,259,63.71,5.02,31.27,2019,14777
231,16,83,330,70.0,4.85,25.15,2019,14846
3380,119,798,4297,78.66,2.77,18.57,2019,14895
3470,103,589,4162,83.37,2.47,14.15,2019,14006
5589,340,1151,7080,78.94,4.8,16.26,2019,14615
7926,291,1347,9564,82.87,3.04,14.08,2019,14220
8015,380,939,9334,85.87,4.07,10.06,2019,14228
4015,80,899,4994,80.4,1.6,18.0,2019,14411
6346,210,689,7245,87.59,2.9,9.51,2019,14420
1498,33,300,1831,81.81,1.8,16.38,2019,14423
10172,350,1596,12118,83.94,2.89,13.17,2019,14424
3260,126,598,3984,81.83,3.16,15.01,2019,14437
106,0,9,115,92.17,0.0,7.83,2019,14441
222,18,17,257,86.38,7.0,6.61,2019,14478
972,127,588,1687,57.62,7.53,34.85,2019,14604
5642,407,849,6898,81.79,5.9,12.31,2019,14610
4758,187,1576,6521,72.96,2.87,24.17,2019,14611
606,39,136,781,77.59,4.99,17.41,2019,14718
888,27,516,1431,62.05,1.89,36.06,2019,14719
1226,68,465,1759,69.7,3.87,26.44,2019,14737
187,7,81,275,68.0,2.55,29.45,2019,14748
1003,87,249,1339,74.91,6.5,18.6,2019,14757
318,4,36,358,88.83,1.12,10.06,2019,14802
873,35,87,995,87.74,3.52,8.74,2019,14817
1136,37,194,1367,83.1,2.71,14.19,2019,14821
272,3,14,289,94.12,1.04,4.84,2019,14825
7234,428,841,8503,85.08,5.03,9.89,2019,14845
522,19,126,667,78.26,2.85,18.89,2019,14880
1634,2,267,1903,85.86,0.11,14.03,2019,14883
1370,50,318,1738,78.83,2.88,18.3,2019,14891
586,16,184,786,74.55,2.04,23.41,2019,16374
5164,210,1010,6384,80.89,3.29,15.82,2019,16504
5138,179,934,6251,82.19,2.86,14.94,2019,16648
48,2,3,53,90.57,3.77,5.66,2019,16048
31,0,16,47,65.96,0.0,34.04,2019,16211
0,0,0,0,,,,2019,16312
89,0,10,99,89.9,0.0,10.1,2019,16328
0,0,0,0,,,,2019,16444
0,0,0,0,,,,2019,16546
0,0,0,0,,,,2019,16563
0,0,0,0,,,,2019,16699
11,3,8,22,50.0,13.64,36.36,2019,16728
126,0,0,126,100.0,0.0,0.0,2019,16821
61,0,9,70,87.14,0.0,12.86,2019,16835
13002,340,2140,15482,83.98,2.2,13.82,2019,60120
13107,344,895,14346,91.36,2.4,6.24,2019,60137
754,26,82,862,87.47,3.02,9.51,2019,60145
5472,363,1960,7795,70.2,4.66,25.14,2019,60153
1111,53,432,1596,69.61,3.32,27.07,2019,74079
6387,213,1530,8130,78.56,2.62,18.82,2019,74107
1635,125,951,2711,60.31,4.61,35.08,2019,74346
3692,108,682,4482,82.37,2.41,15.22,2019,74128
706,55,323,1084,65.13,5.07,29.8,2019,74342
799,53,330,1182,67.6,4.48,27.92,2019,74343
59,10,16,85,69.41,11.76,18.82,2019,74358
644,85,300,1029,62.59,8.26,29.15,2019,74363
844,70,445,1359,62.1,5.15,32.74,2019,74370
3651,900,1834,6385,57.18,14.1,28.72,2019,74401
4685,92,584,5361,87.39,1.72,10.89,2019,74429
1184,81,662,1927,61.44,4.2,34.35,2019,74441
160,2,36,198,80.81,1.01,18.18,2019,74446
58,0,38,96,60.42,0.0,39.58,2019,74456
4886,188,1084,6158,79.34,3.05,17.6,2019,74467
64,14,29,107,59.81,13.08,27.1,2019,74468
8367,331,2243,10941,76.47,3.03,20.5,2019,74501
43,2,19,64,67.19,3.12,29.69,2019,74530
36,1,25,62,58.06,1.61,40.32,2019,74534
90,0,57,147,61.22,0.0,38.78,2019,74543
255,6,131,392,65.05,1.53,33.42,2019,74562
80,2,33,115,69.57,1.74,28.7,2019,74640
2734,132,1358,4224,64.73,3.12,32.15,2019,74728
800,58,249,1107,72.27,5.24,22.49,2019,74729
5711,420,1421,7552,75.62,5.56,18.82,2019,74804
202,3,64,269,75.09,1.12,23.79,2019,74831
448,34,173,655,68.4,5.19,26.41,2019,74840
45,2,23,70,64.29,2.86,32.86,2019,74935
254,39,129,422,60.19,9.24,30.57,2019,74936
80,10,52,142,56.34,7.04,36.62,2019,74949
4107,192,1287,5586,73.52,3.44,23.04,2019,74003
3029,114,509,3652,82.94,3.12,13.94,2019,74015
1339,100,505,1944,68.88,5.14,25.98,2019,74029
861,80,422,1363,63.17,5.87,30.96,2019,74035
521,21,183,725,71.86,2.9,25.24,2019,74051
881,115,428,1424,61.87,8.08,30.06,2019,74058
1858,42,331,2231,83.28,1.88,14.84,2019,74059
10336,294,1106,11736,88.07,2.51,9.42,2019,74074
4255,309,631,5195,81.91,5.95,12.15,2019,74104
494,4,206,704,70.17,0.57,29.26,2019,74130
5948,230,977,7155,83.13,3.21,13.65,2019,74129
11395,423,1854,13672,83.35,3.09,13.56,2019,74136
441,29,144,614,71.82,4.72,23.45,2019,74366
16,0,21,37,43.24,0.0,56.76,2019,74368
17,3,26,46,36.96,6.52,56.52,2019,74438
171,2,108,281,60.85,0.71,38.43,2019,74867
498,63,233,794,62.72,7.93,29.35,2019,74930
6,0,6,12,50.0,0.0,50.0,2019,74117
1391,22,234,1647,84.46,1.34,14.21,2019,74053
10060,217,1930,12207,82.41,1.78,15.81,2019,74066
7045,446,1651,9142,77.06,4.88,18.06,2019,74112
575,18,328,921,62.43,1.95,35.61,2019,74940
79,5,70,154,51.3,3.25,45.45,2019,74945
24,0,21,45,53.33,0.0,46.67,2019,74946
1201,64,486,1751,68.59,3.66,27.76,2019,74962
230,0,43,273,84.25,0.0,15.75,2019,13489
476,13,83,572,83.22,2.27,14.51,2019,13608
2974,141,451,3566,83.4,3.95,12.65,2019,13617
136,8,21,165,82.42,4.85,12.73,2019,13640
830,70,540,1440,57.64,4.86,37.5,2019,13655
725,45,138,908,79.85,4.96,15.2,2019,13658
113,4,16,133,84.96,3.01,12.03,2019,13664
200,0,39,239,83.68,0.0,16.32,2019,13672
2762,86,255,3103,89.01,2.77,8.22,2019,13732
1018,35,308,1361,74.8,2.57,22.63,2019,13754
66,0,0,66,100.0,0.0,0.0,2019,13774
1146,25,138,1309,87.55,1.91,10.54,2019,13795
1726,113,419,2258,76.44,5.0,18.56,2019,13830
1237,42,217,1496,82.69,2.81,14.51,2019,13833
68,0,18,86,79.07,0.0,20.93,2019,13834
660,39,146,845,78.11,4.62,17.28,2019,13843
704,21,173,898,78.4,2.34,19.27,2019,13324
18,0,3,21,85.71,0.0,14.29,2019,13333
495,6,102,603,82.09,1.0,16.92,2019,13348
148,4,93,245,60.41,1.63,37.96,2019,13361
2572,40,519,3131,82.15,1.28,16.58,2019,13365
2633,34,555,3222,81.72,1.06,17.23,2019,13367
4616,135,653,5404,85.42,2.5,12.08,2019,13421
689,21,163,873,78.92,2.41,18.67,2019,13424
671,9,209,889,75.48,1.01,23.51,2019,13425
380,35,193,608,62.5,5.76,31.74,2019,13428
1144,51,211,1406,81.37,3.63,15.01,2019,13438
453,0,15,468,96.79,0.0,3.21,2019,13469
939,68,237,1244,75.48,5.47,19.05,2019,13471
377,6,53,436,86.47,1.38,12.16,2019,13477
1096,77,256,1429,76.7,5.39,17.91,2019,13480
4080,157,581,4818,84.68,3.26,12.06,2019,13492
735,16,217,968,75.93,1.65,22.42,2019,15954
69,0,0,69,100.0,0.0,0.0,2019,15693
135,0,48,183,73.77,0.0,26.23,2019,15695
156,0,45,201,77.61,0.0,22.39,2019,15739
185,59,14,258,71.71,22.87,5.43,2019,15754
19,0,38,57,33.33,0.0,66.67,2019,15761
350,15,200,565,61.95,2.65,35.4,2019,15772
21,0,4,25,84.0,0.0,16.0,2019,15776
37,6,4,47,78.72,12.77,8.51,2019,15783
44,2,15,61,72.13,3.28,24.59,2019,15821
90,0,16,106,84.91,0.0,15.09,2019,15827
477,5,61,543,87.85,0.92,11.23,2019,15829
346,13,114,473,73.15,2.75,24.1,2019,15849
54,2,15,71,76.06,2.82,21.13,2019,15925
1190,43,335,1568,75.89,2.74,21.36,2019,15943
180,0,28,208,86.54,0.0,13.46,2019,15346
225,9,95,329,68.39,2.74,28.88,2019,15362
540,20,184,744,72.58,2.69,24.73,2019,15428
906,60,187,1153,78.58,5.2,16.22,2019,15445
41,4,6,51,80.39,7.84,11.76,2019,15460
41,13,7,61,67.21,21.31,11.48,2019,15472
15,0,26,41,36.59,0.0,63.41,2019,15476
3615,120,1150,4885,74.0,2.46,23.54,2019,15522
1521,40,500,2061,73.8,1.94,24.26,2019,15530
268,0,98,366,73.22,0.0,26.78,2019,15534
537,21,160,718,74.79,2.92,22.28,2019,15550
1290,38,251,1579,81.7,2.41,15.9,2019,15610
636,14,144,794,80.1,1.76,18.14,2019,16922
2170,76,487,2733,79.4,2.78,17.82,2019,16933
59,0,12,71,83.1,0.0,16.9,2019,16937
93,0,25,118,78.81,0.0,21.19,2019,16939
145,6,68,219,66.21,2.74,31.05,2019,16943
810,26,174,1010,80.2,2.57,17.23,2019,16946
114,0,0,114,100.0,0.0,0.0,2019,16825
200,3,81,284,70.42,1.06,28.52,2019,16829
207,8,131,346,59.83,2.31,37.86,2019,16843
70,0,11,81,86.42,0.0,13.58,2019,16744
0,0,12,12,0.0,0.0,100.0,2019,16802
309,0,176,485,63.71,0.0,36.29,2019,16111
174,2,15,191,91.1,1.05,7.85,2019,16113
25,7,22,54,46.3,12.96,40.74,2019,16217
32,0,12,44,72.73,0.0,27.27,2019,16253
148,20,20,188,78.72,10.64,10.64,2019,16329
310,15,80,405,76.54,3.7,19.75,2019,16362
1050,11,275,1336,78.59,0.82,20.58,2019,16373
854,34,391,1279,66.77,2.66,30.57,2019,16404
2475,98,498,3071,80.59,3.19,16.22,2019,16417
5046,251,1392,6689,75.44,3.75,20.81,2019,16502
2947,127,651,3725,79.11,3.41,17.48,2019,16507
10416,139,1552,12107,86.03,1.15,12.82,2019,16509
104,6,24,134,77.61,4.48,17.91,2019,16619
867,14,170,1051,82.49,1.33,16.18,2019,16641
109,0,18,127,85.83,0.0,14.17,2019,16665
445,3,84,532,83.65,0.56,15.79,2019,16667
1183,21,265,1469,80.53,1.43,18.04,2019,16668
183,5,56,244,75.0,2.05,22.95,2019,16674
810,24,265,1099,73.7,2.18,24.11,2019,16678
60,0,24,84,71.43,0.0,28.57,2019,16733
97,0,20,117,82.91,0.0,17.09,2019,16734
227,10,166,403,56.33,2.48,41.19,2019,16820
1631,80,497,2208,73.87,3.62,22.51,2019,16833
107,8,30,145,73.79,5.52,20.69,2019,16834
264,0,0,264,100.0,0.0,0.0,2019,16851
1180,60,305,1545,76.38,3.88,19.74,2019,16875
63,4,70,137,45.99,2.92,51.09,2019,16882
3339,71,723,4133,80.79,1.72,17.49,2019,16901
139,0,35,174,79.89,0.0,20.11,2019,16911
760,24,161,945,80.42,2.54,17.04,2019,16929
5118,79,955,6152,83.19,1.28,15.52,2019,16002
1279,184,503,1966,65.06,9.36,25.58,2019,16023
693,3,143,839,82.6,0.36,17.04,2019,16041
985,33,260,1278,77.07,2.58,20.34,2019,16049
3877,202,604,4683,82.79,4.31,12.9,2019,07057
3396,93,282,3771,90.06,2.47,7.48,2019,07936
5205,93,378,5676,91.7,1.64,6.66,2019,07882
3185,153,499,3837,83.01,3.99,13.0,2019,07885
1082,0,34,1116,96.95,0.0,3.05,2019,07933
2289,5,238,2532,90.4,0.2,9.4,2019,07727
3187,40,248,3475,91.71,1.15,7.14,2019,07642
7879,175,751,8805,89.48,1.99,8.53,2019,07644
2725,28,222,2975,91.6,0.94,7.46,2019,07645
1976,46,138,2160,91.48,2.13,6.39,2019,07648
7646,263,831,8740,87.48,3.01,9.51,2019,07724
14022,417,1043,15482,90.57,2.69,6.74,2019,07726
1993,175,490,2658,74.98,6.58,18.43,2019,07732
8784,277,584,9645,91.07,2.87,6.05,2019,07748
160,0,96,256,62.5,0.0,37.5,2019,16868
949,23,299,1271,74.67,1.81,23.52,2019,16950
59,0,12,71,83.1,0.0,16.9,2019,16837
66,8,74,148,44.59,5.41,50.0,2019,16847
139,0,20,159,87.42,0.0,12.58,2019,16848
85,5,0,90,94.44,5.56,0.0,2019,16024
1715,27,323,2065,83.05,1.31,15.64,2019,16025
1081,30,259,1370,78.91,2.19,18.91,2019,16038
1538,37,210,1785,86.16,2.07,11.76,2019,16053
11414,198,478,12090,94.41,1.64,3.95,2019,16066
10473,453,3182,14108,74.23,3.21,22.55,2019,16101
5723,75,894,6692,85.52,1.12,13.36,2019,16105
654,19,128,801,81.65,2.37,15.98,2019,16123
1276,41,363,1680,75.95,2.44,21.61,2019,16134
49,0,18,67,73.13,0.0,26.87,2019,16140
1020,22,169,1211,84.23,1.82,13.96,2019,16145
1099,69,255,1423,77.23,4.85,17.92,2019,16157
259,8,76,343,75.51,2.33,22.16,2019,16161
143,5,32,180,79.44,2.78,17.78,2019,16238
1393,45,388,1826,76.29,2.46,21.25,2019,16242
430,11,168,609,70.61,1.81,27.59,2019,16255
7,0,12,19,36.84,0.0,63.16,2019,16332
993,58,309,1360,73.01,4.26,22.72,2019,16371
1927,79,430,2436,79.11,3.24,17.65,2019,16403
926,26,287,1239,74.74,2.1,23.16,2019,16406
2952,54,301,3307,89.27,1.63,9.1,2019,16415
1460,34,267,1761,82.91,1.93,15.16,2019,16423
495,11,198,704,70.31,1.56,28.12,2019,16435
817,43,165,1025,79.71,4.2,16.1,2019,16611
37,0,25,62,59.68,0.0,40.32,2019,16616
174,2,36,212,82.08,0.94,16.98,2019,16623
628,32,200,860,73.02,3.72,23.26,2019,16627
107,0,39,146,73.29,0.0,26.71,2019,16634
272,3,32,307,88.6,0.98,10.42,2019,16640
53,1,7,61,86.89,1.64,11.48,2019,16645
71,0,68,139,51.08,0.0,48.92,2019,16680
19,0,9,28,67.86,0.0,32.14,2019,16682
58,0,8,66,87.88,0.0,12.12,2019,16727
388,30,43,461,84.16,6.51,9.33,2019,16746
1818,13,25,1856,97.95,0.7,1.35,2019,16827
118,4,40,162,72.84,2.47,24.69,2019,16832
235,13,76,324,72.53,4.01,23.46,2019,16845
52,7,37,96,54.17,7.29,38.54,2019,16853
730,17,129,876,83.33,1.94,14.73,2019,16914
803,17,213,1033,77.73,1.65,20.62,2019,16153
6250,43,600,6893,90.67,0.62,8.7,2019,08034
874,32,223,1129,77.41,2.83,19.75,2019,08045
9475,162,376,10013,94.63,1.62,3.76,2019,08055
892,36,189,1117,79.86,3.22,16.92,2019,08063
2438,28,359,2825,86.3,0.99,12.71,2019,08065
3994,157,849,5000,79.88,3.14,16.98,2019,08070
95,0,5,100,95.0,0.0,5.0,2019,08072
2726,61,362,3149,86.57,1.94,11.5,2019,08078
3398,41,279,3718,91.39,1.1,7.5,2019,08083
1240,18,244,1502,82.56,1.2,16.25,2019,08089
1604,82,120,1806,88.82,4.54,6.64,2019,08223
4441,207,662,5310,83.63,3.9,12.47,2019,08215
2235,51,223,2509,89.08,2.03,8.89,2019,08221
154,4,27,185,83.24,2.16,14.59,2019,08224
908,122,755,1785,50.87,6.83,42.3,2019,74965
935,24,422,1381,67.7,1.74,30.56,2019,74966
127,0,19,146,86.99,0.0,13.01,2019,73066
3518,87,584,4189,83.98,2.08,13.94,2019,73068
7176,330,1082,8588,83.56,3.84,12.6,2019,78239
16031,127,747,16905,94.83,0.75,4.42,2019,78254
5581,86,136,5803,96.17,1.48,2.34,2019,78261
2285,128,49,2462,92.81,5.2,1.99,2019,78266
5670,205,3480,9355,60.61,2.19,37.2,2019,78332
64,6,62,132,48.48,4.55,46.97,2019,78353
5032,342,1131,6505,77.36,5.26,17.39,2019,78503
11963,2235,7913,22111,54.1,10.11,35.79,2019,78577
140,0,55,195,71.79,0.0,28.21,2019,78932
34,0,13,47,72.34,0.0,27.66,2019,78885
277,6,66,349,79.37,1.72,18.91,2019,78870
382,0,433,815,46.87,0.0,53.13,2019,78881
320,13,87,420,76.19,3.1,20.71,2019,78884
1634,119,627,2380,68.66,5.0,26.34,2019,78934
325,9,64,398,81.66,2.26,16.08,2019,78935
7737,892,244,8873,87.2,10.05,2.75,2019,78705
18971,330,1370,20671,91.78,1.6,6.63,2019,78759
45,5,51,101,44.55,4.95,50.5,2019,78563
6552,107,558,7217,90.79,1.48,7.73,2019,78133
14985,192,906,16083,93.17,1.19,5.63,2019,78258
5248,149,1456,6853,76.58,2.17,21.25,2019,78404
2427,237,1092,3756,64.62,6.31,29.07,2019,78580
2583,41,765,3389,76.22,1.21,22.57,2019,78639
11282,179,872,12333,91.48,1.45,7.07,2019,78628
8513,160,1335,10008,85.06,1.6,13.34,2019,78728
3535,71,72,3678,96.11,1.93,1.96,2019,78736
11319,116,423,11858,95.45,0.98,3.57,2019,78750
16080,512,3960,20552,78.24,2.49,19.27,2019,78753
196,11,183,390,50.26,2.82,46.92,2019,78827
644,33,660,1337,48.17,2.47,49.36,2019,78832
1496,230,992,2718,55.04,8.46,36.5,2019,78839
2989,89,904,3982,75.06,2.24,22.7,2019,78861
83,3,44,130,63.85,2.31,33.85,2019,78938
52,0,57,109,47.71,0.0,52.29,2019,78943
2695,84,1301,4080,66.05,2.06,31.89,2019,78945
295,21,40,356,82.87,5.9,11.24,2019,78963
64,0,29,93,68.82,0.0,31.18,2019,78837
426,63,446,935,45.56,6.74,47.7,2019,78941
177,14,50,241,73.44,5.81,20.75,2019,78944
704,0,96,800,88.0,0.0,12.0,2019,78950
5295,39,154,5488,96.48,0.71,2.81,2019,78248
8601,813,6029,15443,55.7,5.26,39.04,2019,78207
13517,1227,2546,17290,78.18,7.1,14.73,2019,78233
7005,313,1760,9078,77.16,3.45,19.39,2019,78242
18940,241,1429,20610,91.9,1.17,6.93,2019,78251
4354,25,137,4516,96.41,0.55,3.03,2019,78255
1109,45,258,1412,78.54,3.19,18.27,2019,78263
157,8,144,309,50.81,2.59,46.6,2019,78330
62,13,48,123,50.41,10.57,39.02,2019,78351
247,6,45,298,82.89,2.01,15.1,2019,78358
1943,99,1038,3080,63.08,3.21,33.7,2019,78387
2518,41,1544,4103,61.37,1.0,37.63,2019,78408
791,0,202,993,79.66,0.0,20.34,2019,78409
3597,53,1543,5193,69.27,1.02,29.71,2019,78416
1689,52,658,2399,70.4,2.17,27.43,2019,78543
250,3,87,340,73.53,0.88,25.59,2019,15611
97,2,42,141,68.79,1.42,29.79,2019,15617
438,0,175,613,71.45,0.0,28.55,2019,15622
232,0,25,257,90.27,0.0,9.73,2019,15623
140,11,98,249,56.22,4.42,39.36,2019,15633
56,0,10,66,84.85,0.0,15.15,2019,15646
160,25,19,204,78.43,12.25,9.31,2019,15661
41,0,10,51,80.39,0.0,19.61,2019,15087
246,0,49,295,83.39,0.0,16.61,2019,15060
106,0,0,106,100.0,0.0,0.0,2019,15082
135,15,22,172,78.49,8.72,12.79,2019,15088
2947,121,631,3699,79.67,3.27,17.06,2019,15131
6923,262,2718,9903,69.91,2.65,27.45,2019,15132
3719,130,840,4689,79.31,2.77,17.91,2019,15137
3293,183,1040,4516,72.92,4.05,23.03,2019,15208
446,22,90,558,79.93,3.94,16.13,2019,15823
84,12,30,126,66.67,9.52,23.81,2019,15832
124,6,22,152,81.58,3.95,14.47,2019,15841
106,3,37,146,72.6,2.05,25.34,2019,15847
368,15,108,491,74.95,3.05,22.0,2019,15860
443,10,177,630,70.32,1.59,28.1,2019,15865
314,32,110,456,68.86,7.02,24.12,2019,15688
422,0,97,519,81.31,0.0,18.69,2019,15692
1496,36,516,2048,73.05,1.76,25.2,2019,15714
0,0,15,15,0.0,0.0,100.0,2019,15723
5677,149,909,6735,84.29,2.21,13.5,2019,15218
12991,252,1845,15088,86.1,1.67,12.23,2019,15235
1757,156,539,2452,71.66,6.36,21.98,2019,15320
574,10,32,616,93.18,1.62,5.19,2019,15321
86,19,81,186,46.24,10.22,43.55,2019,15325
36,0,9,45,80.0,0.0,20.0,2019,15334
97,0,0,97,100.0,0.0,0.0,2019,15348
5280,169,460,5909,89.36,2.86,7.78,2019,06470
2347,0,53,2400,97.79,0.0,2.21,2019,06472
3183,117,441,3741,85.08,3.13,11.79,2019,06480
18097,293,2515,20905,86.57,1.4,12.03,2019,06511
11520,346,2926,14792,77.88,2.34,19.78,2019,06513
9219,179,597,9995,92.24,1.79,5.97,2019,06514
1851,43,124,2018,91.72,2.13,6.14,2019,06524
6879,371,1592,8842,77.8,4.2,18.0,2019,06605
3352,186,961,4499,74.51,4.13,21.36,2019,06608
11044,268,885,12197,90.55,2.2,7.26,2019,06611
487,259,930,1676,29.06,15.45,55.49,2019,06702
414,7,86,507,81.66,1.38,16.96,2019,06750
643,13,48,704,91.34,1.85,6.82,2019,06752
964,7,103,1074,89.76,0.65,9.59,2019,06756
10084,335,1246,11665,86.45,2.87,10.68,2019,06770
832,10,45,887,93.8,1.13,5.07,2019,06783
1809,8,126,1943,93.1,0.41,6.48,2019,06791
9808,210,1286,11304,86.77,1.86,11.38,2019,06512
17223,319,2344,19886,86.61,1.6,11.79,2019,06516
4957,149,803,5909,83.89,2.52,13.59,2019,06517
925,21,240,1186,77.99,1.77,20.24,2019,06018
2715,14,219,2948,92.1,0.47,7.43,2019,06035
5053,273,1218,6544,77.22,4.17,18.61,2019,06226
7810,554,3493,11857,65.87,4.67,29.46,2019,06051
4183,167,957,5307,78.82,3.15,18.03,2019,06096
2444,102,376,2922,83.64,3.49,12.87,2019,06234
41,0,2,43,95.35,0.0,4.65,2019,06264
1973,81,207,2261,87.26,3.58,9.16,2019,07826
1346,0,68,1414,95.19,0.0,4.81,2019,07750
3519,96,423,4038,87.15,2.38,10.48,2019,07762
639,61,46,746,85.66,8.18,6.17,2019,07847
3367,67,236,3670,91.74,1.83,6.43,2019,07849
1233,122,140,1495,82.47,8.16,9.36,2019,07852
1597,0,151,1748,91.36,0.0,8.64,2019,07856
5663,733,1529,7925,71.46,9.25,19.29,2019,07008
20652,503,3812,24967,82.72,2.01,15.27,2019,07002
3930,33,615,4578,85.85,0.72,13.43,2019,07012
1718,18,108,1844,93.17,0.98,5.86,2019,07014
10646,396,2125,13167,80.85,3.01,16.14,2019,07017
5527,69,788,6384,86.58,1.08,12.34,2019,07031
943,240,133,1316,71.66,18.24,10.11,2019,07064
9625,402,1277,11304,85.15,3.56,11.3,2019,07065
9423,102,755,10280,91.66,0.99,7.34,2019,07090
6873,144,540,7557,90.95,1.91,7.15,2019,07094
13395,735,4804,18934,70.75,3.88,25.37,2019,07104
20782,278,1295,22355,92.96,1.24,5.79,2019,07302
13435,410,1876,15721,85.46,2.61,11.93,2019,07307
2657,0,296,2953,89.98,0.0,10.02,2019,07403
1407,11,20,1438,97.84,0.76,1.39,2019,07423
9277,58,443,9778,94.88,0.59,4.53,2019,07430
2768,76,838,3682,75.18,2.06,22.76,2019,07504
8886,69,621,9576,92.79,0.72,6.48,2019,07006
9912,148,2589,12649,78.36,1.17,20.47,2019,07011
5295,14,442,5751,92.07,0.24,7.69,2019,07020
11600,109,1642,13351,86.88,0.82,12.3,2019,07032
3329,73,324,3726,89.35,1.96,8.7,2019,07035
12662,447,2297,15406,82.19,2.9,14.91,2019,07036
9355,258,823,10436,89.64,2.47,7.89,2019,07042
14517,264,1633,16414,88.44,1.61,9.95,2019,07052
5618,131,448,6197,90.66,2.11,7.23,2019,07067
4071,34,38,4143,98.26,0.82,0.92,2019,07078
19882,498,4132,24512,81.11,2.03,16.86,2019,07087
19316,942,3859,24117,80.09,3.91,16.0,2019,07093
6847,411,1393,8651,79.15,4.75,16.1,2019,07201
18408,603,3641,22652,81.26,2.66,16.07,2019,07305
3301,67,224,3592,91.9,1.87,6.24,2019,07419
4058,35,144,4237,95.78,0.83,3.4,2019,07436
5378,82,373,5833,92.2,1.41,6.39,2019,07481
6171,128,819,7118,86.7,1.8,11.51,2019,07506
1623,7,83,1713,94.75,0.41,4.85,2019,07647
2717,38,33,2788,97.45,1.36,1.18,2019,07649
9495,56,483,10034,94.63,0.56,4.81,2019,07675
10962,597,1640,13199,83.05,4.52,12.43,2019,12203
3346,131,469,3946,84.79,3.32,11.89,2019,12204
4576,271,1381,6228,73.47,4.35,22.17,2019,12206
8984,470,2218,11672,76.97,4.03,19.0,2019,12010
2760,21,279,3060,90.2,0.69,9.12,2019,12018
326,18,62,406,80.3,4.43,15.27,2019,12032
140,0,33,173,80.92,0.0,19.08,2019,12041
325,0,98,423,76.83,0.0,23.17,2019,12046
927,28,284,1239,74.82,2.26,22.92,2019,12068
77,0,50,127,60.63,0.0,39.37,2019,12071
760,32,179,971,78.27,3.3,18.43,2019,12072
1092,5,98,1195,91.38,0.42,8.2,2019,12074
4056,42,761,4859,83.47,0.86,15.66,2019,12095
1123,34,191,1348,83.31,2.52,14.17,2019,12138
9226,261,1079,10566,87.32,2.47,10.21,2019,08330
1479,28,305,1812,81.62,1.55,16.83,2019,08344
134,3,15,152,88.16,1.97,9.87,2019,08353
1558,0,414,1972,79.01,0.0,20.99,2019,08029
3852,81,690,4623,83.32,1.75,14.93,2019,08030
1920,17,303,2240,85.71,0.76,13.53,2019,08036
9597,174,922,10693,89.75,1.63,8.62,2019,08046
30,0,0,30,100.0,0.0,0.0,2019,08064
511,19,57,587,87.05,3.24,9.71,2019,08067
9335,337,1245,10917,85.51,3.09,11.4,2019,08087
1047,17,84,1148,91.2,1.48,7.32,2019,08097
83,5,4,92,90.22,5.43,4.35,2019,08212
12859,366,1433,14658,87.73,2.5,9.78,2019,08012
5666,157,656,6479,87.45,2.42,10.13,2019,08028
5688,21,345,6054,93.95,0.35,5.7,2019,08033
7115,305,905,8325,85.47,3.66,10.87,2019,08037
1484,0,25,1509,98.34,0.0,1.66,2019,08056
1930,9,188,2127,90.74,0.42,8.84,2019,08059
46,0,0,46,100.0,0.0,0.0,2019,08073
12511,142,743,13396,93.39,1.06,5.55,2019,08080
8064,146,1059,9269,87.0,1.58,11.43,2019,08088
7210,72,1140,8422,85.61,0.85,13.54,2019,08109
6823,213,699,7735,88.21,2.75,9.04,2019,08204
1045,9,57,1111,94.06,0.81,5.13,2019,08243
4877,150,1076,6103,79.91,2.46,17.63,2019,08260
2466,64,484,3014,81.82,2.12,16.06,2019,08270
382,13,19,414,92.27,3.14,4.59,2019,08319
10491,416,4597,15504,67.67,2.68,29.65,2019,08401
6336,76,486,6898,91.85,1.1,7.05,2019,08077
6343,130,282,6755,93.9,1.92,4.17,2019,08085
2571,53,151,2775,92.65,1.91,5.44,2019,08090
2941,124,598,3663,80.29,3.39,16.33,2019,08093
17,0,0,17,100.0,0.0,0.0,2019,08095
11580,217,1920,13717,84.42,1.58,14.0,2019,08096
5289,231,2830,8350,63.34,2.77,33.89,2019,08104
4578,196,913,5687,80.5,3.45,16.05,2019,08110
3526,111,415,4052,87.02,2.74,10.24,2019,08203
5559,107,715,6381,87.12,1.68,11.21,2019,08210
2608,28,227,2863,91.09,0.98,7.93,2019,08225
3721,107,597,4425,84.09,2.42,13.49,2019,08244
3512,86,536,4134,84.95,2.08,12.97,2019,08251
3087,70,353,3510,87.95,1.99,10.06,2019,08008
3224,47,440,3711,86.88,1.27,11.86,2019,08022
8322,212,823,9357,88.94,2.27,8.8,2019,08005
339,0,44,383,88.51,0.0,11.49,2019,08511
2643,78,298,3019,87.55,2.58,9.87,2019,12009
2013,34,238,2285,88.1,1.49,10.42,2019,12025
7399,584,1047,9030,81.94,6.47,11.59,2019,12047
538,20,123,681,79.0,2.94,18.06,2019,12052
376,14,159,549,68.49,2.55,28.96,2019,12058
132,0,67,199,66.33,0.0,33.67,2019,12063
112,0,58,170,65.88,0.0,34.12,2019,12064
455,33,142,630,72.22,5.24,22.54,2019,12076
193,19,53,265,72.83,7.17,20.0,2019,12120
539,28,55,622,86.66,4.5,8.84,2019,12125
259,0,64,323,80.19,0.0,19.81,2019,12150
4133,140,550,4823,85.69,2.9,11.4,2019,12188
640,9,73,722,88.64,1.25,10.11,2019,12192
709,72,398,1179,60.14,6.11,33.76,2019,12207
2958,252,548,3758,78.71,6.71,14.58,2019,78557
1326,319,837,2482,53.42,12.85,33.72,2019,78583
185,0,17,202,91.58,0.0,8.42,2019,78608
78,3,25,106,73.58,2.83,23.58,2019,78622
10491,309,1949,12749,82.29,2.42,15.29,2019,61614
194,12,23,229,84.72,5.24,10.04,2019,61721
651,4,75,730,89.18,0.55,10.27,2019,61732
150,6,28,184,81.52,3.26,15.22,2019,61737
265,5,32,302,87.75,1.66,10.6,2019,61771
83,10,8,101,82.18,9.9,7.92,2019,61772
327,12,19,358,91.34,3.35,5.31,2019,61774
430,31,27,488,88.11,6.35,5.53,2019,61776
259,11,91,361,71.75,3.05,25.21,2019,61777
148,6,25,179,82.68,3.35,13.97,2019,61816
1570,60,236,1866,84.14,3.22,12.65,2019,61275
396,17,154,567,69.84,3.0,27.16,2019,61283
437,7,84,528,82.77,1.33,15.91,2019,61329
242,11,37,290,83.45,3.79,12.76,2019,61334
98,7,47,152,64.47,4.61,30.92,2019,61344
93,8,30,131,70.99,6.11,22.9,2019,61359
96,0,45,141,68.09,0.0,31.91,2019,61363
769,4,129,902,85.25,0.44,14.3,2019,61373
9583,592,3297,13472,71.13,4.39,24.47,2019,61401
39,0,10,49,79.59,0.0,20.41,2019,61426
1481,29,256,1766,83.86,1.64,14.5,2019,61063
1672,17,343,2032,82.28,0.84,16.88,2019,61025
158,4,46,208,75.96,1.92,22.12,2019,61049
963,26,184,1173,82.1,2.22,15.69,2019,61053
3149,44,263,3456,91.12,1.27,7.61,2019,61065
3559,117,324,4000,88.97,2.92,8.1,2019,61080
11174,380,1676,13230,84.46,2.87,12.67,2019,61107
335,7,52,394,85.03,1.78,13.2,2019,61257
364,24,48,436,83.49,5.5,11.01,2019,61262
325,56,40,421,77.2,13.3,9.5,2019,61279
657,44,152,853,77.02,5.16,17.82,2019,61284
555,0,93,648,85.65,0.0,14.35,2019,61285
51,0,33,84,60.71,0.0,39.29,2019,61313
272,7,92,371,73.32,1.89,24.8,2019,61314
9,0,0,9,100.0,0.0,0.0,2019,61328
174,0,41,215,80.93,0.0,19.07,2019,61336
370,11,36,417,88.73,2.64,8.63,2019,61428
277,3,40,320,86.56,0.94,12.5,2019,61438
98,0,10,108,90.74,0.0,9.26,2019,61451
36,2,0,38,94.74,5.26,0.0,2019,61471
486,20,92,598,81.27,3.34,15.38,2019,61473
471,15,207,693,67.97,2.16,29.87,2019,61501
901,5,134,1040,86.63,0.48,12.88,2019,61529
918,5,243,1166,78.73,0.43,20.84,2019,61537
1247,56,288,1591,78.38,3.52,18.1,2019,61546
4015,60,413,4488,89.46,1.34,9.2,2019,61548
67,0,7,74,90.54,0.0,9.46,2019,61552
791,17,157,965,81.97,1.76,16.27,2019,61561
8236,159,1442,9837,83.72,1.62,14.66,2019,61571
442,23,113,578,76.47,3.98,19.55,2019,61572
866,43,138,1047,82.71,4.11,13.18,2019,61723
168,7,32,207,81.16,3.38,15.46,2019,61724
459,0,134,593,77.4,0.0,22.6,2019,61725
161,0,25,186,86.56,0.0,13.44,2019,61722
3284,106,652,4042,81.25,2.62,16.13,2019,61727
2294,16,160,2470,92.87,0.65,6.48,2019,06335
29,0,0,29,100.0,0.0,0.0,2019,06336
1492,43,295,1830,81.53,2.35,16.12,2019,06365
47,0,24,71,66.2,0.0,33.8,2019,06373
422,0,0,422,100.0,0.0,0.0,2019,06409
1972,4,193,2169,90.92,0.18,8.9,2019,06423
4271,104,427,4802,88.94,2.17,8.89,2019,06424
856,11,129,996,85.94,1.1,12.95,2019,06442
2149,45,137,2331,92.19,1.93,5.88,2019,06447
5178,172,853,6203,83.48,2.77,13.75,2019,06483
6356,386,2427,9169,69.32,4.21,26.47,2019,06704
7252,702,2253,10207,71.05,6.88,22.07,2019,06705
2356,121,1159,3636,64.8,3.33,31.88,2019,06710
5040,201,811,6052,83.28,3.32,13.4,2019,06716
20468,641,3529,24638,83.07,2.6,14.32,2019,06010
2339,61,238,2638,88.67,2.31,9.02,2019,06016
3219,28,215,3462,92.98,0.81,6.21,2019,06013
906,24,27,957,94.67,2.51,2.82,2019,06039
3194,86,352,3632,87.94,2.37,9.69,2019,06071
2061,37,58,2156,95.59,1.72,2.69,2019,06073
565,16,58,639,88.42,2.5,9.08,2019,06081
14741,450,1553,16744,88.04,2.69,9.27,2019,06082
4092,79,901,5072,80.68,1.56,17.76,2019,06098
7563,353,1839,9755,77.53,3.62,18.85,2019,06105
1600,19,219,1838,87.05,1.03,11.92,2019,06278
882,36,63,981,89.91,3.67,6.42,2019,06334
1303,0,75,1378,94.56,0.0,5.44,2019,06375
5763,543,1448,7754,74.32,7.0,18.67,2019,06401
551,10,53,614,89.74,1.63,8.63,2019,06777
3363,67,517,3947,85.2,1.7,13.1,2019,06786
425,9,54,488,87.09,1.84,11.07,2019,06796
5871,20,381,6272,93.61,0.32,6.07,2019,06804
6022,118,544,6684,90.1,1.77,8.14,2019,11754
7384,157,271,7812,94.52,2.01,3.47,2019,11795
352,5,35,392,89.8,1.28,8.93,2019,11957
26375,299,1919,28593,92.24,1.05,6.71,2019,11201
13373,364,1921,15658,85.41,2.32,12.27,2019,11231
8079,67,752,8898,90.8,0.75,8.45,2019,11417
2832,16,59,2907,97.42,0.55,2.03,2019,11109
0,0,0,0,,,,2019,11351
0,0,0,0,,,,2019,11359
0,0,0,0,,,,2019,11424
0,0,0,0,,,,2019,11425
0,0,0,0,,,,2019,11451
0,0,0,0,,,,2019,11549
0,0,0,0,,,,2019,11556
289,0,4,293,98.63,0.0,1.37,2019,11739
925,82,12,1019,90.78,8.05,1.18,2019,11749
0,0,0,0,,,,2019,11794
10,0,0,10,100.0,0.0,0.0,2019,11931
0,0,0,0,,,,2019,11973
1719,65,32,1816,94.66,3.58,1.76,2019,11955
280,13,62,355,78.87,3.66,17.46,2019,11958
117,0,0,117,100.0,0.0,0.0,2019,11970
250,57,151,458,54.59,12.45,32.97,2019,11972
532,40,98,670,79.4,5.97,14.63,2019,11976
6981,161,690,7832,89.13,2.06,8.81,2019,11010
1550,73,222,1845,84.01,3.96,12.03,2019,11020
22131,348,5797,28276,78.27,1.23,20.5,2019,11203
698,64,176,938,74.41,6.82,18.76,2019,12149
2911,188,428,3527,82.53,5.33,12.13,2019,12159
1760,25,177,1962,89.7,1.27,9.02,2019,12170
617,12,162,791,78.0,1.52,20.48,2019,12193
612,29,137,778,78.66,3.73,17.61,2019,12197
96,0,20,116,82.76,0.0,17.24,2019,12741
786,22,77,885,88.81,2.49,8.7,2019,12583
3309,117,362,3788,87.35,3.09,9.56,2019,12549
789,0,39,828,95.29,0.0,4.71,2019,12578
1410,0,14,1424,99.02,0.0,0.98,2019,12582
4276,46,440,4762,89.79,0.97,9.24,2019,12589
1341,109,217,1667,80.44,6.54,13.02,2019,12594
3196,112,811,4119,77.59,2.72,19.69,2019,12701
410,6,38,454,90.31,1.32,8.37,2019,12719
42,0,9,51,82.35,0.0,17.65,2019,12725
27,0,9,36,75.0,0.0,25.0,2019,12736
292,11,51,354,82.49,3.11,14.41,2019,12746
626,0,30,656,95.43,0.0,4.57,2019,12747
157,10,76,243,64.61,4.12,31.28,2019,12923
215,2,62,279,77.06,0.72,22.22,2019,12930
963,19,239,1221,78.87,1.56,19.57,2019,12546
113,0,13,126,89.68,0.0,10.32,2019,12886
1257,94,425,1776,70.78,5.29,23.93,2019,12887
720,25,151,896,80.36,2.79,16.85,2019,12918
732,13,231,976,75.0,1.33,23.67,2019,12920
350,28,27,405,86.42,6.91,6.67,2019,12837
188,11,61,260,72.31,4.23,23.46,2019,12878
0,0,0,0,,,,2019,12911
107,33,60,200,53.5,16.5,30.0,2019,12943
1341,48,281,1670,80.3,2.87,16.83,2019,12944
2071,135,362,2568,80.65,5.26,14.1,2019,12986
351,9,103,463,75.81,1.94,22.25,2019,12989
313,12,90,415,75.42,2.89,21.69,2019,12934
523,24,164,711,73.56,3.38,23.07,2019,12993
1859,113,264,2236,83.14,5.05,11.81,2019,12962
23,0,13,36,63.89,0.0,36.11,2019,12964
145,0,19,164,88.41,0.0,11.59,2019,12965
759,36,132,927,81.88,3.88,14.24,2019,12996
509,29,85,623,81.7,4.65,13.64,2019,12759
135,0,50,185,72.97,0.0,27.03,2019,12762
164,0,19,183,89.62,0.0,10.38,2019,12766
618,14,221,853,72.45,1.64,25.91,2019,12779
75,0,32,107,70.09,0.0,29.91,2019,12787
3014,41,531,3586,84.05,1.14,14.81,2019,12803
9799,219,1030,11048,88.69,1.98,9.32,2019,12804
328,22,162,512,64.06,4.3,31.64,2019,14858
430,17,100,547,78.61,3.11,18.28,2019,14860
342,8,131,481,71.1,1.66,27.23,2019,14864
433,17,47,497,87.12,3.42,9.46,2019,14869
80,0,38,118,67.8,0.0,32.2,2019,14874
134,6,51,191,70.16,3.14,26.7,2019,14877
103,0,28,131,78.63,0.0,21.37,2019,14884
7129,405,1792,9326,76.44,4.34,19.22,2019,14207
6208,594,2618,9420,65.9,6.31,27.79,2019,14211
384,19,104,507,75.74,3.75,20.51,2019,14418
1026,29,153,1208,84.93,2.4,12.67,2019,14435
6101,109,571,6781,89.97,1.61,8.42,2019,14468
2232,71,432,2735,81.61,2.6,15.8,2019,14489
747,0,238,985,75.84,0.0,24.16,2019,14525
1577,112,410,2099,75.13,5.34,19.53,2019,12307
158,21,4,183,86.34,11.48,2.19,2019,12405
107,0,21,128,83.59,0.0,16.41,2019,12411
990,52,101,1143,86.61,4.55,8.84,2019,12015
12036,541,1171,13748,87.55,3.94,8.52,2019,12020
44,12,32,88,50.0,13.64,36.36,2019,12031
79,0,25,104,75.96,0.0,24.04,2019,12036
1118,49,333,1500,74.53,3.27,22.2,2019,12051
1194,58,132,1384,86.27,4.19,9.54,2019,12053
6290,188,455,6933,90.73,2.71,6.56,2019,12054
647,41,121,809,79.98,5.07,14.96,2019,12056
626,0,148,774,80.88,0.0,19.12,2019,12057
533,19,171,723,73.72,2.63,23.65,2019,12070
830,2,298,1130,73.45,0.18,26.37,2019,12075
285,0,50,335,85.07,0.0,14.93,2019,12087
5788,155,726,6669,86.79,2.32,10.89,2019,12118
616,10,58,684,90.06,1.46,8.48,2019,12121
573,7,106,686,83.53,1.02,15.45,2019,12140
1623,73,277,1973,82.26,3.7,14.04,2019,12143
947,54,178,1179,80.32,4.58,15.1,2019,12154
611,42,176,829,73.7,5.07,21.23,2019,12155
1312,70,303,1685,77.86,4.15,17.98,2019,12157
790,69,269,1128,70.04,6.12,23.85,2019,12167
196,0,159,355,55.21,0.0,44.79,2019,12751
607,16,120,743,81.7,2.15,16.15,2019,12764
353,27,56,436,80.96,6.19,12.84,2019,12777
17,0,0,17,100.0,0.0,0.0,2019,12784
822,0,92,914,89.93,0.0,10.07,2019,12788
748,24,90,862,86.77,2.78,10.44,2019,12789
125,0,17,142,88.03,0.0,11.97,2019,12847
181,0,41,222,81.53,0.0,18.47,2019,12791
662,60,220,942,70.28,6.37,23.35,2019,12817
4533,103,649,5285,85.77,1.95,12.28,2019,12839
173,2,5,180,96.11,1.11,2.78,2019,12851
81,0,24,105,77.14,0.0,22.86,2019,12856
1470,54,204,1728,85.07,3.12,11.81,2019,12871
947,52,135,1134,83.51,4.59,11.9,2019,12919
859,36,91,986,87.12,3.65,9.23,2019,12921
15,0,1,16,93.75,0.0,6.25,2019,12922
425,36,134,595,71.43,6.05,22.52,2019,12956
99,0,75,174,56.9,0.0,43.1,2019,12961
142,0,58,200,71.0,0.0,29.0,2019,12969
130,1,15,146,89.04,0.68,10.27,2019,12970
320,12,203,535,59.81,2.24,37.94,2019,12980
704,33,153,890,79.1,3.71,17.19,2019,12912
2573,49,549,3171,81.14,1.55,17.31,2019,14892
396,0,67,463,85.53,0.0,14.47,2019,14894
271,21,22,314,86.31,6.69,7.01,2019,14897
2734,164,477,3375,81.01,4.86,14.13,2019,14903
4935,203,1104,6242,79.06,3.25,17.69,2019,14904
186,0,18,204,91.18,0.0,8.82,2019,14816
1778,96,395,2269,78.36,4.23,17.41,2019,14727
671,24,178,873,76.86,2.75,20.39,2019,14747
1613,108,338,2059,78.34,5.25,16.42,2019,14750
276,0,53,329,83.89,0.0,16.11,2019,14480
2150,128,102,2380,90.34,5.38,4.29,2019,14487
556,0,0,556,100.0,0.0,0.0,2019,14506
173,4,93,270,64.07,1.48,34.44,2019,14536
1130,36,68,1234,91.57,2.92,5.51,2019,14543
303,26,70,399,75.94,6.52,17.54,2019,61729
1418,81,400,1899,74.67,4.27,21.06,2019,61739
108,2,17,127,85.04,1.57,13.39,2019,61466
378,0,87,465,81.29,0.0,18.71,2019,61480
2133,189,359,2681,79.56,7.05,13.39,2019,60162
822,10,55,887,92.67,1.13,6.2,2019,60184
473,6,119,598,79.1,1.0,19.9,2019,60407
1775,94,239,2108,84.2,4.46,11.34,2019,60408
3146,55,270,3471,90.64,1.58,7.78,2019,60442
8411,140,524,9075,92.68,1.54,5.77,2019,60448
4728,73,632,5433,87.02,1.34,11.63,2019,60463
8709,301,706,9716,89.64,3.1,7.27,2019,60467
3446,214,507,4167,82.7,5.14,12.17,2019,60482
3999,58,274,4331,92.33,1.34,6.33,2019,60558
7681,152,691,8524,90.11,1.78,8.11,2019,60560
14081,252,745,15078,93.39,1.67,4.94,2019,60563
18790,1762,466,21018,89.4,8.38,2.22,2019,60611
20380,765,3424,24569,82.95,3.11,13.94,2019,60616
13130,1416,5314,19860,66.11,7.13,26.76,2019,60651
84,28,24,136,61.76,20.59,17.65,2019,62370
153,14,21,188,81.38,7.45,11.17,2019,62432
1751,50,435,2236,78.31,2.24,19.45,2019,62561
478,28,68,574,83.28,4.88,11.85,2019,62440
2024,43,452,2519,80.35,1.71,17.94,2019,62286
449,23,160,632,71.04,3.64,25.32,2019,62366
65,0,65,130,50.0,0.0,50.0,2019,62631
140,8,47,195,71.79,4.1,24.1,2019,62512
566,27,101,694,81.56,3.89,14.55,2019,62531
11,27,6,44,25.0,61.36,13.64,2019,62532
6,0,9,15,40.0,0.0,60.0,2019,62541
65,4,25,94,69.15,4.26,26.6,2019,58317
16,0,4,20,80.0,0.0,20.0,2019,58325
82,3,34,119,68.91,2.52,28.57,2019,58330
17,0,9,26,65.38,0.0,34.62,2019,58338
19,0,7,26,73.08,0.0,26.92,2019,58343
151,8,32,191,79.06,4.19,16.75,2019,58352
113,1,37,151,74.83,0.66,24.5,2019,58377
128,14,48,190,67.37,7.37,25.26,2019,58380
580,41,178,799,72.59,5.13,22.28,2019,58356
167,2,31,200,83.5,1.0,15.5,2019,58416
547,8,185,740,73.92,1.08,25.0,2019,58436
45,12,5,62,72.58,19.35,8.06,2019,58439
105,0,29,134,78.36,0.0,21.64,2019,58441
114,5,26,145,78.62,3.45,17.93,2019,58455
122,9,23,154,79.22,5.84,14.94,2019,58466
45,10,37,92,48.91,10.87,40.22,2019,58475
30,0,30,60,50.0,0.0,50.0,2019,58477
78,12,8,98,79.59,12.24,8.16,2019,58481
169,14,40,223,75.78,6.28,17.94,2019,58487
200,23,23,246,81.3,9.35,9.35,2019,58521
63,4,76,143,44.06,2.8,53.15,2019,58528
347,26,99,472,73.52,5.51,20.97,2019,58533
123,13,34,170,72.35,7.65,20.0,2019,58570
74,2,24,100,74.0,2.0,24.0,2019,58572
85,5,31,121,70.25,4.13,25.62,2019,58642
126,14,25,165,76.36,8.48,15.15,2019,58650
76,12,11,99,76.77,12.12,11.11,2019,58723
104,6,20,130,80.0,4.62,15.38,2019,58734
458,21,116,595,76.97,3.53,19.5,2019,58746
26832,481,6003,33316,80.54,1.44,18.02,2019,11208
18822,545,2526,21893,85.97,2.49,11.54,2019,11210
23257,947,7598,31802,73.13,2.98,23.89,2019,11212
24258,987,6252,31497,77.02,3.13,19.85,2019,11221
4796,164,1745,6705,71.53,2.45,26.03,2019,11239
8882,135,891,9908,89.64,1.36,8.99,2019,11361
11956,383,1131,13470,88.76,2.84,8.4,2019,11364
10478,185,1634,12297,85.21,1.5,13.29,2019,11413
6507,101,748,7356,88.46,1.37,10.17,2019,11429
16788,359,4559,21706,77.34,1.65,21.0,2019,11434
4640,64,706,5410,85.77,1.18,13.05,2019,11436
4625,146,551,5322,86.9,2.74,10.35,2019,11953
4488,109,899,5496,81.66,1.98,16.36,2019,11961
1082,60,173,1315,82.28,4.56,13.16,2019,11978
9176,169,674,10019,91.59,1.69,6.73,2019,11572
12340,222,1697,14259,86.54,1.56,11.9,2019,11520
13437,1011,2202,16650,80.7,6.07,13.23,2019,11550
14063,286,1311,15660,89.8,1.83,8.37,2019,11561
5707,197,1402,7306,78.11,2.7,19.19,2019,11692
1890,106,559,2555,73.97,4.15,21.88,2019,11096
11133,262,1550,12945,86.0,2.02,11.97,2019,11102
9651,186,1715,11552,83.54,1.61,14.85,2019,11104
25895,1431,6293,33619,77.02,4.26,18.72,2019,11207
19784,711,5009,25504,77.57,2.79,19.64,2019,11213
20707,569,3595,24871,83.26,2.29,14.45,2019,11216
19115,530,4491,24136,79.2,2.2,18.61,2019,11225
7198,312,1250,8760,82.17,3.56,14.27,2019,11232
21492,718,2850,25060,85.76,2.87,11.37,2019,11238
11057,281,1691,13029,84.86,2.16,12.98,2019,11358
13702,206,1797,15705,87.25,1.31,11.44,2019,11365
240,0,10,250,96.0,0.0,4.0,2019,11547
11100,251,953,12304,90.21,2.04,7.75,2019,11554
1599,18,323,1940,82.42,0.93,16.65,2019,13605
332,5,58,395,84.05,1.27,14.68,2019,13325
286,15,26,327,87.46,4.59,7.95,2019,13337
691,42,132,865,79.88,4.86,15.26,2019,13409
93,11,41,145,64.14,7.59,28.28,2019,13437
21,0,7,28,75.0,0.0,25.0,2019,13450
1058,46,133,1237,85.53,3.72,10.75,2019,13461
219,3,46,268,81.72,1.12,17.16,2019,13473
1149,18,215,1382,83.14,1.3,15.56,2019,13033
421,26,124,571,73.73,4.55,21.72,2019,13052
629,25,85,739,85.12,3.38,11.5,2019,13063
10744,750,690,12184,88.18,6.16,5.66,2019,13090
343,14,58,415,82.65,3.37,13.98,2019,13122
1194,13,132,1339,89.17,0.97,9.86,2019,13132
789,13,241,1043,75.65,1.25,23.11,2019,13143
4385,296,771,5452,80.43,5.43,14.14,2019,13209
1890,92,392,2374,79.61,3.88,16.51,2019,13211
255,0,20,275,92.73,0.0,7.27,2019,13319
601,29,171,801,75.03,3.62,21.35,2019,13320
2485,97,539,3121,79.62,3.11,17.27,2019,13340
5,4,0,9,55.56,44.44,0.0,2019,13353
1823,62,298,2183,83.51,2.84,13.65,2019,14530
448,18,163,629,71.22,2.86,25.91,2019,14550
2932,101,1175,4208,69.68,2.4,27.92,2019,14605
3514,263,1452,5229,67.2,5.03,27.77,2019,14613
4011,126,246,4383,91.51,2.87,5.61,2019,14625
1097,34,185,1316,83.36,2.58,14.06,2019,14712
111,8,95,214,51.87,3.74,44.39,2019,14714
1109,79,324,1512,73.35,5.22,21.43,2019,14733
1208,35,230,1473,82.01,2.38,15.61,2019,14738
366,29,39,434,84.33,6.68,8.99,2019,14744
1114,62,434,1610,69.19,3.85,26.96,2019,14772
314,20,56,390,80.51,5.13,14.36,2019,14784
711,6,184,901,78.91,0.67,20.42,2019,14809
287,2,126,415,69.16,0.48,30.36,2019,14822
588,0,124,712,82.58,0.0,17.42,2019,14040
364,39,131,534,68.16,7.3,24.53,2019,14066
7125,547,1476,9148,77.89,5.98,16.13,2019,14213
510,29,154,693,73.59,4.18,22.22,2019,14167
660,15,93,768,85.94,1.95,12.11,2019,14171
2792,195,1191,4178,66.83,4.67,28.51,2019,14208
3006,231,1380,4617,65.11,5.0,29.89,2019,14212
6413,267,1248,7928,80.89,3.37,15.74,2019,14214
8780,172,846,9798,89.61,1.76,8.63,2019,14223
8060,214,1927,10201,79.01,2.1,18.89,2019,14227
1491,168,844,2503,59.57,6.71,33.72,2019,14303
5577,249,1329,7155,77.95,3.48,18.57,2019,14305
1193,11,219,1423,83.84,0.77,15.39,2019,14416
2533,73,248,2854,88.75,2.56,8.69,2019,14428
165,6,14,185,89.19,3.24,7.57,2019,14462
3568,94,369,4031,88.51,2.33,9.15,2019,14467
153,0,10,163,93.87,0.0,6.13,2019,14475
519,28,38,585,88.72,4.79,6.5,2019,14477
1588,44,401,2033,78.11,2.16,19.72,2019,14505
4310,89,599,4998,86.23,1.78,11.98,2019,14519
1615,57,367,2039,79.21,2.8,18.0,2019,14551
1029,22,99,1150,89.48,1.91,8.61,2019,14561
2421,103,464,2988,81.02,3.45,15.53,2019,14589
516,16,84,616,83.77,2.6,13.64,2019,14591
3619,156,1360,5135,70.48,3.04,26.48,2019,14608
8889,362,3262,12513,71.04,2.89,26.07,2019,14621
7279,407,984,8670,83.96,4.69,11.35,2019,14623
12852,181,1270,14303,89.86,1.27,8.88,2019,14624
10552,398,1787,12737,82.85,3.12,14.03,2019,14626
68,0,7,75,90.67,0.0,9.33,2019,14721
328,12,74,414,79.23,2.9,17.87,2019,14723
237,0,107,344,68.9,0.0,31.1,2019,16402
10414,338,2678,13430,77.54,2.52,19.94,2019,16601
278,1,57,336,82.74,0.3,16.96,2019,16636
147,5,51,203,72.41,2.46,25.12,2019,16750
6,0,12,18,33.33,0.0,66.67,2019,16871
15146,1599,1294,18039,83.96,8.86,7.17,2019,16801
256,5,41,302,84.77,1.66,13.58,2019,16029
96,3,18,117,82.05,2.56,15.38,2019,16030
2307,36,270,2613,88.29,1.38,10.33,2019,16033
349,7,69,425,82.12,1.65,16.24,2019,16045
940,10,158,1108,84.84,0.9,14.26,2019,16116
6061,300,1155,7516,80.64,3.99,15.37,2019,16117
1671,43,491,2205,75.78,1.95,22.27,2019,16121
554,18,231,803,68.99,2.24,28.77,2019,16124
1391,16,172,1579,88.09,1.01,10.89,2019,14548
2195,13,58,2266,96.87,0.57,2.56,2019,14568
471,10,84,565,83.36,1.77,14.87,2019,14571
8193,482,889,9564,85.66,5.04,9.3,2019,14607
8973,770,1431,11174,80.3,6.89,12.81,2019,14620
835,61,219,1115,74.89,5.47,19.64,2019,14715
793,22,307,1122,70.68,1.96,27.36,2019,14735
530,33,209,772,68.65,4.27,27.07,2019,14741
213,24,50,287,74.22,8.36,17.42,2019,14754
64,0,40,104,61.54,0.0,38.46,2019,14783
195,0,37,232,84.05,0.0,15.95,2019,14808
812,35,360,1207,67.27,2.9,29.83,2019,14755
1665,70,397,2132,78.1,3.28,18.62,2019,14787
1520,57,431,2008,75.7,2.84,21.46,2019,14801
153,31,79,263,58.17,11.79,30.04,2019,14824
228,6,83,317,71.92,1.89,26.18,2019,14839
1080,17,187,1284,84.11,1.32,14.56,2019,14840
4283,144,769,5196,82.43,2.77,14.8,2019,14843
788,48,237,1073,73.44,4.47,22.09,2019,14847
1893,132,315,2340,80.9,5.64,13.46,2019,14867
1553,85,293,1931,80.42,4.4,15.17,2019,14871
1459,14,148,1621,90.01,0.86,9.13,2019,14882
3872,147,1139,5158,75.07,2.85,22.08,2019,14901
3169,46,491,3706,85.51,1.24,13.25,2019,14905
544,29,247,820,66.34,3.54,30.12,2019,14781
280,3,74,357,78.43,0.84,20.73,2019,14815
642,24,187,853,75.26,2.81,21.92,2019,14879
617,28,101,746,82.71,3.75,13.54,2019,14145
15525,397,1323,17245,90.03,2.3,7.67,2019,14450
19361,725,1739,21825,88.71,3.32,7.97,2019,14580
210,21,29,260,80.77,8.08,11.15,2019,14878
7330,186,475,7991,91.73,2.33,5.94,2019,14051
23,0,7,30,76.67,0.0,23.33,2019,14035
18,7,50,75,24.0,9.33,66.67,2019,14041
93,9,17,119,78.15,7.56,14.29,2019,14061
0,0,0,0,,,,2019,14109
44,0,0,44,100.0,0.0,0.0,2019,14112
191,0,32,223,85.65,0.0,14.35,2019,14126
45,7,15,67,67.16,10.45,22.39,2019,14130
38,0,5,43,88.37,0.0,11.63,2019,14135
6,0,0,6,100.0,0.0,0.0,2019,14168
63,0,0,63,100.0,0.0,0.0,2019,14169
91,0,10,101,90.1,0.0,9.9,2019,14173
4,0,0,4,100.0,0.0,0.0,2019,14261
0,0,30,30,0.0,0.0,100.0,2019,14302
1026,72,311,1409,72.82,5.11,22.07,2019,16858
139,3,119,261,53.26,1.15,45.59,2019,16863
268,14,67,349,76.79,4.01,19.2,2019,16926
1901,49,405,2355,80.72,2.08,17.2,2019,16915
434,16,116,566,76.68,2.83,20.49,2019,16923
1089,18,192,1299,83.83,1.39,14.78,2019,16925
385,31,106,522,73.75,5.94,20.31,2019,16928
212,61,58,331,64.05,18.43,17.52,2019,16932
422,3,81,506,83.4,0.59,16.01,2019,16935
20,0,4,24,83.33,0.0,16.67,2019,16941
1423,19,316,1758,80.94,1.08,17.97,2019,16947
1483,52,382,1917,77.36,2.71,19.93,2019,16630
951,37,231,1219,78.01,3.04,18.95,2019,16666
1299,25,275,1599,81.24,1.56,17.2,2019,17062
53,0,5,58,91.38,0.0,8.62,2019,58755
137,10,32,179,76.54,5.59,17.88,2019,58757
57,10,21,88,64.77,11.36,23.86,2019,58772
142,2,46,190,74.74,1.05,24.21,2019,58779
8723,284,1312,10319,84.53,2.75,12.71,2019,73069
119,10,60,189,62.96,5.29,31.75,2019,73079
2221,236,776,3233,68.7,7.3,24.0,2019,73086
223,14,105,342,65.2,4.09,30.7,2019,73092
57,0,0,57,100.0,0.0,0.0,2019,73097
4130,75,282,4487,92.04,1.67,6.28,2019,73116
4666,181,1514,6361,73.35,2.85,23.8,2019,73129
6750,99,1083,7932,85.1,1.25,13.65,2019,73130
1610,38,167,1815,88.71,2.09,9.2,2019,73150
1052,11,34,1097,95.9,1.0,3.1,2019,73173
1769,20,126,1915,92.38,1.04,6.58,2019,73179
247,19,96,362,68.23,5.25,26.52,2019,73459
15910,519,1942,18371,86.6,2.83,10.57,2019,73505
166,6,2,174,95.4,3.45,1.15,2019,73540
1200,54,357,1611,74.49,3.35,22.16,2019,73542
281,12,133,426,65.96,2.82,31.22,2019,73546
120,3,74,197,60.91,1.52,37.56,2019,73548
20,0,2,22,90.91,0.0,9.09,2019,73553
223,18,42,283,78.8,6.36,14.84,2019,73560
190,5,22,217,87.56,2.3,10.14,2019,73562
269,8,127,404,66.58,1.98,31.44,2019,73568
430,12,93,535,80.37,2.24,17.38,2019,73628
992,77,302,1371,72.36,5.62,22.03,2019,73632
108,6,76,190,56.84,3.16,40.0,2019,73646
2840,88,807,3735,76.04,2.36,21.61,2019,73055
3236,38,315,3589,90.16,1.06,8.78,2019,73078
10,0,4,14,71.43,0.0,28.57,2019,73946
12415,178,430,13023,95.33,1.37,3.3,2019,73012
0,0,0,0,,,,2019,73019
3857,23,178,4058,95.05,0.57,4.39,2019,73025
0,0,0,0,,,,2019,73705
122,6,50,178,68.54,3.37,28.09,2019,73841
818,0,88,906,90.29,0.0,9.71,2019,74041
1589,74,801,2464,64.49,3.0,32.51,2019,74048
68,0,47,115,59.13,0.0,40.87,2019,74050
268,9,132,409,65.53,2.2,32.27,2019,74052
195,32,76,303,64.36,10.56,25.08,2019,74054
50,0,15,65,76.92,0.0,23.08,2019,74071
281,18,233,532,52.82,3.38,43.8,2019,74723
57,3,44,104,54.81,2.88,42.31,2019,74724
853,53,286,1192,71.56,4.45,23.99,2019,74733
545,11,378,934,58.35,1.18,40.47,2019,74740
2254,134,934,3322,67.85,4.03,28.12,2019,74743
17,0,8,25,68.0,0.0,32.0,2019,74755
6377,519,1586,8482,75.18,6.12,18.7,2019,74801
8409,259,3146,11814,71.18,2.19,26.63,2019,74820
178,27,100,305,58.36,8.85,32.79,2019,74856
2733,181,635,3549,77.01,5.1,17.89,2019,74857
1229,195,778,2202,55.81,8.86,35.33,2019,74884
551,6,194,751,73.37,0.8,25.83,2019,74901
622,35,283,940,66.17,3.72,30.11,2019,74941
3041,49,1285,4375,69.51,1.12,29.37,2019,74948
3377,76,1000,4453,75.84,1.71,22.46,2019,74953
4279,269,1287,5835,73.33,4.61,22.06,2019,74955
1232,23,200,1455,84.67,1.58,13.75,2019,13354
1560,18,205,1783,87.49,1.01,11.5,2019,13403
227,13,73,313,72.52,4.15,23.32,2019,13406
650,38,168,856,75.93,4.44,19.63,2019,13416
1107,21,349,1477,74.95,1.42,23.63,2019,13439
12062,431,1418,13911,86.71,3.1,10.19,2019,13027
1198,39,198,1435,83.48,2.72,13.8,2019,13030
5303,259,541,6103,86.89,4.24,8.86,2019,13031
7779,1035,1681,10495,74.12,9.86,16.02,2019,13045
16,0,0,16,100.0,0.0,0.0,2019,13062
800,10,87,897,89.19,1.11,9.7,2019,13076
717,53,266,1036,69.21,5.12,25.68,2019,13092
5473,181,447,6101,89.71,2.97,7.33,2019,13104
33,0,3,36,91.67,0.0,8.33,2019,13124
472,16,74,562,83.99,2.85,13.17,2019,13144
325,19,82,426,76.29,4.46,19.25,2019,13147
2955,90,366,3411,86.63,2.64,10.73,2019,13152
419,46,146,611,68.58,7.53,23.9,2019,13158
1796,30,266,2092,85.85,1.43,12.72,2019,13159
3403,155,743,4301,79.12,3.6,17.28,2019,13165
4699,465,1945,7109,66.1,6.54,27.36,2019,13203
4686,234,512,5432,86.27,4.31,9.43,2019,13215
46,0,7,53,86.79,0.0,13.21,2019,13301
238,0,0,238,100.0,0.0,0.0,2019,13310
1974,174,567,2715,72.71,6.41,20.88,2019,13316
456,18,62,536,85.07,3.36,11.57,2019,13318
66,0,0,66,100.0,0.0,0.0,2019,13331
808,38,195,1041,77.62,3.65,18.73,2019,13332
417,7,75,499,83.57,1.4,15.03,2019,13335
624,6,102,732,85.25,0.82,13.93,2019,13343
3440,143,569,4152,82.85,3.44,13.7,2019,13350
28,1,0,29,96.55,3.45,0.0,2019,13360
1105,52,207,1364,81.01,3.81,15.18,2019,13491
5,0,0,5,100.0,0.0,0.0,2019,13475
326,25,44,395,82.53,6.33,11.14,2019,13486
544,0,110,654,83.18,0.0,16.82,2019,13490
727,22,98,847,85.83,2.6,11.57,2019,13495
927,8,184,1119,82.84,0.71,16.44,2019,13613
602,7,86,695,86.62,1.01,12.37,2019,15360
2987,17,78,3082,96.92,0.55,2.53,2019,15367
3951,100,842,4893,80.75,2.04,17.21,2019,15370
1170,83,352,1605,72.9,5.17,21.93,2019,15419
662,15,125,802,82.54,1.87,15.59,2019,15423
575,27,300,902,63.75,2.99,33.26,2019,15424
334,4,121,459,72.77,0.87,26.36,2019,15427
126,43,0,169,74.56,25.44,0.0,2019,15429
138,0,14,152,90.79,0.0,9.21,2019,15430
852,11,117,980,86.94,1.12,11.94,2019,15469
1909,47,489,2445,78.08,1.92,20.0,2019,15478
4901,172,478,5551,88.29,3.1,8.61,2019,15243
16630,453,3381,20464,81.26,2.21,16.52,2019,15301
1171,26,296,1493,78.43,1.74,19.83,2019,15312
39,0,13,52,75.0,0.0,25.0,2019,16151
731,40,260,1031,70.9,3.88,25.22,2019,16154
1590,19,536,2145,74.13,0.89,24.99,2019,16159
73,15,15,103,70.87,14.56,14.56,2019,16236
64,4,36,104,61.54,3.85,34.62,2019,16861
2668,130,849,3647,73.16,3.56,23.28,2019,16866
680,3,98,781,87.07,0.38,12.55,2019,16877
534,7,199,740,72.16,0.95,26.89,2019,16878
396,12,69,477,83.02,2.52,14.47,2019,16917
167,0,36,203,82.27,0.0,17.73,2019,16927
543,40,190,773,70.25,5.17,24.58,2019,16028
637,16,73,726,87.74,2.2,10.06,2019,16034
1632,55,154,1841,88.65,2.99,8.37,2019,16037
446,27,76,549,81.24,4.92,13.84,2019,16050
1870,52,403,2325,80.43,2.24,17.33,2019,16102
509,7,134,650,78.31,1.08,20.62,2019,16112
5388,146,1341,6875,78.37,2.12,19.51,2019,16125
4636,127,626,5389,86.03,2.36,11.62,2019,16127
3455,133,773,4361,79.22,3.05,17.73,2019,16137
496,15,161,672,73.81,2.23,23.96,2019,16141
870,0,192,1062,81.92,0.0,18.08,2019,16143
14,6,26,46,30.43,13.04,56.52,2019,16155
294,4,82,380,77.37,1.05,21.58,2019,16160
326,12,70,408,79.9,2.94,17.16,2019,16218
355,104,114,573,61.95,18.15,19.9,2019,16239
945,26,269,1240,76.21,2.1,21.69,2019,16248
687,20,156,863,79.61,2.32,18.08,2019,16249
127,12,48,187,67.91,6.42,25.67,2019,16250
186,2,308,496,37.5,0.4,62.1,2019,16256
70,0,46,116,60.34,0.0,39.66,2019,16263
177,2,34,213,83.1,0.94,15.96,2019,16311
9,0,22,31,29.03,0.0,70.97,2019,16321
100,14,37,151,66.23,9.27,24.5,2019,16326
81,0,8,89,91.01,0.0,8.99,2019,16940
56,0,54,110,50.91,0.0,49.09,2019,16860
9,0,5,14,64.29,0.0,35.71,2019,16638
188,11,77,276,68.12,3.99,27.9,2019,16692
5208,295,1326,6829,76.26,4.32,19.42,2019,16323
306,7,70,383,79.9,1.83,18.28,2019,16440
418,7,172,597,70.02,1.17,28.81,2019,16655
512,10,182,704,72.73,1.42,25.85,2019,16838
729,48,245,1022,71.33,4.7,23.97,2019,16881
216,15,60,291,74.23,5.15,20.62,2019,16938
1528,22,293,1843,82.91,1.19,15.9,2019,16828
367,12,107,486,75.51,2.47,22.02,2019,16656
14547,369,1810,16726,86.97,2.21,10.82,2019,07712
2247,11,97,2355,95.41,0.47,4.12,2019,07718
3086,58,138,3282,94.03,1.77,4.2,2019,07722
5328,139,364,5831,91.37,2.38,6.24,2019,07733
3743,103,1015,4861,77.0,2.12,20.88,2019,07734
5518,157,199,5874,93.94,2.67,3.39,2019,07746
2176,4,158,2338,93.07,0.17,6.76,2019,07830
10337,290,1127,11754,87.94,2.47,9.59,2019,07840
26,0,3,29,89.66,0.0,10.34,2019,07851
8212,267,1089,9568,85.83,2.79,11.38,2019,07860
2743,44,240,3027,90.62,1.45,7.93,2019,07930
131,0,10,141,92.91,0.0,7.09,2019,07935
1084,6,20,1110,97.66,0.54,1.8,2019,07946
222,4,5,231,96.1,1.73,2.16,2019,07977
2910,7,167,3084,94.36,0.23,5.42,2019,08530
1624,24,149,1797,90.37,1.34,8.29,2019,08551
10194,359,1035,11588,87.97,3.1,8.93,2019,08648
221,0,31,252,87.7,0.0,12.3,2019,08720
6592,139,651,7382,89.3,1.88,8.82,2019,08721
1737,43,246,2026,85.74,2.12,12.14,2019,08735
4629,30,245,4904,94.39,0.61,5.0,2019,08736
1240,5,50,1295,95.75,0.39,3.86,2019,08750
20885,449,1927,23261,89.79,1.93,8.28,2019,08753
8386,489,1398,10273,81.63,4.76,13.61,2019,08755
2976,121,440,3537,84.14,3.42,12.44,2019,08758
30,0,15,45,66.67,0.0,33.33,2019,08038
45,0,0,45,100.0,0.0,0.0,2019,08039
48,0,19,67,71.64,0.0,28.36,2019,08042
8774,132,1029,9935,88.31,1.33,10.36,2019,08050
16268,270,1086,17624,92.31,1.53,6.16,2019,08053
907,14,25,946,95.88,1.48,2.64,2019,08061
0,0,0,0,,,,2019,08074
15230,384,1177,16791,90.7,2.29,7.01,2019,08081
2299,30,222,2551,90.12,1.18,8.7,2019,08084
2650,137,371,3158,83.91,4.34,11.75,2019,08086
1366,84,507,1957,69.8,4.29,25.91,2019,08091
12683,345,1631,14659,86.52,2.35,11.13,2019,08094
174,0,0,174,100.0,0.0,0.0,2019,08314
76,6,17,99,76.77,6.06,17.17,2019,08316
54,0,8,62,87.1,0.0,12.9,2019,08348
148,0,16,164,90.24,0.0,9.76,2019,08352
7975,85,896,8956,89.05,0.95,10.0,2019,08002
10212,202,456,10870,93.95,1.86,4.2,2019,08003
1711,78,331,2120,80.71,3.68,15.61,2019,08007
173,0,14,187,92.51,0.0,7.49,2019,08014
6164,113,884,7161,86.08,1.58,12.34,2019,08015
14655,343,3318,18316,80.01,1.87,18.12,2019,08021
4214,182,857,5253,80.22,3.46,16.31,2019,08226
2916,218,1592,4726,61.7,4.61,33.69,2019,08103
2825,34,410,3269,86.42,1.04,12.54,2019,08098
1754,101,560,2415,72.63,4.18,23.19,2019,08102
1810,44,231,2085,86.81,2.11,11.08,2019,08230
12340,419,1155,13914,88.69,3.01,8.3,2019,08234
1132,16,126,1274,88.85,1.26,9.89,2019,08242
438,15,45,498,87.95,3.01,9.04,2019,08247
399,13,165,577,69.15,2.25,28.6,2019,08310
501,5,141,647,77.43,0.77,21.79,2019,08311
382,2,141,525,72.76,0.38,26.86,2019,08317
3344,9,335,3688,90.67,0.24,9.08,2019,08322
450,35,42,527,85.39,6.64,7.97,2019,12941
34,0,0,34,100.0,0.0,0.0,2019,12115
211,0,23,234,90.17,0.0,9.83,2019,12187
9595,414,700,10709,89.6,3.87,6.54,2019,12309
390,0,123,513,76.02,0.0,23.98,2019,12515
392,0,87,479,81.84,0.0,18.16,2019,12726
2865,130,193,3188,89.87,4.08,6.05,2019,12033
5578,51,274,5903,94.49,0.86,4.64,2019,12019
228,3,67,298,76.51,1.01,22.48,2019,12022
2280,108,510,2898,78.67,3.73,17.6,2019,12043
575,18,44,637,90.27,2.83,6.91,2019,12060
16516,288,850,17654,93.55,1.63,4.81,2019,12065
1147,24,244,1415,81.06,1.7,17.24,2019,12083
567,20,166,753,75.3,2.66,22.05,2019,12116
1918,66,695,2679,71.59,2.46,25.94,2019,74959
2218,224,2158,4600,48.22,4.87,46.91,2019,74960
1525,50,706,2281,66.86,2.19,30.95,2019,74523
1034,20,329,1383,74.77,1.45,23.79,2019,74547
386,12,122,520,74.23,2.31,23.46,2019,74553
7305,173,1558,9036,80.84,1.91,17.24,2019,78624
9728,252,423,10403,93.51,2.42,4.07,2019,78634
709,47,186,942,75.27,4.99,19.75,2019,78659
3219,147,446,3812,84.44,3.86,11.7,2019,78642
9514,290,1325,11129,85.49,2.61,11.91,2019,78626
286,10,98,394,72.59,2.54,24.87,2019,78632
1315,45,170,1530,85.95,2.94,11.11,2019,78636
1884,41,376,2301,81.88,1.78,16.34,2019,78643
1697,119,322,2138,79.37,5.57,15.06,2019,78652
16636,203,609,17448,95.35,1.16,3.49,2019,78681
7644,253,1816,9713,78.7,2.6,18.7,2019,78702
22659,1424,2673,26756,84.69,5.32,9.99,2019,78745
348,11,99,458,75.98,2.4,21.62,2019,78946
5679,118,592,6389,88.89,1.85,9.27,2019,78374
2331,75,436,2842,82.02,2.64,15.34,2019,78009
131,0,42,173,75.72,0.0,24.28,2019,78066
782,32,825,1639,47.71,1.95,50.34,2019,78595
493,21,97,611,80.69,3.44,15.88,2019,78672
10780,254,565,11599,92.94,2.19,4.87,2019,78109
0,0,0,0,,,,2019,78029
63,0,70,133,47.37,0.0,52.63,2019,78044
0,0,0,0,,,,2019,78060
21,3,35,59,35.59,5.08,59.32,2019,78104
0,0,0,0,,,,2019,78150
75,0,34,109,68.81,0.0,31.19,2019,78162
0,0,0,0,,,,2019,78243
0,0,0,0,,,,2019,78335
434,0,216,650,66.77,0.0,33.23,2019,78341
80,0,21,101,79.21,0.0,20.79,2019,78342
153,19,0,172,88.95,11.05,0.0,2019,78419
114,8,73,195,58.46,4.1,37.44,2019,78535
3077,121,443,3641,84.51,3.32,12.17,2019,78063
146,0,0,146,100.0,0.0,0.0,2019,78057
351,0,49,400,87.75,0.0,12.25,2019,78058
975,41,225,1241,78.57,3.3,18.13,2019,78113
118,0,12,130,90.77,0.0,9.23,2019,78122
866,21,100,987,87.74,2.13,10.13,2019,78123
17,0,11,28,60.71,0.0,39.29,2019,78125
157,4,62,223,70.4,1.79,27.8,2019,78141
47,0,0,47,100.0,0.0,0.0,2019,78143
29,0,0,29,100.0,0.0,0.0,2019,78144
3959,85,235,4279,92.52,1.99,5.49,2019,78163
812,35,222,1069,75.96,3.27,20.77,2019,78205
903,245,488,1636,55.2,14.98,29.83,2019,78208
15120,450,2053,17623,85.8,2.55,11.65,2019,78209
14063,775,2572,17410,80.78,4.45,14.77,2019,78216
512,17,115,644,79.5,2.64,17.86,2019,15327
416,3,106,525,79.24,0.57,20.19,2019,15344
5379,191,911,6481,83.0,2.95,14.06,2019,15201
1274,27,84,1385,91.99,1.95,6.06,2019,15636
99,4,92,195,50.77,2.05,47.18,2019,15696
731,48,210,989,73.91,4.85,21.23,2019,15035
2519,83,149,2751,91.57,3.02,5.42,2019,15222
113,0,23,136,83.09,0.0,16.91,2019,15313
56,0,18,74,75.68,0.0,24.32,2019,15712
40,0,29,69,57.97,0.0,42.03,2019,15780
416,19,122,557,74.69,3.41,21.9,2019,15870
13077,385,2865,16327,80.09,2.36,17.55,2019,15068
712,0,156,868,82.03,0.0,17.97,2019,15955
923,9,254,1186,77.82,0.76,21.42,2019,15956
5491,58,990,6539,83.97,0.89,15.14,2019,15009
683,9,204,896,76.23,1.0,22.77,2019,15034
422,13,89,524,80.53,2.48,16.98,2019,15049
1112,44,178,1334,83.36,3.3,13.34,2019,15052
28,0,69,97,28.87,0.0,71.13,2019,15422
1273,26,484,1783,71.4,1.46,27.15,2019,15431
136,1,79,216,62.96,0.46,36.57,2019,15432
80,0,29,109,73.39,0.0,26.61,2019,15434
695,14,189,898,77.39,1.56,21.05,2019,15438
52,0,27,79,65.82,0.0,34.18,2019,15440
1144,75,143,1362,83.99,5.51,10.5,2019,15026
443,18,130,591,74.96,3.05,22.0,2019,15055
5442,72,595,6109,89.08,1.18,9.74,2019,15116
4963,91,801,5855,84.77,1.55,13.68,2019,15229
879,29,204,1112,79.05,2.61,18.35,2019,15774
929,25,290,1244,74.68,2.01,23.31,2019,15944
115,50,0,165,69.7,30.3,0.0,2019,15007
1101,46,211,1358,81.08,3.39,15.54,2019,15014
3219,123,957,4299,74.88,2.86,22.26,2019,15022
182,0,63,245,74.29,0.0,25.71,2019,15051
97,6,20,123,78.86,4.88,16.26,2019,15054
431,20,100,551,78.22,3.63,18.15,2019,15056
4241,45,1248,5534,76.64,0.81,22.55,2019,15066
0,0,11,11,0.0,0.0,100.0,2019,15072
41,29,9,79,51.9,36.71,11.39,2019,15075
3844,178,740,4762,80.72,3.74,15.54,2019,15084
2621,58,546,3225,81.27,1.8,16.93,2019,15085
9091,314,831,10236,88.81,3.07,8.12,2019,15101
15044,343,1456,16843,89.32,2.04,8.64,2019,15108
2693,49,398,3140,85.76,1.56,12.68,2019,15139
515,0,35,550,93.64,0.0,6.36,2019,15142
16728,290,2062,19080,87.67,1.52,10.81,2019,07601
3077,38,396,3511,87.64,1.08,11.28,2019,07607
2639,56,117,2812,93.85,1.99,4.16,2019,07626
1746,55,42,1843,94.74,2.98,2.28,2019,07632
2951,61,247,3259,90.55,1.87,7.58,2019,07656
3328,33,466,3827,86.96,0.86,12.18,2019,07657
3618,9,240,3867,93.56,0.23,6.21,2019,07661
8871,183,896,9950,89.16,1.84,9.01,2019,07701
1937,20,281,2238,86.55,0.89,12.56,2019,07757
16703,311,1563,18577,89.91,1.67,8.41,2019,07003
2394,46,181,2621,91.34,1.76,6.91,2019,07004
5044,59,386,5489,91.89,1.07,7.03,2019,07005
4135,81,314,4530,91.28,1.79,6.93,2019,07009
7219,117,609,7945,90.86,1.47,7.67,2019,07040
3167,49,342,3558,89.01,1.38,9.61,2019,07981
567,43,55,665,85.26,6.47,8.27,2019,07865
3755,24,213,3992,94.06,0.6,5.34,2019,07932
5103,81,405,5589,91.3,1.45,7.25,2019,07940
205,0,0,205,100.0,0.0,0.0,2019,07979
11425,773,2773,14971,76.31,5.16,18.52,2019,07060
3122,252,655,4029,77.49,6.25,16.26,2019,07062
3046,376,566,3988,76.38,9.43,14.19,2019,07063
6232,98,647,6977,89.32,1.4,9.27,2019,07070
2089,22,303,2414,86.54,0.91,12.55,2019,07072
7926,212,609,8747,90.61,2.42,6.96,2019,07076
7086,150,688,7924,89.42,1.89,8.68,2019,07080
9889,639,2569,13097,75.51,4.88,19.62,2019,07202
1326,52,135,1513,87.64,3.44,8.92,2019,07440
3635,37,332,4004,90.78,0.92,8.29,2019,07442
5124,63,325,5512,92.96,1.14,5.9,2019,07446
6497,279,765,7541,86.16,3.7,10.14,2019,07508
5921,156,506,6583,89.94,2.37,7.69,2019,07461
16889,249,1212,18350,92.04,1.36,6.6,2019,07470
3570,126,808,4504,79.26,2.8,17.94,2019,07502
4643,91,1344,6078,76.39,1.5,22.11,2019,07522
8082,91,773,8946,90.34,1.02,8.64,2019,07621
1567,31,82,1680,93.27,1.85,4.88,2019,07627
6380,68,818,7266,87.81,0.94,11.26,2019,07029
1562,70,93,1725,90.55,4.06,5.39,2019,07027
6367,52,482,6901,92.26,0.75,6.98,2019,07081
1720,38,59,1817,94.66,2.09,3.25,2019,07457
2933,107,315,3355,87.42,3.19,9.39,2019,07605
1776,41,335,2152,82.53,1.91,15.57,2019,07720
7155,145,823,8123,88.08,1.79,10.13,2019,07801
2423,37,35,2495,97.11,1.48,1.4,2019,07028
4428,99,421,4948,89.49,2.0,8.51,2019,07204
5478,94,454,6026,90.91,1.56,7.53,2019,07480
3596,167,333,4096,87.79,4.08,8.13,2019,07643
1311,16,107,1434,91.42,1.12,7.46,2019,07702
6224,43,215,6482,96.02,0.66,3.32,2019,07928
827,6,72,905,91.38,0.66,7.96,2019,07980
3704,29,112,3845,96.33,0.75,2.91,2019,07417
3588,82,189,3859,92.98,2.12,4.9,2019,07458
1757,18,47,1822,96.43,0.99,2.58,2019,07704
4207,40,309,4556,92.34,0.88,6.78,2019,07843
1910,129,60,2099,91.0,6.15,2.86,2019,07069
5876,115,642,6633,88.59,1.73,9.68,2019,07086
190,0,15,205,92.68,0.0,7.32,2019,07311
0,0,0,0,,,,2019,07495
988,67,359,1414,69.87,4.74,25.39,2019,12809
5641,28,500,6169,91.44,0.45,8.11,2019,12831
1512,47,80,1639,92.25,2.87,4.88,2019,12833
651,0,200,851,76.5,0.0,23.5,2019,12958
143,16,28,187,76.47,8.56,14.97,2019,12017
696,25,103,824,84.47,3.03,12.5,2019,12023
393,13,63,469,83.8,2.77,13.43,2019,12029
95,0,19,114,83.33,0.0,16.67,2019,12042
173,11,48,232,74.57,4.74,20.69,2019,12045
621,6,130,757,82.03,0.79,17.17,2019,12066
2497,76,121,2694,92.69,2.82,4.49,2019,12077
7607,314,2097,10018,75.93,3.13,20.93,2019,12078
1877,76,175,2128,88.2,3.57,8.22,2019,12084
621,0,105,726,85.54,0.0,14.46,2019,12086
64,3,4,71,90.14,4.23,5.63,2019,14732
85,0,18,103,82.52,0.0,17.48,2019,14742
114,8,38,160,71.25,5.0,23.75,2019,14752
10,18,0,28,35.71,64.29,0.0,2019,14756
14,1,1,16,87.5,6.25,6.25,2019,14774
0,0,0,0,,,,2019,14778
13,0,0,13,100.0,0.0,0.0,2019,14788
100,0,0,100,100.0,0.0,0.0,2019,14827
0,0,0,0,,,,2019,14853
12,0,0,12,100.0,0.0,0.0,2019,14854
106,0,31,137,77.37,0.0,22.63,2019,14856
0,0,0,0,,,,2019,14893
2902,86,144,3132,92.66,2.75,4.6,2019,14032
47,0,0,47,100.0,0.0,0.0,2019,14134
12,0,33,45,26.67,0.0,73.33,2019,15625
209,0,45,254,82.28,0.0,17.72,2019,15628
92,0,0,92,100.0,0.0,0.0,2019,15635
1135,84,366,1585,71.61,5.3,23.09,2019,15531
1795,67,274,2136,84.04,3.14,12.83,2019,15135
834,37,176,1047,79.66,3.53,16.81,2019,15067
280,24,80,384,72.92,6.25,20.83,2019,15076
2843,55,250,3148,90.31,1.75,7.94,2019,15126
4639,123,692,5454,85.06,2.26,12.69,2019,15215
8998,159,1417,10574,85.1,1.5,13.4,2019,15216
10470,225,1222,11917,87.86,1.89,10.25,2019,15217
10960,205,2478,13643,80.33,1.5,18.16,2019,15001
153,0,13,166,92.17,0.0,7.83,2019,15004
456,17,13,486,93.83,3.5,2.67,2019,15015
69,0,17,86,80.23,0.0,19.77,2019,15028
217,0,50,267,81.27,0.0,18.73,2019,15031
65,35,25,125,52.0,28.0,20.0,2019,15038
714,2,76,792,90.15,0.25,9.6,2019,15043
1551,66,416,2033,76.29,3.25,20.46,2019,15045
5236,73,802,6111,85.68,1.19,13.12,2019,15057
4089,123,750,4962,82.41,2.48,15.11,2019,15063
107,0,0,107,100.0,0.0,0.0,2019,15064
133,0,14,147,90.48,0.0,9.52,2019,15444
117,0,46,163,71.78,0.0,28.22,2019,15462
672,0,254,926,72.57,0.0,27.43,2019,15468
144,2,53,199,72.36,1.01,26.63,2019,15483
711,9,247,967,73.53,0.93,25.54,2019,15486
4701,196,1528,6425,73.17,3.05,23.78,2019,15501
2248,104,994,3346,67.18,3.11,29.71,2019,15537
202,5,95,302,66.89,1.66,31.46,2019,15538
54,0,27,81,66.67,0.0,33.33,2019,15540
1059,18,161,1238,85.54,1.45,13.0,2019,16617
224,11,47,282,79.43,3.9,16.67,2019,16621
65,1,12,78,83.33,1.28,15.38,2019,16624
1233,39,321,1593,77.4,2.45,20.15,2019,16625
22,0,10,32,68.75,0.0,31.25,2019,16631
503,10,111,624,80.61,1.6,17.79,2019,16639
709,20,173,902,78.6,2.22,19.18,2019,16646
422,11,109,542,77.86,2.03,20.11,2019,16657
704,26,171,901,78.14,2.89,18.98,2019,16669
361,16,130,507,71.2,3.16,25.64,2019,16720
317,7,56,380,83.42,1.84,14.74,2019,16729
2039,100,491,2630,77.53,3.8,18.67,2019,16735
488,15,105,608,80.26,2.47,17.27,2019,16738
198,7,25,230,86.09,3.04,10.87,2019,16745
5354,278,1040,6672,80.25,4.17,15.59,2019,76111
12439,921,3338,16698,74.49,5.52,19.99,2019,76112
5072,49,465,5586,90.8,0.88,8.32,2019,76118
6401,280,649,7330,87.33,3.82,8.85,2019,76205
2911,62,1116,4089,71.19,1.52,27.29,2019,76230
343,22,114,479,71.61,4.59,23.8,2019,76239
649,8,134,791,82.05,1.01,16.94,2019,76245
356,17,168,541,65.8,3.14,31.05,2019,76432
114,0,0,114,100.0,0.0,0.0,2019,76460
1842,138,1160,3140,58.66,4.39,36.94,2019,76704
670,53,292,1015,66.01,5.22,28.77,2019,76682
3335,178,568,4081,81.72,4.36,13.92,2019,76692
10326,1126,1858,13310,77.58,8.46,13.96,2019,76706
509,0,90,599,84.97,0.0,15.03,2019,61486
366,7,79,452,80.97,1.55,17.48,2019,61490
1998,84,391,2473,80.79,3.4,15.81,2019,61530
180,9,70,259,69.5,3.47,27.03,2019,61545
161,2,61,224,71.88,0.89,27.23,2019,61563
1342,56,135,1533,87.54,3.65,8.81,2019,61568
3201,231,2437,5869,54.54,3.94,41.52,2019,61605
8477,267,1673,10417,81.38,2.56,16.06,2019,61611
11862,470,2807,15139,78.35,3.1,18.54,2019,61701
53,0,6,59,89.83,0.0,10.17,2019,61731
1474,24,125,1623,90.82,1.48,7.7,2019,61745
778,19,140,937,83.03,2.03,14.94,2019,61760
837,50,232,1119,74.8,4.47,20.73,2019,61817
11490,486,1434,13410,85.68,3.62,10.69,2019,61821
129,12,30,171,75.44,7.02,17.54,2019,61830
411,4,112,527,77.99,0.76,21.25,2019,61854
55,0,9,64,85.94,0.0,14.06,2019,61855
173,4,52,229,75.55,1.75,22.71,2019,61862
584,7,41,632,92.41,1.11,6.49,2019,61864
287,4,74,365,78.63,1.1,20.27,2019,61919
191,7,105,303,63.04,2.31,34.65,2019,61928
331,12,86,429,77.16,2.8,20.05,2019,61933
57,1,15,73,78.08,1.37,20.55,2019,61949
2611,89,542,3242,80.54,2.75,16.72,2019,61951
923,5,214,1142,80.82,0.44,18.74,2019,61956
2171,72,182,2425,89.53,2.97,7.51,2019,61088
280,4,48,332,84.34,1.2,14.46,2019,61089
7746,454,2048,10248,75.59,4.43,19.98,2019,61103
12495,463,2589,15547,80.37,2.98,16.65,2019,61201
479,29,77,585,81.88,4.96,13.16,2019,61232
456,13,68,537,84.92,2.42,12.66,2019,61242
3651,153,594,4398,83.02,3.48,13.51,2019,61254
262,2,62,326,80.37,0.61,19.02,2019,61261
350,25,126,501,69.86,4.99,25.15,2019,61239
1886,57,352,2295,82.18,2.48,15.34,2019,61252
347,23,85,455,76.26,5.05,18.68,2019,61259
62,8,11,81,76.54,9.88,13.58,2019,61315
143,7,23,173,82.66,4.05,13.29,2019,61317
4843,84,383,5310,91.21,1.58,7.21,2019,07044
3650,86,147,3883,94.0,2.21,3.79,2019,07045
10254,228,682,11164,91.85,2.04,6.11,2019,07054
2022,0,327,2349,86.08,0.0,13.92,2019,07068
7301,175,1262,8738,83.55,2.0,14.44,2019,07071
16627,314,2153,19094,87.08,1.64,11.28,2019,07083
3518,295,1688,5501,63.95,5.36,30.69,2019,07102
5658,217,3053,8928,63.37,2.43,34.2,2019,07108
10563,320,1306,12189,86.66,2.63,10.71,2019,07109
2218,222,935,3375,65.72,6.58,27.7,2019,07114
10393,191,803,11387,91.27,1.68,7.05,2019,07410
1913,96,223,2232,85.71,4.3,9.99,2019,07416
1513,63,140,1716,88.17,3.67,8.16,2019,07420
767,25,60,852,90.02,2.93,7.04,2019,07435
3770,111,777,4658,80.94,2.38,16.68,2019,07444
3890,25,177,4092,95.06,0.61,4.33,2019,07456
3814,52,358,4224,90.29,1.23,8.48,2019,07604
32,0,8,40,80.0,0.0,20.0,2019,07608
545,0,19,564,96.63,0.0,3.37,2019,07620
1558,0,68,1626,95.82,0.0,4.18,2019,07640
1652,24,325,2001,82.56,1.2,16.24,2019,07662
4490,33,167,4690,95.74,0.7,3.56,2019,07670
52,0,0,52,100.0,0.0,0.0,2019,07703
224,8,47,279,80.29,2.87,16.85,2019,07723
12138,153,501,12792,94.89,1.2,3.92,2019,07731
1298,0,137,1435,90.45,0.0,9.55,2019,07737
2361,20,125,2506,94.21,0.8,4.99,2019,07023
9693,297,1573,11563,83.83,2.57,13.6,2019,07026
23691,209,1282,25182,94.08,0.83,5.09,2019,07030
2393,16,104,2513,95.22,0.64,4.14,2019,07041
8577,249,2856,11682,73.42,2.13,24.45,2019,07050
1786,0,39,1825,97.86,0.0,2.14,2019,07058
4873,79,240,5192,93.86,1.52,4.62,2019,07059
5439,80,413,5932,91.69,1.35,6.96,2019,07066
3116,0,199,3315,94.0,0.0,6.0,2019,07075
4805,61,296,5162,93.08,1.18,5.73,2019,07079
1430,37,112,1579,90.56,2.34,7.09,2019,07082
1044,65,137,1246,83.79,5.22,11.0,2019,07088
2186,93,249,2528,86.47,3.68,9.85,2019,07092
8624,398,2813,11835,72.87,3.36,23.77,2019,07103
7949,630,2996,11575,68.67,5.44,25.88,2019,07106
9143,74,1295,10512,86.98,0.7,12.32,2019,07010
8556,179,1276,10011,85.47,1.79,12.75,2019,07013
8231,375,1771,10377,79.32,3.61,17.07,2019,07018
3221,12,733,3966,81.22,0.3,18.48,2019,07073
4207,93,213,4513,93.22,2.06,4.72,2019,11576
11890,211,1071,13172,90.27,1.6,8.13,2019,11580
3828,23,217,4068,94.1,0.57,5.33,2019,11598
16619,376,1418,18413,90.26,2.04,7.7,2019,11706
13161,324,1049,14534,90.55,2.23,7.22,2019,11757
3897,30,200,4127,94.43,0.73,4.85,2019,11764
19,0,7,26,73.08,0.0,26.92,2019,11770
5122,138,272,5532,92.59,2.49,4.92,2019,11788
7773,117,333,8223,94.53,1.42,4.05,2019,11791
1168,44,87,1299,89.92,3.39,6.7,2019,11796
1565,68,360,1993,78.52,3.41,18.06,2019,11942
101,20,57,178,56.74,11.24,32.02,2019,11947
11182,206,820,12208,91.6,1.69,6.72,2019,11003
6901,225,674,7800,88.47,2.88,8.64,2019,11021
37,9,0,46,80.43,19.57,0.0,2019,12108
1101,84,191,1376,80.01,6.1,13.88,2019,12117
1453,105,425,1983,73.27,5.3,21.43,2019,12122
1999,34,180,2213,90.33,1.54,8.13,2019,12123
1539,99,97,1735,88.7,5.71,5.59,2019,12148
340,0,8,348,97.7,0.0,2.3,2019,12153
322,0,24,346,93.06,0.0,6.94,2019,12156
2375,66,205,2646,89.76,2.49,7.75,2019,12158
670,20,82,772,86.79,2.59,10.62,2019,12173
50,0,12,62,80.65,0.0,19.35,2019,12720
128,0,11,139,92.09,0.0,7.91,2019,12752
206,0,56,262,78.63,0.0,21.37,2019,12763
286,0,8,294,97.28,0.0,2.72,2019,12768
66,0,11,77,85.71,0.0,14.29,2019,12770
95,9,43,147,64.63,6.12,29.25,2019,12808
193,7,70,270,71.48,2.59,25.93,2019,12810
530,0,105,635,83.46,0.0,16.54,2019,12814
83,0,25,108,76.85,0.0,23.15,2019,12819
409,34,12,455,89.89,7.47,2.64,2019,12824
205,12,54,271,75.65,4.43,19.93,2019,12836
155,45,46,246,63.01,18.29,18.7,2019,12843
102,0,12,114,89.47,0.0,10.53,2019,12844
83,0,83,166,50.0,0.0,50.0,2019,12849
215,5,35,255,84.31,1.96,13.73,2019,12857
796,32,90,918,86.71,3.49,9.8,2019,12859
200,3,70,273,73.26,1.1,25.64,2019,12861
298,9,56,363,82.09,2.48,15.43,2019,12873
1580,207,365,2152,73.42,9.62,16.96,2019,12883
10703,703,1851,13257,80.73,5.3,13.96,2019,12901
457,32,132,621,73.59,5.15,21.26,2019,12910
119,7,6,132,90.15,5.3,4.55,2019,12927
634,93,105,832,76.2,11.18,12.62,2019,12928
479,18,152,649,73.81,2.77,23.42,2019,12935
183,4,28,215,85.12,1.86,13.02,2019,12936
414,0,205,619,66.88,0.0,33.12,2019,12959
528,22,131,681,77.53,3.23,19.24,2019,12974
866,12,243,1121,77.25,1.07,21.68,2019,12979
765,3,310,1078,70.96,0.28,28.76,2019,12981
1417,39,283,1739,81.48,2.24,16.27,2019,12992
41,1,16,58,70.69,1.72,27.59,2019,12194
8906,290,1177,10373,85.86,2.8,11.35,2019,12303
1222,6,87,1315,92.93,0.46,6.62,2019,12404
317,0,0,317,100.0,0.0,0.0,2019,12409
2661,118,1304,4083,65.17,2.89,31.94,2019,12414
3708,98,347,4153,89.28,2.36,8.36,2019,12211
319,9,43,371,85.98,2.43,11.59,2019,14859
1888,75,322,2285,82.63,3.28,14.09,2019,14174
167,6,57,230,72.61,2.61,24.78,2019,14113
688,29,148,865,79.54,3.35,17.11,2019,14139
1026,18,167,1211,84.72,1.49,13.79,2019,14170
5734,329,1902,7965,71.99,4.13,23.88,2019,14218
2723,73,260,3056,89.1,2.39,8.51,2019,14414
45,0,32,77,58.44,0.0,41.56,2019,14415
6014,182,1300,7496,80.23,2.43,17.34,2019,14456
933,12,48,993,93.96,1.21,4.83,2019,14471
604,7,124,735,82.18,0.95,16.87,2019,14481
1343,56,204,1603,83.78,3.49,12.73,2019,14485
1684,12,200,1896,88.82,0.63,10.55,2019,14512
3493,47,1128,4668,74.83,1.01,24.16,2019,14527
1562,42,336,1940,80.52,2.16,17.32,2019,17073
2298,102,602,3002,76.55,3.4,20.05,2019,17074
7710,226,983,8919,86.44,2.53,11.02,2019,17078
382,0,16,398,95.98,0.0,4.02,2019,17093
145,2,52,199,72.86,1.01,26.13,2019,17211
12107,394,1251,13752,88.04,2.87,9.1,2019,17011
500,29,174,703,71.12,4.13,24.75,2019,17017
2552,73,615,3240,78.77,2.25,18.98,2019,17032
8583,89,667,9339,91.9,0.95,7.14,2019,17036
796,5,177,978,81.39,0.51,18.1,2019,17040
2367,230,351,2948,80.29,7.8,11.91,2019,17043
8714,434,2454,11602,75.11,3.74,21.15,2019,17046
1340,48,520,1908,70.23,2.52,27.25,2019,17051
1810,37,329,2176,83.18,1.7,15.12,2019,17053
13953,386,1608,15947,87.5,2.42,10.08,2019,17055
290,9,69,368,78.8,2.45,18.75,2019,17855
5855,199,1531,7585,77.19,2.62,20.18,2019,17821
56,0,23,79,70.89,0.0,29.11,2019,17836
238,0,50,288,82.64,0.0,17.36,2019,17840
940,40,167,1147,81.95,3.49,14.56,2019,17859
3203,53,1192,4448,72.01,1.19,26.8,2019,17872
73,0,12,85,85.88,0.0,14.12,2019,17885
131,2,42,175,74.86,1.14,24.0,2019,17934
221,0,80,301,73.42,0.0,26.58,2019,17941
2393,36,417,2846,84.08,1.26,14.65,2019,17961
808,25,209,1042,77.54,2.4,20.06,2019,17967
87,14,15,116,75.0,12.07,12.93,2019,17974
1770,53,880,2703,65.48,1.96,32.56,2019,17976
850,35,229,1114,76.3,3.14,20.56,2019,17981
479,29,133,641,74.73,4.52,20.75,2019,17052
776,42,450,1268,61.2,3.31,35.49,2019,17063
56,0,8,64,87.5,0.0,12.5,2019,17069
21,0,0,21,100.0,0.0,0.0,2019,17343
2111,10,213,2334,90.45,0.43,9.13,2019,17347
900,7,174,1081,83.26,0.65,16.1,2019,17365
307,0,194,501,61.28,0.0,38.72,2019,17505
5379,426,1529,7334,73.34,5.81,20.85,2019,17512
318,14,145,477,66.67,2.94,30.4,2019,17518
1692,108,138,1938,87.31,5.57,7.12,2019,17520
9760,292,2866,12918,75.55,2.26,22.19,2019,17522
1376,36,266,1678,82.0,2.15,15.85,2019,17752
67,8,11,86,77.91,9.3,12.79,2019,17763
350,10,71,431,81.21,2.32,16.47,2019,17765
1281,47,456,1784,71.8,2.63,25.56,2019,17841
2328,164,1120,3612,64.45,4.54,31.01,2019,17851
64,0,0,64,100.0,0.0,0.0,2019,08528
451,12,63,526,85.74,2.28,11.98,2019,08328
2601,14,352,2967,87.66,0.47,11.86,2019,08312
197,2,32,231,85.28,0.87,13.85,2019,08323
124,0,51,175,70.86,0.0,29.14,2019,08327
490,60,147,697,70.3,8.61,21.09,2019,08349
5546,258,685,6489,85.47,3.98,10.56,2019,08361
3533,36,43,3612,97.81,1.0,1.19,2019,08502
6215,71,594,6880,90.33,1.03,8.63,2019,08505
3763,95,220,4078,92.28,2.33,5.39,2019,08512
1612,101,181,1894,85.11,5.33,9.56,2019,08514
233,0,10,243,95.88,0.0,4.12,2019,08553
275,1,18,294,93.54,0.34,6.12,2019,08555
102,0,0,102,100.0,0.0,0.0,2019,08561
91,2,23,116,78.45,1.72,19.83,2019,61321
52,0,9,61,85.25,0.0,14.75,2019,61324
762,35,162,959,79.46,3.65,16.89,2019,61326
453,21,83,557,81.33,3.77,14.9,2019,61330
10,0,0,10,100.0,0.0,0.0,2019,61331
1615,19,334,1968,82.06,0.97,16.97,2019,61348
3771,61,807,4639,81.29,1.31,17.4,2019,61356
384,5,98,487,78.85,1.03,20.12,2019,61361
514,22,153,689,74.6,3.19,22.21,2019,61369
304,11,95,410,74.15,2.68,23.17,2019,61413
238,21,55,314,75.8,6.69,17.52,2019,61436
267,13,55,335,79.7,3.88,16.42,2019,61437
341,5,64,410,83.17,1.22,15.61,2019,61447
186,3,24,213,87.32,1.41,11.27,2019,61454
5559,249,1378,7186,77.36,3.47,19.18,2019,61455
197,14,106,317,62.15,4.42,33.44,2019,61458
260,9,104,373,69.71,2.41,27.88,2019,61484
160,4,41,205,78.05,1.95,20.0,2019,61485
738,8,131,877,84.15,0.91,14.94,2019,61491
5177,125,1029,6331,81.77,1.97,16.25,2019,61520
346,5,94,445,77.75,1.12,21.12,2019,61014
96,11,20,127,75.59,8.66,15.75,2019,58381
282,9,23,314,89.81,2.87,7.32,2019,58077
63,0,7,70,90.0,0.0,10.0,2019,58238
217,11,74,302,71.85,3.64,24.5,2019,58254
113,7,61,181,62.43,3.87,33.7,2019,58259
527,7,286,820,64.27,0.85,34.88,2019,58270
99,7,29,135,73.33,5.19,21.48,2019,58272
37,0,2,39,94.87,0.0,5.13,2019,58281
133,11,2,146,91.1,7.53,1.37,2019,58018
188,8,36,232,81.03,3.45,15.52,2019,58046
177,2,15,194,91.24,1.03,7.73,2019,58048
41,0,5,46,89.13,0.0,10.87,2019,58058
60,0,19,79,75.95,0.0,24.05,2019,58062
2857,163,692,3712,76.97,4.39,18.64,2019,58072
16239,1360,679,18278,88.84,7.44,3.71,2019,58104
87,0,37,124,70.16,0.0,29.84,2019,58233
148,0,38,186,79.57,0.0,20.43,2019,58235
929,26,198,1153,80.57,2.25,17.17,2019,58249
168,5,30,203,82.76,2.46,14.78,2019,58265
71,2,27,100,71.0,2.0,27.0,2019,58273
254,0,40,294,86.39,0.0,13.61,2019,58275
151,71,9,231,65.37,30.74,3.9,2019,58843
2924,105,244,3273,89.34,3.21,7.45,2019,58854
47,1,4,52,90.38,1.92,7.69,2019,58856
221,42,92,355,62.25,11.83,25.92,2019,58849
451,95,173,719,62.73,13.21,24.06,2019,58852
119,0,26,145,82.07,0.0,17.93,2019,73722
130,3,56,189,68.78,1.59,29.63,2019,73726
79,6,27,112,70.54,5.36,24.11,2019,73733
159,5,53,217,73.27,2.3,24.42,2019,73741
13661,220,1631,15512,88.07,1.42,10.51,2019,11103
25709,317,3326,29352,87.59,1.08,11.33,2019,11209
26111,765,4947,31823,82.05,2.4,15.55,2019,11214
20372,1309,5956,27637,73.71,4.74,21.55,2019,11220
23009,1214,5924,30147,76.32,4.03,19.65,2019,11230
20198,605,6968,27771,72.73,2.18,25.09,2019,11355
25610,1413,4308,31331,81.74,4.51,13.75,2019,11377
10810,254,1637,12701,85.11,2.0,12.89,2019,11378
5469,92,665,6226,87.84,1.48,10.68,2019,11411
6387,65,733,7185,88.89,0.9,10.2,2019,11416
8255,123,1224,9602,85.97,1.28,12.75,2019,11423
9116,96,1074,10286,88.63,0.93,10.44,2019,11570
3962,56,226,4244,93.36,1.32,5.33,2019,11577
12804,234,1263,14301,89.53,1.64,8.83,2019,11590
11338,471,903,12712,89.19,3.71,7.1,2019,11704
2672,94,336,3102,86.14,3.03,10.83,2019,11713
994,55,126,1175,84.6,4.68,10.72,2019,11719
959,0,18,977,98.16,0.0,1.84,2019,11724
8392,121,487,9000,93.24,1.34,5.41,2019,11741
2744,53,184,2981,92.05,1.78,6.17,2019,11752
3766,83,378,4227,89.09,1.96,8.94,2019,11755
5098,69,348,5515,92.44,1.25,6.31,2019,11780
2721,60,316,3097,87.86,1.94,10.2,2019,11797
5355,162,1278,6795,78.81,2.38,18.81,2019,11937
4495,202,240,4937,91.05,4.09,4.86,2019,11949
12011,222,725,12958,92.69,1.71,5.59,2019,11040
13240,217,1768,15225,86.96,1.43,11.61,2019,11105
14510,181,2226,16917,85.77,1.07,13.16,2019,11106
26099,428,4247,30774,84.81,1.39,13.8,2019,11229
27546,691,3506,31743,86.78,2.18,11.04,2019,11234
12457,196,1824,14477,86.05,1.35,12.6,2019,11357
11731,298,2319,14348,81.76,2.08,16.16,2019,11367
7855,240,1560,9655,81.36,2.49,16.16,2019,11369
7079,136,1166,8381,84.46,1.62,13.91,2019,11415
9334,244,1329,10907,85.58,2.24,12.18,2019,11418
10095,180,1274,11549,87.41,1.56,11.03,2019,11421
15768,214,2715,18697,84.33,1.14,14.52,2019,11432
1509,0,66,1575,95.81,0.0,4.19,2019,11715
3303,48,242,3593,91.93,1.34,6.74,2019,11716
2213,55,81,2349,94.21,2.34,3.45,2019,11721
9503,221,339,10063,94.44,2.2,3.37,2019,11731
3059,51,283,3393,90.16,1.5,8.34,2019,11777
6495,126,446,7067,91.91,1.78,6.31,2019,11783
1847,39,14,1900,97.21,2.05,0.74,2019,11786
10973,260,767,12000,91.44,2.17,6.39,2019,11787
638,25,84,747,85.41,3.35,11.24,2019,13618
171,5,53,229,74.67,2.18,23.14,2019,13621
776,47,129,952,81.51,4.94,13.55,2019,13622
1395,20,92,1507,92.57,1.33,6.1,2019,13634
521,25,81,627,83.09,3.99,12.92,2019,13650
518,11,62,591,87.65,1.86,10.49,2019,13694
1705,41,327,2073,82.25,1.98,15.77,2019,13733
1277,30,72,1379,92.6,2.18,5.22,2019,13743
15618,400,2735,18753,83.28,2.13,14.58,2019,13760
608,26,131,765,79.48,3.4,17.12,2019,13775
1098,84,292,1474,74.49,5.7,19.81,2019,13803
103,0,37,140,73.57,0.0,26.43,2019,13804
502,79,103,684,73.39,11.55,15.06,2019,13809
409,22,84,515,79.42,4.27,16.31,2019,13810
5216,165,646,6027,86.54,2.74,10.72,2019,14564
1624,129,468,2221,73.12,5.81,21.07,2019,14590
1176,18,325,1519,77.42,1.18,21.4,2019,14823
628,27,129,784,80.1,3.44,16.45,2019,14826
6816,359,1347,8522,79.98,4.21,15.81,2019,14830
700,6,46,752,93.09,0.8,6.12,2019,14033
1919,43,419,2381,80.6,1.81,17.6,2019,14009
716,10,160,886,80.81,1.13,18.06,2019,14012
637,14,92,743,85.73,1.88,12.38,2019,14028
302,20,115,437,69.11,4.58,26.32,2019,14037
94,6,88,188,50.0,3.19,46.81,2019,14060
7675,227,599,8501,90.28,2.67,7.05,2019,14072
15533,324,2814,18671,83.19,1.74,15.07,2019,14120
1198,18,219,1435,83.48,1.25,15.26,2019,14125
15263,416,3139,18818,81.11,2.21,16.68,2019,14150
1040,29,221,1290,80.62,2.25,17.13,2019,14172
452,15,104,571,79.16,2.63,18.21,2019,14889
439,24,163,626,70.13,3.83,26.04,2019,14898
854,11,86,951,89.8,1.16,9.04,2019,14476
698,13,110,821,85.02,1.58,13.4,2019,14427
1837,56,370,2263,81.18,2.47,16.35,2019,14432
1166,55,306,1527,76.36,3.6,20.04,2019,14433
2766,106,534,3406,81.21,3.11,15.68,2019,14482
1671,125,363,2159,77.4,5.79,16.81,2019,14510
713,44,198,955,74.66,4.61,20.73,2019,14516
7365,194,717,8276,88.99,2.34,8.66,2019,14526
11145,114,558,11817,94.31,0.96,4.72,2019,14534
714,22,191,927,77.02,2.37,20.6,2019,14541
596,12,121,729,81.76,1.65,16.6,2019,14544
1889,31,71,1991,94.88,1.56,3.57,2019,14546
12827,424,1755,15006,85.48,2.83,11.7,2019,14612
76,0,0,76,100.0,0.0,0.0,2019,14614
3586,143,490,4219,85.0,3.39,11.61,2019,14004
1307,16,216,1539,84.93,1.04,14.04,2019,14025
1795,26,259,2080,86.3,1.25,12.45,2019,14036
9064,371,1546,10981,82.54,3.38,14.08,2019,14043
804,19,100,923,87.11,2.06,10.83,2019,14422
4398,82,838,5318,82.7,1.54,15.76,2019,14619
4697,51,829,5577,84.22,0.91,14.86,2019,14622
12998,866,3049,16913,76.85,5.12,18.03,2019,14701
589,8,240,837,70.37,0.96,28.67,2019,14724
742,8,301,1051,70.6,0.76,28.64,2019,14775
683,51,174,908,75.22,5.62,19.16,2019,14782
320,0,53,373,85.79,0.0,14.21,2019,14803
3781,111,1235,5127,73.75,2.17,24.09,2019,14810
139,7,0,146,95.21,4.79,0.0,2019,16132
4659,294,1048,6001,77.64,4.9,17.46,2019,16146
2483,70,624,3177,78.16,2.2,19.64,2019,16150
275,8,57,340,80.88,2.35,16.76,2019,16210
40,2,10,52,76.92,3.85,19.23,2019,16213
2479,107,803,3389,73.15,3.16,23.69,2019,16226
1857,57,330,2244,82.75,2.54,14.71,2019,16229
135,7,31,173,78.03,4.05,17.92,2019,16230
1324,48,330,1702,77.79,2.82,19.39,2019,16232
441,8,170,619,71.24,1.29,27.46,2019,16240
100,0,27,127,78.74,0.0,21.26,2019,16244
914,65,203,1182,77.33,5.5,17.17,2019,16262
2069,61,294,2424,85.35,2.52,12.13,2019,16316
499,6,87,592,84.29,1.01,14.7,2019,16319
32,0,3,35,91.43,0.0,8.57,2019,12131
45,10,0,55,81.82,18.18,0.0,2019,12139
610,6,66,682,89.44,0.88,9.68,2019,12059
957,51,253,1261,75.89,4.04,20.06,2019,12183
337,14,158,509,66.21,2.75,31.04,2019,12932
1358,18,106,1482,91.63,1.21,7.15,2019,12027
1555,57,229,1841,84.46,3.1,12.44,2019,12037
1982,26,512,2520,78.65,1.03,20.32,2019,12090
435,21,168,624,69.71,3.37,26.92,2019,12093
931,8,97,1036,89.86,0.77,9.36,2019,12106
291,0,18,309,94.17,0.0,5.83,2019,12136
7906,225,1013,9144,86.46,2.46,11.08,2019,12144
66,0,2,68,97.06,0.0,2.94,2019,12165
664,26,217,907,73.21,2.87,23.93,2019,12168
165,4,28,197,83.76,2.03,14.21,2019,12175
114,6,40,160,71.25,3.75,25.0,2019,12190
60,13,12,85,70.59,15.29,14.12,2019,12407
116,40,36,192,60.42,20.83,18.75,2019,12489
221,12,44,277,79.78,4.33,15.88,2019,12433
76,0,13,89,85.39,0.0,14.61,2019,12435
323,10,9,342,94.44,2.92,2.63,2019,12456
43,12,17,72,59.72,16.67,23.61,2019,12492
196,0,114,310,63.23,0.0,36.77,2019,12494
6364,121,798,7283,87.38,1.66,10.96,2019,12508
1012,38,88,1138,88.93,3.34,7.73,2019,12514
1945,37,316,2298,84.64,1.61,13.75,2019,12518
454,11,195,660,68.79,1.67,29.55,2019,12521
4475,68,626,5169,86.57,1.32,12.11,2019,12528
734,60,147,941,78.0,6.38,15.62,2019,12529
986,42,85,1113,88.59,3.77,7.64,2019,12531
522,22,0,544,95.96,4.04,0.0,2019,12577
267,0,55,322,82.92,0.0,17.08,2019,12585
3465,166,416,4047,85.62,4.1,10.28,2019,12586
258,8,20,286,90.21,2.8,6.99,2019,12732
100,0,162,262,38.17,0.0,61.83,2019,12733
561,35,108,704,79.69,4.97,15.34,2019,12137
78,9,8,95,82.11,9.47,8.42,2019,12164
335,2,147,484,69.21,0.41,30.37,2019,12166
5014,155,844,6013,83.39,2.58,14.04,2019,12182
2295,28,134,2457,93.41,1.14,5.45,2019,12186
6343,588,1372,8303,76.39,7.08,16.52,2019,12189
8781,248,886,9915,88.56,2.5,8.94,2019,12302
85,21,0,106,80.19,19.81,0.0,2019,12420
90,8,45,143,62.94,5.59,31.47,2019,12439
83,0,0,83,100.0,0.0,0.0,2019,12450
33,0,35,68,48.53,0.0,51.47,2019,14479
138,0,14,152,90.79,0.0,9.21,2019,14486
153,0,15,168,91.07,0.0,8.93,2019,14511
36,0,0,36,100.0,0.0,0.0,2019,14529
59,0,0,59,100.0,0.0,0.0,2019,14537
31,7,0,38,81.58,18.42,0.0,2019,14539
29,5,0,34,85.29,14.71,0.0,2019,14542
26,21,4,51,50.98,41.18,7.84,2019,14549
69,0,0,69,100.0,0.0,0.0,2019,14588
27,0,0,27,100.0,0.0,0.0,2019,14592
0,0,0,0,,,,2019,14627
47,0,15,62,75.81,0.0,24.19,2019,14707
189,33,84,306,61.76,10.78,27.45,2019,14720
21,0,0,21,100.0,0.0,0.0,2019,14722
965,73,419,1457,66.23,5.01,28.76,2019,73742
1353,16,568,1937,69.85,0.83,29.32,2019,73460
26,3,39,68,38.24,4.41,57.35,2019,73487
5405,264,1383,7052,76.64,3.74,19.61,2019,73501
6557,367,1109,8033,81.63,4.57,13.81,2019,73521
122,6,52,180,67.78,3.33,28.89,2019,73530
77,0,27,104,74.04,0.0,25.96,2019,73544
467,7,185,659,70.86,1.06,28.07,2019,73547
21,0,4,25,84.0,0.0,16.0,2019,73551
163,4,10,177,92.09,2.26,5.65,2019,73557
1037,50,281,1368,75.8,3.65,20.54,2019,73572
390,15,53,458,85.15,3.28,11.57,2019,73620
449,33,176,658,68.24,5.02,26.75,2019,73768
510,33,152,695,73.38,4.75,21.87,2019,73848
8026,134,849,9009,89.09,1.49,9.42,2019,73003
308,52,166,526,58.56,9.89,31.56,2019,73027
70,0,24,94,74.47,0.0,25.53,2019,73043
6036,176,1650,7862,76.77,2.24,20.99,2019,73044
779,14,135,928,83.94,1.51,14.55,2019,73048
64,1,8,73,87.67,1.37,10.96,2019,73744
183,6,19,208,87.98,2.88,9.13,2019,73749
256,11,109,376,68.09,2.93,28.99,2019,73755
125,6,9,140,89.29,4.29,6.43,2019,73756
450,21,122,593,75.89,3.54,20.57,2019,73759
69,5,22,96,71.88,5.21,22.92,2019,73835
203,20,46,269,75.46,7.43,17.1,2019,73840
18,0,18,36,50.0,0.0,50.0,2019,73855
230,4,76,310,74.19,1.29,24.52,2019,73857
49,0,0,49,100.0,0.0,0.0,2019,73901
459,14,115,588,78.06,2.38,19.56,2019,74860
3089,446,1303,4838,63.85,9.22,26.93,2019,74868
210,7,91,308,68.18,2.27,29.55,2019,74869
351,38,125,514,68.29,7.39,24.32,2019,74878
42,3,14,59,71.19,5.08,23.73,2019,74943
1473,42,302,1817,81.07,2.31,16.62,2019,74954
443,41,212,696,63.65,5.89,30.46,2019,74956
17360,439,1858,19657,88.31,2.23,9.45,2019,74133
7947,325,1187,9459,84.02,3.44,12.55,2019,74135
540,23,159,722,74.79,3.19,22.02,2019,74332
264,7,138,409,64.55,1.71,33.74,2019,74333
1191,71,722,1984,60.03,3.58,36.39,2019,74338
4828,458,1460,6746,71.57,6.79,21.64,2019,74354
163,8,34,205,79.51,3.9,16.59,2019,74367
268,6,84,358,74.86,1.68,23.46,2019,74423
381,42,91,514,74.12,8.17,17.7,2019,74425
282,8,139,429,65.73,1.86,32.4,2019,74875
1135,67,279,1481,76.64,4.52,18.84,2019,74902
134,5,123,262,51.15,1.91,46.95,2019,74939
306,31,197,534,57.3,5.81,36.89,2019,74951
282,16,134,432,65.28,3.7,31.02,2019,74957
152,9,49,210,72.38,4.29,23.33,2019,74430
2691,88,662,3441,78.2,2.56,19.24,2019,74434
2529,103,1259,3891,65.0,2.65,32.36,2019,74437
270,20,85,375,72.0,5.33,22.67,2019,74442
109,0,47,156,69.87,0.0,30.13,2019,74556
169,7,61,237,71.31,2.95,25.74,2019,74560
1344,15,242,1601,83.95,0.94,15.12,2019,13811
2181,118,428,2727,79.98,4.33,15.69,2019,13856
3342,94,451,3887,85.98,2.42,11.6,2019,13904
479,37,168,684,70.03,5.41,24.56,2019,13607
647,0,58,705,91.77,0.0,8.23,2019,13616
1621,13,111,1745,92.89,0.74,6.36,2019,13637
288,0,43,331,87.01,0.0,12.99,2019,13665
392,15,115,522,75.1,2.87,22.03,2019,13680
305,20,56,381,80.05,5.25,14.7,2019,13681
172,0,25,197,87.31,0.0,12.69,2019,13687
621,7,108,736,84.38,0.95,14.67,2019,13734
465,3,56,524,88.74,0.57,10.69,2019,13757
6264,282,1152,7698,81.37,3.66,14.96,2019,13820
157,22,62,241,65.15,9.13,25.73,2019,13832
334,13,107,454,73.57,2.86,23.57,2019,13835
350,35,122,507,69.03,6.9,24.06,2019,13839
205,2,32,239,85.77,0.84,13.39,2019,13740
804,29,288,1121,71.72,2.59,25.69,2019,13783
475,24,134,633,75.04,3.79,21.17,2019,13801
88,8,28,124,70.97,6.45,22.58,2019,13633
685,29,159,873,78.47,3.32,18.21,2019,13646
764,13,119,896,85.27,1.45,13.28,2019,13648
499,9,50,558,89.43,1.61,8.96,2019,13661
673,15,168,856,78.62,1.75,19.63,2019,13736
255,27,70,352,72.44,7.67,19.89,2019,13739
305,9,97,411,74.21,2.19,23.6,2019,13750
1992,68,320,2380,83.7,2.86,13.45,2019,13778
278,6,42,326,85.28,1.84,12.88,2019,13782
1187,74,431,1692,70.15,4.37,25.47,2019,13838
354,20,73,447,79.19,4.47,16.33,2019,13864
2430,30,314,2774,87.6,1.08,11.32,2019,13029
3702,193,743,4638,79.82,4.16,16.02,2019,13032
1919,46,214,2179,88.07,2.11,9.82,2019,13068
1108,34,135,1277,86.77,2.66,10.57,2019,13080
8350,512,1289,10151,82.26,5.04,12.7,2019,13088
585,5,46,636,91.98,0.79,7.23,2019,13112
974,24,45,1043,93.38,2.3,4.31,2019,13606
1309,97,391,1797,72.84,5.4,21.76,2019,13452
118,38,121,277,42.6,13.72,43.68,2019,13470
314,17,115,446,70.4,3.81,25.78,2019,13485
814,13,173,1000,81.4,1.3,17.3,2019,13612
616,5,131,752,81.91,0.66,17.42,2019,13402
350,8,81,439,79.73,1.82,18.45,2019,13420
83,0,0,83,100.0,0.0,0.0,2019,13602
373,10,62,445,83.82,2.25,13.93,2019,13635
7642,137,842,8621,88.64,1.59,9.77,2019,15143
1544,31,354,1929,80.04,1.61,18.35,2019,15144
429,30,174,633,67.77,4.74,27.49,2019,15757
511,17,137,665,76.84,2.56,20.6,2019,15725
413,20,191,624,66.19,3.21,30.61,2019,15732
108,3,66,177,61.02,1.69,37.29,2019,15753
50,0,0,50,100.0,0.0,0.0,2019,15053
6544,214,1763,8521,76.8,2.51,20.69,2019,15120
4821,158,438,5417,89.0,2.92,8.09,2019,15238
49,3,38,90,54.44,3.33,42.22,2019,15770
224,12,99,335,66.87,3.58,29.55,2019,15775
38,0,10,48,79.17,0.0,20.83,2019,15777
3733,178,1258,5169,72.22,3.44,24.34,2019,15902
259,2,58,319,81.19,0.63,18.18,2019,15920
23,3,3,29,79.31,10.34,10.34,2019,16331
99,3,25,127,77.95,2.36,19.69,2019,16334
593,36,106,735,80.68,4.9,14.42,2019,16340
1236,47,213,1496,82.62,3.14,14.24,2019,16345
1198,48,221,1467,81.66,3.27,15.06,2019,16346
606,24,310,940,64.47,2.55,32.98,2019,16350
427,16,79,522,81.8,3.07,15.13,2019,16360
169,0,37,206,82.04,0.0,17.96,2019,16372
1387,56,293,1736,79.9,3.23,16.88,2019,16401
249,22,51,322,77.33,6.83,15.84,2019,16405
50,11,8,69,72.46,15.94,11.59,2019,16416
135,13,6,154,87.66,8.44,3.9,2019,16422
329,19,99,447,73.6,4.25,22.15,2019,16836
2423,29,692,3144,77.07,0.92,22.01,2019,16438
8851,189,1130,10170,87.03,1.86,11.11,2019,16506
5777,150,960,6887,83.88,2.18,13.94,2019,16508
8612,164,1331,10107,85.21,1.62,13.17,2019,16510
4277,58,1012,5347,79.99,1.08,18.93,2019,16635
299,10,47,356,83.99,2.81,13.2,2019,16131
450,10,157,617,72.93,1.62,25.45,2019,16133
271,10,89,370,73.24,2.7,24.05,2019,16136
1483,33,669,2185,67.87,1.51,30.62,2019,16142
928,25,226,1179,78.71,2.12,19.17,2019,16156
5482,219,1599,7300,75.1,3.0,21.9,2019,16201
45,3,49,97,46.39,3.09,50.52,2019,16223
369,4,93,466,79.18,0.86,19.96,2019,16224
145,2,45,192,75.52,1.04,23.44,2019,16228
354,9,149,512,69.14,1.76,29.1,2019,16233
404,11,71,486,83.13,2.26,14.61,2019,16235
75,8,18,101,74.26,7.92,17.82,2019,16246
1104,30,187,1321,83.57,2.27,14.16,2019,16254
646,23,149,818,78.97,2.81,18.22,2019,16258
601,28,183,812,74.01,3.45,22.54,2019,16259
4985,115,1442,6542,76.2,1.76,22.04,2019,16301
436,9,99,544,80.15,1.65,18.2,2019,16317
114,2,26,142,80.28,1.41,18.31,2019,16333
387,3,94,484,79.96,0.62,19.42,2019,16364
52,2,11,65,80.0,3.08,16.92,2019,16427
3211,67,699,3977,80.74,1.68,17.58,2019,16441
935,9,164,1108,84.39,0.81,14.8,2019,16442
3912,203,801,4916,79.58,4.13,16.29,2019,16511
9784,408,2384,12576,77.8,3.24,18.96,2019,16602
58,7,7,72,80.56,9.72,9.72,2019,16622
256,10,46,312,82.05,3.21,14.74,2019,16647
18,23,62,103,17.48,22.33,60.19,2019,16855
3046,21,253,3320,91.75,0.63,7.62,2019,07676
1892,0,71,1963,96.38,0.0,3.62,2019,07677
0,0,0,0,,,,2019,07820
16,0,0,16,100.0,0.0,0.0,2019,07870
60,0,0,60,100.0,0.0,0.0,2019,07880
4,0,0,4,100.0,0.0,0.0,2019,07881
9,0,0,9,100.0,0.0,0.0,2019,07926
43,0,0,43,100.0,0.0,0.0,2019,07939
0,0,0,0,,,,2019,07961
4204,119,913,5236,80.29,2.27,17.44,2019,07022
5805,706,927,7438,78.05,9.49,12.46,2019,07095
9040,348,1735,11123,81.27,3.13,15.6,2019,07208
3705,119,721,4545,81.52,2.62,15.86,2019,08318
51,8,24,83,61.45,9.64,28.92,2019,08321
3191,102,260,3553,89.81,2.87,7.32,2019,74132
1309,61,913,2283,57.34,2.67,39.99,2019,74848
2396,227,607,3230,74.18,7.03,18.79,2019,74851
1308,29,526,1863,70.21,1.56,28.23,2019,74855
353,4,244,601,58.74,0.67,40.6,2019,78389
40,0,39,79,50.63,0.0,49.37,2019,78391
8621,54,957,9632,89.5,0.56,9.94,2019,78410
13998,101,860,14959,93.58,0.68,5.75,2019,78414
16375,878,3936,21189,77.28,4.14,18.58,2019,78501
11888,5170,8266,25324,46.94,20.42,32.64,2019,78521
8253,2402,2742,13397,61.6,17.93,20.47,2019,78526
2936,632,1208,4776,61.47,13.23,25.29,2019,78566
887,40,628,1555,57.04,2.57,40.39,2019,78593
154,0,75,229,67.25,0.0,32.75,2019,78877
10505,617,4456,15578,67.43,3.96,28.6,2019,78840
0,0,21,21,0.0,0.0,100.0,2019,78860
187,36,260,483,38.72,7.45,53.83,2019,78872
397,15,158,570,69.65,2.63,27.72,2019,78933
281,65,31,377,74.54,17.24,8.22,2019,78953
375,46,92,513,73.1,8.97,17.93,2019,78954
70,0,5,75,93.33,0.0,6.67,2019,78021
3034,53,663,3750,80.91,1.41,17.68,2019,78003
393,0,38,431,91.18,0.0,8.82,2019,78004
80,0,16,96,83.33,0.0,16.67,2019,78012
543,8,95,646,84.06,1.24,14.71,2019,78039
7685,557,4447,12689,60.56,4.39,35.05,2019,78043
10213,470,5688,16371,62.38,2.87,34.74,2019,78046
124,0,79,203,61.08,0.0,38.92,2019,78050
494,24,103,621,79.55,3.86,16.59,2019,78055
5157,72,269,5498,93.8,1.31,4.89,2019,78070
0,0,25,25,0.0,0.0,100.0,2019,78851
9787,381,5818,15986,61.22,2.38,36.39,2019,78852
302,93,240,635,47.56,14.65,37.8,2019,78880
119,5,47,171,69.59,2.92,27.49,2019,78883
157,9,48,214,73.36,4.21,22.43,2019,78949
517,33,300,850,60.82,3.88,35.29,2019,78959
12501,424,2568,15493,80.69,2.74,16.58,2019,78744
18164,794,1281,20239,89.75,3.92,6.33,2019,78748
209,23,150,382,54.71,6.02,39.27,2019,78829
134,18,117,269,49.81,6.69,43.49,2019,78830
57,22,31,110,51.82,20.0,28.18,2019,78838
3999,0,340,4339,92.16,0.0,7.84,2019,78756
780,32,312,1124,69.4,2.85,27.76,2019,78140
8288,518,2766,11572,71.62,4.48,23.9,2019,78221
626,12,316,954,65.62,1.26,33.12,2019,78357
7199,183,1504,8886,81.02,2.06,16.93,2019,78570
5460,254,1368,7082,77.1,3.59,19.32,2019,78654
14237,480,2139,16856,84.46,2.85,12.69,2019,78028
1761,58,387,2206,79.83,2.63,17.54,2019,78101
4381,174,2313,6868,63.79,2.53,33.68,2019,78102
1179,27,549,1755,67.18,1.54,31.28,2019,78119
516,11,111,638,80.88,1.72,17.4,2019,78152
13475,183,799,14457,93.21,1.27,5.53,2019,78154
1231,51,285,1567,78.56,3.25,18.19,2019,78160
841,159,486,1486,56.59,10.7,32.71,2019,78164
2915,414,866,4195,69.49,9.87,20.64,2019,78204
7928,523,2333,10784,73.52,4.85,21.63,2019,78212
1585,92,172,1849,85.72,4.98,9.3,2019,78215
10238,902,2509,13649,75.01,6.61,18.38,2019,78217
607,46,164,817,74.3,5.63,20.07,2019,74561
4930,708,1620,7258,67.93,9.75,22.32,2019,74601
1953,122,957,3032,64.41,4.02,31.56,2019,74631
164,12,55,231,71.0,5.19,23.81,2019,74632
107,8,59,174,61.49,4.6,33.91,2019,74644
37,10,13,60,61.67,16.67,21.67,2019,74646
944,42,431,1417,66.62,2.96,30.42,2019,74647
181,11,61,253,71.54,4.35,24.11,2019,74651
1111,79,278,1468,75.68,5.38,18.94,2019,74653
174,13,58,245,71.02,5.31,23.67,2019,74630
124,12,48,184,67.39,6.52,26.09,2019,74643
885,15,257,1157,76.49,1.3,22.21,2019,74445
1111,7,429,1547,71.82,0.45,27.73,2019,74451
290,36,235,561,51.69,6.42,41.89,2019,74471
1104,28,510,1642,67.24,1.71,31.06,2019,74538
39,4,46,89,43.82,4.49,51.69,2019,74540
125,20,112,257,48.64,7.78,43.58,2019,74572
1693,95,619,2407,70.34,3.95,25.72,2019,74578
92,0,23,115,80.0,0.0,20.0,2019,74636
60,3,20,83,72.29,3.61,24.1,2019,74722
255,21,134,410,62.2,5.12,32.68,2019,74736
82,9,50,141,58.16,6.38,35.46,2019,74760
14,1,11,26,53.85,3.85,42.31,2019,74761
170,6,99,275,61.82,2.18,36.0,2019,74833
1956,60,800,2816,69.46,2.13,28.41,2019,74834
88,2,76,166,53.01,1.2,45.78,2019,74844
787,51,392,1230,63.98,4.15,31.87,2019,74849
57,3,46,106,53.77,2.83,43.4,2019,74850
332,11,150,493,67.34,2.23,30.43,2019,74427
2680,173,1313,4166,64.33,4.15,31.52,2019,74432
870,64,511,1445,60.21,4.43,35.36,2019,74764
264,23,125,412,64.08,5.58,30.34,2019,74826
1338,70,384,1792,74.67,3.91,21.43,2019,76821
0,0,9,9,0.0,0.0,100.0,2019,76824
167,7,50,224,74.55,3.12,22.32,2019,76832
75,0,19,94,79.79,0.0,20.21,2019,76842
353,27,150,530,66.6,5.09,28.3,2019,76853
587,49,164,800,73.38,6.12,20.5,2019,76857
34,0,7,41,82.93,0.0,17.07,2019,76873
9224,455,1938,11617,79.4,3.92,16.68,2019,76901
12479,458,1406,14343,87.0,3.19,9.8,2019,76904
3354,258,720,4332,77.42,5.96,16.62,2019,76905
800,26,266,1092,73.26,2.38,24.36,2019,76932
1879,49,200,2128,88.3,2.3,9.4,2019,76559
40,0,11,51,78.43,0.0,21.57,2019,76565
5002,125,1229,6356,78.7,1.97,19.34,2019,76574
186,10,55,251,74.1,3.98,21.91,2019,76637
294,5,169,468,62.82,1.07,36.11,2019,76653
757,9,188,954,79.35,0.94,19.71,2019,76665
332,13,131,476,69.75,2.73,27.52,2019,76670
223,12,144,379,58.84,3.17,37.99,2019,76690
319,6,189,514,62.06,1.17,36.77,2019,76693
7779,426,2427,10632,73.17,4.01,22.83,2019,76705
79,8,5,92,85.87,8.7,5.43,2019,76862
223,9,45,277,80.51,3.25,16.25,2019,76871
264,19,53,336,78.57,5.65,15.77,2019,76890
32,0,9,41,78.05,0.0,21.95,2019,76930
8,0,0,8,100.0,0.0,0.0,2019,76937
26,21,0,47,55.32,44.68,0.0,2019,76940
386,24,164,574,67.25,4.18,28.57,2019,15936
727,17,119,863,84.24,1.97,13.79,2019,15958
8919,155,1069,10143,87.93,1.53,10.54,2019,15205
8612,187,2141,10940,78.72,1.71,19.57,2019,15210
4894,171,1137,6202,78.91,2.76,18.33,2019,15214
12705,533,2830,16068,79.07,3.32,17.61,2019,15221
4563,147,889,5599,81.5,2.63,15.88,2019,15224
5290,174,824,6288,84.13,2.77,13.1,2019,15226
16372,262,1652,18286,89.53,1.43,9.03,2019,15237
29,0,0,29,100.0,0.0,0.0,2019,15784
44,0,18,62,70.97,0.0,29.03,2019,15680
165,0,5,170,97.06,0.0,2.94,2019,15350
2371,44,592,3007,78.85,1.46,19.69,2019,15021
1098,9,343,1450,75.72,0.62,23.66,2019,15112
10133,201,1269,11603,87.33,1.73,10.94,2019,15227
78,8,12,98,79.59,8.16,12.24,2019,15361
156,4,27,187,83.42,2.14,14.44,2019,15466
83,0,25,108,76.85,0.0,23.15,2019,15520
192,0,114,306,62.75,0.0,37.25,2019,15620
676,0,151,827,81.74,0.0,18.26,2019,15333
46,0,0,46,100.0,0.0,0.0,2019,15047
59,0,10,69,85.51,0.0,14.49,2019,15077
0,0,0,0,,,,2019,15260
4751,70,286,5107,93.03,1.37,5.6,2019,15668
0,0,0,0,,,,2019,15290
86,0,0,86,100.0,0.0,0.0,2019,15366
27,0,0,27,100.0,0.0,0.0,2019,15421
126,0,40,166,75.9,0.0,24.1,2019,15435
80,0,36,116,68.97,0.0,31.03,2019,15449
61,0,0,61,100.0,0.0,0.0,2019,15463
41,0,17,58,70.69,0.0,29.31,2019,15467
58,0,3,61,95.08,0.0,4.92,2019,15502
11,0,0,11,100.0,0.0,0.0,2019,15510
39,0,6,45,86.67,0.0,13.33,2019,15555
71,0,12,83,85.54,0.0,14.46,2019,15561
12,1,6,19,63.16,5.26,31.58,2019,15564
0,0,0,0,,,,2019,15616
35,0,0,35,100.0,0.0,0.0,2019,15621
84,0,20,104,80.77,0.0,19.23,2019,15638
40,0,0,40,100.0,0.0,0.0,2019,15691
56,0,28,84,66.67,0.0,33.33,2019,15727
27,0,3,30,90.0,0.0,10.0,2019,15737
57,0,42,99,57.58,0.0,42.42,2019,15738
27,0,30,57,47.37,0.0,52.63,2019,15746
64,11,53,128,50.0,8.59,41.41,2019,15750
9532,123,570,10225,93.22,1.2,5.57,2019,07039
4006,53,73,4132,96.95,1.28,1.77,2019,07043
14627,328,4899,19854,73.67,1.65,24.68,2019,07055
713,95,162,970,73.51,9.79,16.7,2019,07077
13068,638,3614,17320,75.45,3.68,20.87,2019,07105
15022,459,4543,20024,75.02,2.29,22.69,2019,07111
6770,1146,1779,9695,69.83,11.82,18.35,2019,07112
6344,260,738,7342,86.41,3.54,10.05,2019,07205
13069,458,2548,16075,81.3,2.85,15.85,2019,07304
16771,282,3054,20107,83.41,1.4,15.19,2019,07306
2094,65,51,2210,94.75,2.94,2.31,2019,07401
5906,166,322,6394,92.37,2.6,5.04,2019,07405
2198,36,100,2334,94.17,1.54,4.28,2019,07422
2492,15,162,2669,93.37,0.56,6.07,2019,07432
413,11,50,474,87.13,2.32,10.55,2019,08326
250,18,24,292,85.62,6.16,8.22,2019,08346
427,5,32,464,92.03,1.08,6.9,2019,08403
1622,13,67,1702,95.3,0.76,3.94,2019,08515
1819,101,335,2255,80.67,4.48,14.86,2019,08518
4337,105,297,4739,91.52,2.22,6.27,2019,08534
1550,0,33,1583,97.92,0.0,2.08,2019,08535
7507,174,124,7805,96.18,2.23,1.59,2019,08536
3110,72,895,4077,76.28,1.77,21.95,2019,08629
5591,189,501,6281,89.01,3.01,7.98,2019,08691
14539,284,1687,16510,88.06,1.72,10.22,2019,08724
537,52,102,691,77.71,7.53,14.76,2019,08740
15092,169,1174,16435,91.83,1.03,7.14,2019,08816
1926,20,141,2087,92.29,0.96,6.76,2019,08826
907,19,30,956,94.87,1.99,3.14,2019,08828
6208,97,431,6736,92.16,1.44,6.4,2019,08852
7377,382,886,8645,85.33,4.42,10.25,2019,08879
2324,50,181,2555,90.96,1.96,7.08,2019,08886
4129,105,754,4988,82.78,2.11,15.12,2019,08009
0,0,0,0,,,,2019,08011
10386,321,1438,12145,85.52,2.64,11.84,2019,08016
322,4,44,370,87.03,1.08,11.89,2019,08019
646,28,86,760,85.0,3.68,11.32,2019,08026
2675,29,300,3004,89.05,0.97,9.99,2019,08035
18658,355,1376,20389,91.51,1.74,6.75,2019,08527
1689,76,294,2059,82.03,3.69,14.28,2019,08751
3857,23,175,4055,95.12,0.57,4.32,2019,08824
11867,203,821,12891,92.06,1.57,6.37,2019,08820
1339,12,48,1399,95.71,0.86,3.43,2019,08802
3714,133,314,4161,89.26,3.2,7.55,2019,08805
145,0,0,145,100.0,0.0,0.0,2019,08821
1500,10,179,1689,88.81,0.59,10.6,2019,08827
1243,10,249,1502,82.76,0.67,16.58,2019,08829
18383,561,2167,21111,87.08,2.66,10.26,2019,08831
2578,54,195,2827,91.19,1.91,6.9,2019,08850
1731,0,38,1769,97.85,0.0,2.15,2019,08853
14795,383,998,16176,91.46,2.37,6.17,2019,08854
6400,260,602,7262,88.13,3.58,8.29,2019,08872
2514,68,351,2933,85.71,2.32,11.97,2019,08402
3567,219,580,4366,81.7,5.02,13.28,2019,08406
1691,96,77,1864,90.72,5.15,4.13,2019,08525
2215,0,225,2440,90.78,0.0,9.22,2019,08533
889,0,14,903,98.45,0.0,1.55,2019,08640
1568,16,171,1755,89.34,0.91,9.74,2019,08730
10276,196,687,11159,92.09,1.76,6.16,2019,08822
6660,132,1345,8137,81.85,1.62,16.53,2019,12304
3849,272,834,4955,77.68,5.49,16.83,2019,12308
737,25,39,801,92.01,3.12,4.87,2019,12440
51,30,55,136,37.5,22.06,40.44,2019,12460
510,0,79,589,86.59,0.0,13.41,2019,12481
59,0,80,139,42.45,0.0,57.55,2019,12482
486,56,70,612,79.41,9.15,11.44,2019,12491
157,27,31,215,73.02,12.56,14.42,2019,12517
2311,12,118,2441,94.67,0.49,4.83,2019,12563
2478,47,259,2784,89.01,1.69,9.3,2019,12564
869,45,93,1007,86.3,4.47,9.24,2019,12581
11968,301,706,12975,92.24,2.32,5.44,2019,12590
49,0,12,61,80.33,0.0,19.67,2019,12742
631,7,235,873,72.28,0.8,26.92,2019,12776
1600,109,700,2409,66.42,4.52,29.06,2019,78226
12293,1122,4996,18411,66.77,6.09,27.14,2019,78228
3290,86,54,3430,95.92,2.51,1.57,2019,78231
413,0,0,413,100.0,0.0,0.0,2019,78236
49,0,18,67,73.13,0.0,26.87,2019,62809
21,0,0,21,100.0,0.0,0.0,2019,62829
708,13,157,878,80.64,1.48,17.88,2019,62844
197,12,66,275,71.64,4.36,24.0,2019,62846
117,10,32,159,73.58,6.29,20.13,2019,62862
647,38,171,856,75.58,4.44,19.98,2019,62870
276,3,100,379,72.82,0.79,26.39,2019,62872
70,6,19,95,73.68,6.32,20.0,2019,62886
243,9,64,316,76.9,2.85,20.25,2019,62919
784,35,377,1196,65.55,2.93,31.52,2019,62922
111,5,34,150,74.0,3.33,22.67,2019,62927
1015,30,279,1324,76.66,2.27,21.07,2019,62449
74,33,22,129,57.36,25.58,17.05,2019,62380
1515,57,519,2091,72.45,2.73,24.82,2019,62420
167,23,16,206,81.07,11.17,7.77,2019,62421
774,13,159,946,81.82,1.37,16.81,2019,62451
85,0,44,129,65.89,0.0,34.11,2019,62452
251,6,38,295,85.08,2.03,12.88,2019,62479
0,0,51,51,0.0,0.0,100.0,2019,62519
282,12,51,345,81.74,3.48,14.78,2019,62533
423,9,124,556,76.08,1.62,22.3,2019,62534
274,14,42,330,83.03,4.24,12.73,2019,62551
257,42,63,362,70.99,11.6,17.4,2019,62625
211,0,74,285,74.04,0.0,25.96,2019,62635
279,7,47,333,83.78,2.1,14.11,2019,62807
281,3,78,362,77.62,0.83,21.55,2019,62810
158,9,24,191,82.72,4.71,12.57,2019,62831
3124,131,731,3986,78.37,3.29,18.34,2019,62832
246,3,154,403,61.04,0.74,38.21,2019,62835
236,4,45,285,82.81,1.4,15.79,2019,62836
233,12,56,301,77.41,3.99,18.6,2019,62842
854,98,190,1142,74.78,8.58,16.64,2019,62858
847,6,233,1086,77.99,0.55,21.45,2019,62869
73,3,19,95,76.84,3.16,20.0,2019,62876
153,9,60,222,68.92,4.05,27.03,2019,62877
94,2,46,142,66.2,1.41,32.39,2019,62892
311,4,120,435,71.49,0.92,27.59,2019,62893
589,56,162,807,72.99,6.94,20.07,2019,62895
350,9,136,495,70.71,1.82,27.47,2019,62912
125,0,28,153,81.7,0.0,18.3,2019,62921
136,2,44,182,74.73,1.1,24.18,2019,62923
81,0,32,113,71.68,0.0,28.32,2019,62940
3874,152,1233,5259,73.66,2.89,23.45,2019,62946
56,0,36,92,60.87,0.0,39.13,2019,62950
4700,186,1359,6245,75.26,2.98,21.76,2019,62966
61,5,60,126,48.41,3.97,47.62,2019,62969
476,0,85,561,84.85,0.0,15.15,2019,62642
523,29,56,608,86.02,4.77,9.21,2019,62661
165,5,62,232,71.12,2.16,26.72,2019,62666
455,10,111,576,78.99,1.74,19.27,2019,62668
201,6,28,235,85.53,2.55,11.91,2019,62671
58,1,26,85,68.24,1.18,30.59,2019,62672
487,41,59,587,82.96,6.98,10.05,2019,62693
331,21,207,559,59.21,3.76,37.03,2019,62701
127,7,59,193,65.8,3.63,30.57,2019,62093
80,0,0,80,100.0,0.0,0.0,2019,76958
64,0,3,67,95.52,0.0,4.48,2019,76953
17058,845,3440,21343,79.92,3.96,16.12,2019,76116
11382,509,907,12798,88.94,3.98,7.09,2019,76132
805,18,221,1044,77.11,1.72,21.17,2019,76225
926,67,187,1180,78.47,5.68,15.85,2019,76233
2504,42,344,2890,86.64,1.45,11.9,2019,76249
80,0,15,95,84.21,0.0,15.79,2019,76253
1576,65,531,2172,72.56,2.99,24.45,2019,76255
4496,220,657,5373,83.68,4.09,12.23,2019,76266
429,86,136,651,65.9,13.21,20.89,2019,76270
451,33,96,580,77.76,5.69,16.55,2019,76271
621,116,151,888,69.93,13.06,17.0,2019,76351
3878,91,976,4945,78.42,1.84,19.74,2019,76354
441,22,92,555,79.46,3.96,16.58,2019,76371
167,0,87,254,65.75,0.0,34.25,2019,76377
3236,330,1381,4947,65.41,6.67,27.92,2019,76384
371,11,81,463,80.13,2.38,17.49,2019,76389
10536,226,593,11355,92.79,1.99,5.22,2019,75032
4708,134,339,5181,90.87,2.59,6.54,2019,75057
678,32,163,873,77.66,3.67,18.67,2019,75058
4241,71,249,4561,92.98,1.56,5.46,2019,75065
4067,152,666,4885,83.25,3.11,13.63,2019,75647
1377,83,607,2067,66.62,4.02,29.37,2019,75559
1234,68,568,1870,65.99,3.64,30.37,2019,75563
789,17,398,1204,65.53,1.41,33.06,2019,75630
5007,223,1864,7094,70.58,3.14,26.28,2019,75602
9656,306,1358,11320,85.3,2.7,12.0,2019,75604
3973,78,1010,5061,78.5,1.54,19.96,2019,75633
3469,146,838,4453,77.9,3.28,18.82,2019,75644
2451,117,962,3530,69.43,3.31,27.25,2019,75650
2053,69,1175,3297,62.27,2.09,35.64,2019,75657
568,22,112,702,80.91,3.13,15.95,2019,61051
4517,145,1030,5692,79.36,2.55,18.1,2019,61071
4911,236,989,6136,80.04,3.85,16.12,2019,61102
5523,413,1832,7768,71.1,5.32,23.58,2019,61104
9622,559,1295,11476,83.84,4.87,11.28,2019,61108
9154,472,1292,10918,83.84,4.32,11.83,2019,61109
8243,151,1267,9661,85.32,1.56,13.11,2019,61111
7766,123,982,8871,87.54,1.39,11.07,2019,61115
85,0,33,118,72.03,0.0,27.97,2019,61243
2358,113,441,2912,80.98,3.88,15.14,2019,61270
10148,286,2787,13221,76.76,2.16,21.08,2019,61032
26,0,9,35,74.29,0.0,25.71,2019,61037
120,0,34,154,77.92,0.0,22.08,2019,61050
316,1,58,375,84.27,0.27,15.47,2019,61052
520,37,82,639,81.38,5.79,12.83,2019,61060
1307,59,289,1655,78.97,3.56,17.46,2019,61064
16,0,0,16,100.0,0.0,0.0,2019,61077
1116,44,286,1446,77.18,3.04,19.78,2019,61085
2135,129,209,2473,86.33,5.22,8.45,2019,61240
755,26,76,857,88.1,3.03,8.87,2019,61256
80,8,27,115,69.57,6.96,23.48,2019,61274
1329,20,284,1633,81.38,1.22,17.39,2019,61310
96,0,0,96,100.0,0.0,0.0,2019,61311
252,12,47,311,81.03,3.86,15.11,2019,61318
26,0,2,28,92.86,0.0,7.14,2019,61323
349,15,66,430,81.16,3.49,15.35,2019,61325
417,3,95,515,80.97,0.58,18.45,2019,61327
2355,37,161,2553,92.24,1.45,6.31,2019,07462
2465,44,44,2553,96.55,1.72,1.72,2019,07465
6219,247,4279,10745,57.88,2.3,39.82,2019,07501
2414,117,793,3324,72.62,3.52,23.86,2019,07513
698,9,87,794,87.91,1.13,10.96,2019,07606
1821,76,192,2089,87.17,3.64,9.19,2019,07738
1994,0,49,2043,97.6,0.0,2.4,2019,07739
2145,14,79,2238,95.84,0.63,3.53,2019,07850
6842,72,274,7188,95.19,1.0,3.81,2019,07871
3609,48,137,3794,95.12,1.27,3.61,2019,07921
974,23,34,1031,94.47,2.23,3.3,2019,07931
16569,287,1191,18047,91.81,1.59,6.6,2019,07960
3763,171,200,4134,91.03,4.14,4.84,2019,07974
8845,705,3657,13207,66.97,5.34,27.69,2019,07107
5819,119,159,6097,95.44,1.95,2.61,2019,07310
5724,51,963,6738,84.95,0.76,14.29,2019,07407
2388,61,204,2653,90.01,2.3,7.69,2019,07421
8871,170,715,9756,90.93,1.74,7.33,2019,07424
4000,17,369,4386,91.2,0.39,8.41,2019,07438
749,24,54,827,90.57,2.9,6.53,2019,07439
7942,79,289,8310,95.57,0.95,3.48,2019,07450
1145,44,80,1269,90.23,3.47,6.3,2019,07460
557,9,468,1034,53.87,0.87,45.26,2019,07505
3100,48,1033,4181,74.14,1.15,24.71,2019,07524
9748,159,1180,11087,87.92,1.43,10.64,2019,07631
7471,128,633,8232,90.76,1.55,7.69,2019,07652
9909,308,1913,12130,81.69,2.54,15.77,2019,07740
12967,468,2295,15730,82.43,2.98,14.59,2019,07753
1600,45,292,1937,82.6,2.32,15.07,2019,07756
1486,0,86,1572,94.53,0.0,5.47,2019,07758
2949,50,129,3128,94.28,1.6,4.12,2019,07760
1549,25,150,1724,89.85,1.45,8.7,2019,07848
1213,38,179,1430,84.83,2.66,12.52,2019,07857
2411,10,120,2541,94.88,0.39,4.72,2019,07630
1066,14,33,1113,95.78,1.26,2.96,2019,07641
6517,67,819,7403,88.03,0.91,11.06,2019,07650
4331,31,358,4720,91.76,0.66,7.58,2019,07660
11861,156,1055,13072,90.74,1.19,8.07,2019,07666
5332,142,380,5854,91.08,2.43,6.49,2019,07828
6235,105,463,6803,91.65,1.54,6.81,2019,07834
4084,83,369,4536,90.04,1.83,8.13,2019,07836
1098,21,20,1139,96.4,1.84,1.76,2019,07838
4075,26,80,4181,97.46,0.62,1.91,2019,07853
2951,4,100,3055,96.6,0.13,3.27,2019,07874
567,8,30,605,93.72,1.32,4.96,2019,07711
9445,79,716,10240,92.24,0.77,6.99,2019,11793
11648,227,1012,12887,90.39,1.76,7.85,2019,11801
2612,155,293,3060,85.36,5.07,9.58,2019,11933
404,5,48,457,88.4,1.09,10.5,2019,11939
4388,157,1417,5962,73.6,2.63,23.77,2019,11946
286,26,20,332,86.14,7.83,6.02,2019,11960
2168,57,602,2827,76.69,2.02,21.29,2019,11963
2152,70,346,2568,83.8,2.73,13.47,2019,11971
50,10,41,101,49.5,9.9,40.59,2019,11975
768,9,50,827,92.87,1.09,6.05,2019,11509
6238,512,334,7084,88.06,7.23,4.71,2019,11552
28826,355,3368,32549,88.56,1.09,10.35,2019,11375
11494,228,1399,13121,87.6,1.74,10.66,2019,11420
16319,242,2332,18893,86.38,1.28,12.34,2019,11435
185,0,30,215,86.05,0.0,13.95,2019,12786
1431,26,145,1602,89.33,1.62,9.05,2019,12790
5248,176,1010,6434,81.57,2.74,15.7,2019,12801
1613,18,359,1990,81.06,0.9,18.04,2019,12816
3274,101,465,3840,85.26,2.63,12.11,2019,12828
1672,201,423,2296,72.82,8.75,18.42,2019,12305
306,0,146,452,67.7,0.0,32.3,2019,12406
122,0,5,127,96.06,0.0,3.94,2019,12421
2303,17,259,2579,89.3,0.66,10.04,2019,12428
1702,58,276,2036,83.6,2.85,13.56,2019,12446
551,0,59,610,90.33,0.0,9.67,2019,12472
226,0,61,287,78.75,0.0,21.25,2019,12473
78,0,0,78,100.0,0.0,0.0,2019,12495
77,6,0,83,92.77,7.23,0.0,2019,12507
4459,130,495,5084,87.71,2.56,9.74,2019,12538
952,19,101,1072,88.81,1.77,9.42,2019,12547
8401,463,831,9695,86.65,4.78,8.57,2019,12553
959,11,139,1109,86.47,0.99,12.53,2019,12567
2270,62,105,2437,93.15,2.54,4.31,2019,12570
1750,112,208,2070,84.54,5.41,10.05,2019,12721
581,0,99,680,85.44,0.0,14.56,2019,12723
83,0,31,114,72.81,0.0,27.19,2019,12724
247,25,108,380,65.0,6.58,28.42,2019,12734
111,3,28,142,78.17,2.11,19.72,2019,12743
86,0,42,128,67.19,0.0,32.81,2019,12749
4502,244,974,5720,78.71,4.27,17.03,2019,12771
665,70,109,844,78.79,8.29,12.91,2019,12780
268,11,98,377,71.09,2.92,25.99,2019,12785
85,0,19,104,81.73,0.0,18.27,2019,12792
50,0,0,50,100.0,0.0,0.0,2019,12812
92,0,19,111,82.88,0.0,17.12,2019,12823
2071,87,603,2761,75.01,3.15,21.84,2019,12832
906,26,178,1110,81.62,2.34,16.04,2019,12835
1006,9,106,1121,89.74,0.8,9.46,2019,12850
639,15,97,751,85.09,2.0,12.92,2019,12853
93,2,21,116,80.17,1.72,18.1,2019,12855
592,12,151,755,78.41,1.59,20.0,2019,12870
80,0,8,88,90.91,0.0,9.09,2019,12874
224,9,116,349,64.18,2.58,33.24,2019,12914
652,31,212,895,72.85,3.46,23.69,2019,12916
325,10,197,532,61.09,1.88,37.03,2019,12917
466,9,183,658,70.82,1.37,27.81,2019,12937
1518,106,137,1761,86.2,6.02,7.78,2019,12946
181,3,93,277,65.34,1.08,33.57,2019,12950
426,27,53,506,84.19,5.34,10.47,2019,12985
666,35,39,740,90.0,4.73,5.27,2019,14814
830,9,114,953,87.09,0.94,11.96,2019,14818
196,19,87,302,64.9,6.29,28.81,2019,14820
316,0,52,368,85.87,0.0,14.13,2019,14841
211,0,98,309,68.28,0.0,31.72,2019,14842
3500,56,555,4111,85.14,1.36,13.5,2019,14870
2412,88,372,2872,83.98,3.06,12.95,2019,14886
2535,84,578,3197,79.29,2.63,18.08,2019,14057
2135,156,372,2663,80.17,5.86,13.97,2019,14068
291,0,22,313,92.97,0.0,7.03,2019,14069
512,17,186,715,71.61,2.38,26.01,2019,14101
411,15,29,455,90.33,3.3,6.37,2019,14102
4198,216,716,5130,81.83,4.21,13.96,2019,14063
433,20,182,635,68.19,3.15,28.66,2019,14065
3585,378,1305,5268,68.05,7.18,24.77,2019,62206
1861,189,1623,3673,50.67,5.15,44.19,2019,62207
1333,47,209,1589,83.89,2.96,13.15,2019,62014
126,3,37,166,75.9,1.81,22.29,2019,61449
498,36,80,614,81.11,5.86,13.03,2019,61031
450,16,146,612,73.53,2.61,23.86,2019,61041
1375,18,301,1694,81.17,1.06,17.77,2019,61048
3927,39,388,4354,90.19,0.9,8.91,2019,61072
1685,94,378,2157,78.12,4.36,17.52,2019,61074
413,2,93,508,81.3,0.39,18.31,2019,61078
1121,6,109,1236,90.7,0.49,8.82,2019,61084
5416,438,1698,7552,71.72,5.8,22.48,2019,61101
447,18,82,547,81.72,3.29,14.99,2019,61234
450,10,122,582,77.32,1.72,20.96,2019,61235
32,0,6,38,84.21,0.0,15.79,2019,61236
215,20,89,324,66.36,6.17,27.47,2019,61929
1686,51,209,1946,86.64,2.62,10.74,2019,61016
652,15,87,754,86.47,1.99,11.54,2019,61062
8,7,40,55,14.55,12.73,72.73,2019,61112
244,0,32,276,88.41,0.0,11.59,2019,61560
144,6,40,190,75.79,3.16,21.05,2019,61773
2713,84,383,3180,85.31,2.64,12.04,2019,61856
4172,79,997,5248,79.5,1.51,19.0,2019,61944
561,20,83,664,84.49,3.01,12.5,2019,61877
112,1,18,131,85.5,0.76,13.74,2019,61460
17,0,11,28,60.71,0.0,39.29,2019,61479
6434,311,812,7557,85.14,4.12,10.75,2019,61550
418,14,68,500,83.6,2.8,13.6,2019,61728
104,0,10,114,91.23,0.0,8.77,2019,61775
206,5,38,249,82.73,2.01,15.26,2019,61263
258,5,34,297,86.87,1.68,11.45,2019,61320
94,0,20,114,82.46,0.0,17.54,2019,61417
195,7,69,271,71.96,2.58,25.46,2019,61442
3738,40,556,4334,86.25,0.92,12.83,2019,61607
204,4,32,240,85.0,1.67,13.33,2019,61769
490,16,109,615,79.67,2.6,17.72,2019,61377
127,9,28,164,77.44,5.49,17.07,2019,61459
362,10,55,427,84.78,2.34,12.88,2019,61754
203,7,38,248,81.85,2.82,15.32,2019,61839
664,6,145,815,81.47,0.74,17.79,2019,61914
530,43,104,677,78.29,6.35,15.36,2019,61818
56,0,15,71,78.87,0.0,21.13,2019,61852
4454,149,373,4976,89.51,2.99,7.5,2019,61853
1295,15,207,1517,85.37,0.99,13.65,2019,61880
425,13,119,557,76.3,2.33,21.36,2019,61912
208,3,65,276,75.36,1.09,23.55,2019,61917
7503,101,1727,9331,80.41,1.08,18.51,2019,61938
70,8,29,107,65.42,7.48,27.1,2019,61940
558,26,109,693,80.52,3.75,15.73,2019,61943
305,2,44,351,86.89,0.57,12.54,2019,61733
35,0,0,35,100.0,0.0,0.0,2019,61027
32,0,6,38,84.21,0.0,15.79,2019,61043
50,0,15,65,76.92,0.0,23.08,2019,61079
51,0,12,63,80.95,0.0,19.05,2019,61258
152,12,15,179,84.92,6.7,8.38,2019,61278
28,0,8,36,77.78,0.0,22.22,2019,61433
49,2,29,80,61.25,2.5,36.25,2019,61553
16,0,11,27,59.26,0.0,40.74,2019,61562
2271,40,452,2763,82.19,1.45,16.36,2019,61616
105,4,34,143,73.43,2.8,23.78,2019,61333
83,13,18,114,72.81,11.4,15.79,2019,61338
2826,54,521,3401,83.09,1.59,15.32,2019,61342
260,9,41,310,83.87,2.9,13.23,2019,61345
8704,199,1395,10298,84.52,1.93,13.55,2019,61350
3623,211,753,4587,78.98,4.6,16.42,2019,61354
433,24,97,554,78.16,4.33,17.51,2019,61368
405,8,61,474,85.44,1.69,12.87,2019,62554
191,9,22,222,86.04,4.05,9.91,2019,62572
2058,109,652,2819,73.0,3.87,23.13,2019,62618
369,15,96,480,76.88,3.12,20.0,2019,62621
121,7,47,175,69.14,4.0,26.86,2019,62624
5225,308,1282,6815,76.67,4.52,18.81,2019,62656
2165,87,364,2616,82.76,3.33,13.91,2019,62675
1715,67,315,2097,81.78,3.2,15.02,2019,62681
442,14,110,566,78.09,2.47,19.43,2019,62827
941,61,277,1279,73.57,4.77,21.66,2019,62018
71,4,58,133,53.38,3.01,43.61,2019,62077
205,4,104,313,65.5,1.28,33.23,2019,62949
375,11,108,494,75.91,2.23,21.86,2019,62979
460,7,161,628,73.25,1.11,25.64,2019,62999
351,3,113,467,75.16,0.64,24.2,2019,62063
11556,154,1895,13605,84.94,1.13,13.93,2019,62234
910,29,187,1126,80.82,2.58,16.61,2019,62442
1350,15,149,1514,89.17,0.99,9.84,2019,62467
1086,73,152,1311,82.84,5.57,11.59,2019,62558
996,16,171,1183,84.19,1.35,14.45,2019,62694
8243,271,1525,10039,82.11,2.7,15.19,2019,62864
80,5,30,115,69.57,4.35,26.09,2019,62967
534,10,172,716,74.58,1.4,24.02,2019,62340
176,14,62,252,69.84,5.56,24.6,2019,62423
732,17,276,1025,71.41,1.66,26.93,2019,62501
603,17,185,805,74.91,2.11,22.98,2019,73932
798,41,210,1049,76.07,3.91,20.02,2019,73945
15373,567,1495,17435,88.17,3.25,8.57,2019,73071
15381,814,1306,17501,87.89,4.65,7.46,2019,73072
106,0,75,181,58.56,0.0,41.44,2019,73073
1943,59,714,2716,71.54,2.17,26.29,2019,73084
20611,290,2011,22912,89.96,1.27,8.78,2019,73099
3408,91,1084,4583,74.36,1.99,23.65,2019,73108
14383,1023,2019,17425,82.54,5.87,11.59,2019,73120
9117,1229,3262,13608,67.0,9.03,23.97,2019,73401
29,0,14,43,67.44,0.0,32.56,2019,73437
894,63,439,1396,64.04,4.51,31.45,2019,73438
517,49,191,757,68.3,6.47,25.23,2019,73456
163,10,56,229,71.18,4.37,24.45,2019,73537
407,8,91,506,80.43,1.58,17.98,2019,73552
40,5,13,58,68.97,8.62,22.41,2019,73556
188,7,57,252,74.6,2.78,22.62,2019,73639
424,21,119,564,75.18,3.72,21.1,2019,73645
231,4,26,261,88.51,1.53,9.96,2019,73716
1922,65,456,2443,78.67,2.66,18.67,2019,73717
24,6,4,34,70.59,17.65,11.76,2019,73719
3465,105,1064,4634,74.77,2.27,22.96,2019,73106
3026,100,1633,4759,63.58,2.1,34.31,2019,73111
5190,561,2036,7787,66.65,7.2,26.15,2019,73114
6920,403,2449,9772,70.81,4.12,25.06,2019,73119
7039,308,1727,9074,77.57,3.39,19.03,2019,73127
1246,30,103,1379,90.36,2.18,7.47,2019,73131
5717,192,583,6492,88.06,2.96,8.98,2019,11553
2353,57,139,2549,92.31,2.24,5.45,2019,11559
2824,31,255,3110,90.8,1.0,8.2,2019,11565
4116,30,213,4359,94.43,0.69,4.89,2019,11545
6881,232,937,8050,85.48,2.88,11.64,2019,11563
426,0,61,487,87.47,0.0,12.53,2019,11569
6111,194,460,6765,90.33,2.87,6.8,2019,11581
15828,759,4125,20712,76.42,3.66,19.92,2019,11691
7309,333,897,8539,85.6,3.9,10.5,2019,11701
8100,183,605,8888,91.13,2.06,6.81,2019,11720
5031,125,537,5693,88.37,2.2,9.43,2019,11726
4932,124,366,5422,90.96,2.29,6.75,2019,11738
14343,331,523,15197,94.38,2.18,3.44,2019,11743
3950,44,823,4817,82.0,0.91,17.09,2019,11693
1573,66,320,1959,80.3,3.37,16.33,2019,11944
1222,0,236,1458,83.81,0.0,16.19,2019,11954
121,6,0,127,95.28,4.72,0.0,2019,11956
143,17,80,240,59.58,7.08,33.33,2019,11959
831,0,150,981,84.71,0.0,15.29,2019,11964
21682,2118,4833,28633,75.72,7.4,16.88,2019,11368
29678,478,5345,35501,83.6,1.35,15.06,2019,11385
9350,160,1585,11095,84.27,1.44,14.29,2019,11412
9198,250,1293,10741,85.63,2.33,12.04,2019,11414
0,0,0,0,,,,2019,11430
3642,41,317,4000,91.05,1.02,7.92,2019,11518
8616,162,1220,9998,86.18,1.62,12.2,2019,11542
544,0,0,544,100.0,0.0,0.0,2019,11548
2536,26,328,2890,87.75,0.9,11.35,2019,11558
2024,29,304,2357,85.87,1.23,12.9,2019,11560
1790,0,176,1966,91.05,0.0,8.95,2019,11579
6992,206,1299,8497,82.29,2.42,15.29,2019,11694
1245,0,211,1456,85.51,0.0,14.49,2019,11697
4792,177,319,5288,90.62,3.35,6.03,2019,11703
7728,234,654,8616,89.69,2.72,7.59,2019,11729
1332,34,87,1453,91.67,2.34,5.99,2019,11732
6517,186,300,7003,93.06,2.66,4.28,2019,11747
4473,140,405,5018,89.14,2.79,8.07,2019,11751
16836,261,1468,18565,90.69,1.41,7.91,2019,11758
7426,138,270,7834,94.79,1.76,3.45,2019,11768
14918,359,2026,17303,86.22,2.07,11.71,2019,11772
4501,171,485,5157,87.28,3.32,9.4,2019,11782
6862,214,782,7858,87.33,2.72,9.95,2019,11784
2898,230,451,3579,80.97,6.43,12.6,2019,11798
158,24,294,476,33.19,5.04,61.76,2019,11932
1183,12,90,1285,92.06,0.93,7.0,2019,11935
2920,39,896,3855,75.75,1.01,23.24,2019,13642
626,9,237,872,71.79,1.03,27.18,2019,13654
642,23,299,964,66.6,2.39,31.02,2019,13656
146,0,25,171,85.38,0.0,14.62,2019,13659
517,51,50,618,83.66,8.25,8.09,2019,13660
4905,182,1013,6100,80.41,2.98,16.61,2019,13669
200,12,70,282,70.92,4.26,24.82,2019,13682
689,17,137,843,81.73,2.02,16.25,2019,13697
1687,65,413,2165,77.92,3.0,19.08,2019,13118
676,35,87,798,84.71,4.39,10.9,2019,13120
1182,10,218,1410,83.83,0.71,15.46,2019,13131
81,0,38,119,68.07,0.0,31.93,2019,13614
1607,42,248,1897,84.71,2.21,13.07,2019,13624
665,8,87,760,87.5,1.05,11.45,2019,13625
1657,113,181,1951,84.93,5.79,9.28,2019,14067
1404,22,374,1800,78.0,1.22,20.78,2019,14080
11490,110,1631,13231,86.84,0.83,12.33,2019,14086
401,45,102,548,73.18,8.21,18.61,2019,14129
484,15,230,729,66.39,2.06,31.55,2019,14138
2554,74,545,3173,80.49,2.33,17.18,2019,14141
1473,46,250,1769,83.27,2.6,14.13,2019,14202
2942,101,794,3837,76.67,2.63,20.69,2019,14209
11942,549,4219,16710,71.47,3.29,25.25,2019,14215
4471,80,354,4905,91.15,1.63,7.22,2019,14425
4455,123,968,5546,80.33,2.22,17.45,2019,14219
15038,315,2473,17826,84.36,1.77,13.87,2019,14224
11361,316,1149,12826,88.58,2.46,8.96,2019,14226
2775,64,547,3386,81.96,1.89,16.15,2019,14445
2431,14,362,2807,86.6,0.5,12.9,2019,14464
2575,91,511,3177,81.05,2.86,16.08,2019,14470
3681,101,451,4233,86.96,2.39,10.65,2019,14502
4502,243,1004,5749,78.31,4.23,17.46,2019,14513
950,78,204,1232,77.11,6.33,16.56,2019,14517
696,23,289,1008,69.05,2.28,28.67,2019,14521
3080,109,722,3911,78.75,2.79,18.46,2019,14522
69,0,0,69,100.0,0.0,0.0,2019,14545
6375,116,621,7112,89.64,1.63,8.73,2019,14559
680,5,142,827,82.22,0.6,17.17,2019,14560
1645,53,337,2035,80.84,2.6,16.56,2019,14572
49,0,5,54,90.74,0.0,9.26,2019,14585
3955,89,272,4316,91.64,2.06,6.3,2019,14586
13853,619,2899,17371,79.75,3.56,16.69,2019,14609
9829,274,1519,11622,84.57,2.36,13.07,2019,14616
57,0,12,69,82.61,0.0,17.39,2019,14708
215,0,67,282,76.24,0.0,23.76,2019,14717
239,29,331,599,39.9,4.84,55.26,2019,14726
60,4,20,84,71.43,4.76,23.81,2019,14736
829,26,320,1175,70.55,2.21,27.23,2019,14739
388,12,104,504,76.98,2.38,20.63,2019,14753
474,17,226,717,66.11,2.37,31.52,2019,14767
942,54,212,1208,77.98,4.47,17.55,2019,14770
390,10,181,581,67.13,1.72,31.15,2019,14008
343,3,93,439,78.13,0.68,21.18,2019,14805
998,52,254,1304,76.53,3.99,19.48,2019,14812
732,61,203,996,73.49,6.12,20.38,2019,14813
322,11,189,522,61.69,2.11,36.21,2019,14861
213,7,54,274,77.74,2.55,19.71,2019,14885
3121,53,890,4064,76.8,1.3,21.9,2019,14001
527,28,154,709,74.33,3.95,21.72,2019,14013
2770,14,393,3177,87.19,0.44,12.37,2019,16055
1765,60,334,2159,81.75,2.78,15.47,2019,16056
1058,10,213,1281,82.59,0.78,16.63,2019,16115
800,15,124,939,85.2,1.6,13.21,2019,16120
729,33,131,893,81.63,3.7,14.67,2019,16130
6232,157,1038,7427,83.91,2.11,13.98,2019,16148
3506,218,608,4332,80.93,5.03,14.04,2019,16214
599,10,358,967,61.94,1.03,37.02,2019,16222
135,0,49,184,73.37,0.0,26.63,2019,16260
1762,55,364,2181,80.79,2.52,16.69,2019,16314
664,15,101,780,85.13,1.92,12.95,2019,16341
880,55,277,1212,72.61,4.54,22.85,2019,16353
3516,75,1057,4648,75.65,1.61,22.74,2019,16407
534,5,107,646,82.66,0.77,16.56,2019,16410
0,0,0,0,,,,2019,61625
4284,37,215,4536,94.44,0.82,4.74,2019,61705
43,0,0,43,100.0,0.0,0.0,2019,61751
54,6,20,80,67.5,7.5,25.0,2019,61955
587,49,219,855,68.65,5.73,25.61,2019,74085
1683,105,437,2225,75.64,4.72,19.64,2019,74119
1412,101,373,1886,74.87,5.36,19.78,2019,74337
8109,1206,1495,10810,75.01,11.16,13.83,2019,74075
442,58,244,744,59.41,7.8,32.8,2019,74081
10531,363,1361,12255,85.93,2.96,11.11,2019,74105
3291,132,1496,4919,66.9,2.68,30.41,2019,74110
883,21,219,1123,78.63,1.87,19.5,2019,74131
5127,152,707,5986,85.65,2.54,11.81,2019,74134
2208,99,842,3149,70.12,3.14,26.74,2019,74331
87,7,43,137,63.5,5.11,31.39,2019,74349
522,36,208,766,68.15,4.7,27.15,2019,74369
4177,146,1849,6172,67.68,2.37,29.96,2019,74447
118,4,61,183,64.48,2.19,33.33,2019,74720
60,5,68,133,45.11,3.76,51.13,2019,74750
157,8,115,280,56.07,2.86,41.07,2019,74756
9034,360,1425,10819,83.5,3.33,13.17,2019,74006
2972,78,901,3951,75.22,1.97,22.8,2019,74010
13657,230,841,14728,92.73,1.56,5.71,2019,74014
1524,78,666,2268,67.2,3.44,29.37,2019,74016
501,40,285,826,60.65,4.84,34.5,2019,74038
15808,207,1211,17226,91.77,1.2,7.03,2019,74055
139,13,52,204,68.14,6.37,25.49,2019,74060
0,0,2,2,0.0,0.0,100.0,2019,74068
505,8,219,732,68.99,1.09,29.92,2019,74072
523,26,249,798,65.54,3.26,31.2,2019,74563
320,9,113,442,72.4,2.04,25.57,2019,74741
2217,111,1425,3753,59.07,2.96,37.97,2019,74745
382,14,174,570,67.02,2.46,30.53,2019,74759
314,15,131,460,68.26,3.26,28.48,2019,74824
78,0,45,123,63.41,0.0,36.59,2019,74827
114,8,103,225,50.67,3.56,45.78,2019,74839
511,29,129,669,76.38,4.33,19.28,2019,74854
1496,42,746,2284,65.5,1.84,32.66,2019,74859
927,72,254,1253,73.98,5.75,20.27,2019,74872
1195,31,573,1799,66.43,1.72,31.85,2019,74881
438,6,373,817,53.61,0.73,45.65,2019,74883
191,12,274,477,40.04,2.52,57.44,2019,74931
140,7,51,198,70.71,3.54,25.76,2019,74963
135,11,48,194,69.59,5.67,24.74,2019,74084
336,11,10,357,94.12,3.08,2.8,2019,74103
2052,91,312,2455,83.58,3.71,12.71,2019,74120
4791,230,1611,6632,72.24,3.47,24.29,2019,74127
6351,174,989,7514,84.52,2.32,13.16,2019,74145
247,4,60,311,79.42,1.29,19.29,2019,74350
9289,502,2427,12218,76.03,4.11,19.86,2019,74403
1332,39,477,1848,72.08,2.11,25.81,2019,74421
269,116,110,495,54.34,23.43,22.22,2019,74428
974,17,235,1226,79.45,1.39,19.17,2019,74454
807,79,381,1267,63.69,6.24,30.07,2019,74455
2006,187,839,3032,66.16,6.17,27.67,2019,74462
7714,524,2500,10738,71.84,4.88,23.28,2019,74464
490,79,208,777,63.06,10.17,26.77,2019,74002
20855,547,1606,23008,90.64,2.38,6.98,2019,74012
1886,304,677,2867,65.78,10.6,23.61,2019,74020
5772,171,1434,7377,78.24,2.32,19.44,2019,73139
474,11,24,509,93.12,2.16,4.72,2019,73145
9954,188,1877,12019,82.82,1.56,15.62,2019,73159
10388,234,1032,11654,89.14,2.01,8.86,2019,73162
13138,271,887,14296,91.9,1.9,6.2,2019,73170
341,43,95,479,71.19,8.98,19.83,2019,73430
1419,99,481,1999,70.99,4.95,24.06,2019,73448
184,69,134,387,47.55,17.83,34.63,2019,73458
683,38,104,825,82.79,4.61,12.61,2019,73526
1458,3,191,1652,88.26,0.18,11.56,2019,73527
55,9,25,89,61.8,10.11,28.09,2019,73539
915,0,144,1059,86.4,0.0,13.6,2019,73541
238,40,89,367,64.85,10.9,24.25,2019,73002
332,11,146,489,67.89,2.25,29.86,2019,73009
654,13,167,834,78.42,1.56,20.02,2019,73095
202,8,65,275,73.45,2.91,23.64,2019,73024
226,9,158,393,57.51,2.29,40.2,2019,73042
3114,36,229,3379,92.16,1.07,6.78,2019,73065
4649,423,1981,7053,65.92,6.0,28.09,2019,73109
6612,177,1544,8333,79.35,2.12,18.53,2019,73115
9455,374,979,10808,87.48,3.46,9.06,2019,73132
1342,38,556,1936,69.32,1.96,28.72,2019,73149
591,6,5,602,98.17,1.0,0.83,2019,73151
1861,69,227,2157,86.28,3.2,10.52,2019,73165
9,5,4,18,50.0,27.78,22.22,2019,73425
270,14,152,436,61.93,3.21,34.86,2019,73432
822,33,226,1081,76.04,3.05,20.91,2019,73433
19,7,38,64,29.69,10.94,59.38,2019,73444
18178,251,1148,19577,92.85,1.28,5.86,2019,73013
343,27,188,558,61.47,4.84,33.69,2019,73017
12668,327,1581,14576,86.91,2.24,10.85,2019,73112
1530,79,932,2541,60.21,3.11,36.68,2019,73117
81,5,93,179,45.25,2.79,51.96,2019,74829
67,0,52,119,56.3,0.0,43.7,2019,74837
75,6,35,116,64.66,5.17,30.17,2019,74843
3206,281,797,4284,74.84,6.56,18.6,2019,74873
657,20,212,889,73.9,2.25,23.85,2019,74932
25,4,30,59,42.37,6.78,50.85,2019,74942
308,28,113,449,68.6,6.24,25.17,2019,74944
572,32,411,1015,56.35,3.15,40.49,2019,74964
84,11,66,161,52.17,6.83,40.99,2019,74845
418,17,216,651,64.21,2.61,33.18,2019,74735
15,0,0,15,100.0,0.0,0.0,2019,74753
413,12,322,747,55.29,1.61,43.11,2019,74825
9929,90,590,10609,93.59,0.85,5.56,2019,74011
6014,78,1001,7093,84.79,1.1,14.11,2019,74021
3357,75,937,4369,76.84,1.72,21.45,2019,74023
2131,51,454,2636,80.84,1.93,17.22,2019,74036
5932,28,336,6296,94.22,0.44,5.34,2019,74037
4419,124,965,5508,80.23,2.25,17.52,2019,74070
376,4,208,588,63.95,0.68,35.37,2019,76632
1556,10,227,1793,86.78,0.56,12.66,2019,76633
518,3,53,574,90.24,0.52,9.23,2019,76636
419,30,129,578,72.49,5.19,22.32,2019,76641
174,19,52,245,71.02,7.76,21.22,2019,76649
825,47,342,1214,67.96,3.87,28.17,2019,76664
962,11,308,1281,75.1,0.86,24.04,2019,76431
535,8,39,582,91.92,1.37,6.7,2019,76433
318,7,47,372,85.48,1.88,12.63,2019,76561
627,26,244,897,69.9,2.9,27.2,2019,13626
2999,201,362,3562,84.19,5.64,10.16,2019,13037
870,72,151,1093,79.6,6.59,13.82,2019,13044
1546,30,245,1821,84.9,1.65,13.45,2019,13053
114,0,31,145,78.62,0.0,21.38,2019,13846
7799,309,828,8936,87.28,3.46,9.27,2019,13850
127,0,0,127,100.0,0.0,0.0,2019,13861
1338,47,314,1699,78.75,2.77,18.48,2019,13862
174,11,25,210,82.86,5.24,11.9,2019,13155
3338,113,433,3884,85.94,2.91,11.15,2019,13078
104,0,6,110,94.55,0.0,5.45,2019,13639
163,0,30,193,84.46,0.0,15.54,2019,13756
746,15,133,894,83.45,1.68,14.88,2019,13042
2313,70,247,2630,87.95,2.66,9.39,2019,13135
579,13,185,777,74.52,1.67,23.81,2019,13327
5569,103,721,6393,87.11,1.61,11.28,2019,13413
10031,360,2545,12936,77.54,2.78,19.67,2019,13502
71,0,9,80,88.75,0.0,11.25,2019,13342
3482,102,496,4080,85.34,2.5,12.16,2019,13619
1051,53,156,1260,83.41,4.21,12.38,2019,13730
1244,41,206,1491,83.43,2.75,13.82,2019,13476
314,0,71,385,81.56,0.0,18.44,2019,13615
509,8,138,655,77.71,1.22,21.07,2019,13679
677,27,222,926,73.11,2.92,23.97,2019,13812
13004,412,2845,16261,79.97,2.53,17.5,2019,13440
1047,68,116,1231,85.05,5.52,9.42,2019,13308
1415,74,346,1835,77.11,4.03,18.86,2019,13460
373,2,139,514,72.57,0.39,27.04,2019,13807
438,46,81,565,77.52,8.14,14.34,2019,13808
7992,164,1192,9348,85.49,1.75,12.75,2019,13069
8,0,24,32,25.0,0.0,75.0,2019,13674
8,0,0,8,100.0,0.0,0.0,2019,13677
163,0,29,192,84.9,0.0,15.1,2019,13678
16,0,6,22,72.73,0.0,27.27,2019,13692
39,0,0,39,100.0,0.0,0.0,2019,13695
37,0,0,37,100.0,0.0,0.0,2019,13696
64,9,0,73,87.67,12.33,0.0,2019,13751
31,8,0,39,79.49,20.51,0.0,2019,13784
16,0,0,16,100.0,0.0,0.0,2019,13794
87,3,25,115,75.65,2.61,21.74,2019,13806
15,0,0,15,100.0,0.0,0.0,2019,13826
63,0,0,63,100.0,0.0,0.0,2019,13845
28,0,0,28,100.0,0.0,0.0,2019,13847
7,0,0,7,100.0,0.0,0.0,2019,13860
8,0,0,8,100.0,0.0,0.0,2019,13902
19,0,15,34,55.88,0.0,44.12,2019,15921
49,0,20,69,71.01,0.0,28.99,2019,15922
13,0,22,35,37.14,0.0,62.86,2019,15945
181,0,40,221,81.9,0.0,18.1,2019,15951
39,0,0,39,100.0,0.0,0.0,2019,15953
136,0,41,177,76.84,0.0,23.16,2019,15960
58,2,10,70,82.86,2.86,14.29,2019,15962
52,0,0,52,100.0,0.0,0.0,2019,15353
548,17,115,680,80.59,2.5,16.91,2019,15376
3341,87,531,3959,84.39,2.2,13.41,2019,15005
285,0,80,365,78.08,0.0,21.92,2019,15018
3746,53,720,4519,82.89,1.17,15.93,2019,15037
3248,54,435,3737,86.91,1.45,11.64,2019,15042
1429,46,268,1743,81.99,2.64,15.38,2019,15059
181,9,47,237,76.37,3.8,19.83,2019,16420
861,28,99,988,87.15,2.83,10.02,2019,16421
1687,36,346,2069,81.54,1.74,16.72,2019,16433
466,23,438,927,50.27,2.48,47.25,2019,16434
448,5,110,563,79.57,0.89,19.54,2019,16613
101,4,34,139,72.66,2.88,24.46,2019,16620
545,10,177,732,74.45,1.37,24.18,2019,16650
80,37,45,162,49.38,22.84,27.78,2019,16677
32,0,25,57,56.14,0.0,43.86,2019,16694
219,0,60,279,78.49,0.0,21.51,2019,16726
14116,567,3015,17698,79.76,3.2,17.04,2019,16001
116,4,33,153,75.82,2.61,21.57,2019,16022
77,2,16,95,81.05,2.11,16.84,2019,16027
912,28,104,1044,87.36,2.68,9.96,2019,16052
129,10,42,181,71.27,5.52,23.2,2019,16054
129,7,50,186,69.35,3.76,26.88,2019,16671
1003,42,304,1349,74.35,3.11,22.54,2019,16651
1669,63,524,2256,73.98,2.79,23.23,2019,16662
522,8,186,716,72.91,1.12,25.98,2019,16664
1775,46,325,2146,82.71,2.14,15.14,2019,16673
122,7,61,190,64.21,3.68,32.11,2019,16689
1156,38,315,1509,76.61,2.52,20.87,2019,16693
343,7,77,427,80.33,1.64,18.03,2019,16695
5448,271,1550,7269,74.95,3.73,21.32,2019,16701
329,32,85,446,73.77,7.17,19.06,2019,16740
5774,172,283,6229,92.7,2.76,4.54,2019,16046
971,15,221,1207,80.45,1.24,18.31,2019,16051
4104,284,376,4764,86.15,5.96,7.89,2019,16057
2918,47,414,3379,86.36,1.39,12.25,2019,16059
2696,86,446,3228,83.52,2.66,13.82,2019,16063
398,3,61,462,86.15,0.65,13.2,2019,16020
68,3,19,90,75.56,3.33,21.11,2019,16036
809,23,208,1040,77.79,2.21,20.0,2019,16844
192,4,44,240,80.0,1.67,18.33,2019,16859
681,0,58,739,92.15,0.0,7.85,2019,16865
932,31,193,1156,80.62,2.68,16.7,2019,16327
633,11,122,766,82.64,1.44,15.93,2019,16342
291,0,0,291,100.0,0.0,0.0,2019,16343
3539,108,878,4525,78.21,2.39,19.4,2019,16354
4,0,4,8,50.0,0.0,50.0,2019,16361
6411,259,1342,8012,80.02,3.23,16.75,2019,16365
3869,109,443,4421,87.51,2.47,10.02,2019,16412
1473,41,491,2005,73.47,2.04,24.49,2019,16424
4010,112,719,4841,82.83,2.31,14.85,2019,16428
4003,239,1385,5627,71.14,4.25,24.61,2019,16503
3401,88,173,3662,92.87,2.4,4.72,2019,08823
1279,21,27,1327,96.38,1.58,2.03,2019,08836
5371,275,427,6073,88.44,4.53,7.03,2019,08840
2832,37,303,3172,89.28,1.17,9.55,2019,08848
13355,507,1010,14872,89.8,3.41,6.79,2019,08857
3670,200,398,4268,85.99,4.69,9.33,2019,08863
9688,189,1878,11755,82.42,1.61,15.98,2019,08865
1710,24,85,1819,94.01,1.32,4.67,2019,08867
7479,147,656,8282,90.3,1.77,7.92,2019,08876
1417,0,173,1590,89.12,0.0,10.88,2019,08880
470,0,31,501,93.81,0.0,6.19,2019,08887
3669,183,381,4233,86.68,4.32,9.0,2019,08889
5539,239,2963,8741,63.37,2.73,33.9,2019,08105
1512,21,185,1718,88.01,1.22,10.77,2019,08343
496,43,176,715,69.37,6.01,24.62,2019,74022
242,14,133,389,62.21,3.6,34.19,2019,74027
9709,405,2177,12291,78.99,3.3,17.71,2019,74063
1688,57,387,2132,79.17,2.67,18.15,2019,74073
6884,398,3679,10961,62.8,3.63,33.56,2019,78237
19729,995,2769,23493,83.98,4.24,11.79,2019,78240
19063,710,884,20657,92.28,3.44,4.28,2019,78249
7699,539,2176,10414,73.93,5.18,20.89,2019,78363
545,14,272,831,65.58,1.68,32.73,2019,78393
10475,325,2484,13284,78.85,2.45,18.7,2019,78415
1042,12,221,1275,81.73,0.94,17.33,2019,78417
15868,759,1514,18141,87.47,4.18,8.35,2019,78504
39,23,47,109,35.78,21.1,43.12,2019,78545
87,0,79,166,52.41,0.0,47.59,2019,78548
0,0,61,61,0.0,0.0,100.0,2019,78565
36,0,9,45,80.0,0.0,20.0,2019,78588
204,13,309,526,38.78,2.47,58.75,2019,78594
7622,317,1376,9315,81.83,3.4,14.77,2019,78602
48,0,9,57,84.21,0.0,15.79,2019,78607
5692,59,1215,6966,81.71,0.85,17.44,2019,78621
15634,303,2491,18428,84.84,1.64,13.52,2019,78640
4314,363,1303,5980,72.14,6.07,21.79,2019,78644
37,0,10,47,78.72,0.0,21.28,2019,78670
11857,126,554,12537,94.58,1.01,4.42,2019,78731
7219,115,417,7751,93.14,1.48,5.38,2019,78734
16090,2565,3009,21664,74.27,11.84,13.89,2019,78741
10522,134,238,10894,96.59,1.23,2.18,2019,78746
25711,288,938,26937,95.45,1.07,3.48,2019,78613
258,4,69,331,77.95,1.21,20.85,2019,78615
405,0,30,435,93.1,0.0,6.9,2019,78623
8174,83,559,8816,92.72,0.94,6.34,2019,78754
272,0,111,383,71.02,0.0,28.98,2019,78406
47,0,6,53,88.68,0.0,11.32,2019,78598
2420,55,245,2720,88.97,2.02,9.01,2019,78657
108,8,13,129,83.72,6.2,10.08,2019,78536
9063,446,3488,12997,69.73,3.43,26.84,2019,78541
10192,674,6484,17350,58.74,3.88,37.37,2019,78542
116,5,58,179,64.8,2.79,32.4,2019,78561
18,0,21,39,46.15,0.0,53.85,2019,78564
48,0,94,142,33.8,0.0,66.2,2019,78567
6384,169,3312,9865,64.71,1.71,33.57,2019,78573
9579,201,5768,15548,61.61,1.29,37.1,2019,78574
50,0,64,114,43.86,0.0,56.14,2019,78585
70,0,11,81,86.42,0.0,13.58,2019,78590
59,0,20,79,74.68,0.0,25.32,2019,78591
11225,189,552,11966,93.81,1.58,4.61,2019,78633
14369,151,271,14791,97.15,1.02,1.83,2019,78665
14,0,0,14,100.0,0.0,0.0,2019,78677
0,0,0,0,,,,2019,78712
21,0,0,21,100.0,0.0,0.0,2019,78802
54,0,0,54,100.0,0.0,0.0,2019,78843
7,0,0,7,100.0,0.0,0.0,2019,78871
111,0,40,151,73.51,0.0,26.49,2019,78931
0,0,0,0,,,,2019,78951
1175,34,347,1556,75.51,2.19,22.3,2019,78069
9738,57,667,10462,93.08,0.54,6.38,2019,78132
5485,227,155,5867,93.49,3.87,2.64,2019,78732
245,30,257,532,46.05,5.64,48.31,2019,78833
9353,775,2355,12483,74.93,6.21,18.87,2019,78218
106,10,40,156,67.95,6.41,25.64,2019,76491
6917,548,1642,9107,75.95,6.02,18.03,2019,76504
440,21,214,675,65.19,3.11,31.7,2019,76530
356,31,70,457,77.9,6.78,15.32,2019,76626
2587,48,473,3108,83.24,1.54,15.22,2019,76078
8193,671,1598,10462,78.31,6.41,15.27,2019,76106
70,0,19,89,78.65,0.0,21.35,2019,76474
338,18,93,449,75.28,4.01,20.71,2019,76483
37,0,10,47,78.72,0.0,21.28,2019,76490
1295,81,498,1874,69.1,4.32,26.57,2019,76557
1300,72,214,1586,81.97,4.54,13.49,2019,76579
5523,244,715,6482,85.21,3.76,11.03,2019,76015
21730,614,1931,24275,89.52,2.53,7.95,2019,76028
9122,94,74,9290,98.19,1.01,0.8,2019,76034
1699,66,384,2149,79.06,3.07,17.87,2019,76050
9060,265,1536,10861,83.42,2.44,14.14,2019,76053
5523,227,765,6515,84.77,3.48,11.74,2019,76058
16447,454,1293,18194,90.4,2.5,7.11,2019,76542
834,9,164,1007,82.82,0.89,16.29,2019,76527
1643,25,146,1814,90.57,1.38,8.05,2019,76537
2702,77,403,3182,84.92,2.42,12.66,2019,76539
3590,126,1240,4956,72.44,2.54,25.02,2019,76550
55,0,43,98,56.12,0.0,43.88,2019,76566
2766,46,744,3556,77.78,1.29,20.92,2019,76567
773,67,374,1214,63.67,5.52,30.81,2019,76577
306,12,126,444,68.92,2.7,28.38,2019,76622
464,36,221,721,64.36,4.99,30.65,2019,76629
2876,111,759,3746,76.78,2.96,20.26,2019,76645
589,21,159,769,76.59,2.73,20.68,2019,76687
8291,548,1975,10814,76.67,5.07,18.26,2019,76710
2474,289,707,3470,71.3,8.33,20.37,2019,76711
2028,76,495,2599,78.03,2.92,19.05,2019,76825
7292,442,2160,9894,73.7,4.47,21.83,2019,06114
5593,164,794,6551,85.38,2.5,12.12,2019,06119
1026,14,81,1121,91.53,1.25,7.23,2019,06247
3381,73,634,4088,82.71,1.79,15.51,2019,06260
2559,42,261,2862,89.41,1.47,9.12,2019,06281
424,0,0,424,100.0,0.0,0.0,2019,06282
2519,10,90,2619,96.18,0.38,3.44,2019,06333
88,0,0,88,100.0,0.0,0.0,2019,06376
2360,58,112,2530,93.28,2.29,4.43,2019,06378
737,0,174,911,80.9,0.0,19.1,2019,06782
2122,63,271,2456,86.4,2.57,11.03,2019,06759
243,11,21,275,88.36,4.0,7.64,2019,06785
4686,135,150,4971,94.27,2.72,3.02,2019,06812
3015,150,255,3420,88.16,4.39,7.46,2019,06855
3111,9,238,3358,92.64,0.27,7.09,2019,06906
7239,233,1255,8727,82.95,2.67,14.38,2019,06002
1832,0,195,2027,90.38,0.0,9.62,2019,06026
6440,162,674,7276,88.51,2.23,9.26,2019,06032
6742,173,649,7564,89.13,2.29,8.58,2019,06037
1740,17,64,1821,95.55,0.93,3.51,2019,06043
2144,52,163,2359,90.89,2.2,6.91,2019,06057
7549,337,735,8621,87.57,3.91,8.53,2019,06067
5008,0,244,5252,95.35,0.0,4.65,2019,06084
1150,20,147,1317,87.32,1.52,11.16,2019,06089
311,14,42,367,84.74,3.81,11.44,2019,06090
1227,0,60,1287,95.34,0.0,4.66,2019,06103
6934,237,1703,8874,78.14,2.67,19.19,2019,06108
2765,97,646,3508,78.82,2.77,18.42,2019,15074
105,0,79,184,57.07,0.0,42.93,2019,15078
238,0,134,372,63.98,0.0,36.02,2019,15083
2228,93,563,2884,77.25,3.22,19.52,2019,15089
7984,210,1830,10024,79.65,2.09,18.26,2019,15136
8457,238,1427,10122,83.55,2.35,14.1,2019,15202
3057,56,540,3653,83.68,1.53,14.78,2019,15204
11728,426,2456,14610,80.27,2.92,16.81,2019,15206
4694,120,742,5556,84.49,2.16,13.35,2019,15211
45,0,3,48,93.75,0.0,6.25,2019,15316
14178,188,1345,15711,90.24,1.2,8.56,2019,15317
3527,162,1075,4764,74.03,3.4,22.57,2019,15207
4630,112,859,5601,82.66,2.0,15.34,2019,15209
8503,468,1206,10177,83.55,4.6,11.85,2019,15213
2658,14,430,3102,85.69,0.45,13.86,2019,15223
468,12,85,565,82.83,2.12,15.04,2019,15225
1168,0,334,1502,77.76,0.0,22.24,2019,15233
188,0,35,223,84.3,0.0,15.7,2019,15315
655,8,107,770,85.06,1.04,13.9,2019,15322
194,6,79,279,69.53,2.15,28.32,2019,15324
2280,71,598,2949,77.31,2.41,20.28,2019,15133
473,25,56,554,85.38,4.51,10.11,2019,15329
1794,23,176,1993,90.02,1.15,8.83,2019,15330
407,27,23,457,89.06,5.91,5.03,2019,15340
568,0,40,608,93.42,0.0,6.58,2019,15357
174,0,59,233,74.68,0.0,25.32,2019,15377
32,0,13,45,71.11,0.0,28.89,2019,15379
2846,51,639,3536,80.49,1.44,18.07,2019,15332
174,0,27,201,86.57,0.0,13.43,2019,15337
260,0,49,309,84.14,0.0,15.86,2019,15341
521,12,146,679,76.73,1.77,21.5,2019,15349
230,14,28,272,84.56,5.15,10.29,2019,15358
69,0,0,69,100.0,0.0,0.0,2019,15359
140,0,55,195,71.79,0.0,28.21,2019,15368
6512,160,1760,8432,77.23,1.9,20.87,2019,15425
183,0,74,257,71.21,0.0,28.79,2019,15363
241,2,43,286,84.27,0.7,15.03,2019,15364
288,0,67,355,81.13,0.0,18.87,2019,15433
934,55,229,1218,76.68,4.52,18.8,2019,15436
602,20,235,857,70.25,2.33,27.42,2019,15442
225,6,95,326,69.02,1.84,29.14,2019,16679
110,10,31,151,72.85,6.62,20.53,2019,16683
94,17,35,146,64.38,11.64,23.97,2019,16691
45,0,13,58,77.59,0.0,22.41,2019,16724
26,7,24,57,45.61,12.28,42.11,2019,16730
3273,59,240,3572,91.63,1.65,6.72,2019,07716
800,14,83,897,89.19,1.56,9.25,2019,07717
5899,180,143,6222,94.81,2.89,2.3,2019,07751
2014,58,150,2222,90.64,2.61,6.75,2019,07755
1376,78,214,1668,82.49,4.68,12.83,2019,07827
1119,10,144,1273,87.9,0.79,11.31,2019,07832
45,0,0,45,100.0,0.0,0.0,2019,07842
3275,65,208,3548,92.31,1.83,5.86,2019,07876
1490,15,85,1590,93.71,0.94,5.35,2019,07927
457,5,54,516,88.57,0.97,10.47,2019,07934
2859,23,227,3109,91.96,0.74,7.3,2019,07945
6730,55,362,7147,94.17,0.77,5.07,2019,07950
3318,23,225,3566,93.05,0.64,6.31,2019,07463
5122,364,2408,7894,64.88,4.61,30.5,2019,07206
11168,372,2201,13741,81.28,2.71,16.02,2019,08332
845,15,93,953,88.67,1.57,9.76,2019,08020
2962,94,579,3635,81.49,2.59,15.93,2019,08066
3622,50,720,4392,82.47,1.14,16.39,2019,08031
9978,131,908,11017,90.57,1.19,8.24,2019,08043
698,31,80,809,86.28,3.83,9.89,2019,08202
14389,239,936,15564,92.45,1.54,6.01,2019,08817
2828,26,297,3151,89.75,0.83,9.43,2019,08833
9399,72,739,10210,92.06,0.71,7.24,2019,08205
0,0,0,0,,,,2019,08240
14,0,38,52,26.92,0.0,73.08,2019,08246
0,0,0,0,,,,2019,08320
78,0,7,85,91.76,0.0,8.24,2019,08808
12857,271,675,13803,93.15,1.96,4.89,2019,08844
8,0,0,8,100.0,0.0,0.0,2019,08890
3154,111,279,3544,89.0,3.13,7.87,2019,08071
0,0,0,0,,,,2019,08217
453,0,0,453,100.0,0.0,0.0,2019,08340
1475,68,190,1733,85.11,3.92,10.96,2019,08542
1261,50,56,1367,92.25,3.66,4.1,2019,08560
5079,252,2975,8306,61.15,3.03,35.82,2019,08611
6326,30,553,6909,91.56,0.43,8.0,2019,08690
6927,65,626,7618,90.93,0.85,8.22,2019,08731
12019,886,3694,16599,72.41,5.34,22.25,2019,08757
903,15,54,972,92.9,1.54,5.56,2019,08804
1990,33,179,2202,90.37,1.5,8.13,2019,08809
3007,13,76,3096,97.13,0.42,2.45,2019,08810
5370,56,309,5735,93.64,0.98,5.39,2019,08904
9998,2953,3733,16684,59.93,17.7,22.37,2019,08861
4801,73,878,5752,83.47,1.27,15.26,2019,08882
2727,98,382,3207,85.03,3.06,11.91,2019,08884
365,10,29,404,90.35,2.48,7.18,2019,08241
5724,106,601,6431,89.01,1.65,9.35,2019,08830
684,223,145,1052,65.02,21.2,13.78,2019,08832
207,17,102,326,63.5,5.21,31.29,2019,08001
150,8,19,177,84.75,4.52,10.73,2019,08006
3562,46,735,4343,82.02,1.06,16.92,2019,08010
107,0,36,143,74.83,0.0,25.17,2019,08023
1454,115,357,1926,75.49,5.97,18.54,2019,08027
4119,47,521,4687,87.88,1.0,11.12,2019,08048
3833,184,703,4720,81.21,3.9,14.89,2019,08069
3305,79,409,3793,87.13,2.08,10.78,2019,08106
4561,81,693,5335,85.49,1.52,12.99,2019,08107
3566,42,292,3900,91.44,1.08,7.49,2019,08201
3731,0,298,4029,92.6,0.0,7.4,2019,08004
196,4,43,243,80.66,1.65,17.7,2019,12503
569,45,73,687,82.82,6.55,10.63,2019,12463
1072,0,93,1165,92.02,0.0,7.98,2019,12484
2060,32,291,2383,86.45,1.34,12.21,2019,12498
608,22,120,750,81.07,2.93,16.0,2019,12523
941,53,98,1092,86.17,4.85,8.97,2019,12525
1325,26,171,1522,87.06,1.71,11.24,2019,12526
7901,142,569,8612,91.74,1.65,6.61,2019,12533
1588,93,347,2028,78.3,4.59,17.11,2019,12545
368,15,140,523,70.36,2.87,26.77,2019,12565
3462,123,411,3996,86.64,3.08,10.29,2019,12569
3466,111,163,3740,92.67,2.97,4.36,2019,12572
448,0,55,503,89.07,0.0,10.93,2019,12592
442,70,196,708,62.43,9.89,27.68,2019,12729
4242,252,1077,5571,76.14,4.52,19.33,2019,78219
12436,1282,4356,18074,68.81,7.09,24.1,2019,78223
2782,145,1285,4212,66.05,3.44,30.51,2019,78225
11738,553,2473,14764,79.5,3.75,16.75,2019,78227
345,12,64,421,81.95,2.85,15.2,2019,61467
54,0,0,54,100.0,0.0,0.0,2019,61468
219,4,45,268,81.72,1.49,16.79,2019,61482
1002,6,250,1258,79.65,0.48,19.87,2019,61517
1062,27,249,1338,79.37,2.02,18.61,2019,61531
190,9,36,235,80.85,3.83,15.32,2019,61532
970,53,156,1179,82.27,4.5,13.23,2019,61536
30,0,11,41,73.17,0.0,26.83,2019,61541
1135,34,342,1511,75.12,2.25,22.63,2019,61542
13521,377,3300,17198,78.62,2.19,19.19,2019,61554
605,14,145,764,79.19,1.83,18.98,2019,61570
108,1,52,161,67.08,0.62,32.3,2019,61730
907,37,190,1134,79.98,3.26,16.75,2019,61734
130,0,24,154,84.42,0.0,15.58,2019,61735
598,2,45,645,92.71,0.31,6.98,2019,61736
825,31,53,909,90.76,3.41,5.83,2019,61011
741,27,73,841,88.11,3.21,8.68,2019,61012
1209,40,84,1333,90.7,3.0,6.3,2019,61019
7261,329,1304,8894,81.64,3.7,14.66,2019,61021
330,11,103,444,74.32,2.48,23.2,2019,61038
222,0,72,294,75.51,0.0,24.49,2019,61042
437,24,66,527,82.92,4.55,12.52,2019,61070
6678,160,270,7108,93.95,2.25,3.8,2019,61073
351,11,81,443,79.23,2.48,18.28,2019,61075
811,34,188,1033,78.51,3.29,18.2,2019,61250
294,3,105,402,73.13,0.75,26.12,2019,61260
3822,160,688,4670,81.84,3.43,14.73,2019,61264
999,43,203,1245,80.24,3.45,16.31,2019,61273
18,0,10,28,64.29,0.0,35.71,2019,61276
1038,34,216,1288,80.59,2.64,16.77,2019,61277
2669,206,595,3470,76.92,5.94,17.15,2019,61282
161,7,28,196,82.14,3.57,14.29,2019,61312
475,19,90,584,81.34,3.25,15.41,2019,61319
128,0,24,152,84.21,0.0,15.79,2019,61335
2779,42,457,3278,84.78,1.28,13.94,2019,61341
25,0,6,31,80.65,0.0,19.35,2019,61346
1027,20,67,1114,92.19,1.8,6.01,2019,61360
268,11,84,363,73.83,3.03,23.14,2019,61367
468,21,110,599,78.13,3.51,18.36,2019,61370
504,11,74,589,85.57,1.87,12.56,2019,61412
884,27,315,1226,72.1,2.2,25.69,2019,61422
209,9,66,284,73.59,3.17,23.24,2019,61423
144,0,57,201,71.64,0.0,28.36,2019,61425
84,0,19,103,81.55,0.0,18.45,2019,61439
1162,56,160,1378,84.33,4.06,11.61,2019,61448
3777,170,562,4509,83.77,3.77,12.46,2019,61462
806,6,208,1020,79.02,0.59,20.39,2019,61469
111,15,50,176,63.07,8.52,28.41,2019,61470
231,5,38,274,84.31,1.82,13.87,2019,61472
84,2,22,108,77.78,1.85,20.37,2019,61474
88,2,30,120,73.33,1.67,25.0,2019,61475
275,20,70,365,75.34,5.48,19.18,2019,61489
91,0,10,101,90.1,0.0,9.9,2019,61519
185,0,86,271,68.27,0.0,31.73,2019,61526
670,28,196,894,74.94,3.13,21.92,2019,61533
9276,298,1343,10917,84.97,2.73,12.3,2019,06109
467,0,35,502,93.03,0.0,6.97,2019,06242
2554,34,230,2818,90.63,1.21,8.16,2019,06249
9,0,0,9,100.0,0.0,0.0,2019,06269
2161,146,270,2577,83.86,5.67,10.48,2019,06279
8622,469,1649,10740,80.28,4.37,15.35,2019,06320
1651,39,226,1916,86.17,2.04,11.8,2019,06331
5717,97,802,6616,86.41,1.47,12.12,2019,06351
5037,204,656,5897,85.42,3.46,11.12,2019,06416
1545,18,116,1679,92.02,1.07,6.91,2019,06420
12050,344,2996,15390,78.3,2.24,19.47,2019,06450
15600,597,3097,19294,80.85,3.09,16.05,2019,06457
4587,44,343,4974,92.22,0.88,6.9,2019,06477
467,16,74,557,83.84,2.87,13.29,2019,06481
10737,619,1193,12549,85.56,4.93,9.51,2019,06614
1045,20,139,1204,86.79,1.66,11.54,2019,06751
2847,130,370,3347,85.06,3.88,11.05,2019,06779
2786,113,294,3193,87.25,3.54,9.21,2019,06787
12199,403,1870,14472,84.29,2.78,12.92,2019,06790
297,10,27,334,88.92,2.99,8.08,2019,06794
4499,88,549,5136,87.6,1.71,10.69,2019,06795
10226,191,507,10924,93.61,1.75,4.64,2019,06811
6923,68,540,7531,91.93,0.9,7.17,2019,06850
3375,18,54,3447,97.91,0.52,1.57,2019,06883
3288,62,80,3430,95.86,1.81,2.33,2019,06896
3334,153,595,4082,81.68,3.75,14.58,2019,06901
2983,85,157,3225,92.5,2.64,4.87,2019,06907
1604,107,172,1883,85.18,5.68,9.13,2019,06417
6242,201,469,6912,90.31,2.91,6.79,2019,06443
7938,450,1847,10235,77.56,4.4,18.05,2019,06451
1064,46,91,1201,88.59,3.83,7.58,2019,06455
14630,413,1613,16656,87.84,2.48,9.68,2019,06460
17741,1129,3429,22299,79.56,5.06,15.38,2019,10469
3981,20,71,4072,97.77,0.49,1.74,2019,10514
685,0,0,685,100.0,0.0,0.0,2019,10526
267,0,0,267,100.0,0.0,0.0,2019,10578
8164,92,652,8908,91.65,1.03,7.32,2019,10591
6694,176,385,7255,92.27,2.43,5.31,2019,10605
17931,1088,4546,23565,76.09,4.62,19.29,2019,10701
19929,3788,9742,33459,59.56,11.32,29.12,2019,10002
23977,627,6866,31470,76.19,1.99,21.82,2019,10029
18134,413,3197,21744,83.4,1.9,14.7,2019,10031
13200,500,2456,16156,81.7,3.09,15.2,2019,10034
13728,452,2230,16410,83.66,2.75,13.59,2019,10040
0,0,0,0,,,,2019,10103
0,0,0,0,,,,2019,10154
0,0,0,0,,,,2019,10173
13407,597,3052,17056,78.61,3.5,17.89,2019,11237
14592,288,5045,19925,73.23,1.45,25.32,2019,11354
5985,75,1441,7501,79.79,1.0,19.21,2019,11356
7273,287,981,8541,85.15,3.36,11.49,2019,11360
5996,46,946,6988,85.8,0.66,13.54,2019,11362
4068,46,420,4534,89.72,1.01,9.26,2019,11366
6567,142,1141,7850,83.66,1.81,14.54,2019,11370
0,0,0,0,,,,2019,11371
16337,385,2827,19549,83.57,1.97,14.46,2019,11374
11421,273,1679,13373,85.4,2.04,12.56,2019,11379
10522,163,1482,12167,86.48,1.34,12.18,2019,11419
8508,446,1010,9964,85.39,4.48,10.14,2019,11422
712,26,24,762,93.44,3.41,3.15,2019,07418
3537,55,184,3776,93.67,1.46,4.87,2019,07452
3832,96,1471,5399,70.98,1.78,27.25,2019,07503
3284,100,211,3595,91.35,2.78,5.87,2019,07512
4058,193,1848,6099,66.54,3.16,30.3,2019,07514
2470,59,263,2792,88.47,2.11,9.42,2019,07603
2644,36,98,2778,95.18,1.3,3.53,2019,07624
5600,89,681,6370,87.91,1.4,10.69,2019,07628
4335,277,410,5022,86.32,5.52,8.16,2019,07001
7988,91,815,8894,89.81,1.02,9.16,2019,07016
713,18,34,765,93.2,2.35,4.44,2019,07021
15286,336,1857,17479,87.45,1.92,10.62,2019,07024
2408,89,236,2733,88.11,3.26,8.64,2019,07033
3076,86,156,3318,92.71,2.59,4.7,2019,07034
1346,0,11,1357,99.19,0.0,0.81,2019,07046
18701,342,2751,21794,85.81,1.57,12.62,2019,07047
868,23,46,937,92.64,2.45,4.91,2019,07074
10018,186,829,11033,90.8,1.69,7.51,2019,07110
5898,353,1151,7402,79.68,4.77,15.55,2019,07203
17392,624,1938,19954,87.16,3.13,9.71,2019,07728
5306,32,521,5859,90.56,0.55,8.89,2019,07646
4713,53,562,5328,88.46,0.99,10.55,2019,07663
7686,138,571,8395,91.55,1.64,6.8,2019,07719
1098,83,66,1247,88.05,6.66,5.29,2019,07721
5146,201,474,5821,88.4,3.45,8.14,2019,07730
5845,456,803,7104,82.28,6.42,11.3,2019,07735
10939,329,624,11892,91.99,2.77,5.25,2019,07747
2664,215,452,3331,79.98,6.45,13.57,2019,07823
2212,22,251,2485,89.01,0.89,10.1,2019,07764
1136,9,112,1257,90.37,0.72,8.91,2019,07803
3098,91,163,3352,92.42,2.71,4.86,2019,07821
206,20,53,279,73.84,7.17,19.0,2019,07822
3112,17,360,3489,89.19,0.49,10.32,2019,07825
50,0,6,56,89.29,0.0,10.71,2019,07833
15,0,0,15,100.0,0.0,0.0,2019,07846
1289,20,156,1465,87.99,1.37,10.65,2019,07863
8693,67,409,9169,94.81,0.73,4.46,2019,07869
206,27,7,240,85.83,11.25,2.92,2019,07878
7808,116,452,8376,93.22,1.38,5.4,2019,07901
3870,38,236,4144,93.39,0.92,5.69,2019,07922
270,0,32,302,89.4,0.0,10.6,2019,07976
7957,121,545,8623,92.28,1.4,6.32,2019,07866
9234,204,364,9802,94.21,2.08,3.71,2019,07920
2495,0,86,2581,96.67,0.0,3.33,2019,07924
57,0,0,57,100.0,0.0,0.0,2019,07970
8122,148,843,9113,89.13,1.62,9.25,2019,11001
1835,15,149,1999,91.8,0.75,7.45,2019,11024
10287,100,562,10949,93.95,0.91,5.13,2019,11050
18344,449,4604,23397,78.4,1.92,19.68,2019,11204
20349,382,4117,24848,81.89,1.54,16.57,2019,11218
23474,406,4071,27951,83.98,1.45,14.56,2019,11223
13527,534,4869,18930,71.46,2.82,25.72,2019,11224
25424,607,4255,30286,83.95,2.0,14.05,2019,11373
5636,131,524,6291,89.59,2.08,8.33,2019,11030
7278,135,649,8062,90.28,1.67,8.05,2019,11967
718,4,87,809,88.75,0.49,10.75,2019,11977
6769,109,676,7554,89.61,1.44,8.95,2019,11762
7139,192,627,7958,89.71,2.41,7.88,2019,11776
2549,26,300,2875,88.66,0.9,10.43,2019,11789
436,18,28,482,90.46,3.73,5.81,2019,05738
241,24,8,273,88.28,8.79,2.93,2019,05742
410,13,104,527,77.8,2.47,19.73,2019,05767
183,10,61,254,72.05,3.94,24.02,2019,05820
104,0,11,115,90.43,0.0,9.57,2019,05827
234,4,73,311,75.24,1.29,23.47,2019,05867
607,12,50,669,90.73,1.79,7.47,2019,05444
409,13,64,486,84.16,2.67,13.17,2019,05456
525,11,87,623,84.27,1.77,13.96,2019,05457
1674,77,171,1922,87.1,4.01,8.9,2019,05461
637,20,49,706,90.23,2.83,6.94,2019,05486
2490,14,313,2817,88.39,0.5,11.11,2019,05488
601,27,48,676,88.91,3.99,7.1,2019,05651
234,3,53,290,80.69,1.03,18.28,2019,05652
405,0,60,465,87.1,0.0,12.9,2019,05654
678,39,171,888,76.35,4.39,19.26,2019,05667
1726,71,202,1999,86.34,3.55,10.11,2019,05676
868,32,112,1012,85.77,3.16,11.07,2019,05677
47,0,0,47,100.0,0.0,0.0,2019,05678
1219,61,294,1574,77.45,3.88,18.68,2019,05743
131,2,17,150,87.33,1.33,11.33,2019,05748
216,7,46,269,80.3,2.6,17.1,2019,05778
37,0,0,37,100.0,0.0,0.0,2019,05825
96,0,12,108,88.89,0.0,11.11,2019,05833
853,48,238,1139,74.89,4.21,20.9,2019,05857
258,14,126,398,64.82,3.52,31.66,2019,05872
217,35,38,290,74.83,12.07,13.1,2019,05873
80,0,16,96,83.33,0.0,16.67,2019,05902
97,0,10,107,90.65,0.0,9.35,2019,05052
1456,120,331,1907,76.35,6.29,17.36,2019,05089
530,2,91,623,85.07,0.32,14.61,2019,05151
1612,190,258,2060,78.25,9.22,12.52,2019,05346
226,56,20,302,74.83,18.54,6.62,2019,05355
222,88,18,328,67.68,26.83,5.49,2019,05356
600,188,145,933,64.31,20.15,15.54,2019,05363
602,15,136,753,79.95,1.99,18.06,2019,05440
62,16,5,83,74.7,19.28,6.02,2019,05360
190,14,27,231,82.25,6.06,11.69,2019,05042
143,8,31,182,78.57,4.4,17.03,2019,05841
36,0,0,36,100.0,0.0,0.0,2019,05031
402,18,110,530,75.85,3.4,20.75,2019,05077
113,48,42,203,55.67,23.65,20.69,2019,05341
287,12,15,314,91.4,3.82,4.78,2019,05751
298,6,33,337,88.43,1.78,9.79,2019,05757
329,10,193,532,61.84,1.88,36.28,2019,05846
11196,240,1585,13021,85.98,1.84,12.17,2019,08723
2852,169,352,3373,84.55,5.01,10.44,2019,08734
954,21,210,1185,80.51,1.77,17.72,2019,08752
13807,629,4940,19376,71.26,3.25,25.5,2019,08759
4225,50,288,4563,92.59,1.1,6.31,2019,08812
15725,1166,4944,21835,72.02,5.34,22.64,2019,10472
367,0,29,396,92.68,0.0,7.32,2019,10518
810,0,16,826,98.06,0.0,1.94,2019,10537
402,0,8,410,98.05,0.0,1.95,2019,10546
10051,194,1278,11523,87.23,1.68,11.09,2019,10309
28314,1949,6779,37042,76.44,5.26,18.3,2019,10467
3384,73,351,3808,88.87,1.92,9.22,2019,10604
1461,28,230,1719,84.99,1.63,13.38,2019,10928
22509,1466,6885,30860,72.94,4.75,22.31,2019,10456
238,19,119,376,63.3,5.05,31.65,2019,04912
3199,152,586,3937,81.25,3.86,14.88,2019,04915
29,0,2,31,93.55,0.0,6.45,2019,04925
2061,37,661,2759,74.7,1.34,23.96,2019,04937
302,0,85,387,78.04,0.0,21.96,2019,04949
55,0,0,55,100.0,0.0,0.0,2019,04962
683,24,170,877,77.88,2.74,19.38,2019,04965
1026,19,279,1324,77.49,1.44,21.07,2019,04974
141,0,8,149,94.63,0.0,5.37,2019,04003
1194,113,302,1609,74.21,7.02,18.77,2019,04015
18,0,0,18,100.0,0.0,0.0,2019,04019
602,10,87,699,86.12,1.43,12.45,2019,04029
763,0,0,763,100.0,0.0,0.0,2019,04030
5023,345,644,6012,83.55,5.74,10.71,2019,04038
3740,311,439,4490,83.3,6.93,9.78,2019,04064
369,28,162,559,66.01,5.01,28.98,2019,04068
534,21,35,590,90.51,3.56,5.93,2019,04069
276,24,40,340,81.18,7.06,11.76,2019,04091
2721,47,363,3131,86.91,1.5,11.59,2019,04093
2308,61,248,2617,88.19,2.33,9.48,2019,04364
3204,148,418,3770,84.99,3.93,11.09,2019,04412
62,0,33,95,65.26,0.0,34.74,2019,04413
1554,137,221,1912,81.28,7.17,11.56,2019,04426
301,21,106,428,70.33,4.91,24.77,2019,04435
456,19,64,539,84.6,3.53,11.87,2019,04449
251,22,146,419,59.9,5.25,34.84,2019,04459
269,58,0,327,82.26,17.74,0.0,2019,04544
190,6,11,207,91.79,2.9,5.31,2019,04573
291,18,59,368,79.08,4.89,16.03,2019,04623
31,0,8,39,79.49,0.0,20.51,2019,04625
0,0,0,0,,,,2019,04629
608,10,161,779,78.05,1.28,20.67,2019,04634
208,8,61,277,75.09,2.89,22.02,2019,04648
220,15,57,292,75.34,5.14,19.52,2019,04653
125,0,57,182,68.68,0.0,31.32,2019,04674
115,0,11,126,91.27,0.0,8.73,2019,04733
2774,301,969,4044,68.6,7.44,23.96,2019,04736
333,17,68,418,79.67,4.07,16.27,2019,04745
16,0,2,18,88.89,0.0,11.11,2019,04764
233,51,78,362,64.36,14.09,21.55,2019,04772
200,26,69,295,67.8,8.81,23.39,2019,04774
608,73,283,964,63.07,7.57,29.36,2019,04785
157,9,49,215,73.02,4.19,22.79,2019,04787
40,0,2,42,95.24,0.0,4.76,2019,04851
610,15,75,700,87.14,2.14,10.71,2019,04854
8,0,17,25,32.0,0.0,68.0,2019,72617
193,49,30,272,70.96,18.01,11.03,2019,72060
128,0,54,182,70.33,0.0,29.67,2019,72134
8752,403,1205,10360,84.48,3.89,11.63,2019,72205
234,0,120,354,66.1,0.0,33.9,2019,72374
1472,55,584,2111,69.73,2.61,27.66,2019,72454
112,0,33,145,77.24,0.0,22.76,2019,72140
8361,428,3150,11939,70.03,3.58,26.38,2019,72204
547,73,243,863,63.38,8.46,28.16,2019,72013
469,8,208,685,68.47,1.17,30.36,2019,72863
671,0,269,940,71.38,0.0,28.62,2019,72843
723,51,265,1039,69.59,4.91,25.51,2019,72847
1030,42,228,1300,79.23,3.23,17.54,2019,72858
103,0,13,116,88.79,0.0,11.21,2019,72930
9835,193,2563,12591,78.11,1.53,20.36,2019,02904
10316,306,3545,14167,72.82,2.16,25.02,2019,02909
4173,29,485,4687,89.03,0.62,10.35,2019,02917
21126,335,1884,23345,90.49,1.43,8.07,2019,02360
3624,43,211,3878,93.45,1.11,5.44,2019,02375
54,21,0,75,72.0,28.0,0.0,2019,02047
16,0,14,30,53.33,0.0,46.67,2019,02203
24,0,0,24,100.0,0.0,0.0,2019,02357
0,8,0,8,0.0,100.0,0.0,2019,02457
97,0,14,111,87.39,0.0,12.61,2019,02553
1392,179,179,1750,79.54,10.23,10.23,2019,02557
65,0,72,137,47.45,0.0,52.55,2019,02561
1219,17,56,1292,94.35,1.32,4.33,2019,02562
66,0,0,66,100.0,0.0,0.0,2019,02564
0,0,0,0,,,,2019,02584
77,0,0,77,100.0,0.0,0.0,2019,02637
42,8,67,117,35.9,6.84,57.26,2019,02641
0,0,0,0,,,,2019,02643
8,0,0,8,100.0,0.0,0.0,2019,02651
28,0,36,64,43.75,0.0,56.25,2019,02663
156,50,28,234,66.67,21.37,11.97,2019,02791
201,0,52,253,79.45,0.0,20.55,2019,02802
164,0,14,178,92.13,0.0,7.87,2019,02826
0,0,0,0,,,,2019,02841
64,0,68,132,48.48,0.0,51.52,2019,02872
106,0,0,106,100.0,0.0,0.0,2019,02873
219,0,0,219,100.0,0.0,0.0,2019,02876
0,0,0,0,,,,2019,02912
15855,726,3329,19910,79.63,3.65,16.72,2019,02780
674,0,90,764,88.22,0.0,11.78,2019,02808
359,12,32,403,89.08,2.98,7.94,2019,02812
6709,154,736,7599,88.29,2.03,9.69,2019,02818
1822,19,190,2031,89.71,0.94,9.35,2019,02825
746,23,88,857,87.05,2.68,10.27,2019,02827
2803,93,263,3159,88.73,2.94,8.33,2019,02857
966,59,19,1044,92.53,5.65,1.82,2019,02881
555,0,26,581,95.52,0.0,4.48,2019,02898
7232,420,1710,9362,77.25,4.49,18.27,2019,02907
5416,68,230,5714,94.78,1.19,4.03,2019,02332
8074,254,943,9271,87.09,2.74,10.17,2019,02346
0,0,0,0,,,,2019,02366
10408,190,1314,11912,87.37,1.6,11.03,2019,02368
7864,220,323,8407,93.54,2.62,3.84,2019,02445
9959,176,1462,11597,85.88,1.52,12.61,2019,02453
1960,22,26,2008,97.61,1.1,1.29,2019,02468
67,0,19,86,77.91,0.0,22.09,2019,97484
263,9,10,282,93.26,3.19,3.55,2019,97486
2372,130,496,2998,79.12,4.34,16.54,2019,97496
12228,708,2221,15157,80.68,4.67,14.65,2019,97526
428,0,67,495,86.46,0.0,13.54,2019,97534
2567,44,482,3093,82.99,1.42,15.58,2019,97537
584,9,84,677,86.26,1.33,12.41,2019,97538
1486,80,531,2097,70.86,3.81,25.32,2019,97630
2128,16,448,2592,82.1,0.62,17.28,2019,97707
72,2,32,106,67.92,1.89,30.19,2019,97721
97,2,2,101,96.04,1.98,1.98,2019,97730
25,0,13,38,65.79,0.0,34.21,2019,97732
917,19,139,1075,85.3,1.77,12.93,2019,97734
0,0,0,0,,,,2019,97752
4488,188,732,5408,82.99,3.48,13.54,2019,03743
521,32,88,641,81.28,4.99,13.73,2019,03745
272,0,27,299,90.97,0.0,9.03,2019,03750
2460,122,37,2619,93.93,4.66,1.41,2019,03755
126,0,0,126,100.0,0.0,0.0,2019,03770
269,5,70,344,78.2,1.45,20.35,2019,03771
613,46,94,753,81.41,6.11,12.48,2019,03774
11826,316,1366,13508,87.55,2.34,10.11,2019,03820
953,0,73,1026,92.88,0.0,7.12,2019,03826
129,6,12,147,87.76,4.08,8.16,2019,03832
920,14,153,1087,84.64,1.29,14.08,2019,03269
2826,51,423,3300,85.64,1.55,12.82,2019,03276
5384,202,664,6250,86.14,3.23,10.62,2019,03303
54,0,15,69,78.26,0.0,21.74,2019,03441
1537,33,192,1762,87.23,1.87,10.9,2019,03461
1591,102,300,1993,79.83,5.12,15.05,2019,03470
2075,0,456,2531,81.98,0.0,18.02,2019,03446
373,0,46,419,89.02,0.0,10.98,2019,03450
680,27,130,837,81.24,3.23,15.53,2019,03465
1198,36,209,1443,83.02,2.49,14.48,2019,03581
1222,41,207,1470,83.13,2.79,14.08,2019,03598
1304,62,195,1561,83.54,3.97,12.49,2019,03741
1914,124,108,2146,89.19,5.78,5.03,2019,03748
1274,0,98,1372,92.86,0.0,7.14,2019,03813
358,49,40,447,80.09,10.96,8.95,2019,03817
2645,444,98,3187,82.99,13.93,3.07,2019,03824
562,0,56,618,90.94,0.0,9.06,2019,03837
395,62,47,504,78.37,12.3,9.33,2019,03838
6333,164,540,7037,90.0,2.33,7.67,2019,03842
354,32,26,412,85.92,7.77,6.31,2019,03846
1750,16,87,1853,94.44,0.86,4.7,2019,03858
517,24,53,594,87.04,4.04,8.92,2019,03882
1251,7,83,1341,93.29,0.52,6.19,2019,03884
2617,18,162,2797,93.56,0.64,5.79,2019,03885
1952,84,120,2156,90.54,3.9,5.57,2019,03873
3195,140,252,3587,89.07,3.9,7.03,2019,03904
817,11,101,929,87.94,1.18,10.87,2019,03905
517,14,45,576,89.76,2.43,7.81,2019,03907
4097,33,421,4551,90.02,0.73,9.25,2019,03909
2276,234,384,2894,78.65,8.09,13.27,2019,03561
334,8,54,396,84.34,2.02,13.64,2019,03583
124,14,16,154,80.52,9.09,10.39,2019,03607
236,0,89,325,72.62,0.0,27.38,2019,03609
96,12,47,155,61.94,7.74,30.32,2019,03780
927,28,217,1172,79.1,2.39,18.52,2019,03814
1485,14,185,1684,88.18,0.83,10.99,2019,02538
749,11,13,773,96.9,1.42,1.68,2019,02630
1252,46,213,1511,82.86,3.04,14.1,2019,02639
624,0,86,710,87.89,0.0,12.11,2019,02670
5016,259,1658,6933,72.35,3.74,23.91,2019,02723
738,42,151,931,79.27,4.51,16.22,2019,02725
5616,44,391,6051,92.81,0.73,6.46,2019,02806
11809,265,1264,13338,88.54,1.99,9.48,2019,02816
2503,42,475,3020,82.88,1.39,15.73,2019,02828
1841,0,78,1919,95.94,0.0,4.06,2019,02832
1194,0,157,1351,88.38,0.0,11.62,2019,02838
11379,151,1708,13238,85.96,1.14,12.9,2019,02864
5736,198,635,6569,87.32,3.01,9.67,2019,02878
1809,15,93,1917,94.37,0.78,4.85,2019,02892
4568,62,503,5133,88.99,1.21,9.8,2019,10520
2524,53,127,2704,93.34,1.96,4.7,2019,10590
5354,194,627,6175,86.7,3.14,10.15,2019,10960
11866,227,904,12997,91.3,1.75,6.96,2019,10001
9628,276,4620,14524,66.29,1.9,31.81,2019,10035
13924,407,924,15255,91.27,2.67,6.06,2019,10065
10487,276,625,11388,92.09,2.42,5.49,2019,10075
0,0,0,0,,,,2019,10110
0,0,0,0,,,,2019,10168
0,0,0,0,,,,2019,10174
0,0,0,0,,,,2019,10199
0,0,0,0,,,,2019,10311
308,0,60,368,83.7,0.0,16.3,2019,10505
152,0,0,152,100.0,0.0,0.0,2019,10517
0,0,0,0,,,,2019,10545
337,8,109,454,74.23,1.76,24.01,2019,10596
0,0,0,0,,,,2019,10910
0,0,0,0,,,,2019,10911
115,0,0,115,100.0,0.0,0.0,2019,10914
30,0,0,30,100.0,0.0,0.0,2019,10915
577,0,46,623,92.62,0.0,7.38,2019,10922
31,19,0,50,62.0,38.0,0.0,2019,10932
169,8,0,177,95.48,4.52,0.0,2019,10933
58,0,0,58,100.0,0.0,0.0,2019,10953
76,0,0,76,100.0,0.0,0.0,2019,10979
212,0,23,235,90.21,0.0,9.79,2019,10988
2267,17,132,2416,93.83,0.7,5.46,2019,10607
20958,870,4500,26328,79.6,3.3,17.09,2019,10468
9240,2059,2445,13744,67.23,14.98,17.79,2019,10550
5526,378,3378,9282,59.53,4.07,36.39,2019,10952
866,26,69,961,90.11,2.71,7.18,2019,10984
1912,27,183,2122,90.1,1.27,8.62,2019,10516
4386,81,260,4727,92.79,1.71,5.5,2019,10018
18858,754,4344,23956,78.72,3.15,18.13,2019,10027
15042,513,1705,17260,87.15,2.97,9.88,2019,10036
0,0,0,0,,,,2019,10170
0,0,0,0,,,,2019,10171
10704,253,3646,14603,73.3,1.73,24.97,2019,10304
9043,433,1068,10544,85.76,4.11,10.13,2019,10308
12142,527,4199,16868,71.98,3.12,24.89,2019,10459
18716,1712,3788,24216,77.29,7.07,15.64,2019,10466
2439,152,1032,3623,67.32,4.2,28.48,2019,10474
6300,152,411,6863,91.8,2.21,5.99,2019,10509
107,0,0,107,100.0,0.0,0.0,2019,10519
2770,42,138,2950,93.9,1.42,4.68,2019,10523
183,0,0,183,100.0,0.0,0.0,2019,12769
71,32,15,118,60.17,27.12,12.71,2019,12781
33,0,0,33,100.0,0.0,0.0,2019,12811
0,0,0,0,,,,2019,12862
19,0,0,19,100.0,0.0,0.0,2019,12864
16,0,0,16,100.0,0.0,0.0,2019,12872
172,4,20,196,87.76,2.04,10.2,2019,12884
365,11,30,406,89.9,2.71,7.39,2019,12151
9640,242,1179,11061,87.15,2.19,10.66,2019,12205
384,15,120,519,73.99,2.89,23.12,2019,12464
584,0,16,600,97.33,0.0,2.67,2019,12486
1498,53,348,1899,78.88,2.79,18.33,2019,12522
804,0,19,823,97.69,0.0,2.31,2019,12575
22,0,15,37,59.46,0.0,40.54,2019,12924
365,38,152,555,65.77,6.85,27.39,2019,72932
598,31,296,925,64.65,3.35,32.0,2019,72943
248,7,125,380,65.26,1.84,32.89,2019,72951
115,0,77,192,59.9,0.0,40.1,2019,72955
1448,101,1142,2691,53.81,3.75,42.44,2019,72958
862,47,384,1293,66.67,3.63,29.7,2019,72132
613,32,171,816,75.12,3.92,20.96,2019,72142
9928,431,2480,12839,77.33,3.36,19.32,2019,72143
5631,295,3063,8989,62.64,3.28,34.07,2019,72206
456,9,212,677,67.36,1.33,31.31,2019,72327
21,0,15,36,58.33,0.0,41.67,2019,72332
3681,468,2003,6152,59.83,7.61,32.56,2019,72335
61,13,134,208,29.33,6.25,64.42,2019,72359
1393,21,917,2331,59.76,0.9,39.34,2019,72360
3717,211,1120,5048,73.63,4.18,22.19,2019,72396
9272,379,854,10505,88.26,3.61,8.13,2019,72404
15,10,8,33,45.45,30.3,24.24,2019,72424
20,7,3,30,66.67,23.33,10.0,2019,72428
839,75,385,1299,64.59,5.77,29.64,2019,72433
12,0,16,28,42.86,0.0,57.14,2019,72038
538,28,228,794,67.76,3.53,28.72,2019,72039
5759,360,920,7039,81.82,5.11,13.07,2019,72210
4511,149,556,5216,86.48,2.86,10.66,2019,72227
574,62,235,871,65.9,7.12,26.98,2019,72324
32,0,22,54,59.26,0.0,40.74,2019,72340
2000,96,993,3089,64.75,3.11,32.15,2019,72390
201,30,119,350,57.43,8.57,34.0,2019,72003
629,8,467,1104,56.97,0.72,42.3,2019,72006
1543,245,568,2356,65.49,10.4,24.11,2019,72736
368,15,121,504,73.02,2.98,24.01,2019,72136
346,13,193,552,62.68,2.36,34.96,2019,72857
100,6,44,150,66.67,4.0,29.33,2019,72950
521,88,42,651,80.03,13.52,6.45,2019,72626
72,0,23,95,75.79,0.0,24.21,2019,72440
50,30,31,111,45.05,27.03,27.93,2019,72517
29,20,36,85,34.12,23.53,42.35,2019,72841
66,0,33,99,66.67,0.0,33.33,2019,72945
622,236,371,1229,50.61,19.2,30.19,2019,72722
8984,655,938,10577,84.94,6.19,8.87,2019,72113
0,0,0,0,,,,2019,72181
6750,518,1320,8588,78.6,6.03,15.37,2019,72315
924,319,506,1749,52.83,18.24,28.93,2019,72576
104,0,0,104,100.0,0.0,0.0,2019,72668
274,6,211,491,55.8,1.22,42.97,2019,72768
86,0,46,132,65.15,0.0,34.85,2019,72449
13158,91,88,13337,98.66,0.68,0.66,2019,98006
10910,157,792,11859,92.0,1.32,6.68,2019,98007
12221,305,778,13304,91.86,2.29,5.85,2019,98011
3975,49,76,4100,96.95,1.2,1.85,2019,98019
2328,37,8,2373,98.1,1.56,0.34,2019,98024
11662,217,454,12333,94.56,1.76,3.68,2019,98031
16623,298,725,17646,94.2,1.69,4.11,2019,98034
5300,130,236,5666,93.54,2.29,4.17,2019,98045
1337,10,275,1622,82.43,0.62,16.95,2019,98051
8591,148,466,9205,93.33,1.61,5.06,2019,98072
6473,341,1472,8286,78.12,4.12,17.76,2019,98104
13338,270,605,14213,93.84,1.9,4.26,2019,98107
10249,234,1335,11818,86.72,1.98,11.3,2019,98168
7641,266,373,8280,92.28,3.21,4.5,2019,98177
6093,152,1128,7373,82.64,2.06,15.3,2019,97801
331,0,119,450,73.56,0.0,26.44,2019,97826
860,17,199,1076,79.93,1.58,18.49,2019,97827
290,16,40,346,83.82,4.62,11.56,2019,97833
183,15,56,254,72.05,5.91,22.05,2019,97843
10654,184,467,11305,94.24,1.63,4.13,2019,97035
5569,99,715,6383,87.25,1.55,11.2,2019,97051
1066,25,156,1247,85.49,2.0,12.51,2019,97053
705,20,138,863,81.69,2.32,15.99,2019,97067
1179,75,219,1473,80.04,5.09,14.87,2019,97101
3255,258,163,3676,88.55,7.02,4.43,2019,97351
1932,92,386,2410,80.17,3.82,16.02,2019,97378
1901,149,347,2397,79.31,6.22,14.48,2019,97394
3505,349,262,4116,85.16,8.48,6.37,2019,97403
396,43,47,486,81.48,8.85,9.67,2019,97413
87,15,14,116,75.0,12.93,12.07,2019,97414
149,7,55,211,70.62,3.32,26.07,2019,97441
572,15,89,676,84.62,2.22,13.17,2019,97452
472,0,68,540,87.41,0.0,12.59,2019,97454
3267,140,591,3998,81.72,3.5,14.78,2019,97457
773,43,162,978,79.04,4.4,16.56,2019,97469
13266,503,2123,15892,83.48,3.17,13.36,2019,97477
3042,62,355,3459,87.94,1.79,10.26,2019,97487
445,36,163,644,69.1,5.59,25.31,2019,97497
575,16,239,830,69.28,1.93,28.8,2019,97499
8104,528,847,9479,85.49,5.57,8.94,2019,97116
52,0,0,52,100.0,0.0,0.0,2019,97125
265,8,0,273,97.07,2.93,0.0,2019,97130
970,24,217,1211,80.1,1.98,17.92,2019,97131
173,0,0,173,100.0,0.0,0.0,2019,97134
65,0,0,65,100.0,0.0,0.0,2019,97144
2108,36,226,2370,88.95,1.52,9.54,2019,97146
129,11,26,166,77.71,6.63,15.66,2019,97147
16651,412,1241,18304,90.97,2.25,6.78,2019,97202
5044,70,362,5476,92.11,1.28,6.61,2019,97218
2349,127,98,2574,91.26,4.93,3.81,2019,97227
13356,449,1186,14991,89.09,3.0,7.91,2019,97303
2138,91,114,2343,91.25,3.88,4.87,2019,97325
1143,29,117,1289,88.67,2.25,9.08,2019,97327
23856,590,1082,25528,93.45,2.31,4.24,2019,97007
1071,34,112,1217,88.0,2.79,9.2,2019,97019
165,1,43,209,78.95,0.48,20.57,2019,97857
1424,52,213,1689,84.31,3.08,12.61,2019,97032
2946,269,652,3867,76.18,6.96,16.86,2019,97023
166,8,103,277,59.93,2.89,37.18,2019,98941
0,0,0,0,,,,2019,95226
1202,23,306,1531,78.51,1.5,19.99,2019,95236
250,23,28,301,83.06,7.64,9.3,2019,95251
280,0,36,316,88.61,0.0,11.39,2019,95254
3871,86,483,4440,87.18,1.94,10.88,2019,95320
840,11,227,1078,77.92,1.02,21.06,2019,95329
3149,66,428,3643,86.44,1.81,11.75,2019,95357
7334,141,1306,8781,83.52,1.61,14.87,2019,95358
3488,21,400,3909,89.23,0.54,10.23,2019,95360
3443,34,510,3987,86.36,0.85,12.79,2019,95368
299,0,71,370,80.81,0.0,19.19,2019,95369
9899,278,1881,12058,82.09,2.31,15.6,2019,95370
14750,321,1149,16220,90.94,1.98,7.08,2019,95376
2617,10,430,3057,85.61,0.33,14.07,2019,95386
10970,450,1811,13231,82.91,3.4,13.69,2019,02893
13313,367,2983,16663,79.9,2.2,17.9,2019,02895
7115,180,840,8135,87.46,2.21,10.33,2019,02910
6438,611,1753,8802,73.14,6.94,19.92,2019,02914
5967,232,1157,7356,81.12,3.15,15.73,2019,02915
3930,107,423,4460,88.12,2.4,9.48,2019,02921
9609,368,1620,11597,82.86,3.17,13.97,2019,02919
5961,65,500,6526,91.34,1.0,7.66,2019,02019
4032,59,154,4245,94.98,1.39,3.63,2019,02052
3439,34,193,3666,93.81,0.93,5.26,2019,02061
6416,175,331,6922,92.69,2.53,4.78,2019,02066
196,0,0,196,100.0,0.0,0.0,2019,02071
11294,186,743,12223,92.4,1.52,6.08,2019,02116
15648,797,2698,19143,81.74,4.16,14.09,2019,02124
9856,223,1369,11448,86.09,1.95,11.96,2019,02132
9791,164,1129,11084,88.33,1.48,10.19,2019,02143
10743,288,2228,13259,81.02,2.17,16.8,2019,02150
21003,330,1554,22887,91.77,1.44,6.79,2019,02155
22066,441,2961,25468,86.64,1.73,11.63,2019,02169
5480,245,444,6169,88.83,3.97,7.2,2019,02189
3213,139,318,3670,87.55,3.79,8.66,2019,02191
711,35,67,813,87.45,4.31,8.24,2019,02199
7954,95,824,8873,89.64,1.07,9.29,2019,02043
8068,181,401,8650,93.27,2.09,4.64,2019,02048
8954,95,837,9886,90.57,0.96,8.47,2019,02050
10587,190,1194,11971,88.44,1.59,9.97,2019,02062
9729,214,957,10900,89.26,1.96,8.78,2019,02072
1232,14,45,1291,95.43,1.08,3.49,2019,02110
3885,8,224,4117,94.36,0.19,5.44,2019,02113
7223,182,1186,8591,84.08,2.12,13.81,2019,02122
10461,322,1922,12705,82.34,2.53,15.13,2019,02125
14040,219,2306,16565,84.76,1.32,13.92,2019,02128
13117,322,1202,14641,89.59,2.2,8.21,2019,02139
8484,280,710,9474,89.55,2.96,7.49,2019,02140
19728,540,2757,23025,85.68,2.35,11.97,2019,02148
6597,316,918,7831,84.24,4.04,11.72,2019,02152
6489,225,675,7389,87.82,3.05,9.14,2019,02190
9157,96,1478,10731,85.33,0.89,13.77,2019,02302
1527,75,307,1909,79.99,3.93,16.08,2019,05450
695,14,96,805,86.34,1.74,11.93,2019,05462
166,3,18,187,88.77,1.6,9.63,2019,05463
1038,19,219,1276,81.35,1.49,17.16,2019,05655
1043,170,136,1349,77.32,12.6,10.08,2019,05656
118,3,30,151,78.15,1.99,19.87,2019,05681
1318,97,307,1722,76.54,5.63,17.83,2019,05735
112,9,84,205,54.63,4.39,40.98,2019,96059
275,13,78,366,75.14,3.55,21.31,2019,96069
4015,131,877,5023,79.93,2.61,17.46,2019,96130
7,0,15,22,31.82,0.0,68.18,2019,96136
9922,396,1449,11767,84.32,3.37,12.31,2019,96150
266,7,121,394,67.51,1.78,30.71,2019,96713
261,8,61,330,79.09,2.42,18.48,2019,96729
810,62,13,885,91.53,7.01,1.47,2019,96762
48,6,5,59,81.36,10.17,8.47,2019,96773
325,39,231,595,54.62,6.55,38.82,2019,96783
9778,419,1901,12098,80.82,3.46,15.71,2019,96792
1533,24,318,1875,81.76,1.28,16.96,2019,96064
1322,68,88,1478,89.45,4.6,5.95,2019,96073
188,0,61,249,75.5,0.0,24.5,2019,96087
283,2,29,314,90.13,0.64,9.24,2019,12929
16,0,10,26,61.54,0.0,38.46,2019,12933
97,0,0,97,100.0,0.0,0.0,2019,12939
38,5,7,50,76.0,10.0,14.0,2019,12973
130,6,0,136,95.59,4.41,0.0,2019,12975
109,2,9,120,90.83,1.67,7.5,2019,12976
37,0,0,37,100.0,0.0,0.0,2019,12977
122,0,21,143,85.31,0.0,14.69,2019,12978
456,29,28,513,88.89,5.65,5.46,2019,12997
125,0,98,223,56.05,0.0,43.95,2019,12998
2773,77,498,3348,82.83,2.3,14.87,2019,12983
103,0,3,106,97.17,0.0,2.83,2019,12987
731,53,250,1034,70.7,5.13,24.18,2019,12413
131,0,15,146,89.73,0.0,10.27,2019,12418
218,0,10,228,95.61,0.0,4.39,2019,12419
84,6,25,115,73.04,5.22,21.74,2019,12422
123,0,0,123,100.0,0.0,0.0,2019,12429
417,18,57,492,84.76,3.66,11.59,2019,12430
1274,0,130,1404,90.74,0.0,9.26,2019,12443
132,0,51,183,72.13,0.0,27.87,2019,12470
6640,114,1059,7813,84.99,1.46,13.55,2019,12477
100,0,36,136,73.53,0.0,26.47,2019,12513
2526,59,174,2759,91.55,2.14,6.31,2019,12540
869,55,114,1038,83.72,5.3,10.98,2019,12520
373,43,138,554,67.33,7.76,24.91,2019,12485
76,0,0,76,100.0,0.0,0.0,2019,12493
540,9,90,639,84.51,1.41,14.08,2019,12516
5341,86,511,5938,89.95,1.45,8.61,2019,12524
5633,357,1604,7594,74.18,4.7,21.12,2019,12534
1919,27,321,2267,84.65,1.19,14.16,2019,12542
3449,48,390,3887,88.73,1.23,10.03,2019,12571
13125,457,2517,16099,81.53,2.84,15.63,2019,12601
672,89,137,898,74.83,9.91,15.26,2019,12748
173,11,67,251,68.92,4.38,26.69,2019,12760
287,0,30,317,90.54,0.0,9.46,2019,12765
641,12,60,713,89.9,1.68,8.42,2019,12775
214,10,21,245,87.35,4.08,8.57,2019,12778
497,72,58,627,79.27,11.48,9.25,2019,12783
86,0,32,118,72.88,0.0,27.12,2019,12821
2200,119,270,2589,84.97,4.6,10.43,2019,12834
227,8,27,262,86.64,3.05,10.31,2019,12838
1232,37,214,1483,83.07,2.49,14.43,2019,12846
15999,455,1174,17628,90.76,2.58,6.66,2019,12866
1449,10,480,1939,74.73,0.52,24.76,2019,12885
629,17,51,697,90.24,2.44,7.32,2019,12903
1927,53,841,2821,68.31,1.88,29.81,2019,15851
462,35,154,651,70.97,5.38,23.66,2019,15868
1067,127,841,2035,52.43,6.24,41.33,2019,15901
5140,148,1177,6465,79.51,2.29,18.21,2019,15904
1774,57,357,2188,81.08,2.61,16.32,2019,15909
12,0,0,12,100.0,0.0,0.0,2019,15934
2215,46,590,2851,77.69,1.61,20.69,2019,15946
153,19,32,204,75.0,9.31,15.69,2019,15948
452,14,138,604,74.83,2.32,22.85,2019,15952
3412,90,1281,4783,71.34,1.88,26.78,2019,15963
5923,198,236,6357,93.17,3.11,3.71,2019,15232
7151,68,532,7751,92.26,0.88,6.86,2019,15241
520,0,90,610,85.25,0.0,14.75,2019,15311
1218,40,347,1605,75.89,2.49,21.62,2019,15314
14827,332,1231,16390,90.46,2.03,7.51,2019,98223
38,0,0,38,100.0,0.0,0.0,2019,98235
1597,104,212,1913,83.48,5.44,11.08,2019,98245
3336,165,322,3823,87.26,4.32,8.42,2019,98250
851,0,46,897,94.87,0.0,5.13,2019,98253
415,0,58,473,87.74,0.0,12.26,2019,98262
181,7,51,239,75.73,2.93,21.34,2019,98587
857,84,147,1088,78.77,7.72,13.51,2019,98601
1095,48,111,1254,87.32,3.83,8.85,2019,98612
436,18,97,551,79.13,3.27,17.6,2019,98638
6536,100,354,6990,93.51,1.43,5.06,2019,98642
6299,143,1065,7507,83.91,1.9,14.19,2019,98264
7798,111,267,8176,95.38,1.36,3.27,2019,98275
565,6,72,643,87.87,0.93,11.2,2019,98281
7401,190,789,8380,88.32,2.27,9.42,2019,98292
9744,45,307,10096,96.51,0.45,3.04,2019,98296
126,0,29,155,81.29,0.0,18.71,2019,98305
1882,115,414,2411,78.06,4.77,17.17,2019,98331
298,0,46,344,86.63,0.0,13.37,2019,98336
1234,24,194,1452,84.99,1.65,13.36,2019,98339
556,16,182,754,73.74,2.12,24.14,2019,98356
356,8,60,424,83.96,1.89,14.15,2019,98358
9212,181,970,10363,88.89,1.75,9.36,2019,98372
8619,152,652,9423,91.47,1.61,6.92,2019,98373
9286,147,516,9949,93.34,1.48,5.19,2019,98375
2341,33,121,2495,93.83,1.32,4.85,2019,98388
1274,19,86,1379,92.39,1.38,6.24,2019,98392
7314,99,358,7771,94.12,1.27,4.61,2019,98422
3418,91,450,3959,86.33,2.3,11.37,2019,98446
114,0,35,149,76.51,0.0,23.49,2019,98527
10044,319,914,11277,89.07,2.83,8.1,2019,98498
9074,254,751,10079,90.03,2.52,7.45,2019,98516
1402,0,89,1491,94.03,0.0,5.97,2019,98524
296,0,59,355,83.38,0.0,16.62,2019,98535
637,0,116,753,84.59,0.0,15.41,2019,98547
3919,148,797,4864,80.57,3.04,16.39,2019,98550
1110,6,240,1356,81.86,0.44,17.7,2019,98557
0,0,0,0,,,,2019,98559
47,0,0,47,100.0,0.0,0.0,2019,98562
198,0,85,283,69.96,0.0,30.04,2019,98565
1753,59,184,1996,87.83,2.96,9.22,2019,98576
208,20,107,335,62.09,5.97,31.94,2019,98581
2521,64,324,2909,86.66,2.2,11.14,2019,98589
119,2,8,129,92.25,1.55,6.2,2019,98590
10614,117,563,11294,93.98,1.04,4.98,2019,98607
4911,96,305,5312,92.45,1.81,5.74,2019,01730
4480,206,573,5259,85.19,3.92,10.9,2019,01835
5532,85,588,6205,89.15,1.37,9.48,2019,01904
1456,11,135,1602,90.89,0.69,8.43,2019,01908
7744,63,315,8122,95.35,0.78,3.88,2019,01945
7092,116,628,7836,90.51,1.48,8.01,2019,01950
3485,72,332,3889,89.61,1.85,8.54,2019,01952
1258,46,114,1418,88.72,3.24,8.04,2019,01984
1222,6,199,1427,85.63,0.42,13.95,2019,01518
5425,98,263,5786,93.76,1.69,4.55,2019,01520
1157,20,83,1260,91.83,1.59,6.59,2019,01522
4786,43,446,5275,90.73,0.82,8.45,2019,01527
2521,18,241,2780,90.68,0.65,8.67,2019,01536
3593,157,449,4199,85.57,3.74,10.69,2019,01540
302,7,86,395,76.46,1.77,21.77,2019,95410
45,0,13,58,77.59,0.0,22.41,2019,95429
2177,119,214,2510,86.73,4.74,8.53,2019,95446
3655,184,823,4662,78.4,3.95,17.65,2019,95453
574,12,171,757,75.83,1.59,22.59,2019,95469
259,11,0,270,95.93,4.07,0.0,2019,95471
814,0,140,954,85.32,0.0,14.68,2019,95310
4662,177,382,5221,89.29,3.39,7.32,2019,95252
630,53,256,939,67.09,5.64,27.26,2019,95311
629,30,153,812,77.46,3.69,18.84,2019,95333
3875,95,806,4776,81.13,1.99,16.88,2019,95338
259,33,135,427,60.66,7.73,31.62,2019,95345
7286,182,1422,8890,81.96,2.05,16.0,2019,95354
0,0,0,0,,,,2019,95364
1307,44,250,1601,81.64,2.75,15.62,2019,95379
3466,61,608,4135,83.82,1.48,14.7,2019,95388
12197,359,1079,13635,89.45,2.63,7.91,2019,95401
10808,355,1622,12785,84.54,2.78,12.69,2019,95407
75,0,66,141,53.19,0.0,46.81,2019,95417
557,0,51,608,91.61,0.0,8.39,2019,95426
115,0,0,115,100.0,0.0,0.0,2019,95427
694,43,237,974,71.25,4.41,24.33,2019,95428
244,0,82,326,74.85,0.0,25.15,2019,95432
4907,169,1004,6080,80.71,2.78,16.51,2019,95437
40,0,41,81,49.38,0.0,50.62,2019,95443
55,0,18,73,75.34,0.0,24.66,2019,95463
342,16,201,559,61.18,2.86,35.96,2019,95468
79,0,0,79,100.0,0.0,0.0,2019,95488
87,9,12,108,80.56,8.33,11.11,2019,95511
557,32,574,1163,47.89,2.75,49.36,2019,95546
142,14,56,212,66.98,6.6,26.42,2019,95556
264,0,77,341,77.42,0.0,22.58,2019,95563
127,21,30,178,71.35,11.8,16.85,2019,95569
8477,257,1859,10593,80.02,2.43,17.55,2019,95660
798,32,54,884,90.27,3.62,6.11,2019,95663
133,0,0,133,100.0,0.0,0.0,2019,95007
20266,357,995,21618,93.75,1.65,4.6,2019,95014
3271,81,214,3566,91.73,2.27,6.0,2019,95033
226,24,64,314,71.97,7.64,20.38,2019,95039
17489,618,2772,20879,83.76,2.96,13.28,2019,95112
13364,357,1310,15031,88.91,2.38,8.72,2019,95126
12119,103,221,12443,97.4,0.83,1.78,2019,95134
1157,123,1646,2926,39.54,4.2,56.25,2019,95202
11780,333,1069,13182,89.36,2.53,8.11,2019,95209
1816,136,387,2339,77.64,5.81,16.55,2019,95222
2110,105,2022,4237,49.8,2.48,47.72,2019,00688
5828,124,2575,8527,68.35,1.45,30.2,2019,00705
3844,62,2720,6626,58.01,0.94,41.05,2019,00720
11174,100,4593,15867,70.42,0.63,28.95,2019,00745
7905,546,3748,12199,64.8,4.48,30.72,2019,00771
6031,125,4459,10615,56.82,1.18,42.01,2019,00915
3174,227,4925,8326,38.12,2.73,59.15,2019,00917
4067,358,2396,6821,59.62,5.25,35.13,2019,00920
4819,94,928,5841,82.5,1.61,15.89,2019,00966
16348,371,3848,20567,79.49,1.8,18.71,2019,00987
2974,60,2475,5509,53.98,1.09,44.93,2019,00601
1732,136,1581,3449,50.22,3.94,45.84,2019,00616
6397,424,4573,11394,56.14,3.72,40.14,2019,00627
3122,58,2719,5899,52.92,0.98,46.09,2019,00638
95,0,21,116,81.9,0.0,18.1,2019,96092
1152,26,156,1334,86.36,1.95,11.69,2019,96114
136,0,56,192,70.83,0.0,29.17,2019,96124
431,0,49,480,89.79,0.0,10.21,2019,96140
151,13,20,184,82.07,7.07,10.87,2019,96141
321,0,13,334,96.11,0.0,3.89,2019,96142
1258,96,204,1558,80.74,6.16,13.09,2019,96143
6662,54,211,6927,96.17,0.78,3.05,2019,96161
2067,149,456,2672,77.36,5.58,17.07,2019,96704
725,24,128,877,82.67,2.74,14.6,2019,96716
12643,1173,3084,16900,74.81,6.94,18.25,2019,96720
920,58,80,1058,86.96,5.48,7.56,2019,96725
6325,217,1125,7667,82.5,2.83,14.67,2019,96732
14600,272,929,15801,92.4,1.72,5.88,2019,96734
4573,276,1055,5904,77.46,4.67,17.87,2019,96749
854,10,202,1066,80.11,0.94,18.95,2019,96755
1806,46,282,2134,84.63,2.16,13.21,2019,96756
48,0,60,108,44.44,0.0,55.56,2019,96769
84,9,26,119,70.59,7.56,21.85,2019,96774
4125,155,1516,5796,71.17,2.67,26.16,2019,96778
692,16,89,797,86.83,2.01,11.17,2019,96779
10938,352,1485,12775,85.62,2.76,11.62,2019,96786
16106,672,2004,18782,85.75,3.58,10.67,2019,96797
11810,511,2397,14718,80.24,3.47,16.29,2019,96826
40,0,0,40,100.0,0.0,0.0,2019,96015
252,0,171,423,59.57,0.0,40.43,2019,96024
412,0,147,559,73.7,0.0,26.3,2019,96028
15056,638,2716,18410,81.78,3.47,14.75,2019,96003
822,18,163,1003,81.95,1.79,16.25,2019,96025
1096,42,399,1537,71.31,2.73,25.96,2019,96055
140,19,50,209,66.99,9.09,23.92,2019,96033
106,2,28,136,77.94,1.47,20.59,2019,96034
53,0,10,63,84.13,0.0,15.87,2019,96040
147,1,47,195,75.38,0.51,24.1,2019,96058
22,0,27,49,44.9,0.0,55.1,2019,96068
3176,256,356,3788,83.84,6.76,9.4,2019,96708
86,0,75,161,53.42,0.0,46.58,2019,96710
988,105,547,1640,60.24,6.4,33.35,2019,96737
175,8,57,240,72.92,3.33,23.75,2019,96747
142,0,71,213,66.67,0.0,33.33,2019,96757
0,33,87,120,0.0,27.5,72.5,2019,96759
185,14,51,250,74.0,5.6,20.4,2019,96764
116,17,62,195,59.49,8.72,31.79,2019,96780
3088,59,317,3464,89.15,1.7,9.15,2019,96790
14724,408,2093,17225,85.48,2.37,12.15,2019,96816
272,31,34,337,80.71,9.2,10.09,2019,95466
4273,83,879,5235,81.62,1.59,16.79,2019,95490
458,37,75,570,80.35,6.49,13.16,2019,95551
1084,8,244,1336,81.14,0.6,18.26,2019,95562
10,0,31,41,24.39,0.0,75.61,2019,95587
49,10,9,68,72.06,14.71,13.24,2019,95601
6232,75,396,6703,92.97,1.12,5.91,2019,95620
11134,229,677,12040,92.48,1.9,5.62,2019,95132
7050,101,397,7548,93.4,1.34,5.26,2019,95135
14621,335,744,15700,93.13,2.13,4.74,2019,95136
6247,182,757,7186,86.93,2.53,10.53,2019,95212
189,0,33,222,85.14,0.0,14.86,2019,95227
0,0,0,0,,,,2019,95305
41,0,29,70,58.57,0.0,41.43,2019,95312
2470,185,780,3435,71.91,5.39,22.71,2019,15062
3896,147,935,4978,78.26,2.95,18.78,2019,15065
11062,184,1172,12418,89.08,1.48,9.44,2019,15102
7984,133,1455,9572,83.41,1.39,15.2,2019,15106
3983,97,330,4410,90.32,2.2,7.48,2019,15129
1090,36,332,1458,74.76,2.47,22.77,2019,15140
4741,117,783,5641,84.05,2.07,13.88,2019,15203
1431,29,316,1776,80.57,1.63,17.79,2019,15323
1934,28,211,2173,89.0,1.29,9.71,2019,15342
173,2,56,231,74.89,0.87,24.24,2019,15641
499,0,68,567,88.01,0.0,11.99,2019,15665
1394,68,384,1846,75.51,3.68,20.8,2019,15681
745,16,162,923,80.72,1.73,17.55,2019,15722
1077,19,319,1415,76.11,1.34,22.54,2019,15728
48,0,53,101,47.52,0.0,52.48,2019,15731
96,18,78,192,50.0,9.38,40.62,2019,15734
22,0,6,28,78.57,0.0,21.43,2019,15741
43,0,11,54,79.63,0.0,20.37,2019,15744
0,17,0,17,0.0,100.0,0.0,2019,15752
1665,25,471,2161,77.05,1.16,21.8,2019,15824
1315,64,139,1518,86.63,4.22,9.16,2019,15846
3525,75,1279,4879,72.25,1.54,26.21,2019,15906
263,0,36,299,87.96,0.0,12.04,2019,15937
574,5,103,682,84.16,0.73,15.1,2019,15940
164,0,90,254,64.57,0.0,35.43,2019,15957
166,0,39,205,80.98,0.0,19.02,2019,15634
3502,129,668,4299,81.46,3.0,15.54,2019,15656
197,0,30,227,86.78,0.0,13.22,2019,15663
5460,197,1123,6780,80.53,2.91,16.56,2019,15666
976,93,331,1400,69.71,6.64,23.64,2019,15670
484,7,178,669,72.35,1.05,26.61,2019,15923
830,13,227,1070,77.57,1.21,21.21,2019,15926
972,70,358,1400,69.43,5.0,25.57,2019,15935
229,0,75,304,75.33,0.0,24.67,2019,15961
268,7,58,333,80.48,2.1,17.42,2019,15762
48,0,17,65,73.85,0.0,26.15,2019,15760
4271,129,1528,5928,72.05,2.18,25.78,2019,15767
134,3,45,182,73.63,1.65,24.73,2019,15773
93,1,5,99,93.94,1.01,5.05,2019,15655
3415,31,587,4033,84.68,0.77,14.55,2019,15658
96,0,16,112,85.71,0.0,14.29,2019,15662
1221,44,148,1413,86.41,3.11,10.47,2019,15672
120,0,50,170,70.59,0.0,29.41,2019,15677
2674,136,610,3420,78.19,3.98,17.84,2019,15683
305,3,11,319,95.61,0.94,3.45,2019,15686
64,0,0,64,100.0,0.0,0.0,2019,05050
59,2,47,108,54.63,1.85,43.52,2019,05141
0,0,0,0,,,,2019,05405
3562,185,336,4083,87.24,4.53,8.23,2019,05408
0,0,0,0,,,,2019,05439
24,0,6,30,80.0,0.0,20.0,2019,05447
0,0,0,0,,,,2019,05481
30,0,0,30,100.0,0.0,0.0,2019,05485
0,0,27,27,0.0,0.0,100.0,2019,05740
59,0,0,59,100.0,0.0,0.0,2019,05850
105,0,21,126,83.33,0.0,16.67,2019,05862
4,0,3,7,57.14,0.0,42.86,2019,05901
2618,20,41,2679,97.72,0.75,1.53,2019,06807
15775,483,2760,19018,82.95,2.54,14.51,2019,06810
2629,131,125,2885,91.13,4.54,4.33,2019,01543
12180,294,1068,13542,89.94,2.17,7.89,2019,01545
4683,65,308,5056,92.62,1.29,6.09,2019,01569
12362,462,2001,14825,83.39,3.12,13.5,2019,01604
14535,191,1004,15730,92.4,1.21,6.38,2019,01752
14134,333,1484,15951,88.61,2.09,9.3,2019,01801
10124,213,1133,11470,88.27,1.86,9.88,2019,01826
5221,75,579,5875,88.87,1.28,9.86,2019,01907
2865,12,122,2999,95.53,0.4,4.07,2019,01949
1279,31,44,1354,94.46,2.29,3.25,2019,01951
1301,70,894,2265,57.44,3.09,39.47,2019,01840
10693,368,4088,15149,70.59,2.43,26.99,2019,01841
7671,289,2248,10208,75.15,2.83,22.02,2019,01851
8564,156,455,9175,93.34,1.7,4.96,2019,01867
4939,150,672,5761,85.73,2.6,11.66,2019,01938
2546,34,139,2719,93.64,1.25,5.11,2019,01982
7895,150,485,8530,92.56,1.76,5.69,2019,01720
6162,161,315,6638,92.83,2.43,4.75,2019,01742
1910,30,241,2181,87.57,1.38,11.05,2019,01747
1938,13,108,2059,94.12,0.63,5.25,2019,01756
2205,90,153,2448,90.07,3.68,6.25,2019,01834
3516,190,465,4171,84.3,4.56,11.15,2019,01062
628,10,50,688,91.28,1.45,7.27,2019,01068
425,46,55,526,80.8,8.75,10.46,2019,01071
512,8,110,630,81.27,1.27,17.46,2019,01072
2270,0,136,2406,94.35,0.0,5.65,2019,01073
5780,279,557,6616,87.36,4.22,8.42,2019,01075
855,87,118,1060,80.66,8.21,11.13,2019,01096
862,40,165,1067,80.79,3.75,15.46,2019,01223
55,0,25,80,68.75,0.0,31.25,2019,01264
318,0,47,365,87.12,0.0,12.88,2019,01342
1581,240,277,2098,75.36,11.44,13.2,2019,01240
160,0,0,160,100.0,0.0,0.0,2019,01242
242,2,49,293,82.59,0.68,16.72,2019,01256
2056,52,264,2372,86.68,2.19,11.13,2019,01267
467,10,69,546,85.53,1.83,12.64,2019,01344
414,3,83,500,82.8,0.6,16.6,2019,01349
310,12,76,398,77.89,3.02,19.1,2019,01355
1034,20,171,1225,84.41,1.63,13.96,2019,01360
12344,474,2147,14965,82.49,3.17,14.35,2019,01420
1060,20,87,1167,90.83,1.71,7.46,2019,01431
1624,0,0,1624,100.0,0.0,0.0,2019,01451
73,0,38,111,65.77,0.0,34.23,2019,01467
2555,210,105,2870,89.02,7.32,3.66,2019,01473
1135,57,212,1404,80.84,4.06,15.1,2019,01506
1284,37,241,1562,82.2,2.37,15.43,2019,04862
367,4,67,438,83.79,0.91,15.3,2019,04863
806,16,148,970,83.09,1.65,15.26,2019,04694
1097,110,407,1614,67.97,6.82,25.22,2019,04756
143,16,34,193,74.09,8.29,17.62,2019,04768
204,11,120,335,60.9,3.28,35.82,2019,04780
164,22,56,242,67.77,9.09,23.14,2019,04781
449,154,215,818,54.89,18.83,26.28,2019,04786
25,3,1,29,86.21,10.34,3.45,2019,04852
1069,56,127,1252,85.38,4.47,10.14,2019,04861
963,7,110,1080,89.17,0.65,10.19,2019,04917
516,18,125,659,78.3,2.73,18.97,2019,04921
1638,88,174,1900,86.21,4.63,9.16,2019,04950
633,33,100,766,82.64,4.31,13.05,2019,04971
1079,39,1562,2680,40.26,1.46,58.28,2019,00670
6770,267,2608,9645,70.19,2.77,27.04,2019,00687
8614,289,10132,19035,45.25,1.52,53.23,2019,00693
3691,73,2135,5899,62.57,1.24,36.19,2019,00714
6634,400,4026,11060,59.98,3.62,36.4,2019,00716
3956,159,4483,8598,46.01,1.85,52.14,2019,00719
20563,221,9472,30256,67.96,0.73,31.31,2019,00725
2013,167,2181,4361,46.16,3.83,50.01,2019,00731
11608,496,5134,17238,67.34,2.88,29.78,2019,00736
547,14,179,740,73.92,1.89,24.19,2019,00740
2374,0,1608,3982,59.62,0.0,40.38,2019,00780
10441,405,8384,19230,54.3,2.11,43.6,2019,00924
21964,688,13462,36114,60.82,1.91,37.28,2019,00926
29,0,0,29,100.0,0.0,0.0,2019,00934
14216,332,3137,17685,80.38,1.88,17.74,2019,00959
15395,353,5676,21424,71.86,1.65,26.49,2019,00976
586,38,1322,1946,30.11,1.95,67.93,2019,00606
5240,458,3097,8795,59.58,5.21,35.21,2019,00610
6044,457,5151,11652,51.87,3.92,44.21,2019,00646
1696,177,1723,3596,47.16,4.92,47.91,2019,00653
5633,174,2264,8071,69.79,2.16,28.05,2019,00766
4742,36,1804,6582,72.04,0.55,27.41,2019,00773
323,35,116,474,68.14,7.38,24.47,2019,00775
9697,147,2938,12782,75.86,1.15,22.99,2019,00777
1619,220,921,2760,58.66,7.97,33.37,2019,00901
840,112,372,1324,63.44,8.46,28.1,2019,00741
5539,78,3040,8657,63.98,0.9,35.12,2019,00971
11194,399,6771,18364,60.96,2.17,36.87,2019,00680
11234,208,3056,14498,77.49,1.43,21.08,2019,00778
3540,118,3171,6829,51.84,1.73,46.43,2019,00962
173,0,456,629,27.5,0.0,72.5,2019,00631
1093,28,1393,2514,43.48,1.11,55.41,2019,00965
8519,614,5027,14160,60.16,4.34,35.5,2019,00659
8270,360,5078,13708,60.33,2.63,37.04,2019,00784
0,17,13,30,0.0,56.67,43.33,2019,00694
14406,118,4728,19252,74.83,0.61,24.56,2019,00727
29,0,70,99,29.29,0.0,70.71,2019,00786
0,0,0,0,,,,2019,00936
0,0,0,0,,,,2019,00950
0,0,0,0,,,,2019,00951
0,0,0,0,,,,2019,00960
6620,100,762,7482,88.48,1.34,10.18,2019,02476
3522,61,204,3787,93.0,1.61,5.39,2019,02493
837,127,104,1068,78.37,11.89,9.74,2019,02575
1598,13,187,1798,88.88,0.72,10.4,2019,02576
1262,46,114,1422,88.75,3.23,8.02,2019,02655
1435,77,190,1702,84.31,4.52,11.16,2019,02657
3056,109,445,3610,84.65,3.02,12.33,2019,02673
2730,106,260,3096,88.18,3.42,8.4,2019,02675
1381,57,88,1526,90.5,3.74,5.77,2019,02702
3799,111,250,4160,91.32,2.67,6.01,2019,02769
503,58,138,699,71.96,8.3,19.74,2019,02804
2550,62,366,2978,85.63,2.08,12.29,2019,02814
2164,22,70,2256,95.92,0.98,3.1,2019,02817
2088,17,196,2301,90.74,0.74,8.52,2019,02822
346,5,95,446,77.58,1.12,21.3,2019,95313
236,24,81,341,69.21,7.04,23.75,2019,95317
14811,455,1074,16340,90.64,2.78,6.57,2019,95404
385,17,40,442,87.1,3.85,9.05,2019,95415
152,0,29,181,83.98,0.0,16.02,2019,95420
918,37,113,1068,85.96,3.46,10.58,2019,95445
393,36,113,542,72.51,6.64,20.85,2019,95449
16,0,0,16,100.0,0.0,0.0,2019,95974
2457,66,151,2674,91.88,2.47,5.65,2019,95005
16289,440,1149,17878,91.11,2.46,6.43,2019,95008
2636,64,149,2849,92.52,2.25,5.23,2019,95018
17028,290,1274,18592,91.59,1.56,6.85,2019,95020
77,0,23,100,77.0,0.0,23.0,2019,95041
20501,332,846,21679,94.57,1.53,3.9,2019,95051
259,154,8,421,61.52,36.58,1.9,2019,95064
2937,10,273,3220,91.21,0.31,8.48,2019,95065
5987,56,504,6547,91.45,0.86,7.7,2019,95110
14317,444,1408,16169,88.55,2.75,8.71,2019,95111
16291,187,771,17249,94.45,1.08,4.47,2019,95124
19309,247,1532,21088,91.56,1.17,7.26,2019,95125
9341,29,330,9700,96.3,0.3,3.4,2019,95131
7707,147,920,8774,87.84,1.68,10.49,2019,95133
4277,269,2066,6612,64.69,4.07,31.25,2019,95215
1067,33,174,1274,83.75,2.59,13.66,2019,95223
65,20,0,85,76.47,23.53,0.0,2019,95224
333,4,34,371,89.76,1.08,9.16,2019,95303
87,0,32,119,73.11,0.0,26.89,2019,95318
1384,67,230,1681,82.33,3.99,13.68,2019,95321
1961,66,526,2553,76.81,2.59,20.6,2019,95327
10496,163,1142,11801,88.94,1.38,9.68,2019,95340
9120,115,1282,10517,86.72,1.09,12.19,2019,95348
90,0,38,128,70.31,0.0,29.69,2019,95571
13953,333,2192,16478,84.68,2.02,13.3,2019,95240
5354,235,546,6135,87.27,3.83,8.9,2019,95366
6238,98,881,7217,86.43,1.36,12.21,2019,95367
461,8,100,569,81.02,1.41,17.57,2019,95374
11735,185,1600,13520,86.8,1.37,11.83,2019,95382
188,6,26,220,85.45,2.73,11.82,2019,95439
194,0,20,214,90.65,0.0,9.35,2019,95444
314,4,92,410,76.59,0.98,22.44,2019,95323
910,24,160,1094,83.18,2.19,14.63,2019,95465
1583,88,282,1953,81.05,4.51,14.44,2019,95672
9827,141,645,10613,92.59,1.33,6.08,2019,95834
1028,0,239,1267,81.14,0.0,18.86,2019,95460
64,0,0,64,100.0,0.0,0.0,2019,95494
2169,63,179,2411,89.96,2.61,7.42,2019,03848
452,20,63,535,84.49,3.74,11.78,2019,03849
385,13,38,436,88.3,2.98,8.72,2019,03854
592,40,154,786,75.32,5.09,19.59,2019,03864
4737,82,190,5009,94.57,1.64,3.79,2019,03087
12270,319,1650,14239,86.17,2.24,11.59,2019,03103
3857,16,227,4100,94.07,0.39,5.54,2019,03109
1591,27,169,1787,89.03,1.51,9.46,2019,03234
1670,19,47,1736,96.2,1.09,2.71,2019,03033
905,0,20,925,97.84,0.0,2.16,2019,03057
10290,377,1585,12252,83.99,3.08,12.94,2019,03060
601,13,53,667,90.1,1.95,7.95,2019,03082
4458,32,342,4832,92.26,0.66,7.08,2019,03076
11272,331,1803,13406,84.08,2.47,13.45,2019,03301
6440,104,351,6895,93.4,1.51,5.09,2019,06820
5854,15,221,6090,96.12,0.25,3.63,2019,06897
7503,384,1984,9871,76.01,3.89,20.1,2019,06604
1049,64,81,1194,87.86,5.36,6.78,2019,06469
4075,18,250,4343,93.83,0.41,5.76,2019,06475
14029,404,1752,16185,86.68,2.5,10.82,2019,06484
2672,0,120,2792,95.7,0.0,4.3,2019,06612
5806,313,1189,7308,79.45,4.28,16.27,2019,06615
3030,49,257,3336,90.83,1.47,7.7,2019,06712
4858,60,130,5048,96.24,1.19,2.58,2019,06831
9637,188,745,10570,91.17,1.78,7.05,2019,06851
1391,25,109,1525,91.21,1.64,7.15,2019,06853
9847,280,915,11042,89.18,2.54,8.29,2019,06854
2413,30,141,2584,93.38,1.16,5.46,2019,06878
4656,14,82,4752,97.98,0.29,1.73,2019,06903
2236,87,124,2447,91.38,3.56,5.07,2019,06403
5716,48,480,6244,91.54,0.77,7.69,2019,06415
2481,113,174,2768,89.63,4.08,6.29,2019,06422
1697,82,95,1874,90.55,4.38,5.07,2019,06441
5965,221,487,6673,89.39,3.31,7.3,2019,06468
6688,429,849,7966,83.96,5.39,10.66,2019,06488
15571,556,2561,18688,83.32,2.98,13.7,2019,06492
2169,84,538,2791,77.71,3.01,19.28,2019,06607
698,7,19,724,96.41,0.97,2.62,2019,06754
307,0,15,322,95.34,0.0,4.66,2019,06755
1464,32,231,1727,84.77,1.85,13.38,2019,06255
814,11,73,898,90.65,1.22,8.13,2019,06256
220,0,148,368,59.78,0.0,40.22,2019,06262
3117,360,292,3769,82.7,9.55,7.75,2019,06268
3045,22,144,3211,94.83,0.69,4.48,2019,06339
1005,0,154,1159,86.71,0.0,13.29,2019,06377
3590,45,477,4112,87.31,1.09,11.6,2019,06382
5616,59,665,6340,88.58,0.93,10.49,2019,06385
8541,220,1419,10180,83.9,2.16,13.94,2019,06118
3596,173,860,4629,77.68,3.74,18.58,2019,06239
1079,24,144,1247,86.53,1.92,11.55,2019,06330
3847,62,256,4165,92.36,1.49,6.15,2019,06371
2273,109,464,2846,79.87,3.83,16.3,2019,06374
34,0,6,40,85.0,0.0,15.0,2019,06390
8975,355,815,10145,88.47,3.5,8.03,2019,06410
4831,99,458,5388,89.66,1.84,8.5,2019,06413
3943,140,1115,5198,75.86,2.69,21.45,2019,06418
7732,166,499,8397,92.08,1.98,5.94,2019,06437
933,0,146,1079,86.47,0.0,13.53,2019,06438
63,0,0,63,100.0,0.0,0.0,2019,06022
290,0,26,316,91.77,0.0,8.23,2019,10527
2477,42,100,2619,94.58,1.6,3.82,2019,10533
5535,0,277,5812,95.23,0.0,4.77,2019,10538
2301,0,219,2520,91.31,0.0,8.69,2019,10547
1145,59,117,1321,86.68,4.47,8.86,2019,10548
6208,162,397,6767,91.74,2.39,5.87,2019,10567
3605,56,388,4049,89.03,1.38,9.58,2019,10570
5079,113,440,5632,90.18,2.01,7.81,2019,10606
11653,693,2412,14758,78.96,4.7,16.34,2019,10801
3612,137,257,4006,90.16,3.42,6.42,2019,10803
4889,24,211,5124,95.41,0.47,4.12,2019,10804
6223,271,1108,7602,81.86,3.56,14.58,2019,10805
1141,16,111,1268,89.98,1.26,8.75,2019,10916
2966,116,651,3733,79.45,3.11,17.44,2019,10927
320,12,6,338,94.67,3.55,1.78,2019,04859
386,23,74,483,79.92,4.76,15.32,2019,04969
331,12,35,378,87.57,3.17,9.26,2019,04979
494,42,111,647,76.35,6.49,17.16,2019,04983
534,15,94,643,83.05,2.33,14.62,2019,04986
328,13,63,404,81.19,3.22,15.59,2019,04987
174,3,34,211,82.46,1.42,16.11,2019,04024
3212,10,225,3447,93.18,0.29,6.53,2019,04032
1119,48,251,1418,78.91,3.39,17.7,2019,04040
1194,46,361,1601,74.58,2.87,22.55,2019,04294
7763,223,1730,9716,79.9,2.3,17.81,2019,04005
1939,64,408,2411,80.42,2.65,16.92,2019,04009
513,12,94,619,82.88,1.94,15.19,2019,04020
2868,58,328,3254,88.14,1.78,10.08,2019,04039
1190,0,140,1330,89.47,0.0,10.53,2019,04049
295,0,54,349,84.53,0.0,15.47,2019,04066
963,34,81,1078,89.33,3.15,7.51,2019,04076
1597,58,100,1755,91.0,3.3,5.7,2019,04079
2416,41,177,2634,91.72,1.56,6.72,2019,04084
488,13,71,572,85.31,2.27,12.41,2019,04088
3001,84,324,3409,88.03,2.46,9.5,2019,04096
1302,19,76,1397,93.2,1.36,5.44,2019,04097
7481,568,1037,9086,82.34,6.25,11.41,2019,04101
164,4,43,211,77.73,1.9,20.38,2019,04216
7406,229,498,8133,91.06,2.82,6.12,2019,02324
11205,138,598,11941,93.84,1.16,5.01,2019,02038
4211,109,445,4765,88.37,2.29,9.34,2019,02045
2969,33,159,3161,93.93,1.04,5.03,2019,02054
5962,39,325,6326,94.25,0.62,5.14,2019,02067
1992,11,88,2091,95.27,0.53,4.21,2019,02108
4022,165,739,4926,81.65,3.35,15.0,2019,02120
17200,481,1887,19568,87.9,2.46,9.64,2019,02135
16557,476,4053,21086,78.52,2.26,19.22,2019,02301
3766,165,558,4489,83.89,3.68,12.43,2019,02330
6123,267,569,6959,87.99,3.84,8.18,2019,02370
6464,30,281,6775,95.41,0.44,4.15,2019,02421
2565,0,92,2657,96.54,0.0,3.46,2019,02461
6035,43,324,6402,94.27,0.67,5.06,2019,02467
7568,155,1413,9136,82.84,1.7,15.47,2019,02115
2001,0,30,2031,98.52,0.0,1.48,2019,02030
6566,94,483,7143,91.92,1.32,6.76,2019,02081
1928,11,37,1976,97.57,0.56,1.87,2019,02109
13483,355,2183,16021,84.16,2.22,13.63,2019,02149
15666,729,2837,19232,81.46,3.79,14.75,2019,02151
6771,90,1009,7870,86.04,1.14,12.82,2019,02170
170,23,113,306,55.56,7.52,36.93,2019,72928
617,57,263,937,65.85,6.08,28.07,2019,72354
179,0,90,269,66.54,0.0,33.46,2019,72412
8377,129,1130,9636,86.93,1.34,11.73,2019,72019
16060,1037,1804,18901,84.97,5.49,9.54,2019,72034
0,0,0,0,,,,2019,72035
1,0,12,13,7.69,0.0,92.31,2019,72037
8,0,12,20,40.0,0.0,60.0,2019,72059
0,0,0,0,,,,2019,72119
0,0,0,0,,,,2019,72149
11,0,2,13,84.62,0.0,15.38,2019,72325
62,9,10,81,76.54,11.11,12.35,2019,72546
3,0,0,3,100.0,0.0,0.0,2019,72636
40,0,0,40,100.0,0.0,0.0,2019,72670
2100,73,128,2301,91.26,3.17,5.56,2019,02835
2116,98,157,2371,89.25,4.13,6.62,2019,02718
5406,118,868,6392,84.57,1.85,13.58,2019,02719
5144,663,2082,7889,65.2,8.4,26.39,2019,02724
2403,56,189,2648,90.75,2.11,7.14,2019,02739
13752,513,3731,17996,76.42,2.85,20.73,2019,02740
3318,32,316,3666,90.51,0.87,8.62,2019,02762
4739,120,444,5303,89.36,2.26,8.37,2019,02767
2111,66,207,2384,88.55,2.77,8.68,2019,02779
2963,19,300,3282,90.28,0.58,9.14,2019,02813
8659,411,1197,10267,84.34,4.0,11.66,2019,02840
56,0,0,56,100.0,0.0,0.0,2019,02836
1384,14,163,1561,88.66,0.9,10.44,2019,02837
220,0,13,233,94.42,0.0,5.58,2019,02858
5241,129,500,5870,89.28,2.2,8.52,2019,02882
7888,535,910,9333,84.52,5.73,9.75,2019,02891
5788,243,837,6868,84.27,3.54,12.19,2019,02842
8679,200,1216,10095,85.97,1.98,12.05,2019,02861
9800,233,654,10687,91.7,2.18,6.12,2019,02906
7132,346,1402,8880,80.32,3.9,15.79,2019,02905
8911,239,876,10026,88.88,2.38,8.74,2019,02026
1369,14,42,1425,96.07,0.98,2.95,2019,02032
4493,45,197,4735,94.89,0.95,4.16,2019,02053
5146,45,350,5541,92.87,0.81,6.32,2019,02090
3909,114,235,4258,91.8,2.68,5.52,2019,02093
5986,111,828,6925,86.44,1.6,11.96,2019,02141
9446,341,899,10686,88.4,3.19,8.41,2019,02144
6154,75,334,6563,93.77,1.14,5.09,2019,02359
913,0,104,1017,89.77,0.0,10.23,2019,02646
52,0,0,52,100.0,0.0,0.0,2019,02647
5629,76,655,6360,88.51,1.19,10.3,2019,02649
3454,161,983,4598,75.12,3.5,21.38,2019,02744
4145,173,1817,6135,67.56,2.82,29.62,2019,02746
4168,119,491,4778,87.23,2.49,10.28,2019,02748
9474,270,736,10480,90.4,2.58,7.02,2019,02760
6007,161,402,6570,91.43,2.45,6.12,2019,02766
1765,21,102,1888,93.49,1.11,5.4,2019,02770
12547,308,1161,14016,89.52,2.2,8.28,2019,02184
8035,128,712,8875,90.54,1.44,8.02,2019,02186
5590,266,639,6495,86.07,4.1,9.84,2019,02188
4796,22,218,5036,95.23,0.44,4.33,2019,02420
3861,57,249,4167,92.66,1.37,5.98,2019,02465
2708,87,164,2959,91.52,2.94,5.54,2019,02466
14356,293,1035,15684,91.53,1.87,6.6,2019,02472
234,41,16,291,80.41,14.09,5.5,2019,02534
10406,176,665,11247,92.52,1.56,5.91,2019,98001
9843,212,1127,11182,88.03,1.9,10.08,2019,98273
14479,295,1051,15825,91.49,1.86,6.64,2019,98277
137,24,0,161,85.09,14.91,0.0,2019,98283
11843,140,1090,13073,90.59,1.07,8.34,2019,98290
2381,53,265,2699,88.22,1.96,9.82,2019,98294
483,20,126,629,76.79,3.18,20.03,2019,98320
3331,57,439,3827,87.04,1.49,11.47,2019,98328
67,0,0,67,100.0,0.0,0.0,2019,98330
2223,67,200,2490,89.28,2.69,8.03,2019,98365
6694,226,699,7619,87.86,2.97,9.17,2019,98368
14400,294,1624,16318,88.25,1.8,9.95,2019,98387
238,21,23,282,84.4,7.45,8.16,2019,98396
2930,151,523,3604,81.3,4.19,14.51,2019,98402
3516,176,532,4224,83.24,4.17,12.59,2019,03766
1171,36,237,1444,81.09,2.49,16.41,2019,03048
407,12,47,466,87.34,2.58,10.09,2019,03227
277,4,23,304,91.12,1.32,7.57,2019,03457
1081,31,101,1213,89.12,2.56,8.33,2019,03782
219,0,16,235,93.19,0.0,6.81,2019,03853
143,11,30,184,77.72,5.98,16.3,2019,03601
294,6,32,332,88.55,1.81,9.64,2019,03779
188,0,0,188,100.0,0.0,0.0,2019,03852
526,29,144,699,75.25,4.15,20.6,2019,03047
879,12,39,930,94.52,1.29,4.19,2019,03255
271,14,42,327,82.87,4.28,12.84,2019,03456
10308,141,1087,11536,89.36,1.22,9.42,2019,03079
1588,45,141,1774,89.52,2.54,7.95,2019,03254
2591,38,94,2723,95.15,1.4,3.45,2019,03304
890,14,34,938,94.88,1.49,3.62,2019,03046
96,21,19,136,70.59,15.44,13.97,2019,03231
38,0,1,39,97.44,0.0,2.56,2019,03238
665,43,73,781,85.15,5.51,9.35,2019,03245
2813,42,193,3048,92.29,1.38,6.33,2019,03249
878,48,48,974,90.14,4.93,4.93,2019,03258
831,35,95,961,86.47,3.64,9.89,2019,03285
78,0,8,86,90.7,0.0,9.3,2019,03293
7,0,0,7,100.0,0.0,0.0,2019,03575
239,11,22,272,87.87,4.04,8.09,2019,03586
172,12,12,196,87.76,6.12,6.12,2019,03593
1910,23,40,1973,96.81,1.17,2.03,2019,03032
1406,76,143,1625,86.52,4.68,8.8,2019,03037
2364,91,225,2680,88.21,3.4,8.4,2019,03042
1653,31,71,1755,94.19,1.77,4.05,2019,03044
2836,0,132,2968,95.55,0.0,4.45,2019,03049
10686,118,617,11421,93.56,1.03,5.4,2019,03062
1336,57,216,1609,83.03,3.54,13.42,2019,03086
7464,38,311,7813,95.53,0.49,3.98,2019,03110
1190,8,124,1322,90.02,0.61,9.38,2019,03225
1498,36,97,1631,91.85,2.21,5.95,2019,03261
452,5,43,500,90.4,1.0,8.6,2019,03268
25,0,12,37,67.57,0.0,32.43,2019,03291
684,29,72,785,87.13,3.69,9.17,2019,03449
2900,73,235,3208,90.4,2.28,7.33,2019,03458
4048,36,115,4199,96.4,0.86,2.74,2019,03031
11784,295,789,12868,91.58,2.29,6.13,2019,03038
4474,61,505,5040,88.77,1.21,10.02,2019,03045
11558,450,1483,13491,85.67,3.34,10.99,2019,03102
4835,93,316,5244,92.2,1.77,6.03,2019,03106
1122,57,116,1295,86.64,4.4,8.96,2019,05464
1770,190,109,2069,85.55,9.18,5.27,2019,05465
617,14,82,713,86.54,1.96,11.5,2019,05472
573,5,40,618,92.72,0.81,6.47,2019,05487
1069,184,74,1327,80.56,13.87,5.58,2019,05489
2040,64,253,2357,86.55,2.72,10.73,2019,05491
4547,225,581,5353,84.94,4.2,10.85,2019,05602
231,0,16,247,93.52,0.0,6.48,2019,05070
157,0,9,166,94.58,0.0,5.42,2019,05053
133,8,19,160,83.12,5.0,11.88,2019,05058
162,0,19,181,89.5,0.0,10.5,2019,05059
159,0,30,189,84.13,0.0,15.87,2019,05072
1391,169,379,1939,71.74,8.72,19.55,2019,05101
221,0,59,280,78.93,0.0,21.07,2019,05146
12691,2961,2423,18075,70.21,16.38,13.41,2019,10940
10223,514,5532,16269,62.84,3.16,34.0,2019,10977
4442,55,301,4798,92.58,1.15,6.27,2019,10980
881,0,86,967,91.11,0.0,8.89,2019,10998
1756,21,0,1777,98.82,1.18,0.0,2019,10004
35461,1199,4695,41355,85.75,2.9,11.35,2019,10025
10359,507,1822,12688,81.64,4.0,14.36,2019,10030
7499,247,1835,9581,78.27,2.58,19.15,2019,10037
6502,843,1227,8572,75.85,9.83,14.31,2019,10552
803,8,18,829,96.86,0.97,2.17,2019,10577
3468,39,313,3820,90.79,1.02,8.19,2019,10589
2118,76,160,2354,89.97,3.23,6.8,2019,10595
4707,151,410,5268,89.35,2.87,7.78,2019,10601
6474,50,516,7040,91.96,0.71,7.33,2019,10603
7639,143,827,8609,88.73,1.66,9.61,2019,10901
519,0,8,527,98.48,0.0,1.52,2019,10917
3822,72,273,4167,91.72,1.73,6.55,2019,10918
384,11,61,456,84.21,2.41,13.38,2019,10969
1002,25,100,1127,88.91,2.22,8.87,2019,10974
1792,37,132,1961,91.38,1.89,6.73,2019,10983
0,0,0,0,,,,2019,10271
18519,731,2068,21318,86.87,3.43,9.7,2019,10312
18863,1147,6427,26437,71.35,4.34,24.31,2019,10452
23971,1035,4530,29536,81.16,3.5,15.34,2019,10462
16158,1038,3993,21189,76.26,4.9,18.84,2019,10473
356,8,59,423,84.16,1.89,13.95,2019,10501
1829,21,0,1850,98.86,1.14,0.0,2019,10506
4363,0,0,4363,100.0,0.0,0.0,2019,10005
15299,304,1212,16815,90.98,1.81,7.21,2019,10010
26822,463,1915,29200,91.86,1.59,6.56,2019,10016
9062,285,316,9663,93.78,2.95,3.27,2019,10017
12870,301,2308,15479,83.14,1.94,14.91,2019,10026
16398,349,3086,19833,82.68,1.76,15.56,2019,10033
3066,50,114,3230,94.92,1.55,3.53,2019,10069
0,0,0,0,,,,2019,10111
0,0,0,0,,,,2019,10115
27309,535,2225,30069,90.82,1.78,7.4,2019,10128
0,0,0,0,,,,2019,10153
0,0,0,0,,,,2019,10169
6396,244,1886,8526,75.02,2.86,22.12,2019,10310
1767,0,41,1808,97.73,0.0,2.27,2019,10576
5182,110,499,5791,89.48,1.9,8.62,2019,10549
2388,691,273,3352,71.24,20.61,8.14,2019,10553
1530,77,76,1683,90.91,4.58,4.52,2019,10560
5609,19,356,5984,93.73,0.32,5.95,2019,10580
406,8,96,510,79.61,1.57,18.82,2019,12913
693,31,254,978,70.86,3.17,25.97,2019,12926
376,0,16,392,95.92,0.0,4.08,2019,12942
154,23,25,202,76.24,11.39,12.38,2019,12945
78,4,47,129,60.47,3.1,36.43,2019,12952
3553,320,854,4727,75.16,6.77,18.07,2019,12953
101,0,57,158,63.92,0.0,36.08,2019,12955
498,34,150,682,73.02,4.99,21.99,2019,12957
268,16,49,333,80.48,4.8,14.71,2019,12960
917,42,173,1132,81.01,3.71,15.28,2019,12966
321,44,98,463,69.33,9.5,21.17,2019,12967
1865,31,389,2285,81.62,1.36,17.02,2019,12972
7794,336,1141,9271,84.07,3.62,12.31,2019,12306
12212,528,1573,14313,85.32,3.69,10.99,2019,12401
246,52,35,333,73.87,15.62,10.51,2019,72537
123,0,5,128,96.09,0.0,3.91,2019,97476
120,13,13,146,82.19,8.9,8.9,2019,97493
9934,225,1719,11878,83.63,1.89,14.47,2019,97603
0,0,0,0,,,,2019,97604
432,0,147,579,74.61,0.0,25.39,2019,97633
9,3,7,19,47.37,15.79,36.84,2019,97711
10979,324,2379,13682,80.24,2.37,17.39,2019,97233
10807,144,2128,13079,82.63,1.1,16.27,2019,97236
12493,221,1899,14613,85.49,1.51,13.0,2019,97305
50,0,18,68,73.53,0.0,26.47,2019,97329
1090,36,210,1336,81.59,2.69,15.72,2019,97341
55,0,50,105,52.38,0.0,47.62,2019,97343
540,28,157,725,74.48,3.86,21.66,2019,97347
478,35,96,609,78.49,5.75,15.76,2019,97348
162,13,16,191,84.82,6.81,8.38,2019,97364
251,29,48,328,76.52,8.84,14.63,2019,97390
948,115,224,1287,73.66,8.94,17.4,2019,97396
9,0,21,30,30.0,0.0,70.0,2019,97406
5389,65,426,5880,91.65,1.11,7.24,2019,97408
22,0,0,22,100.0,0.0,0.0,2019,97909
47,1,9,57,82.46,1.75,15.79,2019,97920
11170,296,670,12136,92.04,2.44,5.52,2019,97008
306,0,25,331,92.45,0.0,7.55,2019,97020
956,59,123,1138,84.01,5.18,10.81,2019,97026
4149,114,533,4796,86.51,2.38,11.11,2019,97027
18377,347,1835,20559,89.39,1.69,8.93,2019,97045
72,9,14,95,75.79,9.47,14.74,2019,97050
10252,178,745,11175,91.74,1.59,6.67,2019,97062
10248,228,518,10994,93.21,2.07,4.71,2019,97068
8957,538,690,10185,87.94,5.28,6.77,2019,97070
7270,436,1482,9188,79.12,4.75,16.13,2019,97071
137,0,10,147,93.2,0.0,6.8,2019,97102
192,0,34,226,84.96,0.0,15.04,2019,97108
199,0,63,262,75.95,0.0,24.05,2019,97117
459,0,86,545,84.22,0.0,15.78,2019,97121
19012,885,933,20830,91.27,4.25,4.48,2019,97124
11781,570,1911,14262,82.6,4.0,13.4,2019,97128
235,0,46,281,83.63,0.0,16.37,2019,97135
582,16,116,714,81.51,2.24,16.25,2019,97136
12653,291,1079,14023,90.23,2.08,7.69,2019,97213
13378,357,959,14694,91.04,2.43,6.53,2019,97217
9755,316,1301,11372,85.78,2.78,11.44,2019,97220
4879,97,173,5149,94.76,1.88,3.36,2019,97221
25312,955,955,27222,92.98,3.51,3.51,2019,97006
909,38,308,1255,72.43,3.03,24.54,2019,98610
415,21,56,492,84.35,4.27,11.38,2019,98617
172,16,44,232,74.14,6.9,18.97,2019,98619
11,0,0,11,100.0,0.0,0.0,2019,98641
314,23,50,387,81.14,5.94,12.92,2019,98651
7823,181,596,8600,90.97,2.1,6.93,2019,98671
7367,137,957,8461,87.07,1.62,11.31,2019,98022
16191,288,1303,17782,91.05,1.62,7.33,2019,98023
13925,220,673,14818,93.97,1.48,4.54,2019,98026
11311,240,394,11945,94.69,2.01,3.3,2019,98027
10822,182,267,11271,96.02,1.61,2.37,2019,98029
13463,395,1094,14952,90.04,2.64,7.32,2019,98036
13006,121,922,14049,92.58,0.86,6.56,2019,98056
14846,309,675,15830,93.78,1.95,4.26,2019,98058
18584,906,2160,21650,85.84,4.18,9.98,2019,98133
7587,406,1206,9199,82.48,4.41,13.11,2019,98101
9360,306,1335,11001,85.08,2.78,12.14,2019,98106
4046,100,470,4616,87.65,2.17,10.18,2019,98148
8607,209,1079,9895,86.98,2.11,10.9,2019,98178
9501,132,250,9883,96.13,1.34,2.53,2019,98199
10573,612,1757,12942,81.7,4.73,13.58,2019,98201
14819,534,1679,17032,87.01,3.14,9.86,2019,98204
4884,134,185,5203,93.87,2.58,3.56,2019,98205
1561,5,123,1689,92.42,0.3,7.28,2019,98232
0,0,0,0,,,,2019,98238
632,39,162,833,75.87,4.68,19.45,2019,98241
2854,36,319,3209,88.94,1.12,9.94,2019,98247
1143,121,241,1505,75.95,8.04,16.01,2019,98591
77,0,0,77,100.0,0.0,0.0,2019,98602
1261,38,302,1601,78.76,2.37,18.86,2019,98631
578,13,171,762,75.85,1.71,22.44,2019,98635
212,0,0,212,100.0,0.0,0.0,2019,98644
324,12,24,360,90.0,3.33,6.67,2019,98650
135,3,72,210,64.29,1.43,34.29,2019,98673
9492,479,1471,11442,82.96,4.19,12.86,2019,98802
1146,18,547,1711,66.98,1.05,31.97,2019,98812
3223,135,601,3959,81.41,3.41,15.18,2019,98823
2704,133,281,3118,86.72,4.27,9.01,2019,98826
509,8,149,666,76.43,1.2,22.37,2019,98843
426,31,109,566,75.27,5.48,19.26,2019,98850
683,40,83,806,84.74,4.96,10.3,2019,98858
1089,41,45,1175,92.68,3.49,3.83,2019,98862
175,0,247,422,41.47,0.0,58.53,2019,98923
260,7,78,345,75.36,2.03,22.61,2019,98933
634,5,90,729,86.97,0.69,12.35,2019,98938
2834,57,639,3530,80.28,1.61,18.1,2019,98951
1977,35,281,2293,86.22,1.53,12.25,2019,98953
15926,512,2109,18547,85.87,2.76,11.37,2019,98003
10245,146,426,10817,94.71,1.35,3.94,2019,98021
12454,159,1343,13956,89.24,1.14,9.62,2019,98032
11509,218,400,12127,94.9,1.8,3.3,2019,98038
7856,90,217,8163,96.24,1.1,2.66,2019,98053
173,28,7,208,83.17,13.46,3.37,2019,98068
1808,81,233,2122,85.2,3.82,10.98,2019,98249
8394,156,610,9160,91.64,1.7,6.66,2019,98272
15450,458,616,16524,93.5,2.77,3.73,2019,98033
9559,126,514,10199,93.72,1.24,5.04,2019,98040
129,0,0,129,100.0,0.0,0.0,2019,98164
1040,15,105,1160,89.66,1.29,9.05,2019,98240
66,0,0,66,100.0,0.0,0.0,2019,95232
515,8,144,667,77.21,1.2,21.59,2019,95245
1427,21,189,1637,87.17,1.28,11.55,2019,95249
14375,198,1179,15752,91.26,1.26,7.48,2019,95023
22368,168,1124,23660,94.54,0.71,4.75,2019,95035
12963,556,1463,14982,86.52,3.71,9.77,2019,95062
3365,199,527,4091,82.25,4.86,12.88,2019,95713
8091,58,229,8378,96.57,0.69,2.73,2019,95746
19636,533,1338,21507,91.3,2.48,6.22,2019,95758
12086,137,689,12912,93.6,1.06,5.34,2019,95765
7120,181,1925,9226,77.17,1.96,20.86,2019,95815
8761,275,907,9943,88.11,2.77,9.12,2019,95818
12677,410,1957,15044,84.27,2.73,13.01,2019,95821
13365,318,2296,15979,83.64,1.99,14.37,2019,95822
10847,292,1159,12298,88.2,2.37,9.42,2019,97304
11422,290,497,12209,93.55,2.38,4.07,2019,97306
97,0,11,108,89.81,0.0,10.19,2019,97357
674,0,98,772,87.31,0.0,12.69,2019,97366
223,0,23,246,90.65,0.0,9.35,2019,97371
991,26,204,1221,81.16,2.13,16.71,2019,97385
606,27,64,697,86.94,3.87,9.18,2019,97389
5945,280,987,7212,82.43,3.88,13.69,2019,97424
3361,191,316,3868,86.89,4.94,8.17,2019,97426
257,0,85,342,75.15,0.0,24.85,2019,97434
1441,74,435,1950,73.9,3.79,22.31,2019,97458
1369,3,220,1592,85.99,0.19,13.82,2019,97462
691,36,319,1046,66.06,3.44,30.5,2019,97465
283,34,146,463,61.12,7.34,31.53,2019,97466
425,0,57,482,88.17,0.0,11.83,2019,97488
80,0,12,92,86.96,0.0,13.04,2019,97490
3483,136,477,4096,85.03,3.32,11.65,2019,97503
173,14,73,260,66.54,5.38,28.08,2019,97522
1837,236,408,2481,74.04,9.51,16.44,2019,97523
220,11,46,277,79.42,3.97,16.61,2019,97543
851,72,170,1093,77.86,6.59,15.55,2019,97544
143,0,39,182,78.57,0.0,21.43,2019,97731
6873,224,1483,8580,80.1,2.61,17.28,2019,97754
50,8,37,95,52.63,8.42,38.95,2019,97620
114,0,4,118,96.61,0.0,3.39,2019,97621
144,0,52,196,73.47,0.0,26.53,2019,97622
752,79,262,1093,68.8,7.23,23.97,2019,97623
46,2,5,53,86.79,3.77,9.43,2019,97710
1549,126,354,2029,76.34,6.21,17.45,2019,97720
10,30,13,53,18.87,56.6,24.53,2019,97735
709,2,247,958,74.01,0.21,25.78,2019,97360
1169,97,344,1610,72.61,6.02,21.37,2019,97362
3726,142,664,4532,82.22,3.13,14.65,2019,97367
2929,111,261,3301,88.73,3.36,7.91,2019,97370
794,14,158,966,82.19,1.45,16.36,2019,97380
2180,54,216,2450,88.98,2.2,8.82,2019,97392
11927,428,1192,13547,88.04,3.16,8.8,2019,97404
17240,559,1416,19215,89.72,2.91,7.37,2019,97405
253,11,59,323,78.33,3.41,18.27,2019,97410
5097,398,1053,6548,77.84,6.08,16.08,2019,97415
273,12,120,405,67.41,2.96,29.63,2019,97416
141,4,20,165,85.45,2.42,12.12,2019,97430
760,9,141,910,83.52,0.99,15.49,2019,97435
5830,246,998,7074,82.41,3.48,14.11,2019,97439
658,78,171,907,72.55,8.6,18.85,2019,97442
1854,107,232,2193,84.54,4.88,10.58,2019,03229
326,4,43,373,87.4,1.07,11.53,2019,03243
1213,176,281,1670,72.63,10.54,16.83,2019,03263
539,22,15,576,93.58,3.82,2.6,2019,03444
270,2,22,294,91.84,0.68,7.48,2019,03448
337,14,63,414,81.4,3.38,15.22,2019,03464
650,0,29,679,95.73,0.0,4.27,2019,03466
1115,45,134,1294,86.17,3.48,10.36,2019,03608
236,0,9,245,96.33,0.0,3.67,2019,03765
2529,75,573,3177,79.6,2.36,18.04,2019,03773
492,0,72,564,87.23,0.0,12.77,2019,03816
895,0,12,907,98.68,0.0,1.32,2019,03830
2993,129,837,3959,75.6,3.26,21.14,2019,03235
859,11,49,919,93.47,1.2,5.33,2019,03237
201,0,5,206,97.57,0.0,2.43,2019,12410
80,29,13,122,65.57,23.77,10.66,2019,12424
376,8,18,402,93.53,1.99,4.48,2019,12431
158,2,58,218,72.48,0.92,26.61,2019,12444
351,0,129,480,73.12,0.0,26.88,2019,12451
84,7,24,115,73.04,6.09,20.87,2019,12454
375,26,77,478,78.45,5.44,16.11,2019,12457
257,7,79,343,74.93,2.04,23.03,2019,13072
2180,173,368,2721,80.12,6.36,13.52,2019,13077
2175,89,208,2472,87.99,3.6,8.41,2019,13108
686,10,53,749,91.59,1.34,7.08,2019,13156
747,29,102,878,85.08,3.3,11.62,2019,13164
1715,230,738,2683,63.92,8.57,27.51,2019,13202
4714,728,2461,7903,59.65,9.21,31.14,2019,13204
3895,320,964,5179,75.21,6.18,18.61,2019,13207
0,0,0,0,,,,2019,13290
404,0,31,435,92.87,0.0,7.13,2019,13303
1846,80,310,2236,82.56,3.58,13.86,2019,13309
103,3,50,156,66.03,1.92,32.05,2019,13313
80,0,44,124,64.52,0.0,35.48,2019,13314
311,7,67,385,80.78,1.82,17.4,2019,13322
13440,524,2744,16708,80.44,3.14,16.42,2019,13021
594,6,97,697,85.22,0.86,13.92,2019,13304
708,19,157,884,80.09,2.15,17.76,2019,13110
11606,349,1679,13634,85.13,2.56,12.31,2019,13126
614,19,57,690,88.99,2.75,8.26,2019,13145
6224,294,1275,7793,79.87,3.77,16.36,2019,13206
5832,265,512,6609,88.24,4.01,7.75,2019,13039
639,9,116,764,83.64,1.18,15.18,2019,13083
588,94,208,890,66.07,10.56,23.37,2019,13101
2165,26,156,2347,92.25,1.11,6.65,2019,13114
1409,33,358,1800,78.28,1.83,19.89,2019,13140
2023,143,401,2567,78.81,5.57,15.62,2019,13142
618,22,190,830,74.46,2.65,22.89,2019,13146
602,9,113,724,83.15,1.24,15.61,2019,13160
1839,55,391,2285,80.48,2.41,17.11,2019,13166
4349,327,2261,6937,62.69,4.71,32.59,2019,13205
6008,432,1199,7639,78.65,5.66,15.7,2019,13210
7380,369,1166,8915,82.78,4.14,13.08,2019,13212
534,27,100,661,80.79,4.08,15.13,2019,13431
1968,70,286,2324,84.68,3.01,12.31,2019,13326
988,19,259,1266,78.04,1.5,20.46,2019,13411
1359,0,308,1667,81.52,0.0,18.48,2019,13417
537,23,92,652,82.36,3.53,14.11,2019,13433
384,22,182,588,65.31,3.74,30.95,2019,13464
241,0,60,301,80.07,0.0,19.93,2019,15347
0,0,21,21,0.0,0.0,100.0,2019,15378
955,84,216,1255,76.1,6.69,17.21,2019,15456
559,17,218,794,70.4,2.14,27.46,2019,15474
612,19,151,782,78.26,2.43,19.31,2019,15480
140,0,37,177,79.1,0.0,20.9,2019,15489
43,0,0,43,100.0,0.0,0.0,2019,15492
124,8,42,174,71.26,4.6,24.14,2019,15536
1057,29,257,1343,78.7,2.16,19.14,2019,15541
659,26,167,852,77.35,3.05,19.6,2019,15479
511,20,148,679,75.26,2.95,21.8,2019,15521
867,25,194,1086,79.83,2.3,17.86,2019,15554
20232,785,3966,24983,80.98,3.14,15.87,2019,15601
15626,391,2336,18353,85.14,2.13,12.73,2019,15642
4220,24,420,4664,90.48,0.51,9.01,2019,98070
9720,126,269,10115,96.09,1.25,2.66,2019,98110
14125,171,669,14965,94.39,1.14,4.47,2019,98117
11813,328,628,12769,92.51,2.57,4.92,2019,98119
11660,459,824,12943,90.09,3.55,6.37,2019,98121
12581,289,732,13602,92.49,2.12,5.38,2019,98155
1068,65,213,1346,79.35,4.83,15.82,2019,97127
5992,188,1057,7237,82.8,2.6,14.61,2019,97031
354,19,62,435,81.38,4.37,14.25,2019,97137
393,21,85,499,78.76,4.21,17.03,2019,97324
1,0,3,4,25.0,0.0,75.0,2019,97057
10245,349,784,11378,90.04,3.07,6.89,2019,97086
4200,181,258,4639,90.54,3.9,5.56,2019,97089
0,0,0,0,,,,2019,97208
8369,258,395,9022,92.76,2.86,4.38,2019,97239
6728,172,858,7758,86.72,2.22,11.06,2019,97317
12007,483,1577,14067,85.36,3.43,11.21,2019,97322
92,0,0,92,100.0,0.0,0.0,2019,97369
0,0,0,0,,,,2019,97373
0,0,0,0,,,,2019,97384
351,0,14,365,96.16,0.0,3.84,2019,97388
10575,244,1807,12626,83.76,1.93,14.31,2019,97471
46,0,0,46,100.0,0.0,0.0,2019,97494
673,27,11,711,94.66,3.8,1.55,2019,97495
176,0,32,208,84.62,0.0,15.38,2019,95585
222,0,23,245,90.61,0.0,9.39,2019,95615
1656,28,226,1910,86.7,1.47,11.83,2019,95692
3530,34,81,3645,96.84,0.93,2.22,2019,95742
7619,289,1018,8926,85.36,3.24,11.4,2019,95961
9220,99,437,9756,94.51,1.01,4.48,2019,95121
869,50,171,1090,79.72,4.59,15.69,2019,95461
829,39,49,917,90.4,4.25,5.34,2019,95542
195,0,57,252,77.38,0.0,22.62,2019,95543
390,13,47,450,86.67,2.89,10.44,2019,95547
324,10,16,350,92.57,2.86,4.57,2019,95549
136,0,42,178,76.4,0.0,23.6,2019,95554
136,13,37,186,73.12,6.99,19.89,2019,95558
235,17,32,284,82.75,5.99,11.27,2019,95565
72,0,7,79,91.14,0.0,8.86,2019,95568
4132,87,708,4927,83.86,1.77,14.37,2019,95605
9071,200,421,9692,93.59,2.06,4.34,2019,95618
1543,51,85,1679,91.9,3.04,5.06,2019,95665
8545,92,726,9363,91.26,0.98,7.75,2019,95677
12186,270,1209,13665,89.18,1.98,8.85,2019,95691
32,0,35,67,47.76,0.0,52.24,2019,95625
2610,37,504,3151,82.83,1.17,15.99,2019,01364
247,0,123,370,66.76,0.0,33.24,2019,01379
6755,318,1155,8228,82.1,3.86,14.04,2019,01440
1673,9,117,1799,93.0,0.5,6.5,2019,01505
2026,35,392,2453,82.59,1.43,15.98,2019,01524
1095,24,122,1241,88.24,1.93,9.83,2019,01529
1942,36,322,2300,84.43,1.57,14.0,2019,01583
3071,74,430,3575,85.9,2.07,12.03,2019,01588
6088,246,1525,7859,77.47,3.13,19.4,2019,01609
6356,53,387,6796,93.53,0.78,5.69,2019,01721
560,0,0,560,100.0,0.0,0.0,2019,01731
1689,1,49,1739,97.12,0.06,2.82,2019,01740
1800,28,48,1876,95.95,1.49,2.56,2019,01741
1443,0,82,1525,94.62,0.0,5.38,2019,01770
16395,391,1657,18443,88.9,2.12,8.98,2019,95831
9287,206,1563,11056,84.0,1.86,14.14,2019,95838
6,25,22,53,11.32,47.17,41.51,2019,95910
18,0,16,34,52.94,0.0,47.06,2019,95930
647,0,179,826,78.33,0.0,21.67,2019,95947
347,22,65,434,79.95,5.07,14.98,2019,95968
27,0,54,81,33.33,0.0,66.67,2019,95978
1063,0,124,1187,89.55,0.0,10.45,2019,95982
31,0,96,127,24.41,0.0,75.59,2019,95984
11,0,0,11,100.0,0.0,0.0,2019,99154
19634,332,1870,21836,89.92,1.52,8.56,2019,99208
3103,148,488,3739,82.99,3.96,13.05,2019,99320
64,0,43,107,59.81,0.0,40.19,2019,99321
3259,116,384,3759,86.7,3.09,10.22,2019,99324
1315,46,274,1635,80.43,2.81,16.76,2019,99328
5261,138,181,5580,94.28,2.47,3.24,2019,99338
13221,640,1856,15717,84.12,4.07,11.81,2019,99362
140,0,36,176,79.55,0.0,20.45,2019,99401
482,10,116,608,79.28,1.64,19.08,2019,99402
13532,223,1117,14872,90.99,1.5,7.51,2019,99504
67,2,9,78,85.9,2.56,11.54,2019,99550
122,16,18,156,78.21,10.26,11.54,2019,99572
740,0,43,783,94.51,0.0,5.49,2019,99587
17,3,6,26,65.38,11.54,23.08,2019,99591
3387,126,534,4047,83.69,3.11,13.19,2019,99603
14,0,8,22,63.64,0.0,36.36,2019,99624
31,0,27,58,53.45,0.0,46.55,2019,99626
41,2,20,63,65.08,3.17,31.75,2019,99784
4587,220,590,5397,84.99,4.08,10.93,2019,99901
0,0,0,0,,,,2019,99903
188,1,128,317,59.31,0.32,40.38,2019,99925
36,0,8,44,81.82,0.0,18.18,2019,99589
40,2,29,71,56.34,2.82,40.85,2019,99602
4520,205,1114,5839,77.41,3.51,19.08,2019,99611
203,16,92,311,65.27,5.14,29.58,2019,99612
116,10,24,150,77.33,6.67,16.0,2019,99613
22,0,13,35,62.86,0.0,37.14,2019,99625
1,0,4,5,20.0,0.0,80.0,2019,99651
159,1,59,219,72.6,0.46,26.94,2019,99689
341,27,181,549,62.11,4.92,32.97,2019,99101
374,8,85,467,80.09,1.71,18.2,2019,99115
204,21,96,321,63.55,6.54,29.91,2019,99129
1032,22,280,1334,77.36,1.65,20.99,2019,99326
4932,171,239,5342,92.32,3.2,4.47,2019,99353
109,5,18,132,82.58,3.79,13.64,2019,99371
658,39,154,851,77.32,4.58,18.1,2019,03266
1062,28,75,1165,91.16,2.4,6.44,2019,03278
282,39,34,355,79.44,10.99,9.58,2019,03282
518,41,87,646,80.19,6.35,13.47,2019,03442
923,26,133,1082,85.3,2.4,12.29,2019,03574
1042,38,328,1408,74.01,2.7,23.3,2019,03576
1285,74,179,1538,83.55,4.81,11.64,2019,03584
1783,112,596,2491,71.58,4.5,23.93,2019,72855
89,0,49,138,64.49,0.0,35.51,2019,72856
721,36,284,1041,69.26,3.46,27.28,2019,72952
10207,592,2755,13554,75.31,4.37,20.33,2019,72956
613,10,458,1081,56.71,0.93,42.37,2019,72959
621,33,286,940,66.06,3.51,30.43,2019,72326
33,0,22,55,60.0,0.0,40.0,2019,72339
494,0,249,743,66.49,0.0,33.51,2019,72376
5014,81,694,5789,86.61,1.4,11.99,2019,72364
720,69,280,1069,67.35,6.45,26.19,2019,72365
0,0,6,6,0.0,0.0,100.0,2019,72367
312,5,71,388,80.41,1.29,18.3,2019,72395
116,7,63,186,62.37,3.76,33.87,2019,72410
665,303,242,1210,54.96,25.04,20.0,2019,72519
37,51,106,194,19.07,26.29,54.64,2019,72522
73,11,80,164,44.51,6.71,48.78,2019,72533
85,13,68,166,51.2,7.83,40.96,2019,72564
408,8,92,508,80.31,1.57,18.11,2019,72581
9925,201,2022,12148,81.7,1.65,16.64,2019,72601
530,0,143,673,78.75,0.0,21.25,2019,72633
1166,25,299,1490,78.26,1.68,20.07,2019,72635
884,11,145,1040,85.0,1.06,13.94,2019,72644
441,23,156,620,71.13,3.71,25.16,2019,72675
163,59,80,302,53.97,19.54,26.49,2019,72680
13978,1629,1451,17058,81.94,9.55,8.51,2019,72701
2338,244,911,3493,66.93,6.99,26.08,2019,72740
1838,12,371,2221,82.76,0.54,16.7,2019,72417
1330,122,495,1947,68.31,6.27,25.42,2019,72422
3680,278,1212,5170,71.18,5.38,23.44,2019,72455
89,12,60,161,55.28,7.45,37.27,2019,72462
27,14,120,161,16.77,8.7,74.53,2019,72478
290,84,167,541,53.6,15.53,30.87,2019,72482
0,0,0,0,,,,2019,72515
0,0,0,0,,,,2019,72528
179,16,144,339,52.8,4.72,42.48,2019,72531
278,36,284,598,46.49,6.02,47.49,2019,72534
1375,214,325,1914,71.84,11.18,16.98,2019,72632
1491,117,957,2565,58.13,4.56,37.31,2019,72638
930,25,140,1095,84.93,2.28,12.79,2019,72662
33,0,45,78,42.31,0.0,57.69,2019,72663
72,0,42,114,63.16,0.0,36.84,2019,72672
2057,28,612,2697,76.27,1.04,22.69,2019,72687
12212,787,1696,14695,83.1,5.36,11.54,2019,72703
5843,600,737,7180,81.38,8.36,10.26,2019,72715
1627,490,801,2918,55.76,16.79,27.45,2019,72734
3483,60,720,4263,81.7,1.41,16.89,2019,98580
11464,284,1948,13696,83.7,2.07,14.22,2019,98584
0,0,0,0,,,,2019,98154
8443,116,317,8876,95.12,1.31,3.57,2019,98028
10060,296,806,11162,90.13,2.65,7.22,2019,98037
1137,5,53,1195,95.15,0.42,4.44,2019,98039
13021,60,714,13795,94.39,0.43,5.18,2019,98059
15475,969,702,17146,90.25,5.65,4.09,2019,98105
16536,284,522,17342,95.35,1.64,3.01,2019,98109
9202,165,833,10200,90.22,1.62,8.17,2019,98146
107,20,59,186,57.53,10.75,31.72,2019,98647
77,6,55,138,55.8,4.35,39.86,2019,98621
2371,73,214,2658,89.2,2.75,8.05,2019,98625
7956,181,1254,9391,84.72,1.93,13.35,2019,98626
9002,262,1852,11116,80.98,2.36,16.66,2019,15650
101,0,95,196,51.53,0.0,48.47,2019,15660
221,17,81,319,69.28,5.33,25.39,2019,15675
891,56,220,1167,76.35,4.8,18.85,2019,15679
315,8,22,345,91.3,2.32,6.38,2019,15684
10255,453,1989,12697,80.77,3.57,15.67,2019,15701
249,12,68,329,75.68,3.65,20.67,2019,15716
3308,91,821,4220,78.39,2.16,19.45,2019,15717
429,0,171,600,71.5,0.0,28.5,2019,15729
298,0,46,344,86.63,0.0,13.37,2019,15736
193,5,49,247,78.14,2.02,19.84,2019,15380
43,0,26,69,62.32,0.0,37.68,2019,15448
351,0,98,449,78.17,0.0,21.83,2019,15451
51,0,14,65,78.46,0.0,21.54,2019,15454
1259,52,328,1639,76.82,3.17,20.01,2019,15473
305,8,65,378,80.69,2.12,17.2,2019,15477
105,16,40,161,65.22,9.94,24.84,2019,15482
95,0,76,171,55.56,0.0,44.44,2019,15490
468,6,146,620,75.48,0.97,23.55,2019,15533
335,11,103,449,74.61,2.45,22.94,2019,15542
1059,32,363,1454,72.83,2.2,24.97,2019,15557
505,7,273,785,64.33,0.89,34.78,2019,15558
654,13,125,792,82.58,1.64,15.78,2019,15559
137,0,18,155,88.39,0.0,11.61,2019,15615
3572,107,461,4140,86.28,2.58,11.14,2019,15632
471,30,93,594,79.29,5.05,15.66,2019,15637
156,0,51,207,75.36,0.0,24.64,2019,15640
6683,334,1568,8585,77.85,3.89,18.26,2019,15644
2893,133,907,3933,73.56,3.38,23.06,2019,15690
1020,42,335,1397,73.01,3.01,23.98,2019,15697
149,10,29,188,79.26,5.32,15.43,2019,15711
144,9,35,188,76.6,4.79,18.62,2019,15715
197,2,155,354,55.65,0.56,43.79,2019,15742
82,0,7,89,92.13,0.0,7.87,2019,15745
776,39,328,1143,67.89,3.41,28.7,2019,15759
45,0,10,55,81.82,0.0,18.18,2019,15778
714,22,106,842,84.8,2.61,12.59,2019,15840
1097,39,300,1436,76.39,2.72,20.89,2019,15845
66,0,0,66,100.0,0.0,0.0,2019,15443
81,0,33,114,71.05,0.0,28.95,2019,15446
236,12,60,308,76.62,3.9,19.48,2019,15470
380,9,142,531,71.56,1.69,26.74,2019,15475
43,0,0,43,100.0,0.0,0.0,2019,15484
91,0,62,153,59.48,0.0,40.52,2019,15539
228,11,73,312,73.08,3.53,23.4,2019,15551
978,30,94,1102,88.75,2.72,8.53,2019,06069
8775,187,821,9783,89.7,1.91,8.39,2019,06074
6609,165,359,7133,92.65,2.31,5.03,2019,06001
10325,147,775,11247,91.8,1.31,6.89,2019,06033
0,0,0,0,,,,2019,06059
4388,42,627,5057,86.77,0.83,12.4,2019,06076
3593,77,218,3888,92.41,1.98,5.61,2019,06078
35,0,4,39,89.74,0.0,10.26,2019,06091
10514,431,1421,12366,85.02,3.49,11.49,2019,06111
196,0,25,221,88.69,0.0,11.31,2019,06024
2597,67,253,2917,89.03,2.3,8.67,2019,06085
1934,68,215,2217,87.24,3.07,9.7,2019,06088
1954,29,250,2233,87.51,1.3,11.2,2019,06354
1607,0,49,1656,97.04,0.0,2.96,2019,06426
1937,74,158,2169,89.3,3.41,7.28,2019,01773
2442,0,116,2558,95.47,0.0,4.53,2019,01775
10752,113,696,11561,93.0,0.98,6.02,2019,01821
6741,183,1621,8545,78.89,2.14,18.97,2019,01843
3407,36,407,3850,88.49,0.94,10.57,2019,01863
5199,23,321,5543,93.79,0.41,5.79,2019,01864
10580,136,968,11684,90.55,1.16,8.28,2019,01876
9508,198,823,10529,90.3,1.88,7.82,2019,01880
9145,235,1051,10431,87.67,2.25,10.08,2019,01906
9402,212,1075,10689,87.96,1.98,10.06,2019,01923
1361,33,63,1457,93.41,2.26,4.32,2019,01929
4495,79,391,4965,90.53,1.59,7.88,2019,01940
4863,153,942,5958,81.62,2.57,15.81,2019,01028
2267,18,318,2603,87.09,0.69,12.22,2019,01033
200,17,21,238,84.03,7.14,8.82,2019,01037
1537,57,350,1944,79.06,2.93,18.0,2019,01005
7045,200,683,7928,88.86,2.52,8.62,2019,01027
1053,21,146,1220,86.31,1.72,11.97,2019,01038
711,15,40,766,92.82,1.96,5.22,2019,01054
56,4,15,75,74.67,5.33,20.0,2019,01084
371,0,90,461,80.48,0.0,19.52,2019,01092
905,209,367,1481,61.11,14.11,24.78,2019,01103
2825,96,928,3849,73.4,2.49,24.11,2019,01107
3806,172,922,4900,77.67,3.51,18.82,2019,01119
534,0,4,538,99.26,0.0,0.74,2019,01236
335,15,47,397,84.38,3.78,11.84,2019,01245
415,5,23,443,93.68,1.13,5.19,2019,01254
419,0,71,490,85.51,0.0,14.49,2019,01262
55,0,6,61,90.16,0.0,9.84,2019,01338
417,29,135,581,71.77,4.99,23.24,2019,01368
14643,462,1743,16848,86.91,2.74,10.35,2019,01453
3326,34,297,3657,90.95,0.93,8.12,2019,01460
3900,69,341,4310,90.49,1.6,7.91,2019,01462
3048,97,620,3765,80.96,2.58,16.47,2019,01475
2469,0,35,2504,98.6,0.0,1.4,2019,01519
5214,38,147,5399,96.57,0.7,2.72,2019,01532
2031,64,256,2351,86.39,2.72,10.89,2019,01534
1563,21,257,1841,84.9,1.14,13.96,2019,01535
1507,18,317,1842,81.81,0.98,17.21,2019,01585
958,48,61,1067,89.78,4.5,5.72,2019,01050
6852,435,2403,9690,70.71,4.49,24.8,2019,01108
883,67,135,1085,81.38,6.18,12.44,2019,01128
920,30,166,1116,82.44,2.69,14.87,2019,01235
6024,338,1051,7413,81.26,4.56,14.18,2019,01001
349,10,89,448,77.9,2.23,19.87,2019,01026
10156,90,1083,11329,89.65,0.79,9.56,2019,02176
1301,78,195,1574,82.66,4.96,12.39,2019,02322
2535,17,352,2904,87.29,0.59,12.12,2019,02338
4300,115,160,4575,93.99,2.51,3.5,2019,02356
899,39,72,1010,89.01,3.86,7.13,2019,02367
2219,99,181,2499,88.8,3.96,7.24,2019,02379
4186,185,353,4724,88.61,3.92,7.47,2019,02452
570,35,27,632,90.19,5.54,4.27,2019,02535
253,49,11,313,80.83,15.65,3.51,2019,02542
5186,187,989,6362,81.52,2.94,15.55,2019,02601
4098,67,245,4410,92.93,1.52,5.56,2019,02632
10746,101,736,11583,92.77,0.87,6.35,2019,02474
3567,112,210,3889,91.72,2.88,5.4,2019,02482
1121,148,184,1453,77.15,10.19,12.66,2019,02539
610,13,93,716,85.2,1.82,12.99,2019,03588
782,70,160,1012,77.27,6.92,15.81,2019,03602
9336,273,761,10370,90.03,2.63,7.34,2019,03801
723,26,55,804,89.93,3.23,6.84,2019,03810
8071,189,709,8969,89.99,2.11,7.91,2019,03833
2383,32,215,2630,90.61,1.22,8.17,2019,03841
865,12,28,905,95.58,1.33,3.09,2019,03844
1749,18,61,1828,95.68,0.98,3.34,2019,03862
101,0,0,101,100.0,0.0,0.0,2019,03883
1421,0,144,1565,90.8,0.0,9.2,2019,03034
1631,12,44,1687,96.68,0.71,2.61,2019,03036
9106,210,635,9951,91.51,2.11,6.38,2019,03054
5692,162,434,6288,90.52,2.58,6.9,2019,03055
6426,103,448,6977,92.1,1.48,6.42,2019,03063
3772,41,286,4099,92.02,1.0,6.98,2019,03077
448,12,27,487,91.99,2.46,5.54,2019,03084
868,22,28,918,94.55,2.4,3.05,2019,03216
458,8,74,540,84.81,1.48,13.7,2019,03240
291,14,46,351,82.91,3.99,13.11,2019,03241
2693,43,325,3061,87.98,1.4,10.62,2019,03244
220,41,48,309,71.2,13.27,15.53,2019,03279
412,35,90,537,76.72,6.52,16.76,2019,03280
2952,103,74,3129,94.34,3.29,2.36,2019,03281
284,31,26,341,83.28,9.09,7.62,2019,03284
1708,54,94,1856,92.03,2.91,5.06,2019,03290
1911,24,115,2050,93.22,1.17,5.61,2019,03307
153,0,0,153,100.0,0.0,0.0,2019,03443
489,20,73,582,84.02,3.44,12.54,2019,03580
835,40,170,1045,79.9,3.83,16.27,2019,03582
922,35,155,1112,82.91,3.15,13.94,2019,03585
448,16,100,564,79.43,2.84,17.73,2019,03592
1128,23,35,1186,95.11,1.94,2.95,2019,03753
683,48,58,789,86.57,6.08,7.35,2019,03781
1473,100,217,1790,82.29,5.59,12.12,2019,03784
643,53,142,838,76.73,6.32,16.95,2019,03785
276,33,84,393,70.23,8.4,21.37,2019,03812
1487,14,174,1675,88.78,0.84,10.39,2019,03819
2831,130,276,3237,87.46,4.02,8.53,2019,03825
1405,19,84,1508,93.17,1.26,5.57,2019,03840
7602,177,1241,9020,84.28,1.96,13.76,2019,03867
896,25,100,1021,87.76,2.45,9.79,2019,03869
1294,38,71,1403,92.23,2.71,5.06,2019,03872
522,20,87,629,82.99,3.18,13.83,2019,03043
8848,64,320,9232,95.84,0.69,3.47,2019,03051
2966,22,54,3042,97.5,0.72,1.78,2019,03052
388,52,82,522,74.33,9.96,15.71,2019,05739
92,6,22,120,76.67,5.0,18.33,2019,05747
253,8,46,307,82.41,2.61,14.98,2019,05772
115,17,63,195,58.97,8.72,32.31,2019,05775
398,3,90,491,81.06,0.61,18.33,2019,05824
740,58,366,1164,63.57,4.98,31.44,2019,05843
242,41,82,365,66.3,11.23,22.47,2019,05847
195,8,41,244,79.92,3.28,16.8,2019,05874
150,7,21,178,84.27,3.93,11.8,2019,05875
43,2,22,67,64.18,2.99,32.84,2019,05907
975,57,232,1264,77.14,4.51,18.35,2019,05764
228,0,45,273,83.52,0.0,16.48,2019,05766
234,2,41,277,84.48,0.72,14.8,2019,05776
1132,40,260,1432,79.05,2.79,18.16,2019,05777
168,80,77,325,51.69,24.62,23.69,2019,05150
112,15,22,149,75.17,10.07,14.77,2019,05152
73,0,0,73,100.0,0.0,0.0,2019,05254
1569,82,258,1909,82.19,4.3,13.51,2019,05255
764,48,87,899,84.98,5.34,9.68,2019,05458
233,0,15,248,93.95,0.0,6.05,2019,05471
576,7,41,624,92.31,1.12,6.57,2019,05473
345,12,48,405,85.19,2.96,11.85,2019,05474
2771,146,265,3182,87.08,4.59,8.33,2019,05482
628,31,63,722,86.98,4.29,8.73,2019,05494
398,0,74,472,84.32,0.0,15.68,2019,05647
26,6,0,32,81.25,18.75,0.0,2019,05657
442,14,124,580,76.21,2.41,21.38,2019,05658
663,3,81,747,88.76,0.4,10.84,2019,05660
2068,97,222,2387,86.64,4.06,9.3,2019,05661
793,10,95,898,88.31,1.11,10.58,2019,05680
173,0,10,183,94.54,0.0,5.46,2019,05154
228,11,24,263,86.69,4.18,9.13,2019,05161
4780,95,891,5766,82.9,1.65,15.45,2019,05201
105,0,15,120,87.5,0.0,12.5,2019,05252
233,25,5,263,88.59,9.51,1.9,2019,05253
688,66,177,931,73.9,7.09,19.01,2019,05257
226,26,77,329,68.69,7.9,23.4,2019,05343
231,14,33,278,83.09,5.04,11.87,2019,05492
65,0,3,68,95.59,0.0,4.41,2019,05640
2341,74,378,2793,83.82,2.65,13.53,2019,05443
4831,156,822,5809,83.16,2.69,14.15,2019,05478
243,3,50,296,82.09,1.01,16.89,2019,05669
405,3,89,497,81.49,0.6,17.91,2019,05675
1188,17,191,1396,85.1,1.22,13.68,2019,05679
2052,37,386,2475,82.91,1.49,15.6,2019,05733
386,6,96,488,79.1,1.23,19.67,2019,05760
360,26,42,428,84.11,6.07,9.81,2019,05761
634,9,78,721,87.93,1.25,10.82,2019,05765
372,33,32,437,85.13,7.55,7.32,2019,05774
3036,158,645,3839,79.08,4.12,16.8,2019,05819
522,30,148,700,74.57,4.29,21.14,2019,05822
688,9,175,872,78.9,1.03,20.07,2019,05828
346,53,130,529,65.41,10.02,24.57,2019,05845
2537,52,495,3084,82.26,1.69,16.05,2019,05855
139,4,52,195,71.28,2.05,26.67,2019,05858
586,16,143,745,78.66,2.15,19.19,2019,05859
209,8,52,269,77.7,2.97,19.33,2019,05866
265,16,68,349,75.93,4.58,19.48,2019,05905
3821,215,501,4537,84.22,4.74,11.04,2019,05001
111,3,49,163,68.1,1.84,30.06,2019,96009
840,2,92,934,89.94,0.21,9.85,2019,96027
812,14,436,1262,64.34,1.11,34.55,2019,96035
203,19,44,266,76.32,7.14,16.54,2019,96038
368,8,95,471,78.13,1.7,20.17,2019,96044
153,1,23,177,86.44,0.56,12.99,2019,96065
3142,51,269,3462,90.76,1.47,7.77,2019,96067
15,0,0,15,100.0,0.0,0.0,2019,96071
8864,334,1986,11184,79.26,2.99,17.76,2019,96080
17,0,2,19,89.47,0.0,10.53,2019,96085
2264,77,520,2861,79.13,2.69,18.18,2019,96094
428,7,62,497,86.12,1.41,12.47,2019,96107
573,5,160,738,77.64,0.68,21.68,2019,96118
50,0,0,50,100.0,0.0,0.0,2019,96126
1407,118,57,1582,88.94,7.46,3.6,2019,06510
6767,81,268,7116,95.1,1.14,3.77,2019,06840
8179,112,873,9164,89.25,1.22,9.53,2019,06473
2438,35,252,2725,89.47,1.28,9.25,2019,06762
9491,164,410,10065,94.3,1.63,4.07,2019,06880
713,77,454,1244,57.32,6.19,36.5,2019,06380
829,0,18,847,97.87,0.0,2.13,2019,06060
1063,62,57,1182,89.93,5.25,4.82,2019,06063
236,6,20,262,90.08,2.29,7.63,2019,06065
2946,308,1236,4490,65.61,6.86,27.53,2019,06120
4281,107,338,4726,90.58,2.26,7.15,2019,06357
6308,216,458,6982,90.35,3.09,6.56,2019,06029
9526,255,1005,10786,88.32,2.36,9.32,2019,06095
3316,91,389,3796,87.36,2.4,10.25,2019,06379
2619,107,443,3169,82.64,3.38,13.98,2019,06052
8846,150,636,9632,91.84,1.56,6.6,2019,06042
132,0,0,132,100.0,0.0,0.0,2019,06061
0,0,0,0,,,,2019,06160
28,0,44,72,38.89,0.0,61.11,2019,06243
93,0,16,109,85.32,0.0,14.68,2019,06263
166,0,22,188,88.3,0.0,11.7,2019,06332
19,0,5,24,79.17,0.0,20.83,2019,06350
34,0,57,91,37.36,0.0,62.64,2019,06353
110,10,38,158,69.62,6.33,24.05,2019,06387
0,0,0,0,,,,2019,06389
42,0,0,42,100.0,0.0,0.0,2019,06414
109,0,0,109,100.0,0.0,0.0,2019,06444
94,30,11,135,69.63,22.22,8.15,2019,06456
5163,111,521,5795,89.09,1.92,8.99,2019,06461
124,0,0,124,100.0,0.0,0.0,2019,06467
122,0,5,127,96.06,0.0,3.94,2019,06758
11075,82,555,11712,94.56,0.7,4.74,2019,06824
6568,78,621,7267,90.38,1.07,8.55,2019,06825
0,0,0,0,,,,2019,06856
1552,24,36,1612,96.28,1.49,2.23,2019,06890
725,21,112,858,84.5,2.45,13.05,2019,06757
1440,23,43,1506,95.62,1.53,2.86,2019,06092
215,0,43,258,83.33,0.0,16.67,2019,06266
1732,110,228,2070,83.67,5.31,11.01,2019,06359
4215,197,282,4694,89.8,4.2,6.01,2019,06478
2854,67,256,3177,89.83,2.11,8.06,2019,06498
3592,77,360,4029,89.15,1.91,8.94,2019,06479
3760,36,180,3976,94.57,0.91,4.53,2019,06482
5663,49,807,6519,86.87,0.75,12.38,2019,06515
2753,16,128,2897,95.03,0.55,4.42,2019,06525
330,0,0,330,100.0,0.0,0.0,2019,10597
1388,69,31,1488,93.28,4.64,2.08,2019,10913
297,10,32,339,87.61,2.95,9.44,2019,10919
3562,267,505,4334,82.19,6.16,11.65,2019,10924
7909,241,4213,12363,63.97,1.95,34.08,2019,10950
3553,35,376,3964,89.63,0.88,9.49,2019,10707
8237,205,1189,9631,85.53,2.13,12.35,2019,10710
1517,29,167,1713,88.56,1.69,9.75,2019,10925
4060,685,248,4993,81.31,13.72,4.97,2019,10941
426,0,53,479,88.94,0.0,11.06,2019,10964
1096,14,44,1154,94.97,1.21,3.81,2019,10968
1202,25,109,1336,89.97,1.87,8.16,2019,10987
773,55,109,937,82.5,5.87,11.63,2019,10958
3148,91,168,3407,92.4,2.67,4.93,2019,10989
526,45,167,738,71.27,6.1,22.63,2019,02558
3613,98,239,3950,91.47,2.48,6.05,2019,02645
2717,32,85,2834,95.87,1.13,3.0,2019,02648
297,0,41,338,87.87,0.0,12.13,2019,02652
1342,42,150,1534,87.48,2.74,9.78,2019,02667
136,0,0,136,100.0,0.0,0.0,2019,02672
5688,167,506,6361,89.42,2.63,7.95,2019,02777
123,0,0,123,100.0,0.0,0.0,2019,02815
1033,25,110,1168,88.44,2.14,9.42,2019,02831
2174,17,296,2487,87.41,0.68,11.9,2019,02859
14503,498,3542,18543,78.21,2.69,19.1,2019,02860
3095,129,483,3707,83.49,3.48,13.03,2019,02916
5719,143,635,6497,88.03,2.2,9.77,2019,02865
6313,161,605,7079,89.18,2.27,8.55,2019,02871
5568,63,990,6621,84.1,0.95,14.95,2019,02911
1502,11,300,1813,82.85,0.61,16.55,2019,02559
12300,198,618,13116,93.78,1.51,4.71,2019,02446
3336,23,298,3657,91.22,0.63,8.15,2019,02460
503,0,53,556,90.47,0.0,9.53,2019,02462
1413,67,356,1836,76.96,3.65,19.39,2019,02568
3581,56,548,4185,85.57,1.34,13.09,2019,02571
2165,70,153,2388,90.66,2.93,6.41,2019,02642
456,9,45,510,89.41,1.76,8.82,2019,02671
7094,594,2989,10677,66.44,5.56,27.99,2019,02721
5258,104,663,6025,87.27,1.73,11.0,2019,02726
5895,96,933,6924,85.14,1.39,13.47,2019,02747
1276,8,119,1403,90.95,0.57,8.48,2019,02764
5471,61,520,6052,90.4,1.01,8.59,2019,02771
7116,70,1145,8331,85.42,0.84,13.74,2019,02809
1920,22,331,2273,84.47,0.97,14.56,2019,02830
653,46,117,816,80.02,5.64,14.34,2019,02839
144,18,0,162,88.89,11.11,0.0,2019,02875
7912,455,697,9064,87.29,5.02,7.69,2019,02021
3052,17,117,3186,95.79,0.53,3.67,2019,02056
11373,245,1575,13193,86.2,1.86,11.94,2019,02118
7572,226,2868,10666,70.99,2.12,26.89,2019,02121
8073,432,1583,10088,80.03,4.28,15.69,2019,02126
15154,203,1778,17135,88.44,1.18,10.38,2019,02127
8001,124,1037,9162,87.33,1.35,11.32,2019,02129
247,259,0,506,48.81,51.19,0.0,2019,02163
8508,87,1071,9666,88.02,0.9,11.08,2019,02180
2847,39,201,3087,92.23,1.26,6.51,2019,02025
6936,185,378,7499,92.49,2.47,5.04,2019,02114
8447,396,2727,11570,73.01,3.42,23.57,2019,02119
14858,381,1585,16824,88.31,2.26,9.42,2019,02130
4630,316,687,5633,82.19,5.61,12.2,2019,97038
6343,158,526,7027,90.27,2.25,7.49,2019,97055
6405,449,1268,8122,78.86,5.53,15.61,2019,97058
1104,4,167,1275,86.59,0.31,13.1,2019,97064
1329,77,113,1519,87.49,5.07,7.44,2019,97106
641,23,86,750,85.47,3.07,11.47,2019,97107
150,6,39,195,76.92,3.08,20.0,2019,97109
585,10,193,788,74.24,1.27,24.49,2019,97112
1291,41,142,1474,87.58,2.78,9.63,2019,97115
8422,312,311,9045,93.11,3.45,3.44,2019,97140
1224,26,96,1346,90.94,1.93,7.13,2019,97148
15438,454,986,16878,91.47,2.69,5.84,2019,97219
12831,447,1869,15147,84.71,2.95,12.34,2019,97230
4640,133,613,5386,86.15,2.47,11.38,2019,97459
344,51,68,463,74.3,11.02,14.69,2019,05821
279,6,100,385,72.47,1.56,25.97,2019,05826
587,30,108,725,80.97,4.14,14.9,2019,05829
70,0,56,126,55.56,0.0,44.44,2019,05837
113,0,15,128,88.28,0.0,11.72,2019,05868
283,11,71,365,77.53,3.01,19.45,2019,05903
71,16,18,105,67.62,15.24,17.14,2019,05904
418,26,112,556,75.18,4.68,20.14,2019,05906
1629,84,393,2106,77.35,3.99,18.66,2019,05663
465,3,74,542,85.79,0.55,13.65,2019,05682
153,11,25,189,80.95,5.82,13.23,2019,05762
901,20,150,1071,84.13,1.87,14.01,2019,05763
7217,189,1711,9117,79.16,2.07,18.77,2019,05701
6012,353,907,7272,82.67,4.85,12.47,2019,05641
169,22,18,209,80.86,10.53,8.61,2019,05648
612,0,66,678,90.27,0.0,9.73,2019,05674
430,21,117,568,75.7,3.7,20.6,2019,05734
195,0,56,251,77.69,0.0,22.31,2019,05744
373,16,66,455,81.98,3.52,14.51,2019,05769
481,18,120,619,77.71,2.91,19.39,2019,05830
343,7,50,400,85.75,1.75,12.5,2019,05832
375,35,73,483,77.64,7.25,15.11,2019,05836
1867,82,488,2437,76.61,3.36,20.02,2019,05851
185,3,38,226,81.86,1.33,16.81,2019,05853
878,43,273,1194,73.53,3.6,22.86,2019,05860
427,47,103,577,74.0,8.15,17.85,2019,05871
881,56,178,1115,79.01,5.02,15.96,2019,05033
273,15,40,328,83.23,4.57,12.2,2019,05035
360,4,62,426,84.51,0.94,14.55,2019,05036
203,0,37,240,84.58,0.0,15.42,2019,05040
1120,59,104,1283,87.3,4.6,8.11,2019,05048
1172,28,38,1238,94.67,2.26,3.07,2019,05055
383,14,36,433,88.45,3.23,8.31,2019,05075
379,37,17,433,87.53,8.55,3.93,2019,05148
212,7,25,244,86.89,2.87,10.25,2019,05153
275,44,76,395,69.62,11.14,19.24,2019,05155
392,26,79,497,78.87,5.23,15.9,2019,05158
327,2,44,373,87.67,0.54,11.8,2019,05352
50,6,6,62,80.65,9.68,9.68,2019,05358
312,102,37,451,69.18,22.62,8.2,2019,05361
10567,804,1234,12605,83.83,6.38,9.79,2019,05401
2451,189,549,3189,76.86,5.93,17.22,2019,05404
1394,42,26,1462,95.35,2.87,1.78,2019,05445
1599,89,268,1956,81.75,4.55,13.7,2019,05454
335,24,46,405,82.72,5.93,11.36,2019,05455
7194,116,302,7612,94.51,1.52,3.97,2019,98136
12255,139,603,12997,94.29,1.07,4.64,2019,98116
15164,260,1894,17318,87.56,1.5,10.94,2019,98118
221,0,0,221,100.0,0.0,0.0,2019,98134
0,0,0,0,,,,2019,98174
48,0,0,48,100.0,0.0,0.0,2019,98222
5643,116,572,6331,89.13,1.83,9.03,2019,98233
230,33,14,277,83.03,11.91,5.05,2019,98243
310,21,8,339,91.45,6.19,2.36,2019,98279
194,56,8,258,75.19,21.71,3.1,2019,98280
9823,69,606,10498,93.57,0.66,5.77,2019,98311
255,7,86,348,73.28,2.01,24.71,2019,98326
6548,123,299,6970,93.95,1.76,4.29,2019,98332
377,14,86,477,79.04,2.94,18.03,2019,98357
326,10,77,413,78.93,2.42,18.64,2019,03262
1861,127,324,2312,80.49,5.49,14.01,2019,03264
92,0,61,153,60.13,0.0,39.87,2019,03597
58,0,0,58,100.0,0.0,0.0,2019,03604
262,8,35,305,85.9,2.62,11.48,2019,03740
84,0,16,100,84.0,0.0,16.0,2019,03746
14,0,0,14,100.0,0.0,0.0,2019,03754
563,6,27,596,94.46,1.01,4.53,2019,03823
219,0,0,219,100.0,0.0,0.0,2019,03847
104,0,17,121,85.95,0.0,14.05,2019,03850
1353,101,172,1626,83.21,6.21,10.58,2019,03851
1697,60,119,1876,90.46,3.2,6.34,2019,03861
104,0,0,104,100.0,0.0,0.0,2019,03871
53,0,0,53,100.0,0.0,0.0,2019,03890
175,0,0,175,100.0,0.0,0.0,2019,03910
28,0,0,28,100.0,0.0,0.0,2019,03911
1101,14,273,1388,79.32,1.01,19.67,2019,04217
4426,58,187,4671,94.75,1.24,4.0,2019,04105
531,14,13,558,95.16,2.51,2.33,2019,04110
1472,27,148,1647,89.37,1.64,8.99,2019,04222
0,0,0,0,,,,2019,04228
1688,15,159,1862,90.66,0.81,8.54,2019,04252
356,12,65,433,82.22,2.77,15.01,2019,04284
359,4,98,461,77.87,0.87,21.26,2019,04410
883,80,117,1080,81.76,7.41,10.83,2019,04419
851,27,135,1013,84.01,2.67,13.33,2019,04427
436,114,171,721,60.47,15.81,23.72,2019,04441
1959,209,269,2437,80.39,8.58,11.04,2019,04457
469,12,95,576,81.42,2.08,16.49,2019,04460
344,10,144,498,69.08,2.01,28.92,2019,04922
1311,79,428,1818,72.11,4.35,23.54,2019,04930
326,17,121,464,70.26,3.66,26.08,2019,04939
563,32,130,725,77.66,4.41,17.93,2019,04941
535,22,131,688,77.76,3.2,19.04,2019,04958
584,34,181,799,73.09,4.26,22.65,2019,04966
1236,64,321,1621,76.25,3.95,19.8,2019,04967
484,95,92,671,72.13,14.16,13.71,2019,04970
277,4,50,331,83.69,1.21,15.11,2019,04978
995,39,197,1231,80.83,3.17,16.0,2019,04981
622,16,79,717,86.75,2.23,11.02,2019,04342
881,29,194,1104,79.8,2.63,17.57,2019,04347
991,9,65,1065,93.05,0.85,6.1,2019,04351
1414,28,186,1628,86.86,1.72,11.43,2019,04357
228,25,54,307,74.27,8.14,17.59,2019,04406
897,29,115,1041,86.17,2.79,11.05,2019,04001
38,0,142,180,21.11,0.0,78.89,2019,72752
10654,2391,1862,14907,71.47,16.04,12.49,2019,72758
11869,1144,1511,14524,81.72,7.88,10.4,2019,72762
6390,196,1345,7931,80.57,2.47,16.96,2019,72802
8,8,98,114,7.02,7.02,85.96,2019,72827
2693,48,833,3574,75.35,1.34,23.31,2019,72834
281,45,84,410,68.54,10.98,20.49,2019,72845
34,0,74,108,31.48,0.0,68.52,2019,72860
6151,333,2653,9137,67.32,3.64,29.04,2019,72901
3926,219,1133,5278,74.38,4.15,21.47,2019,72921
1555,40,222,1817,85.58,2.2,12.22,2019,72923
828,7,185,1020,81.18,0.69,18.14,2019,72940
3436,938,552,4926,69.75,19.04,11.21,2019,72745
422,0,115,537,78.58,0.0,21.42,2019,72824
2446,93,91,2630,93.0,3.54,3.46,2019,10994
3508,35,50,3593,97.63,0.97,1.39,2019,10536
8376,177,507,9060,92.45,1.95,5.6,2019,10541
1415,0,137,1552,91.17,0.0,8.83,2019,10594
7307,232,1828,9367,78.01,2.48,19.52,2019,10566
10996,184,1303,12483,88.09,1.47,10.44,2019,10573
13297,109,517,13923,95.5,0.78,3.71,2019,10583
9995,938,1289,12222,81.78,7.67,10.55,2019,10704
2895,19,214,3128,92.55,0.61,6.84,2019,10706
2705,87,203,2995,90.32,2.9,6.78,2019,10920
1246,29,116,1391,89.58,2.08,8.34,2019,10921
2706,35,178,2919,92.7,1.2,6.1,2019,10930
7378,112,813,8303,88.86,1.35,9.79,2019,10954
1745,31,85,1861,93.77,1.67,4.57,2019,10962
772,10,13,795,97.11,1.26,1.64,2019,10973
92,0,9,101,91.09,0.0,8.91,2019,10975
523,0,189,712,73.46,0.0,26.54,2019,10976
865,10,0,875,98.86,1.14,0.0,2019,10996
71,51,0,122,58.2,41.8,0.0,2019,10535
2712,48,42,2802,96.79,1.71,1.5,2019,10007
23504,333,2321,26158,89.85,1.27,8.87,2019,10019
0,0,0,0,,,,2019,10020
22418,332,1185,23935,93.66,1.39,4.95,2019,10021
8485,151,1825,10461,81.11,1.44,17.45,2019,10038
9009,461,1898,11368,79.25,4.06,16.7,2019,10039
0,0,0,0,,,,2019,10165
0,0,0,0,,,,2019,10167
0,0,0,0,,,,2019,10278
4458,61,39,4558,97.81,1.34,0.86,2019,10280
4447,271,1372,6090,73.02,4.45,22.53,2019,10302
6114,306,1848,8268,73.95,3.7,22.35,2019,10303
16798,1279,6700,24777,67.8,5.16,27.04,2019,10457
1517,24,310,1851,81.96,1.3,16.75,2019,10464
484,29,38,551,87.84,5.26,6.9,2019,10986
2655,239,350,3244,81.84,7.37,10.79,2019,10992
1862,17,330,2209,84.29,0.77,14.94,2019,10507
23100,1069,1874,26043,88.7,4.1,7.2,2019,10003
21272,4248,4244,29764,71.47,14.27,14.26,2019,10009
26856,593,1640,29089,92.32,2.04,5.64,2019,10011
16682,261,1010,17953,92.92,1.45,5.63,2019,10022
23345,313,982,24640,94.74,1.27,3.99,2019,10028
0,0,0,0,,,,2019,10119
4193,221,360,4774,87.83,4.63,7.54,2019,10044
673,0,0,673,100.0,0.0,0.0,2019,10162
18,0,0,18,100.0,0.0,0.0,2019,10279
543,34,158,735,73.88,4.63,21.5,2019,13493
12268,400,2408,15076,81.37,2.65,15.97,2019,13601
588,31,143,762,77.17,4.07,18.77,2019,13620
1119,74,199,1392,80.39,5.32,14.3,2019,13116
216,3,48,267,80.9,1.12,17.98,2019,13141
3871,42,632,4545,85.17,0.92,13.91,2019,13148
2960,134,453,3547,83.45,3.78,12.77,2019,13224
386,21,137,544,70.96,3.86,25.18,2019,13315
558,9,68,635,87.87,1.42,10.71,2019,13328
312,6,66,384,81.25,1.56,17.19,2019,13334
388,8,167,563,68.92,1.42,29.66,2019,13338
63,0,0,63,100.0,0.0,0.0,2019,13341
1439,68,260,1767,81.44,3.85,14.71,2019,13346
3456,127,601,4184,82.6,3.04,14.36,2019,13357
7459,164,1207,8830,84.47,1.86,13.67,2019,97470
12646,338,1521,14505,87.18,2.33,10.49,2019,97478
114,4,49,167,68.26,2.4,29.34,2019,97480
296,20,30,346,85.55,5.78,8.67,2019,97489
213,9,21,243,87.65,3.7,8.64,2019,97492
9666,562,951,11179,86.47,5.03,8.51,2019,97502
10504,316,788,11608,90.49,2.72,6.79,2019,97520
4971,135,765,5871,84.67,2.3,13.03,2019,97524
12360,622,1949,14931,82.78,4.17,13.05,2019,97527
2749,78,337,3164,86.88,2.47,10.65,2019,97530
895,38,149,1082,82.72,3.51,13.77,2019,97532
1757,301,451,2509,70.03,12.0,17.98,2019,97535
94,0,8,102,92.16,0.0,7.84,2019,97625
29,0,16,45,64.44,0.0,35.56,2019,97626
39,0,15,54,72.22,0.0,27.78,2019,97637
60,2,10,72,83.33,2.78,13.89,2019,97640
39,5,2,46,84.78,10.87,4.35,2019,97736
665,11,68,744,89.38,1.48,9.14,2019,97738
3756,370,991,5117,73.4,7.23,19.37,2019,97739
2917,117,231,3265,89.34,3.58,7.08,2019,97759
289,13,54,356,81.18,3.65,15.17,2019,97812
449,4,77,530,84.72,0.75,14.53,2019,97813
704,8,125,837,84.11,0.96,14.93,2019,97836
197,30,30,257,76.65,11.67,11.67,2019,97481
16744,721,2004,19469,86.0,3.7,10.29,2019,97504
1108,60,405,1573,70.44,3.81,25.75,2019,97539
1103,60,497,1660,66.45,3.61,29.94,2019,97624
56,0,15,71,78.87,0.0,21.13,2019,97634
148,16,40,204,72.55,7.84,19.61,2019,97636
161,0,66,227,70.93,0.0,29.07,2019,97638
17623,442,1498,19563,90.08,2.26,7.66,2019,97702
24,0,19,43,55.81,0.0,44.19,2019,97751
597,44,360,1001,59.64,4.4,35.96,2019,97761
11,0,0,11,100.0,0.0,0.0,2019,97817
308,31,116,455,67.69,6.81,25.49,2019,97823
564,8,143,715,78.88,1.12,20.0,2019,97824
91,0,27,118,77.12,0.0,22.88,2019,97839
160,11,34,205,78.05,5.37,16.59,2019,97841
1101,74,183,1358,81.08,5.45,13.48,2019,97844
722,16,153,891,81.03,1.8,17.17,2019,97846
28,0,29,57,49.12,0.0,50.88,2019,97859
3310,49,936,4295,77.07,1.14,21.79,2019,97862
876,19,188,1083,80.89,1.75,17.36,2019,97875
1501,181,404,2086,71.96,8.68,19.37,2019,97882
61,0,44,105,58.1,0.0,41.9,2019,97904
1703,66,134,1903,89.49,3.47,7.04,2019,95626
1005,0,172,1177,85.39,0.0,14.61,2019,95627
8945,243,854,10042,89.08,2.42,8.5,2019,95632
191,21,7,219,87.21,9.59,3.2,2019,95651
133,27,33,193,68.91,13.99,17.1,2019,95653
1278,48,76,1402,91.16,3.42,5.42,2019,95655
6249,70,478,6797,91.94,1.03,7.03,2019,95448
11470,220,334,12024,95.39,1.83,2.78,2019,95148
3648,114,202,3964,92.03,2.88,5.1,2019,95073
2044,37,154,2235,91.45,1.66,6.89,2019,95139
2550,84,604,3238,78.75,2.59,18.65,2019,95322
643,3,77,723,88.93,0.41,10.65,2019,95372
672,19,96,787,85.39,2.41,12.2,2019,95421
1219,24,69,1312,92.91,1.83,5.26,2019,95442
8776,264,1458,10498,83.6,2.51,13.89,2019,98362
11838,188,1365,13391,88.4,1.4,10.19,2019,98366
7377,199,934,8510,86.69,2.34,10.98,2019,98371
8171,137,412,8720,93.7,1.57,4.72,2019,98383
190,0,8,198,95.96,0.0,4.04,2019,98533
168,21,26,215,78.14,9.77,12.09,2019,98542
975,8,124,1107,88.08,0.72,11.2,2019,98548
298,9,88,395,75.44,2.28,22.28,2019,98593
50,0,0,50,100.0,0.0,0.0,2019,98616
2647,44,526,3217,82.28,1.37,16.35,2019,98620
16947,520,1816,19283,87.89,2.7,9.42,2019,98125
2469,24,216,2709,91.14,0.89,7.97,2019,98260
1352,62,66,1480,91.35,4.19,4.46,2019,98333
0,0,0,0,,,,2019,98421
124,2,32,158,78.48,1.27,20.25,2019,98613
23174,405,667,24246,95.58,1.67,2.75,2019,98012
17451,590,1426,19467,89.64,3.03,7.33,2019,98122
13012,302,706,14020,92.81,2.15,5.04,2019,98198
1721,21,192,1934,88.99,1.09,9.93,2019,98257
1135,10,7,1152,98.52,0.87,0.61,2019,98315
599,35,277,911,65.75,3.84,30.41,2019,98377
9295,484,1913,11692,79.5,4.14,16.36,2019,98404
7738,595,1467,9800,78.96,6.07,14.97,2019,98405
1892,88,163,2143,88.29,4.11,7.61,2019,98443
115,0,89,204,56.37,0.0,43.63,2019,98555
2266,76,449,2791,81.19,2.72,16.09,2019,98577
98,0,0,98,100.0,0.0,0.0,2019,98582
323,0,107,430,75.12,0.0,24.88,2019,98585
7840,194,523,8557,91.62,2.27,6.11,2019,98043
26685,556,781,28022,95.23,1.98,2.79,2019,98052
15289,197,911,16397,93.24,1.2,5.56,2019,98092
14650,628,372,15650,93.61,4.01,2.38,2019,98102
7081,189,1221,8491,83.39,2.23,14.38,2019,98108
1522,97,101,1720,88.49,5.64,5.87,2019,98380
5516,148,380,6044,91.26,2.45,6.29,2019,98467
54,0,0,54,100.0,0.0,0.0,2019,98536
722,12,236,970,74.43,1.24,24.33,2019,98564
11358,256,696,12310,92.27,2.08,5.65,2019,98604
286,0,61,347,82.42,0.0,17.58,2019,98649
9563,195,342,10100,94.68,1.93,3.39,2019,98335
1767,45,89,1901,92.95,2.37,4.68,2019,98359
2471,125,530,3126,79.05,4.0,16.95,2019,98465
7717,94,49,7860,98.18,1.2,0.62,2019,98075
4395,41,130,4566,96.25,0.9,2.85,2019,98077
13367,595,715,14677,91.07,4.05,4.87,2019,98087
5970,389,1186,7545,79.13,5.16,15.72,2019,99501
8166,226,617,9009,90.64,2.51,6.85,2019,99502
0,0,0,0,,,,2019,99513
4101,41,666,4808,85.3,0.85,13.85,2019,99006
2196,37,224,2457,89.38,1.51,9.12,2019,99027
176,13,104,293,60.07,4.44,35.49,2019,99040
5987,74,733,6794,88.12,1.09,10.79,2019,99517
60,20,55,135,44.44,14.81,40.74,2019,99551
124,0,57,181,68.51,0.0,31.49,2019,99563
42,0,27,69,60.87,0.0,39.13,2019,99571
9,0,19,28,32.14,0.0,67.86,2019,99575
67,17,42,126,53.17,13.49,33.33,2019,99578
14,2,12,28,50.0,7.14,42.86,2019,99580
65,3,37,105,61.9,2.86,35.24,2019,99606
322,26,78,426,75.59,6.1,18.31,2019,98639
4550,253,788,5591,81.38,4.53,14.09,2019,98660
5420,59,651,6130,88.42,0.96,10.62,2019,98663
3858,181,620,4659,82.81,3.88,13.31,2019,98674
2027,105,514,2646,76.61,3.97,19.43,2019,98815
71,28,26,125,56.8,22.4,20.8,2019,98819
1116,8,217,1341,83.22,0.6,16.18,2019,98831
2998,89,827,3914,76.6,2.27,21.13,2019,98841
100,11,19,130,76.92,8.46,14.62,2019,98845
332,16,97,445,74.61,3.6,21.8,2019,98846
69,0,22,91,75.82,0.0,24.18,2019,98859
8126,324,2185,10635,76.41,3.05,20.55,2019,98901
12614,759,3091,16464,76.62,4.61,18.77,2019,98902
12572,461,1541,14574,86.26,3.16,10.57,2019,98908
5512,83,793,6388,86.29,1.3,12.41,2019,98944
2902,116,733,3751,77.37,3.09,19.54,2019,98948
23,0,0,23,100.0,0.0,0.0,2019,98950
442,7,112,561,78.79,1.25,19.96,2019,98952
8039,223,888,9150,87.86,2.44,9.7,2019,98248
8132,125,529,8786,92.56,1.42,6.02,2019,98166
1520,38,268,1826,83.24,2.08,14.68,2019,98237
1614,15,209,1838,87.81,0.82,11.37,2019,98251
3257,81,407,3745,86.97,2.16,10.87,2019,98252
117,13,29,159,73.58,8.18,18.24,2019,98256
8543,150,935,9628,88.73,1.56,9.71,2019,98284
76,4,2,82,92.68,4.88,2.44,2019,98286
63,0,3,66,95.45,0.0,4.55,2019,98560
2970,33,314,3317,89.54,0.99,9.47,2019,98569
248,4,28,280,88.57,1.43,10.0,2019,98572
40,0,25,65,61.54,0.0,38.46,2019,98575
4388,61,422,4871,90.08,1.25,8.66,2019,98579
2828,36,189,3053,92.63,1.18,6.19,2019,98606
3128,41,340,3509,89.14,1.17,9.69,2019,98611
501,3,133,637,78.65,0.47,20.88,2019,98624
17051,691,3221,20963,81.34,3.3,15.37,2019,98632
1893,17,290,2200,86.05,0.77,13.18,2019,98640
12136,346,1277,13759,88.2,2.51,9.28,2019,98683
9906,100,885,10891,90.96,0.92,8.13,2019,98684
1724,87,533,2344,73.55,3.71,22.74,2019,98816
63,0,0,63,100.0,0.0,0.0,2019,98833
244,0,76,320,76.25,0.0,23.75,2019,98836
15551,520,2209,18280,85.07,2.84,12.08,2019,96822
105,10,6,121,86.78,8.26,4.96,2019,96037
503,19,169,691,72.79,2.75,24.46,2019,96796
11208,708,1572,13488,83.1,5.25,11.65,2019,96815
754,8,70,832,90.62,0.96,8.41,2019,97443
1497,108,332,1937,77.28,5.58,17.14,2019,97446
179,12,56,247,72.47,4.86,22.67,2019,97447
168,0,79,247,68.02,0.0,31.98,2019,97450
133,0,5,138,96.38,0.0,3.62,2019,97451
3498,149,546,4193,83.42,3.55,13.02,2019,97479
682,19,79,780,87.44,2.44,10.13,2019,97498
1559,99,170,1828,85.28,5.42,9.3,2019,97525
70,0,15,85,82.35,0.0,17.65,2019,97635
272,123,261,656,41.46,18.75,39.79,2019,97641
25727,442,2236,28405,90.57,1.56,7.87,2019,97701
20,1,9,30,66.67,3.33,30.0,2019,97722
138,0,89,227,60.79,0.0,39.21,2019,97733
175,18,70,263,66.54,6.84,26.62,2019,97737
1600,70,370,2040,78.43,3.43,18.14,2019,13407
761,46,165,972,78.29,4.73,16.98,2019,13408
98,0,13,111,88.29,0.0,11.71,2019,13418
1218,70,342,1630,74.72,4.29,20.98,2019,13329
280,0,38,318,88.05,0.0,11.95,2019,13355
306,7,134,447,68.46,1.57,29.98,2019,13368
2460,136,384,2980,82.55,4.56,12.89,2019,13035
5480,568,2516,8564,63.99,6.63,29.38,2019,13208
507,23,139,669,75.78,3.44,20.78,2019,13302
516,30,73,619,83.36,4.85,11.79,2019,13652
5855,167,1187,7209,81.22,2.32,16.47,2019,13662
742,10,139,891,83.28,1.12,15.6,2019,13673
27,0,9,36,75.0,0.0,25.0,2019,13675
4571,116,715,5402,84.62,2.15,13.24,2019,13676
322,3,83,408,78.92,0.74,20.34,2019,13684
208,13,100,321,64.8,4.05,31.15,2019,13690
337,4,118,459,73.42,0.87,25.71,2019,13731
422,5,27,454,92.95,1.1,5.95,2019,13744
645,19,172,836,77.15,2.27,20.57,2019,13746
1519,57,247,1823,83.32,3.13,13.55,2019,13753
212,5,39,256,82.81,1.95,15.23,2019,13776
312,0,69,381,81.89,0.0,18.11,2019,13780
466,7,98,571,81.61,1.23,17.16,2019,13796
249,0,5,254,98.03,0.0,1.97,2019,13802
193,25,86,304,63.49,8.22,28.29,2019,13813
989,45,210,1244,79.5,3.62,16.88,2019,13825
2148,45,319,2512,85.51,1.79,12.7,2019,13865
6374,294,1440,8108,78.61,3.63,17.76,2019,13901
6518,209,922,7649,85.21,2.73,12.05,2019,13903
8730,283,2181,11194,77.99,2.53,19.48,2019,13905
483,20,79,582,82.99,3.44,13.57,2019,13026
374,17,95,486,76.95,3.5,19.55,2019,13028
683,8,119,810,84.32,0.99,14.69,2019,13034
3191,83,465,3739,85.34,2.22,12.44,2019,13036
3967,153,213,4333,91.55,3.53,4.92,2019,13041
4994,217,910,6121,81.59,3.55,14.87,2019,13057
345,24,51,420,82.14,5.71,12.14,2019,13061
4628,157,374,5159,89.71,3.04,7.25,2019,13066
1453,66,166,1685,86.23,3.92,9.85,2019,13082
551,25,60,636,86.64,3.93,9.43,2019,13111
260,14,27,301,86.38,4.65,8.97,2019,13752
395,19,76,490,80.61,3.88,15.51,2019,13755
116,0,21,137,84.67,0.0,15.33,2019,13777
138,9,40,187,73.8,4.81,21.39,2019,13786
1250,10,200,1460,85.62,0.68,13.7,2019,13787
921,35,287,1243,74.09,2.82,23.09,2019,15563
140,0,8,148,94.59,0.0,5.41,2019,15624
102,0,7,109,93.58,0.0,6.42,2019,15647
260,0,10,270,96.3,0.0,3.7,2019,15671
234,0,50,284,82.39,0.0,17.61,2019,15676
230,0,52,282,81.56,0.0,18.44,2019,15678
337,6,137,480,70.21,1.25,28.54,2019,15687
102,0,14,116,87.93,0.0,12.07,2019,15710
149,0,0,149,100.0,0.0,0.0,2019,15713
13,0,23,36,36.11,0.0,63.89,2019,15730
22,0,43,65,33.85,0.0,66.15,2019,15733
484,30,118,632,76.58,4.75,18.67,2019,15765
10049,354,2886,13289,75.62,2.66,21.72,2019,15401
330,0,136,466,70.82,0.0,29.18,2019,15410
371,20,50,441,84.13,4.54,11.34,2019,95635
10849,269,2267,13385,81.05,2.01,16.94,2019,95351
17,15,0,32,53.12,46.88,0.0,2019,95013
0,0,0,0,,,,2019,95053
121,2,21,144,84.03,1.39,14.58,2019,95075
423,0,195,618,68.45,0.0,31.55,2019,95645
916,23,264,1203,76.14,1.91,21.95,2019,95458
342,0,61,403,84.86,0.0,15.14,2019,95553
15463,462,2002,17927,86.26,2.58,11.17,2019,95610
10503,232,1471,12206,86.05,1.9,12.05,2019,95361
902,11,418,1331,67.77,0.83,31.4,2019,95457
3,0,35,38,7.89,0.0,92.11,2019,95545
15965,781,556,17302,92.27,4.51,3.21,2019,95616
0,0,0,0,,,,2019,95211
0,0,0,0,,,,2019,95234
45,0,11,56,80.36,0.0,19.64,2019,95248
3365,103,288,3756,89.59,2.74,7.67,2019,95304
0,0,0,0,,,,2019,95314
375,8,240,623,60.19,1.28,38.52,2019,95319
7193,191,1108,8492,84.7,2.25,13.05,2019,95341
0,0,0,0,,,,2019,95375
8551,106,194,8851,96.61,1.2,2.19,2019,95377
4857,15,172,5044,96.29,0.3,3.41,2019,95391
75,13,0,88,85.23,14.77,0.0,2019,95435
1957,25,72,2054,95.28,1.22,3.51,2019,95467
17,16,0,33,51.52,48.48,0.0,2019,95486
39,0,12,51,76.47,0.0,23.53,2019,95604
200,18,0,218,91.74,8.26,0.0,2019,95652
24,0,0,24,100.0,0.0,0.0,2019,95679
10,0,0,10,100.0,0.0,0.0,2019,95680
47,10,37,94,50.0,10.64,39.36,2019,95697
63,20,24,107,58.88,18.69,22.43,2019,95698
2,18,0,20,10.0,90.0,0.0,2019,95699
0,0,0,0,,,,2019,95724
13625,279,478,14382,94.74,1.94,3.32,2019,95757
8258,165,794,9217,89.6,1.79,8.61,2019,98188
12624,377,902,13903,90.8,2.71,6.49,2019,98203
69,7,45,121,57.02,5.79,37.19,2019,98224
18831,605,1793,21229,88.7,2.85,8.45,2019,98225
2392,64,94,2550,93.8,2.51,3.69,2019,98236
3014,121,298,3433,87.79,3.52,8.68,2019,98239
10561,222,715,11498,91.85,1.93,6.22,2019,98258
214,2,48,264,81.06,0.76,18.18,2019,98323
1480,17,203,1700,87.06,1.0,11.94,2019,98349
85,4,30,119,71.43,3.36,25.21,2019,98350
407,8,45,460,88.48,1.74,9.78,2019,01531
5937,144,1246,7327,81.03,1.97,17.01,2019,01603
2991,81,630,3702,80.79,2.19,17.02,2019,01607
13207,257,1748,15212,86.82,1.69,11.49,2019,01702
13220,269,941,14430,91.61,1.86,6.52,2019,01760
4624,50,175,4849,95.36,1.03,3.61,2019,01778
8377,312,1407,10096,82.97,3.09,13.94,2019,01830
10844,261,3150,14255,76.07,1.83,22.1,2019,01852
4130,61,248,4439,93.04,1.37,5.59,2019,01879
7453,74,430,7957,93.67,0.93,5.4,2019,01887
2726,48,65,2839,96.02,1.69,2.29,2019,01921
3083,548,1360,4991,61.77,10.98,27.25,2019,01105
16557,474,2989,20020,82.7,2.37,14.93,2019,01201
3104,52,355,3511,88.41,1.48,10.11,2019,01230
39,0,26,65,60.0,0.0,40.0,2019,99607
83,4,54,141,58.87,2.84,38.3,2019,99621
81,5,58,144,56.25,3.47,40.28,2019,99628
61,3,60,124,49.19,2.42,48.39,2019,99636
11,0,0,11,100.0,0.0,0.0,2019,99647
15,2,12,29,51.72,6.9,41.38,2019,99648
16340,431,1752,18523,88.21,2.33,9.46,2019,99654
4799,190,958,5947,80.7,3.19,16.11,2019,99669
16,0,0,16,100.0,0.0,0.0,2019,99677
3,0,26,29,10.34,0.0,89.66,2019,99724
793,11,145,949,83.56,1.16,15.28,2019,99752
2,0,15,17,11.76,0.0,88.24,2019,99757
79,1,75,155,50.97,0.65,48.39,2019,99770
0,0,8,8,0.0,0.0,100.0,2019,99774
39,3,17,59,66.1,5.08,28.81,2019,99786
29,2,11,42,69.05,4.76,26.19,2019,99791
61,5,36,102,59.8,4.9,35.29,2019,99918
133,0,35,168,79.17,0.0,20.83,2019,99632
15,3,15,33,45.45,9.09,45.45,2019,99649
97,0,30,127,76.38,0.0,23.62,2019,99650
969,18,188,1175,82.47,1.53,16.0,2019,99652
31,0,1,32,96.88,0.0,3.12,2019,99653
275,6,143,424,64.86,1.42,33.73,2019,99661
1330,0,123,1453,91.53,0.0,8.47,2019,99664
4690,220,896,5806,80.78,3.79,15.43,2019,99712
78,2,13,93,83.87,2.15,13.98,2019,99729
7,0,0,7,100.0,0.0,0.0,2019,99732
27,1,6,34,79.41,2.94,17.65,2019,99736
62,2,155,219,28.31,0.91,70.78,2019,99740
123,1,59,183,67.21,0.55,32.24,2019,99741
47,0,9,56,83.93,0.0,16.07,2019,99744
9,0,27,36,25.0,0.0,75.0,2019,99745
38,4,14,56,67.86,7.14,25.0,2019,99747
19,6,31,56,33.93,10.71,55.36,2019,99748
82,3,29,114,71.93,2.63,25.44,2019,99750
16,2,8,26,61.54,7.69,30.77,2019,99751
99,2,48,149,66.44,1.34,32.21,2019,99766
470,20,146,636,73.9,3.14,22.96,2019,99780
905,28,81,1014,89.25,2.76,7.99,2019,99824
134,6,56,196,68.37,3.06,28.57,2019,99826
39,0,28,67,58.21,0.0,41.79,2019,99841
199,11,83,293,67.92,3.75,28.33,2019,99919
60,2,55,117,51.28,1.71,47.01,2019,99922
44,7,49,100,44.0,7.0,49.0,2019,99746
38,0,52,90,42.22,0.0,57.78,2019,99764
1600,50,155,1805,88.64,2.77,8.59,2019,03242
2471,109,264,2844,86.88,3.83,9.28,2019,03253
1445,32,119,1596,90.54,2.01,7.46,2019,03257
3898,83,497,4478,87.05,1.85,11.1,2019,03275
623,14,33,670,92.99,2.09,4.93,2019,03287
889,76,123,1088,81.71,6.99,11.31,2019,03440
1775,51,124,1950,91.03,2.62,6.36,2019,03070
1667,104,95,1866,89.34,5.57,5.09,2019,03071
81,7,4,92,88.04,7.61,4.35,2019,03215
2576,164,297,3037,84.82,5.4,9.78,2019,03220
1048,119,218,1385,75.67,8.59,15.74,2019,03223
842,15,95,952,88.45,1.58,9.98,2019,03224
402,7,39,448,89.73,1.56,8.71,2019,03251
119,4,47,170,70.0,2.35,27.65,2019,03259
23,0,4,27,85.19,0.0,14.81,2019,96132
480,0,247,727,66.02,0.0,33.98,2019,96134
453,26,24,503,90.06,5.17,4.77,2019,96146
483,31,150,664,72.74,4.67,22.59,2019,96703
17958,566,1224,19748,90.94,2.87,6.2,2019,96706
279,18,61,358,77.93,5.03,17.04,2019,96714
1066,23,152,1241,85.9,1.85,12.25,2019,96717
752,32,30,814,92.38,3.93,3.69,2019,96722
1119,44,311,1474,75.92,2.99,21.1,2019,96727
396,13,70,479,82.67,2.71,14.61,2019,96730
680,21,90,791,85.97,2.65,11.38,2019,96731
12615,426,1398,14439,87.37,2.95,9.68,2019,96740
117,4,18,139,84.17,2.88,12.95,2019,96086
3428,110,798,4336,79.06,2.54,18.4,2019,96097
1487,76,619,2182,68.15,3.48,28.37,2019,96101
267,14,35,316,84.49,4.43,11.08,2019,96120
1151,13,354,1518,75.82,0.86,23.32,2019,96122
9,0,0,9,100.0,0.0,0.0,2019,96123
252,8,42,302,83.44,2.65,13.91,2019,96128
11959,212,1105,13276,90.08,1.6,8.32,2019,96701
649,7,156,812,79.93,0.86,19.21,2019,96705
26,2,11,39,66.67,5.13,28.21,2019,96742
5929,124,627,6680,88.76,1.86,9.39,2019,96746
57,0,0,57,100.0,0.0,0.0,2019,96751
882,56,213,1151,76.63,4.87,18.51,2019,96752
9615,497,668,10780,89.19,4.61,6.2,2019,96753
1783,127,316,2226,80.1,5.71,14.2,2019,96795
8521,524,1566,10611,80.3,4.94,14.76,2019,96814
5144,173,706,6023,85.41,2.87,11.72,2019,98057
9251,103,101,9455,97.84,1.09,1.07,2019,98074
15,0,7,22,68.18,0.0,31.82,2019,98670
639,0,96,735,86.94,0.0,13.06,2019,98847
122,14,0,136,89.71,10.29,0.0,2019,98940
544,0,81,625,87.04,0.0,12.96,2019,98586
16371,695,1731,18797,87.09,3.7,9.21,2019,98661
633,0,248,881,71.85,0.0,28.15,2019,98828
1092,10,307,1409,77.5,0.71,21.79,2019,98932
1978,25,132,2135,92.65,1.17,6.18,2019,98010
9224,167,971,10362,89.02,1.61,9.37,2019,98126
6467,189,767,7423,87.12,2.55,10.33,2019,98230
2647,42,356,3045,86.93,1.38,11.69,2019,98563
745,1,109,855,87.13,0.12,12.75,2019,98537
3307,137,634,4078,81.09,3.36,15.55,2019,98541
1144,70,124,1338,85.5,5.23,9.27,2019,98546
89,0,0,89,100.0,0.0,0.0,2019,98571
164,0,112,276,59.42,0.0,40.58,2019,95527
3715,42,491,4248,87.45,0.99,11.56,2019,97024
75,0,30,105,71.43,0.0,28.57,2019,97028
677,12,128,817,82.86,1.47,15.67,2019,97041
6459,70,569,7098,91.0,0.99,8.02,2019,97060
1060,22,220,1302,81.41,1.69,16.9,2019,97111
1150,66,295,1511,76.11,4.37,19.52,2019,97119
156,0,0,156,100.0,0.0,0.0,2019,97145
11212,169,868,12249,91.53,1.38,7.09,2019,97203
18372,434,1812,20618,89.11,2.1,8.79,2019,97206
10846,898,1328,13072,82.97,6.87,10.16,2019,97209
12292,277,1051,13620,90.25,2.03,7.72,2019,97211
11882,308,959,13149,90.36,2.34,7.29,2019,97214
1403,46,129,1578,88.91,2.92,8.17,2019,97231
196,7,30,233,84.12,3.0,12.88,2019,15412
103,18,56,177,58.19,10.17,31.64,2019,15413
2784,161,588,3533,78.8,4.56,16.64,2019,15417
90,0,11,101,89.11,0.0,10.89,2019,15420
766,32,234,1032,74.22,3.1,22.67,2019,15618
9242,240,1790,11272,81.99,2.13,15.88,2019,15010
5878,195,1071,7144,82.28,2.73,14.99,2019,15017
44,0,10,54,81.48,0.0,18.52,2019,15020
5932,135,890,6957,85.27,1.94,12.79,2019,15025
1457,21,523,2001,72.81,1.05,26.14,2019,15033
4215,233,406,4854,86.84,4.8,8.36,2019,15071
559,38,347,944,59.22,4.03,36.76,2019,15458
200,0,55,255,78.43,0.0,21.57,2019,15411
730,8,138,876,83.33,0.91,15.75,2019,15437
18,0,15,33,54.55,0.0,45.45,2019,15447
447,0,177,624,71.63,0.0,28.37,2019,15459
1295,36,452,1783,72.63,2.02,25.35,2019,15461
425,29,142,596,71.31,4.87,23.83,2019,15464
58,0,7,65,89.23,0.0,10.77,2019,15532
680,14,185,879,77.36,1.59,21.05,2019,15535
43,0,14,57,75.44,0.0,24.56,2019,15544
845,8,264,1117,75.65,0.72,23.63,2019,15545
48,5,20,73,65.75,6.85,27.4,2019,15560
47,0,14,61,77.05,0.0,22.95,2019,15562
4634,215,947,5796,79.95,3.71,16.34,2019,15613
752,13,140,905,83.09,1.44,15.47,2019,15639
170,0,0,170,100.0,0.0,0.0,2019,15006
5317,112,1214,6643,80.04,1.69,18.27,2019,15012
558,7,76,641,87.05,1.09,11.86,2019,15019
2936,127,617,3680,79.78,3.45,16.77,2019,15024
9412,101,820,10333,91.09,0.98,7.94,2019,15044
902,0,143,1045,86.32,0.0,13.68,2019,15046
794,32,192,1018,78.0,3.14,18.86,2019,15050
131,4,30,165,79.39,2.42,18.18,2019,15081
3719,297,1405,5421,68.6,5.48,25.92,2019,15219
2528,72,553,3153,80.18,2.28,17.54,2019,15145
10846,228,1132,12206,88.86,1.87,9.27,2019,15146
10637,401,2432,13470,78.97,2.98,18.05,2019,15212
7081,132,798,8011,88.39,1.65,9.96,2019,15220
6682,74,439,7195,92.87,1.03,6.1,2019,15228
255,6,66,327,77.98,1.83,20.18,2019,15331
431,14,135,580,74.31,2.41,23.28,2019,15345
304,0,62,366,83.06,0.0,16.94,2019,15351
675,18,177,870,77.59,2.07,20.34,2019,15928
544,24,251,819,66.42,2.93,30.65,2019,15942
13346,434,2204,15984,83.5,2.72,13.79,2019,06606
6744,254,1653,8651,77.96,2.94,19.11,2019,06610
3682,215,1140,5037,73.1,4.27,22.63,2019,06706
9184,307,1710,11201,81.99,2.74,15.27,2019,06708
683,20,24,727,93.95,2.75,3.3,2019,06763
1392,37,66,1495,93.11,2.47,4.41,2019,06784
553,9,18,580,95.34,1.55,3.1,2019,06793
3730,64,335,4129,90.34,1.55,8.11,2019,06798
6648,71,431,7150,92.98,0.99,6.03,2019,06801
8557,155,798,9510,89.98,1.63,8.39,2019,06830
2453,16,70,2539,96.61,0.63,2.76,2019,06870
22901,530,2787,26218,87.35,2.02,10.63,2019,06902
6761,168,488,7417,91.16,2.27,6.58,2019,06905
510,30,77,617,82.66,4.86,12.48,2019,06023
2082,64,162,2308,90.21,2.77,7.02,2019,01238
729,24,165,918,79.41,2.61,17.97,2019,01257
157,29,51,237,66.24,12.24,21.52,2019,01367
1918,39,90,2047,93.7,1.91,4.4,2019,01430
2905,162,375,3442,84.4,4.71,10.89,2019,01432
1119,0,176,1295,86.41,0.0,13.59,2019,01436
3984,75,385,4444,89.65,1.69,8.66,2019,01463
1723,8,93,1824,94.46,0.44,5.1,2019,01468
2852,74,308,3234,88.19,2.29,9.52,2019,01516
2218,21,191,2430,91.28,0.86,7.86,2019,01523
1165,13,93,1271,91.66,1.02,7.32,2019,01541
1588,10,152,1750,90.74,0.57,8.69,2019,01560
5633,309,1004,6946,81.1,4.45,14.45,2019,01570
1354,73,489,1916,70.67,3.81,25.52,2019,01608
2859,53,412,3324,86.01,1.59,12.39,2019,01966
16233,264,1874,18371,88.36,1.44,10.2,2019,01970
1593,19,66,1678,94.93,1.13,3.93,2019,01985
4059,60,143,4262,95.24,1.41,3.36,2019,01754
203,9,18,230,88.26,3.91,7.83,2019,01745
4875,110,285,5270,92.5,2.09,5.41,2019,01746
6974,134,769,7877,88.54,1.7,9.76,2019,01749
1141,5,32,1178,96.86,0.42,2.72,2019,01827
3091,56,148,3295,93.81,1.7,4.49,2019,01833
15915,286,1706,17907,88.88,1.6,9.53,2019,01844
10088,135,889,11112,90.78,1.21,8.0,2019,01845
4362,144,954,5460,79.89,2.64,17.47,2019,01850
14438,348,1657,16443,87.81,2.12,10.08,2019,01915
1886,46,143,2075,90.89,2.22,6.89,2019,01944
115,0,0,115,100.0,0.0,0.0,2019,00906
1367,30,400,1797,76.07,1.67,22.26,2019,00968
3974,110,1826,5910,67.24,1.86,30.9,2019,00982
5394,16,4965,10375,51.99,0.15,47.86,2019,00783
3705,231,2226,6162,60.13,3.75,36.12,2019,00723
2719,202,1382,4303,63.19,4.69,32.12,2019,00735
6717,87,4989,11793,56.96,0.74,42.3,2019,00739
4787,88,2492,7367,64.98,1.19,33.83,2019,00757
2619,61,911,3591,72.93,1.7,25.37,2019,00911
1269,101,1426,2796,45.39,3.61,51.0,2019,00952
8767,122,2389,11278,77.74,1.08,21.18,2019,00961
4404,185,3321,7910,55.68,2.34,41.98,2019,00617
3620,202,3211,7033,51.47,2.87,45.66,2019,00637
4853,94,3998,8945,54.25,1.05,44.7,2019,00641
2619,311,2206,5136,50.99,6.06,42.95,2019,00650
5022,127,4448,9597,52.33,1.32,46.35,2019,00669
5305,64,3106,8475,62.6,0.76,36.65,2019,00703
11014,246,1432,12692,86.78,1.94,11.28,2019,02131
7811,91,680,8582,91.02,1.06,7.92,2019,02134
10220,196,1584,12000,85.17,1.63,13.2,2019,02136
12513,917,758,14188,88.19,6.46,5.34,2019,02138
1691,0,70,1761,96.02,0.0,3.98,2019,02142
9592,192,1131,10915,87.88,1.76,10.36,2019,02145
6893,139,817,7849,87.82,1.77,10.41,2019,02171
3508,64,335,3907,89.79,1.64,8.57,2019,02341
3493,91,510,4094,85.32,2.22,12.46,2019,02343
6788,94,423,7305,92.92,1.29,5.79,2019,02451
4532,7,351,4890,92.68,0.14,7.18,2019,02458
4263,112,177,4552,93.65,2.46,3.89,2019,02481
3344,129,135,3608,92.68,3.58,3.74,2019,02494
5190,91,470,5751,90.25,1.58,8.17,2019,02532
285,6,22,313,91.05,1.92,7.03,2019,03260
8691,94,426,9211,94.35,1.02,4.62,2019,03053
12100,355,1199,13654,88.62,2.6,8.78,2019,03104
1924,60,350,2334,82.43,2.57,15.0,2019,03222
371,6,42,419,88.54,1.43,10.02,2019,03226
5303,225,356,5884,90.13,3.82,6.05,2019,03064
1414,36,337,1787,79.13,2.01,18.86,2019,03101
604,57,181,842,71.73,6.77,21.5,2019,03217
385,12,12,409,94.13,2.93,2.93,2019,03218
750,20,93,863,86.91,2.32,10.78,2019,03221
434,6,75,515,84.27,1.17,14.56,2019,03230
53,0,0,53,100.0,0.0,0.0,2019,03233
5839,231,847,6917,84.42,3.34,12.25,2019,03246
814,21,86,921,88.38,2.28,9.34,2019,03256
110,0,0,110,100.0,0.0,0.0,2019,03273
8596,343,1226,10165,84.56,3.37,12.06,2019,03431
245,4,42,291,84.19,1.37,14.43,2019,03445
877,22,127,1026,85.48,2.14,12.38,2019,03447
1443,29,171,1643,87.83,1.77,10.41,2019,03451
1642,73,392,2107,77.93,3.46,18.6,2019,03452
737,5,186,928,79.42,0.54,20.04,2019,03455
300,58,38,396,75.76,14.65,9.6,2019,03605
147,40,46,233,63.09,17.17,19.74,2019,03751
211,32,34,277,76.17,11.55,12.27,2019,03752
621,7,56,684,90.79,1.02,8.19,2019,03768
452,5,27,484,93.39,1.03,5.58,2019,03777
1160,0,111,1271,91.27,0.0,8.73,2019,03809
2647,0,98,2745,96.43,0.0,3.57,2019,03811
1557,3,185,1745,89.23,0.17,10.6,2019,03818
1092,27,55,1174,93.02,2.3,4.68,2019,03827
1237,5,234,1476,83.81,0.34,15.85,2019,03839
3639,108,288,4035,90.19,2.68,7.14,2019,03857
1603,16,222,1841,87.07,0.87,12.06,2019,03860
620,36,82,738,84.01,4.88,11.11,2019,03886
2571,56,558,3185,80.72,1.76,17.52,2019,03901
930,16,14,960,96.88,1.67,1.46,2019,03902
2059,0,225,2284,90.15,0.0,9.85,2019,03868
3407,105,365,3877,87.88,2.71,9.41,2019,03874
414,0,15,429,96.5,0.0,3.5,2019,03875
4343,123,680,5146,84.4,2.39,13.21,2019,03878
1608,82,178,1868,86.08,4.39,9.53,2019,03906
2479,33,273,2785,89.01,1.18,9.8,2019,03908
2340,135,393,2868,81.59,4.71,13.7,2019,03835
557,4,50,611,91.16,0.65,8.18,2019,03836
552,33,28,613,90.05,5.38,4.57,2019,03845
103,12,28,143,72.03,8.39,19.58,2019,05034
394,19,84,497,79.28,3.82,16.9,2019,05061
362,17,44,423,85.58,4.02,10.4,2019,05065
92,0,0,92,100.0,0.0,0.0,2019,05071
148,9,49,206,71.84,4.37,23.79,2019,05081
81,0,34,115,70.43,0.0,29.57,2019,05083
228,8,59,295,77.29,2.71,20.0,2019,05086
720,64,112,896,80.36,7.14,12.5,2019,05149
5588,1036,837,7461,74.9,13.89,11.22,2019,05301
147,59,58,264,55.68,22.35,21.97,2019,05342
247,66,59,372,66.4,17.74,15.86,2019,05353
722,62,68,852,84.74,7.28,7.98,2019,05354
3104,208,372,3684,84.26,5.65,10.1,2019,05753
688,17,166,871,78.99,1.95,19.06,2019,05045
782,46,200,1028,76.07,4.47,19.46,2019,16748
1693,100,433,2226,76.06,4.49,19.45,2019,16841
9542,259,1801,11602,82.24,2.23,15.52,2019,16335
68,3,26,97,70.1,3.09,26.8,2019,16245
586,43,152,781,75.03,5.51,19.46,2019,16313
22,0,7,29,75.86,0.0,24.14,2019,16322
134,2,42,178,75.28,1.12,23.6,2019,16344
719,65,139,923,77.9,7.04,15.06,2019,16347
510,10,168,688,74.13,1.45,24.42,2019,16351
61,8,13,82,74.39,9.76,15.85,2019,16352
103,0,24,127,81.1,0.0,18.9,2019,16370
547,25,63,635,86.14,3.94,9.92,2019,16411
1214,70,201,1485,81.75,4.71,13.54,2019,16426
183,11,81,275,66.55,4.0,29.45,2019,16436
368,0,136,504,73.02,0.0,26.98,2019,16443
658,62,613,1333,49.36,4.65,45.99,2019,16501
6202,240,1050,7492,82.78,3.2,14.01,2019,16505
83,7,4,94,88.3,7.45,4.26,2019,16633
805,17,121,943,85.37,1.8,12.83,2019,16637
4318,160,1154,5632,76.67,2.84,20.49,2019,16652
83,0,13,96,86.46,0.0,13.54,2019,16659
280,13,59,352,79.55,3.69,16.76,2019,16661
15,0,11,26,57.69,0.0,42.31,2019,16670
68,0,5,73,93.15,0.0,6.85,2019,16672
58,0,11,69,84.06,0.0,15.94,2019,16685
4393,167,993,5553,79.11,3.01,17.88,2019,16686
792,26,177,995,79.6,2.61,17.79,2019,16731
90,0,46,136,66.18,0.0,33.82,2019,16732
585,43,183,811,72.13,5.3,22.56,2019,16822
8904,466,1536,10906,81.64,4.27,14.08,2019,16823
157,0,57,214,73.36,0.0,26.64,2019,16826
4248,209,1409,5866,72.42,3.56,24.02,2019,16830
196,17,23,236,83.05,7.2,9.75,2019,16839
187,9,76,272,68.75,3.31,27.94,2019,16854
2379,66,205,2650,89.77,2.49,7.74,2019,16870
199,7,258,464,42.89,1.51,55.6,2019,16872
674,29,142,845,79.76,3.43,16.8,2019,16912
585,6,194,785,74.52,0.76,24.71,2019,16920
366,8,118,492,74.39,1.63,23.98,2019,16930
602,27,160,789,76.3,3.42,20.28,2019,16936
363,27,176,566,64.13,4.77,31.1,2019,16948
81,0,7,88,92.05,0.0,7.95,2019,16725
405,6,107,518,78.19,1.16,20.66,2019,16874
248,6,49,303,81.85,1.98,16.17,2019,16942
123,7,25,155,79.35,4.52,16.13,2019,16212
6453,74,130,6657,96.94,1.11,1.95,2019,08550
2362,28,188,2578,91.62,1.09,7.29,2019,08558
1943,37,138,2118,91.74,1.75,6.52,2019,08559
1549,21,198,1768,87.61,1.19,11.2,2019,08562
9481,801,2779,13061,72.59,6.13,21.28,2019,08618
1158,0,4,1162,99.66,0.0,0.34,2019,08641
566,7,25,598,94.65,1.17,4.18,2019,08732
583,6,29,618,94.34,0.97,4.69,2019,08738
870,20,105,995,87.44,2.01,10.55,2019,08741
2454,0,110,2564,95.71,0.0,4.29,2019,08801
12171,271,741,13183,92.32,2.06,5.62,2019,08807
1464,11,230,1705,85.87,0.65,13.49,2019,08825
3067,140,554,3761,81.55,3.72,14.73,2019,08835
35,0,0,35,100.0,0.0,0.0,2019,08858
3564,52,367,3983,89.48,1.31,9.21,2019,06019
0,0,0,0,,,,2019,06020
116,20,0,136,85.29,14.71,0.0,2019,06021
12064,298,1651,14013,86.09,2.13,11.78,2019,06040
10115,410,2707,13232,76.44,3.1,20.46,2019,06053
617,12,82,711,86.78,1.69,11.53,2019,06058
6301,136,1200,7637,82.51,1.78,15.71,2019,06062
655,0,43,698,93.84,0.0,6.16,2019,06068
5801,46,291,6138,94.51,0.75,4.74,2019,06070
4368,100,555,5023,86.96,1.99,11.05,2019,06110
5216,524,1760,7500,69.55,6.99,23.47,2019,06112
1160,0,56,1216,95.39,0.0,4.61,2019,06232
1964,39,166,2169,90.55,1.8,7.65,2019,06237
2357,37,161,2555,92.25,1.45,6.3,2019,06241
518,4,29,551,94.01,0.73,5.26,2019,06027
498,0,69,567,87.83,0.0,12.17,2019,06031
10797,662,1598,13057,82.69,5.07,12.24,2019,06066
9672,777,3601,14050,68.84,5.53,25.63,2019,06106
4931,99,457,5487,89.87,1.8,8.33,2019,06117
1356,16,37,1409,96.24,1.14,2.63,2019,06231
880,4,91,975,90.26,0.41,9.33,2019,06235
4367,44,224,4635,94.22,0.95,4.83,2019,06238
1890,24,205,2119,89.19,1.13,9.67,2019,06248
1628,34,84,1746,93.24,1.95,4.81,2019,06250
601,30,86,717,83.82,4.18,11.99,2019,06254
1560,49,163,1772,88.04,2.77,9.2,2019,06259
1300,0,145,1445,89.97,0.0,10.03,2019,06277
1100,34,98,1232,89.29,2.76,7.95,2019,06280
10522,418,1381,12321,85.4,3.39,11.21,2019,06340
4913,81,527,5521,88.99,1.47,9.55,2019,06355
12171,368,2314,14853,81.94,2.48,15.58,2019,06360
2441,62,280,2783,87.71,2.23,10.06,2019,06370
976,0,116,1092,89.38,0.0,10.62,2019,06384
10837,153,1312,12302,88.09,1.24,10.66,2019,06405
1606,73,93,1772,90.63,4.12,5.25,2019,06412
2057,26,221,2304,89.28,1.13,9.59,2019,06419
2650,39,317,3006,88.16,1.3,10.55,2019,06471
11289,240,1341,12870,87.72,1.86,10.42,2019,06489
5800,190,665,6655,87.15,2.85,9.99,2019,06518
3728,135,1277,5140,72.53,2.63,24.84,2019,06519
9168,261,736,10165,90.19,2.57,7.24,2019,06776
405,31,94,530,76.42,5.85,17.74,2019,06778
8434,111,478,9023,93.47,1.23,5.3,2019,06877
1210,0,60,1270,95.28,0.0,4.72,2019,06093
6952,107,375,7434,93.52,1.44,5.04,2019,06107
2217,74,0,2291,96.77,3.23,0.0,2019,10282
11054,508,2905,14467,76.41,3.51,20.08,2019,10301
4456,94,721,5271,84.54,1.78,13.68,2019,10307
14666,651,5461,20778,70.58,3.13,26.28,2019,10460
13140,431,2260,15831,83.0,2.72,14.28,2019,10465
4829,393,976,6198,77.91,6.34,15.75,2019,10470
7487,367,963,8817,84.92,4.16,10.92,2019,10471
93,0,18,111,83.78,0.0,16.22,2019,10503
3459,68,143,3670,94.25,1.85,3.9,2019,10522
6805,127,661,7593,89.62,1.67,8.71,2019,10543
1703,26,0,1729,98.5,1.5,0.0,2019,10006
10804,254,1123,12181,88.7,2.09,9.22,2019,10012
9832,138,2056,12026,81.76,1.15,17.1,2019,10013
16976,350,687,18013,94.24,1.94,3.81,2019,10014
7198,270,767,8235,87.41,3.28,9.31,2019,02536
2283,24,114,2421,94.3,0.99,4.71,2019,02537
3354,70,223,3647,91.97,1.92,6.11,2019,02554
1115,15,43,1173,95.06,1.28,3.67,2019,02556
303,53,17,373,81.23,14.21,4.56,2019,02650
430,0,18,448,95.98,0.0,4.02,2019,02659
2516,96,320,2932,85.81,3.27,10.91,2019,02660
9693,559,2561,12813,75.65,4.36,19.99,2019,02720
1758,36,148,1942,90.53,1.85,7.62,2019,02738
3293,210,591,4094,80.43,5.13,14.44,2019,02743
5494,130,764,6388,86.01,2.04,11.96,2019,02790
396,11,33,440,90.0,2.5,7.5,2019,02807
8177,71,757,9005,90.81,0.79,8.41,2019,02852
7560,147,673,8380,90.21,1.75,8.03,2019,02879
10701,267,1530,12498,85.62,2.14,12.24,2019,02886
10173,215,1062,11450,88.85,1.88,9.28,2019,02889
5886,109,401,6396,92.03,1.7,6.27,2019,02351
2303,0,21,2324,99.1,0.0,0.9,2019,02210
7095,415,335,7845,90.44,5.29,4.27,2019,02215
3775,78,242,4095,92.19,1.9,5.91,2019,02347
4556,100,293,4949,92.06,2.02,5.92,2019,02364
6161,48,179,6388,96.45,0.75,2.8,2019,02459
9160,69,583,9812,93.36,0.7,5.94,2019,02478
6792,94,307,7193,94.43,1.31,4.27,2019,02492
3231,209,613,4053,79.72,5.16,15.12,2019,02540
318,8,34,360,88.33,2.22,9.44,2019,02543
3646,130,222,3998,91.2,3.25,5.55,2019,02563
1277,24,94,1395,91.54,1.72,6.74,2019,02635
1288,33,113,1434,89.82,2.3,7.88,2019,02644
2453,26,270,2749,89.23,0.95,9.82,2019,02653
3382,139,465,3986,84.85,3.49,11.67,2019,02664
1076,15,67,1158,92.92,1.3,5.79,2019,02668
19,0,0,19,100.0,0.0,0.0,2019,02669
20,0,6,26,76.92,0.0,23.08,2019,02713
1172,96,164,1432,81.84,6.7,11.45,2019,02715
1481,107,148,1736,85.31,6.16,8.53,2019,02717
2046,29,81,2156,94.9,1.35,3.76,2019,02874
3989,172,696,4857,82.13,3.54,14.33,2019,02885
6892,344,957,8193,84.12,4.2,11.68,2019,02888
181,0,60,241,75.1,0.0,24.9,2019,02894
3384,122,1195,4701,71.98,2.6,25.42,2019,02903
10202,245,1632,12079,84.46,2.03,13.51,2019,02908
11777,297,2027,14101,83.52,2.11,14.37,2019,02920
3078,33,341,3452,89.17,0.96,9.88,2019,02111
4650,254,562,5466,85.07,4.65,10.28,2019,02382
9,0,10,19,47.37,0.0,52.63,2019,97908
297,17,95,409,72.62,4.16,23.23,2019,97810
6,0,4,10,60.0,0.0,40.0,2019,97819
333,8,59,400,83.25,2.0,14.75,2019,97820
228,16,72,316,72.15,5.06,22.78,2019,97830
383,5,72,460,83.26,1.09,15.65,2019,97834
30,0,16,46,65.22,0.0,34.78,2019,97911
62,0,0,62,100.0,0.0,0.0,2019,97840
533,49,121,703,75.82,6.97,17.21,2019,97868
16446,442,1207,18095,90.89,2.44,6.67,2019,97330
39,0,12,51,76.47,0.0,23.53,2019,97342
174,14,16,204,85.29,6.86,7.84,2019,97345
1881,41,183,2105,89.36,1.95,8.69,2019,97352
3480,106,461,4047,85.99,2.62,11.39,2019,97361
178,18,35,231,77.06,7.79,15.15,2019,05062
1179,72,138,1389,84.88,5.18,9.94,2019,05068
110,0,57,167,65.87,0.0,34.13,2019,05076
47,0,0,47,100.0,0.0,0.0,2019,05084
1214,75,157,1446,83.96,5.19,10.86,2019,05091
268,11,24,303,88.45,3.63,7.92,2019,05758
583,0,118,701,83.17,0.0,16.83,2019,05759
329,15,101,445,73.93,3.37,22.7,2019,05770
784,41,96,921,85.12,4.45,10.42,2019,05773
241,9,46,296,81.42,3.04,15.54,2019,05839
181,4,30,215,84.19,1.86,13.95,2019,05842
797,64,134,995,80.1,6.43,13.47,2019,05032
221,28,11,260,85.0,10.77,4.23,2019,05037
390,13,117,520,75.0,2.5,22.5,2019,05039
72,0,29,101,71.29,0.0,28.71,2019,05041
441,12,12,465,94.84,2.58,2.58,2019,05043
326,53,73,452,72.12,11.73,16.15,2019,05046
199,5,31,235,84.68,2.13,13.19,2019,05056
1554,20,322,1896,81.96,1.05,16.98,2019,05060
84,0,3,87,96.55,0.0,3.45,2019,05067
235,9,42,286,82.17,3.15,14.69,2019,05079
1450,58,299,1807,80.24,3.21,16.55,2019,05143
3358,114,559,4031,83.3,2.83,13.87,2019,05156
125,0,54,179,69.83,0.0,30.17,2019,05260
769,40,121,930,82.69,4.3,13.01,2019,05261
6050,191,608,6849,88.33,2.79,8.88,2019,05446
211,7,56,274,77.01,2.55,20.44,2019,05350
234,15,9,258,90.7,5.81,3.49,2019,05359
267,10,52,329,81.16,3.04,15.81,2019,05441
530,114,217,861,61.56,13.24,25.2,2019,05459
4185,430,666,5281,79.25,8.14,12.61,2019,05468
893,63,311,1267,70.48,4.97,24.55,2019,05476
432,36,47,515,83.88,6.99,9.13,2019,05650
136,8,41,185,73.51,4.32,22.16,2019,05649
194,6,52,252,76.98,2.38,20.63,2019,05653
68,0,0,68,100.0,0.0,0.0,2019,05664
1734,139,232,2105,82.38,6.6,11.02,2019,05672
980,60,85,1125,87.11,5.33,7.56,2019,05673
260,0,70,330,78.79,0.0,21.21,2019,05732
427,24,106,557,76.66,4.31,19.03,2019,05038
561,26,126,713,78.68,3.65,17.67,2019,05051
141,9,26,176,80.11,5.11,14.77,2019,05069
263,0,18,281,93.59,0.0,6.41,2019,05142
1352,67,95,1514,89.3,4.43,6.27,2019,05250
445,47,40,532,83.65,8.83,7.52,2019,05251
0,0,0,0,,,,2019,98158
0,0,0,0,,,,2019,98195
0,0,0,0,,,,2019,98207
12339,216,577,13132,93.96,1.64,4.39,2019,98229
64,0,9,73,87.67,0.0,12.33,2019,98255
34,0,0,34,100.0,0.0,0.0,2019,98263
1081,67,372,1520,71.12,4.41,24.47,2019,98266
190,0,4,194,97.94,0.0,2.06,2019,98276
0,0,0,0,,,,2019,98278
6680,101,451,7232,92.37,1.4,6.24,2019,98282
16,0,0,16,100.0,0.0,0.0,2019,98314
16662,283,783,17728,93.99,1.6,4.42,2019,98391
0,0,0,0,,,,2019,98416
3061,304,463,3828,79.96,7.94,12.1,2019,98418
7693,208,545,8446,91.08,2.46,6.45,2019,08859
2644,47,304,2995,88.28,1.57,10.15,2019,08869
18984,259,1176,20419,92.97,1.27,5.76,2019,08873
232,50,257,539,43.04,9.28,47.68,2019,08608
2603,183,1377,4163,62.53,4.4,33.08,2019,08609
9353,355,1437,11145,83.92,3.19,12.89,2019,08610
6109,335,1587,8031,76.07,4.17,19.76,2019,08638
3405,53,282,3740,91.04,1.42,7.54,2019,08722
808,5,114,927,87.16,0.54,12.3,2019,08733
9050,141,616,9807,92.28,1.44,6.28,2019,08742
5652,90,358,6100,92.66,1.48,5.87,2019,08837
4417,23,428,4868,90.74,0.47,8.79,2019,08846
11586,798,2944,15328,75.59,5.21,19.21,2019,08901
13196,192,1100,14488,91.08,1.33,7.59,2019,08902
287,4,39,330,86.97,1.21,11.82,2019,08041
1792,37,204,2033,88.15,1.82,10.03,2019,08049
3753,38,385,4176,89.87,0.91,9.22,2019,08051
7243,153,889,8285,87.42,1.85,10.73,2019,08052
15836,196,1270,17302,91.53,1.13,7.34,2019,08054
6506,244,477,7227,90.02,3.38,6.6,2019,08057
8084,123,678,8885,90.98,1.38,7.63,2019,08060
5057,30,257,5344,94.63,0.56,4.81,2019,08062
2395,65,352,2812,85.17,2.31,12.52,2019,08068
9434,222,1291,10947,86.18,2.03,11.79,2019,08075
2862,146,862,3870,73.95,3.77,22.27,2019,08079
1159,38,180,1377,84.17,2.76,13.07,2019,08092
7011,137,483,7631,91.88,1.8,6.33,2019,08108
4921,122,1207,6250,78.74,1.95,19.31,2019,08232
55,0,0,55,100.0,0.0,0.0,2019,08248
10407,555,2965,13927,74.73,3.99,21.29,2019,08302
87,0,21,108,80.56,0.0,19.44,2019,08324
137,0,15,152,90.13,0.0,9.87,2019,08329
219,0,13,232,94.4,0.0,5.6,2019,08350
2149,61,145,2355,91.25,2.59,6.16,2019,08501
1685,40,87,1812,92.99,2.21,4.8,2019,08510
7955,306,1020,9281,85.71,3.3,10.99,2019,08520
724,0,308,1032,70.16,0.0,29.84,2019,08341
158,20,53,231,68.4,8.66,22.94,2019,08345
11324,727,2580,14631,77.4,4.97,17.63,2019,08360
16077,695,713,17485,91.95,3.97,4.08,2019,08540
1311,0,183,1494,87.75,0.0,12.25,2019,08554
7501,197,1011,8709,86.13,2.26,11.61,2019,08619
3709,28,318,4055,91.47,0.69,7.84,2019,08620
3305,207,274,3786,87.3,5.47,7.24,2019,08628
14586,762,8433,23781,61.33,3.2,35.46,2019,08701
933,8,57,998,93.49,0.8,5.71,2019,12466
240,18,111,369,65.04,4.88,30.08,2019,12468
212,5,69,286,74.13,1.75,24.13,2019,12469
320,20,108,448,71.43,4.46,24.11,2019,12474
172,0,91,263,65.4,0.0,34.6,2019,12480
1146,45,82,1273,90.02,3.53,6.44,2019,12487
427,22,112,561,76.11,3.92,19.96,2019,12496
764,23,185,972,78.6,2.37,19.03,2019,12501
365,7,65,437,83.52,1.6,14.87,2019,12502
1162,78,122,1362,85.32,5.73,8.96,2019,12543
473,0,48,521,90.79,0.0,9.21,2019,12548
15263,714,3707,19684,77.54,3.63,18.83,2019,12550
5664,124,654,6442,87.92,1.92,10.15,2019,12561
3405,200,394,3999,85.15,5.0,9.85,2019,12566
31438,508,2343,34289,91.69,1.48,6.83,2019,10023
25761,711,1693,28165,91.46,2.52,6.01,2019,10024
16667,434,4125,21226,78.52,2.04,19.43,2019,10032
0,0,0,0,,,,2019,10112
0,0,0,0,,,,2019,10152
0,0,0,0,,,,2019,10177
16854,539,2796,20189,83.48,2.67,13.85,2019,10306
15343,671,2848,18862,81.34,3.56,15.1,2019,10461
2538,73,137,2748,92.36,2.66,4.99,2019,10504
661,27,58,746,88.61,3.62,7.77,2019,10511
8407,254,689,9350,89.91,2.72,7.37,2019,10512
4406,12,365,4783,92.12,0.25,7.63,2019,10528
5340,43,311,5694,93.78,0.76,5.46,2019,10530
9489,244,797,10530,90.11,2.32,7.57,2019,10598
10623,606,2812,14041,75.66,4.32,20.03,2019,10705
3163,65,424,3652,86.61,1.78,11.61,2019,10709
278,0,25,303,91.75,0.0,8.25,2019,10931
878,13,80,971,90.42,1.34,8.24,2019,10963
3305,6,253,3564,92.73,0.17,7.1,2019,10970
49,0,0,49,100.0,0.0,0.0,2019,10985
6410,212,847,7469,85.82,2.84,11.34,2019,10990
1022,16,144,1182,86.46,1.35,12.18,2019,10588
5912,266,1123,7301,80.98,3.64,15.38,2019,10703
8100,121,647,8868,91.34,1.36,7.3,2019,10708
2502,40,217,2759,90.69,1.45,7.87,2019,10923
1156,11,168,1335,86.59,0.82,12.58,2019,10926
9701,160,541,10402,93.26,1.54,5.2,2019,10956
4618,143,571,5332,86.61,2.68,10.71,2019,10965
1388,27,168,1583,87.68,1.71,10.61,2019,10993
0,0,0,0,,,,2019,10172
12115,362,2088,14565,83.18,2.49,14.34,2019,10305
26897,696,3289,30882,87.1,2.25,10.65,2019,10314
13941,636,4945,19522,71.41,3.26,25.33,2019,10451
24195,572,3985,28752,84.15,1.99,13.86,2019,10463
14224,716,3962,18902,75.25,3.79,20.96,2019,10475
1738,48,176,1962,88.58,2.45,8.97,2019,10502
9662,261,1363,11286,85.61,2.31,12.08,2019,10562
3422,52,248,3722,91.94,1.4,6.66,2019,10510
1407,12,16,1435,98.05,0.84,1.11,2019,10524
1497,32,210,1739,86.08,1.84,12.08,2019,10532
2853,15,165,3033,94.07,0.49,5.44,2019,10579
20813,845,6116,27774,74.94,3.04,22.02,2019,10453
8701,210,4518,13429,64.79,1.56,33.64,2019,10454
10284,621,3522,14427,71.28,4.3,24.41,2019,10455
22161,1477,3943,27581,80.35,5.36,14.3,2019,10458
6109,380,1130,7619,80.18,4.99,14.83,2019,13790
717,16,103,836,85.77,1.91,12.32,2019,13797
1473,25,354,1852,79.54,1.35,19.11,2019,13849
82,0,0,82,100.0,0.0,0.0,2019,13859
1534,28,93,1655,92.69,1.69,5.62,2019,13456
160,0,28,188,85.11,0.0,14.89,2019,13468
355,20,158,533,66.6,3.75,29.64,2019,13630
10630,537,2608,13775,77.17,3.9,18.93,2019,13501
3092,36,94,3222,95.97,1.12,2.92,2019,13603
1128,40,216,1384,81.5,2.89,15.61,2019,13668
158,3,36,197,80.2,1.52,18.27,2019,13670
982,39,207,1228,79.97,3.18,16.86,2019,13691
157,5,29,191,82.2,2.62,15.18,2019,13693
1281,158,171,1610,79.57,9.81,10.62,2019,13748
4242,115,555,4912,86.36,2.34,11.3,2019,97365
4444,247,847,5538,80.25,4.46,15.29,2019,97386
17235,1929,1891,21055,81.86,9.16,8.98,2019,97401
18311,717,2307,21335,85.83,3.36,10.81,2019,97402
699,77,287,1063,65.76,7.24,27.0,2019,97417
419,7,53,479,87.47,1.46,11.06,2019,97419
924,8,146,1078,85.71,0.74,13.54,2019,97437
361,35,44,440,82.05,7.95,10.0,2019,97438
17728,607,1358,19693,90.02,3.08,6.9,2019,97223
13243,314,1206,14763,89.7,2.13,8.17,2019,97224
14068,418,1308,15794,89.07,2.65,8.28,2019,97302
324,28,36,388,83.51,7.22,9.28,2019,97346
9702,313,1744,11759,82.51,2.66,14.83,2019,97355
1365,143,169,1677,81.4,8.53,10.08,2019,97374
5032,110,565,5707,88.17,1.93,9.9,2019,97381
178,3,23,204,87.25,1.47,11.27,2019,97412
770,0,38,808,95.3,0.0,4.7,2019,97431
279,4,35,318,87.74,1.26,11.01,2019,97436
846,29,60,935,90.48,3.1,6.42,2019,97455
1237,79,369,1685,73.41,4.69,21.9,2019,97463
119,3,3,125,95.2,2.4,2.4,2019,97473
331,10,125,466,71.03,2.15,26.82,2019,97536
3411,81,410,3902,87.42,2.08,10.51,2019,97540
8103,245,1378,9726,83.31,2.52,14.17,2019,97601
1129,70,323,1522,74.18,4.6,21.22,2019,97818
193,0,50,243,79.42,0.0,20.58,2019,97639
7,21,0,28,25.0,75.0,0.0,2019,97712
890,25,12,927,96.01,2.7,1.29,2019,97753
291,21,98,410,70.98,5.12,23.9,2019,97869
126,13,47,186,67.74,6.99,25.27,2019,97877
275,10,92,377,72.94,2.65,24.4,2019,97870
204,6,75,285,71.58,2.11,26.32,2019,98925
3782,90,553,4425,85.47,2.03,12.5,2019,98930
13221,759,1811,15791,83.72,4.81,11.47,2019,97222
24004,439,718,25161,95.4,1.74,2.85,2019,97229
10621,232,1800,12653,83.94,1.83,14.23,2019,97266
7095,190,874,8159,86.96,2.33,10.71,2019,97338
438,33,41,512,85.55,6.45,8.01,2019,97344
1160,76,225,1461,79.4,5.2,15.4,2019,97368
444,0,106,550,80.73,0.0,19.27,2019,97376
3145,69,353,3567,88.17,1.93,9.9,2019,97383
1892,117,248,2257,83.83,5.18,10.99,2019,97391
2326,163,905,3394,68.53,4.8,26.66,2019,97411
2109,134,304,2547,82.8,5.26,11.94,2019,97444
4235,110,746,5091,83.19,2.16,14.65,2019,97448
391,87,79,557,70.2,15.62,14.18,2019,98351
2389,160,433,2982,80.11,5.37,14.52,2019,98354
251,0,101,352,71.31,0.0,28.69,2019,98355
325,65,50,440,73.86,14.77,11.36,2019,98361
4960,84,742,5786,85.72,1.45,12.82,2019,98363
44,0,0,44,100.0,0.0,0.0,2019,98364
10314,235,513,11062,93.24,2.12,4.64,2019,98367
11510,136,747,12393,92.88,1.1,6.03,2019,98370
13152,270,1093,14515,90.61,1.86,7.53,2019,98374
3736,116,326,4178,89.42,2.78,7.8,2019,98403
8191,227,880,9298,88.09,2.44,9.46,2019,98407
3838,107,304,4249,90.33,2.52,7.15,2019,98433
1765,13,280,2058,85.76,0.63,13.61,2019,98439
10839,228,848,11915,90.97,1.91,7.12,2019,98466
0,0,0,0,,,,2019,98430
4,0,0,4,100.0,0.0,0.0,2019,98438
0,0,0,0,,,,2019,98447
21,0,0,21,100.0,0.0,0.0,2019,98544
90,0,0,90,100.0,0.0,0.0,2019,98558
48,13,3,64,75.0,20.31,4.69,2019,98583
83,0,18,101,82.18,0.0,17.82,2019,98824
0,0,59,59,0.0,0.0,100.0,2019,98921
0,0,0,0,,,,2019,98929
18,0,26,44,40.91,0.0,59.09,2019,98939
2319,84,401,2804,82.7,3.0,14.3,2019,98672
2890,70,457,3417,84.58,2.05,13.37,2019,98848
208,0,43,251,82.87,0.0,17.13,2019,98946
11330,331,954,12615,89.81,2.62,7.56,2019,98030
155,0,0,155,100.0,0.0,0.0,2019,98050
1257,26,126,1409,89.21,1.85,8.94,2019,98261
94,0,47,141,66.67,0.0,33.33,2019,98267
16352,305,1134,17791,91.91,1.71,6.37,2019,98270
6116,117,563,6796,89.99,1.72,8.28,2019,98274
75,11,24,110,68.18,10.0,21.82,2019,98288
371,0,88,459,80.83,0.0,19.17,2019,98304
11455,327,1028,12810,89.42,2.55,8.02,2019,98312
4885,116,590,5591,87.37,2.07,10.55,2019,98321
3571,47,213,3831,93.21,1.23,5.56,2019,98327
3600,70,191,3861,93.24,1.81,4.95,2019,98329
18,0,0,18,100.0,0.0,0.0,2019,98353
4237,113,338,4688,90.38,2.41,7.21,2019,98360
3858,101,497,4456,86.58,2.27,11.15,2019,98390
8374,309,1500,10183,82.24,3.03,14.73,2019,98531
1756,155,205,2116,82.99,7.33,9.69,2019,98675
387,0,40,427,90.63,0.0,9.37,2019,98814
157,0,24,181,86.74,0.0,13.26,2019,98829
808,43,528,1379,58.59,3.12,38.29,2019,96748
9996,289,1150,11435,87.42,2.53,10.06,2019,96782
16174,342,1153,17669,91.54,1.94,6.53,2019,96789
8814,392,1422,10628,82.93,3.69,13.38,2019,96813
9325,247,682,10254,90.94,2.41,6.65,2019,96825
404,5,55,464,87.07,1.08,11.85,2019,96008
63,0,26,89,70.79,0.0,29.21,2019,96014
112,0,77,189,59.26,0.0,40.74,2019,96016
53,8,16,77,68.83,10.39,20.78,2019,96017
939,41,144,1124,83.54,3.65,12.81,2019,96020
30,0,30,60,50.0,0.0,50.0,2019,96031
509,41,146,696,73.13,5.89,20.98,2019,96056
430,18,163,611,70.38,2.95,26.68,2019,96057
54,75,0,129,41.86,58.14,0.0,2019,99775
5511,255,1217,6983,78.92,3.65,17.43,2019,99201
23,6,4,33,69.7,18.18,12.12,2019,99825
880,13,146,1039,84.7,1.25,14.05,2019,99827
760,51,216,1027,74.0,4.97,21.03,2019,99929
3732,195,1014,4941,75.53,3.95,20.52,2019,99344
763,23,205,991,76.99,2.32,20.69,2019,99347
3573,407,917,4897,72.96,8.31,18.73,2019,99350
6892,267,774,7933,86.88,3.37,9.76,2019,99004
2931,16,177,3124,93.82,0.51,5.67,2019,99022
5517,154,307,5978,92.29,2.58,5.14,2019,99037
1475,84,496,2055,71.78,4.09,24.14,2019,99109
2999,87,461,3547,84.55,2.45,13.0,2019,99835
316,12,47,375,84.27,3.2,12.53,2019,99840
1475,16,178,1669,88.38,0.96,10.67,2019,12580
14473,217,1018,15708,92.14,1.38,6.48,2019,12603
457,10,140,607,75.29,1.65,23.06,2019,12067
1145,70,295,1510,75.83,4.64,19.54,2019,12134
591,15,209,815,72.52,1.84,25.64,2019,12455
136,0,8,144,94.44,0.0,5.56,2019,12416
529,8,67,604,87.58,1.32,11.09,2019,12062
736,32,85,853,86.28,3.75,9.96,2019,12094
212,0,59,271,78.23,0.0,21.77,2019,12130
3521,116,517,4154,84.76,2.79,12.45,2019,12209
0,0,9,9,0.0,0.0,100.0,2019,12007
0,0,0,0,,,,2019,12024
42,9,4,55,76.36,16.36,7.27,2019,12040
79,0,24,103,76.7,0.0,23.3,2019,12069
160,0,29,189,84.66,0.0,15.34,2019,12085
28,0,7,35,80.0,0.0,20.0,2019,12089
192,0,0,192,100.0,0.0,0.0,2019,12124
110,0,24,134,82.09,0.0,17.91,2019,12132
77,0,0,77,100.0,0.0,0.0,2019,12161
64,0,20,84,76.19,0.0,23.81,2019,12172
126,0,15,141,89.36,0.0,10.64,2019,12174
146,17,0,163,89.57,10.43,0.0,2019,12177
65,0,0,65,100.0,0.0,0.0,2019,12195
15,0,0,15,100.0,0.0,0.0,2019,12222
122,0,22,144,84.72,0.0,15.28,2019,12417
88,0,18,106,83.02,0.0,16.98,2019,12432
75,0,19,94,79.79,0.0,20.21,2019,12436
8,0,0,8,100.0,0.0,0.0,2019,12438
6,0,36,42,14.29,0.0,85.71,2019,12441
58,17,26,101,57.43,16.83,25.74,2019,12452
83,0,8,91,91.21,0.0,8.79,2019,12453
90,0,18,108,83.33,0.0,16.67,2019,12465
79,0,25,104,75.96,0.0,24.04,2019,12475
101,0,40,141,71.63,0.0,28.37,2019,12483
14,0,0,14,100.0,0.0,0.0,2019,12490
41,0,0,41,100.0,0.0,0.0,2019,12504
58,0,0,58,100.0,0.0,0.0,2019,12512
0,0,0,0,,,,2019,12527
40,0,0,40,100.0,0.0,0.0,2019,12530
102,0,0,102,100.0,0.0,0.0,2019,12574
7,0,0,7,100.0,0.0,0.0,2019,12604
30,0,28,58,51.72,0.0,48.28,2019,12722
65,0,11,76,85.53,0.0,14.47,2019,12745
73,0,0,73,100.0,0.0,0.0,2019,12750
53,0,13,66,80.3,0.0,19.7,2019,12767
75,30,26,131,57.25,22.9,19.85,2019,15546
374,2,92,468,79.91,0.43,19.66,2019,15631
81,0,15,96,84.38,0.0,15.62,2019,15450
160,0,12,172,93.02,0.0,6.98,2019,15455
237,8,135,380,62.37,2.11,35.53,2019,15771
6156,257,1243,7656,80.41,3.36,16.24,2019,15801
2945,81,633,3659,80.49,2.21,17.3,2019,15825
75,12,30,117,64.1,10.26,25.64,2019,15828
1430,36,491,1957,73.07,1.84,25.09,2019,15834
322,6,53,381,84.51,1.57,13.91,2019,15856
61,7,17,85,71.76,8.24,20.0,2019,15861
48,4,40,92,52.17,4.35,43.48,2019,15866
7283,253,1359,8895,81.88,2.84,15.28,2019,15905
328,20,99,447,73.38,4.47,22.15,2019,15924
243,11,30,284,85.56,3.87,10.56,2019,13844
4146,76,861,5083,81.57,1.5,16.94,2019,13827
187,6,61,254,73.62,2.36,24.02,2019,13841
167,0,45,212,78.77,0.0,21.23,2019,13842
184,8,46,238,77.31,3.36,19.33,2019,13863
701,53,226,980,71.53,5.41,23.06,2019,13040
566,0,77,643,88.02,0.0,11.98,2019,13054
742,154,311,1207,61.47,12.76,25.77,2019,13060
285,0,80,365,78.08,0.0,21.92,2019,13071
2101,85,435,2621,80.16,3.24,16.6,2019,13073
1414,9,165,1588,89.04,0.57,10.39,2019,13074
351,6,81,438,80.14,1.37,18.49,2019,13081
5067,235,922,6224,81.41,3.78,14.81,2019,13219
1368,6,202,1576,86.8,0.38,12.82,2019,13084
143,4,45,192,74.48,2.08,23.44,2019,13136
2399,162,319,2880,83.3,5.62,11.08,2019,13214
1723,77,415,2215,77.79,3.48,18.74,2019,13339
806,40,139,985,81.83,4.06,14.11,2019,13363
83,0,47,130,63.85,0.0,36.15,2019,13638
883,87,293,1263,69.91,6.89,23.2,2019,13667
291,3,87,381,76.38,0.79,22.83,2019,13788
972,75,71,1118,86.94,6.71,6.35,2019,13685
4389,351,875,5615,78.17,6.25,15.58,2019,13815
28,4,5,37,75.68,10.81,13.51,2019,13020
0,0,0,0,,,,2019,13024
88,0,0,88,100.0,0.0,0.0,2019,13051
80,0,0,80,100.0,0.0,0.0,2019,13064
42,0,10,52,80.77,0.0,19.23,2019,13087
20,0,9,29,68.97,0.0,31.03,2019,13102
79,0,40,119,66.39,0.0,33.61,2019,13103
84,0,15,99,84.85,0.0,15.15,2019,13113
89,0,21,110,80.91,0.0,19.09,2019,13115
68,6,41,115,59.13,5.22,35.65,2019,13117
60,20,0,80,75.0,25.0,0.0,2019,13123
52,0,13,65,80.0,0.0,20.0,2019,13134
19,0,0,19,100.0,0.0,0.0,2019,13138
107,36,30,173,61.85,20.81,17.34,2019,13153
267,18,30,315,84.76,5.71,9.52,2019,13157
88,0,44,132,66.67,0.0,33.33,2019,13162
102,14,23,139,73.38,10.07,16.55,2019,13163
96,0,0,96,100.0,0.0,0.0,2019,13305
356,24,61,441,80.73,5.44,13.83,2019,13321
47,0,7,54,87.04,0.0,12.96,2019,13345
11,0,0,11,100.0,0.0,0.0,2019,13352
35,15,0,50,70.0,30.0,0.0,2019,13362
8047,80,444,8571,93.89,0.93,5.18,2019,01886
8975,268,555,9798,91.6,2.74,5.66,2019,01002
445,40,79,564,78.9,7.09,14.01,2019,01011
722,42,154,918,78.65,4.58,16.78,2019,01080
6645,582,2077,9304,71.42,6.26,22.32,2019,01109
2366,96,968,3430,68.98,2.8,28.22,2019,01151
281,0,62,343,81.92,0.0,18.08,2019,01222
1179,29,240,1448,81.42,2.0,16.57,2019,01225
907,16,150,1073,84.53,1.49,13.98,2019,01337
685,11,82,778,88.05,1.41,10.54,2019,01341
127,0,56,183,69.4,0.0,30.6,2019,01346
850,17,107,974,87.27,1.75,10.99,2019,01351
359,12,102,473,75.9,2.54,21.56,2019,01366
1652,112,282,2046,80.74,5.47,13.78,2019,01373
10942,460,1771,13173,83.06,3.49,13.44,2019,98499
15268,765,1380,17413,87.68,4.39,7.93,2019,98501
12469,514,1307,14290,87.26,3.6,9.15,2019,98502
10749,684,883,12316,87.28,5.55,7.17,2019,98512
6647,252,1294,8193,81.13,3.08,15.79,2019,98520
827,4,182,1013,81.64,0.39,17.97,2019,98568
879,0,13,892,98.54,0.0,1.46,2019,98588
702,34,44,780,90.0,4.36,5.64,2019,98592
57,0,7,64,89.06,0.0,10.94,2019,98811
158,0,33,191,82.72,0.0,17.28,2019,98827
82,3,0,85,96.47,3.53,0.0,2019,98832
1556,60,365,1981,78.55,3.03,18.43,2019,98840
4,0,3,7,57.14,0.0,42.86,2019,98852
855,31,291,1177,72.64,2.63,24.72,2019,98857
4199,209,979,5387,77.95,3.88,18.17,2019,98903
3011,156,282,3449,87.3,4.52,8.18,2019,95811
0,0,0,0,,,,2019,95915
8160,42,362,8564,95.28,0.49,4.23,2019,95054
9918,175,718,10811,91.74,1.62,6.64,2019,95219
9004,495,1387,10886,82.71,4.55,12.74,2019,99216
8030,191,743,8964,89.58,2.13,8.29,2019,99224
77,6,20,103,74.76,5.83,19.42,2019,99322
1209,21,73,1303,92.79,1.61,5.6,2019,99323
183,2,92,277,66.06,0.72,33.21,2019,99829
976,26,185,1187,82.22,2.19,15.59,2019,99833
0,0,0,0,,,,2019,99927
121,3,70,194,62.37,1.55,36.08,2019,99830
181,26,26,233,77.68,11.16,11.16,2019,99008
1831,57,141,2029,90.24,2.81,6.95,2019,99025
2956,11,346,3313,89.22,0.33,10.44,2019,99026
489,16,48,553,88.43,2.89,8.68,2019,99031
237,10,67,314,75.48,3.18,21.34,2019,99032
208,9,13,230,90.43,3.91,5.65,2019,99102
17,1,1,19,89.47,5.26,5.26,2019,99105
564,0,154,718,78.55,0.0,21.45,2019,99116
73,0,18,91,80.22,0.0,19.78,2019,99121
1455,48,160,1663,87.49,2.89,9.62,2019,99122
211,0,37,248,85.08,0.0,14.92,2019,99134
257,23,156,436,58.94,5.28,35.78,2019,99138
10616,189,378,11183,94.93,1.69,3.38,2019,95070
1203,36,70,1309,91.9,2.75,5.35,2019,95113
12130,243,1854,14227,85.26,1.71,13.03,2019,95116
12603,440,4184,17227,73.16,2.55,24.29,2019,95206
15520,387,2507,18414,84.28,2.1,13.61,2019,95207
2298,28,244,2570,89.42,1.09,9.49,2019,95220
486,52,494,1032,47.09,5.04,47.87,2019,00715
3933,173,2653,6759,58.19,2.56,39.25,2019,00717
6733,590,4218,11541,58.34,5.11,36.55,2019,00767
13222,339,5667,19228,68.76,1.76,29.47,2019,00603
473,8,1586,2067,22.88,0.39,76.73,2019,00622
861,123,935,1919,44.87,6.41,48.72,2019,00647
2423,101,2354,4878,49.67,2.07,48.26,2019,00664
1859,60,5862,7781,23.89,0.77,75.34,2019,00667
1768,24,615,2407,73.45,1.0,25.55,2019,00690
5723,358,4845,10926,52.38,3.28,44.34,2019,00698
9008,159,3972,13139,68.56,1.21,30.23,2019,00728
12781,71,3629,16481,77.55,0.43,22.02,2019,00729
4628,123,2858,7609,60.82,1.62,37.56,2019,00751
7549,289,5202,13040,57.89,2.22,39.89,2019,00769
547,24,243,814,67.2,2.95,29.85,2019,99921
94,0,12,106,88.68,0.0,11.32,2019,99631
36,0,22,58,62.07,0.0,37.93,2019,99546
40,0,20,60,66.67,0.0,33.33,2019,99356
77,10,0,87,88.51,11.49,0.0,2019,99363
7398,122,419,7939,93.19,1.54,5.28,2019,99515
5,4,3,12,41.67,33.33,25.0,2019,99547
21,2,15,38,55.26,5.26,39.47,2019,99558
4,0,8,12,33.33,0.0,66.67,2019,99566
105,0,57,162,64.81,0.0,35.19,2019,99568
773,19,43,835,92.57,2.28,5.15,2019,99574
9235,33,241,9509,97.12,0.35,2.53,2019,99577
3403,119,479,4001,85.05,2.97,11.97,2019,99615
130,6,28,164,79.27,3.66,17.07,2019,99633
42,0,46,88,47.73,0.0,52.27,2019,99643
117,7,39,163,71.78,4.29,23.93,2019,99655
19,4,12,35,54.29,11.43,34.29,2019,99666
488,17,95,600,81.33,2.83,15.83,2019,99676
11,8,50,69,15.94,11.59,72.46,2019,99720
90,2,22,114,78.95,1.75,19.3,2019,99727
2298,239,667,3204,71.72,7.46,20.82,2019,95988
2295,68,336,2699,85.03,2.52,12.45,2019,95631
632,28,81,741,85.29,3.78,10.93,2019,95638
2821,96,300,3217,87.69,2.98,9.33,2019,95640
2381,18,300,2699,88.22,0.67,11.12,2019,95658
1983,55,319,2357,84.13,2.33,13.53,2019,95666
311,40,53,404,76.98,9.9,13.12,2019,95681
302,8,62,372,81.18,2.15,16.67,2019,95686
535,21,192,748,71.52,2.81,25.67,2019,95690
2264,69,177,2510,90.2,2.75,7.05,2019,95693
12218,298,2233,14749,82.84,2.02,15.14,2019,95695
1738,53,299,2090,83.16,2.54,14.31,2019,95709
2832,115,370,3317,85.38,3.47,11.15,2019,95726
92,0,9,101,91.09,0.0,8.91,2019,95728
9011,327,623,9961,90.46,3.28,6.25,2019,95816
7831,215,397,8443,92.75,2.55,4.7,2019,95829
13462,228,966,14656,91.85,1.56,6.59,2019,95833
13233,229,256,13718,96.46,1.67,1.87,2019,95835
8616,136,607,9359,92.06,1.45,6.49,2019,95864
170,31,119,320,53.12,9.69,37.19,2019,95914
16,0,0,16,100.0,0.0,0.0,2019,95923
75,0,22,97,77.32,0.0,22.68,2019,95934
57,0,12,69,82.61,0.0,17.39,2019,95936
7103,219,1086,8408,84.48,2.6,12.92,2019,95949
4080,144,1249,5473,74.55,2.63,22.82,2019,95963
883,7,63,953,92.65,0.73,6.61,2019,03855
580,3,17,600,96.67,0.5,2.83,2019,03856
2826,57,236,3119,90.61,1.83,7.57,2019,03865
2169,17,74,2260,95.97,0.75,3.27,2019,03870
655,27,83,765,85.62,3.53,10.85,2019,03887
2574,0,429,3003,85.71,0.0,14.29,2019,03894
2503,42,131,2676,93.54,1.57,4.9,2019,03903
505,18,6,529,95.46,3.4,1.13,2019,03462
613,7,43,663,92.46,1.06,6.49,2019,03467
2948,195,834,3977,74.13,4.9,20.97,2019,03570
122,1,42,165,73.94,0.61,25.45,2019,03579
284,8,112,404,70.3,1.98,27.72,2019,03590
277,11,29,317,87.38,3.47,9.15,2019,03595
1655,128,413,2196,75.36,5.83,18.81,2019,03603
316,0,184,500,63.2,0.0,36.8,2019,15927
29,0,56,85,34.12,0.0,65.88,2019,15930
704,32,220,956,73.64,3.35,23.01,2019,15938
159,0,52,211,75.36,0.0,24.64,2019,15949
4680,90,1078,5848,80.03,1.54,18.43,2019,15857
73,0,29,102,71.57,0.0,28.43,2019,15863
553,8,108,669,82.66,1.2,16.14,2019,15864
8,0,16,24,33.33,0.0,66.67,2019,15929
2991,92,639,3722,80.36,2.47,17.17,2019,15931
429,41,114,584,73.46,7.02,19.52,2019,15673
143,52,12,207,69.08,25.12,5.8,2019,15086
8379,99,363,8841,94.77,1.12,4.11,2019,15090
2856,161,1042,4059,70.36,3.97,25.67,2019,15104
1528,107,612,2247,68.0,4.76,27.24,2019,15110
7061,238,1497,8796,80.28,2.71,17.02,2019,15122
6830,220,1350,8400,81.31,2.62,16.07,2019,15147
839,22,271,1132,74.12,1.94,23.94,2019,15148
5465,92,741,6298,86.77,1.46,11.77,2019,15234
11015,149,1410,12574,87.6,1.18,11.21,2019,15236
169,9,32,210,80.48,4.29,15.24,2019,15547
1573,77,650,2300,68.39,3.35,28.26,2019,15552
152,9,17,178,85.39,5.06,9.55,2019,15612
2060,219,224,2503,82.3,8.75,8.95,2019,15626
2177,67,466,2710,80.33,2.47,17.2,2019,15627
230,27,55,312,73.72,8.65,17.63,2019,15629
4157,89,775,5021,82.79,1.77,15.44,2019,15003
818,44,198,1060,77.17,4.15,18.68,2019,15027
360,17,167,544,66.18,3.12,30.7,2019,15030
4328,123,849,5300,81.66,2.32,16.02,2019,15061
83,0,0,83,100.0,0.0,0.0,2019,15689
224,0,94,318,70.44,0.0,29.56,2019,15698
58,1,24,83,69.88,1.2,28.92,2019,15721
546,25,315,886,61.63,2.82,35.55,2019,15724
478,33,281,792,60.35,4.17,35.48,2019,15747
2201,69,568,2838,77.55,2.43,20.01,2019,15748
53,11,31,95,55.79,11.58,32.63,2019,15756
307,8,80,395,77.72,2.03,20.25,2019,15352
7487,102,963,8552,87.55,1.19,11.26,2019,15239
61,5,53,119,51.26,4.2,44.54,2019,15310
511,22,127,660,77.42,3.33,19.24,2019,15338
236,13,151,400,59.0,3.25,37.75,2019,15848
2249,244,409,2902,77.5,8.41,14.09,2019,15853
69,0,23,92,75.0,0.0,25.0,2019,15764
133,0,69,202,65.84,0.0,34.16,2019,15779
41,3,4,48,85.42,6.25,8.33,2019,15781
645,148,68,861,74.91,17.19,7.9,2019,05262
243,64,40,347,70.03,18.44,11.53,2019,05340
673,155,143,971,69.31,15.96,14.73,2019,05345
7855,308,708,8871,88.55,3.47,7.98,2019,05452
33,0,0,33,100.0,0.0,0.0,2019,05362
7422,354,852,8628,86.02,4.1,9.87,2019,05403
275,4,59,338,81.36,1.18,17.46,2019,05448
1670,95,48,1813,92.11,5.24,2.65,2019,05477
460,6,74,540,85.19,1.11,13.7,2019,05483
3783,82,288,4153,91.09,1.97,6.93,2019,05495
142,1,34,177,80.23,0.56,19.21,2019,05442
105,3,9,117,89.74,2.56,7.69,2019,05730
206,0,40,246,83.74,0.0,16.26,2019,05736
330,7,39,376,87.77,1.86,10.37,2019,05737
1801,69,519,2389,75.39,2.89,21.72,2019,01376
284,16,45,345,82.32,4.64,13.04,2019,01378
3178,15,119,3312,95.95,0.45,3.59,2019,01772
6918,388,2192,9498,72.84,4.09,23.08,2019,01854
696,6,93,795,87.55,0.75,11.7,2019,01515
4040,130,713,4883,82.74,2.66,14.6,2019,01562
2589,42,146,2777,93.23,1.51,5.26,2019,01564
2461,98,157,2716,90.61,3.61,5.78,2019,01568
3551,44,310,3905,90.93,1.13,7.94,2019,01571
3148,47,222,3417,92.13,1.38,6.5,2019,01590
8210,399,2064,10673,76.92,3.74,19.34,2019,01605
6882,172,1105,8159,84.35,2.11,13.54,2019,01606
2192,10,64,2266,96.73,0.44,2.82,2019,01719
353,13,124,490,72.04,2.65,25.31,2019,01008
220,24,28,272,80.88,8.82,10.29,2019,01012
7526,253,1361,9140,82.34,2.77,14.89,2019,01013
203,16,19,238,85.29,6.72,7.98,2019,01029
393,43,101,537,73.18,8.01,18.81,2019,01031
199,20,15,234,85.04,8.55,6.41,2019,01032
6358,218,1349,7925,80.23,2.75,17.02,2019,01056
5724,229,603,6556,87.31,3.49,9.2,2019,01060
2980,146,382,3508,84.95,4.16,10.89,2019,01069
241,25,30,296,81.42,8.45,10.14,2019,01070
3056,90,658,3804,80.34,2.37,17.3,2019,01077
835,46,185,1066,78.33,4.32,17.35,2019,01083
4629,170,454,5253,88.12,3.24,8.64,2019,01095
491,12,81,584,84.08,2.05,13.87,2019,01098
2249,94,521,2864,78.53,3.28,18.19,2019,01129
856,81,99,1036,82.63,7.82,9.56,2019,01237
35,0,23,58,60.34,0.0,39.66,2019,01244
5047,240,1275,6562,76.91,3.66,19.43,2019,01247
329,15,62,406,81.03,3.69,15.27,2019,01253
517,25,30,572,90.38,4.37,5.24,2019,01266
468,3,103,574,81.53,0.52,17.94,2019,01330
4354,151,766,5271,82.6,2.86,14.53,2019,01331
589,15,152,756,77.91,1.98,20.11,2019,01340
26,7,16,49,53.06,14.29,32.65,2019,01350
198,0,0,198,100.0,0.0,0.0,2019,01438
12752,632,3701,17085,74.64,3.7,21.66,2019,01902
6341,175,699,7215,87.89,2.43,9.69,2019,01913
1181,0,42,1223,96.57,0.0,3.43,2019,01922
11321,286,1503,13110,86.35,2.18,11.46,2019,01930
12223,53,778,13054,93.63,0.41,5.96,2019,01701
8232,424,842,9498,86.67,4.46,8.87,2019,01602
670,58,60,788,85.03,7.36,7.61,2019,01611
1007,12,154,1173,85.85,1.02,13.13,2019,04614
67,0,7,74,90.54,0.0,9.46,2019,04624
487,53,89,629,77.42,8.43,14.15,2019,04631
5,0,1,6,83.33,0.0,16.67,2019,04635
427,11,140,578,73.88,1.9,24.22,2019,04649
365,40,76,481,75.88,8.32,15.8,2019,04681
167,7,36,210,79.52,3.33,17.14,2019,04693
1341,144,378,1863,71.98,7.73,20.29,2019,04743
564,54,143,761,74.11,7.1,18.79,2019,04750
213,20,84,317,67.19,6.31,26.5,2019,04760
97,10,56,163,59.51,6.13,34.36,2019,04766
256,20,114,390,65.64,5.13,29.23,2019,04776
2918,124,444,3486,83.71,3.56,12.74,2019,04841
550,20,64,634,86.75,3.15,10.09,2019,04847
10809,188,3785,14782,73.12,1.27,25.61,2019,00795
1336,39,1814,3189,41.89,1.22,56.88,2019,00925
6633,270,1294,8197,80.92,3.29,15.79,2019,00979
10222,122,2940,13284,76.95,0.92,22.13,2019,00983
4924,62,2425,7411,66.44,0.84,32.72,2019,00624
4388,74,2040,6502,67.49,1.14,31.37,2019,00656
4034,125,2096,6255,64.49,2.0,33.51,2019,00660
5646,1322,6881,13849,40.77,9.55,49.69,2019,00662
6902,359,7597,14858,46.45,2.42,51.13,2019,00674
4207,167,6693,11067,38.01,1.51,60.48,2019,00683
5709,351,1919,7979,71.55,4.4,24.05,2019,00718
7929,913,4703,13545,58.54,6.74,34.72,2019,00921
4534,21,1883,6438,70.43,0.33,29.25,2019,00772
2154,20,1136,3310,65.08,0.6,34.32,2019,00913
3341,390,6308,10039,33.28,3.88,62.83,2019,00923
14704,505,10419,25628,57.37,1.97,40.65,2019,00949
11929,202,2212,14343,83.17,1.41,15.42,2019,00969
9154,110,2902,12166,75.24,0.9,23.85,2019,00985
7077,466,5197,12740,55.55,3.66,40.79,2019,00602
9007,234,4184,13425,67.09,1.74,31.17,2019,00676
8373,286,3209,11868,70.55,2.41,27.04,2019,00682
1737,0,987,2724,63.77,0.0,36.23,2019,00704
2100,192,1523,3815,55.05,5.03,39.92,2019,00707
1453,0,757,2210,65.75,0.0,34.25,2019,00765
6192,496,4870,11558,53.57,4.29,42.14,2019,00730
8273,122,3163,11558,71.58,1.06,27.37,2019,00738
7092,874,5684,13650,51.96,6.4,41.64,2019,00754
2042,60,3105,5207,39.22,1.15,59.63,2019,00782
10139,823,5329,16291,62.24,5.05,32.71,2019,00791
4476,70,4195,8741,51.21,0.8,47.99,2019,00794
5617,408,2018,8043,69.84,5.07,25.09,2019,00907
1361,69,813,2243,60.68,3.08,36.25,2019,00909
1803,43,732,2578,69.94,1.67,28.39,2019,00912
4438,321,3296,8055,55.1,3.99,40.92,2019,00918
4040,55,1868,5963,67.75,0.92,31.33,2019,00927
11425,247,10057,21729,52.58,1.14,46.28,2019,00953
17444,513,6650,24607,70.89,2.08,27.02,2019,00956
10507,195,3598,14300,73.48,1.36,25.16,2019,00957
14733,589,7487,22809,64.59,2.58,32.82,2019,00612
4098,63,9245,13406,30.57,0.47,68.96,2019,00623
758,42,519,1319,57.47,3.18,39.35,2019,00652
2825,215,1989,5029,56.17,4.28,39.55,2019,00677
6248,242,4840,11330,55.15,2.14,42.72,2019,00692
5314,478,3019,8811,60.31,5.43,34.26,2019,00678
5433,761,7189,13383,40.6,5.69,53.72,2019,00685
1391,22,160,1573,88.43,1.4,10.17,2019,02638
6405,83,317,6805,94.12,1.22,4.66,2019,02035
4322,134,372,4828,89.52,2.78,7.71,2019,02333
227,0,36,263,86.31,0.0,13.69,2019,02666
569,22,0,591,96.28,3.72,0.0,2019,02763
4472,119,322,4913,91.02,2.42,6.55,2019,02339
1176,7,48,1231,95.53,0.57,3.9,2019,02464
1775,92,187,2054,86.42,4.48,9.1,2019,02633
15137,674,1821,17632,85.85,3.82,10.33,2019,02703
427,0,16,443,96.39,0.0,3.61,2019,02833
3747,176,219,4142,90.46,4.25,5.29,2019,02631
8476,197,1394,10067,84.2,1.96,13.85,2019,02745
4195,244,1664,6103,68.74,4.0,27.27,2019,02863
3980,49,559,4588,86.75,1.07,12.18,2019,02896
319,132,133,584,54.62,22.6,22.77,2019,25559
261,0,0,261,100.0,0.0,0.0,2019,25611
50,0,41,91,54.95,0.0,45.05,2019,25624
287,13,128,428,67.06,3.04,29.91,2019,25625
97,8,64,169,57.4,4.73,37.87,2019,25634
871,33,215,1119,77.84,2.95,19.21,2019,25674
450,0,33,483,93.17,0.0,6.83,2019,25676
1806,299,949,3054,59.14,9.79,31.07,2019,25702
1504,43,103,1650,91.15,2.61,6.24,2019,25832
181,0,51,232,78.02,0.0,21.98,2019,25845
84,0,53,137,61.31,0.0,38.69,2019,25846
4584,419,1519,6522,70.29,6.42,23.29,2019,25704
79,0,0,79,100.0,0.0,0.0,2019,25826
85,24,0,109,77.98,22.02,0.0,2019,25849
86,0,42,128,67.19,0.0,32.81,2019,25864
133,0,37,170,78.24,0.0,21.76,2019,25904
209,6,111,326,64.11,1.84,34.05,2019,25958
677,5,132,814,83.17,0.61,16.22,2019,25882
12,0,9,21,57.14,0.0,42.86,2019,25907
54,0,0,54,100.0,0.0,0.0,2019,25920
1757,74,1031,2862,61.39,2.59,36.02,2019,25951
992,55,392,1439,68.94,3.82,27.24,2019,25962
1285,43,600,1928,66.65,2.23,31.12,2019,25045
519,11,272,802,64.71,1.37,33.92,2019,25063
357,4,36,397,89.92,1.01,9.07,2019,25081
190,0,35,225,84.44,0.0,15.56,2019,25083
374,9,129,512,73.05,1.76,25.2,2019,25984
144,0,47,191,75.39,0.0,24.61,2019,25985
102,6,0,108,94.44,5.56,0.0,2019,25021
354,25,173,552,64.13,4.53,31.34,2019,25043
13,0,19,32,40.62,0.0,59.38,2019,25048
1499,22,198,1719,87.2,1.28,11.52,2019,25053
126,41,141,308,40.91,13.31,45.78,2019,25075
58,18,38,114,50.88,15.79,33.33,2019,25076
266,13,151,430,61.86,3.02,35.12,2019,25085
45,0,13,58,77.59,0.0,22.41,2019,25090
51,4,7,62,82.26,6.45,11.29,2019,25102
82,0,25,107,76.64,0.0,23.36,2019,25103
23,0,13,36,63.89,0.0,36.11,2019,25126
990,48,278,1316,75.23,3.65,21.12,2019,25130
55,0,9,64,85.94,0.0,14.06,2019,25141
283,30,104,417,67.87,7.19,24.94,2019,25164
277,0,49,326,84.97,0.0,15.03,2019,25165
176,0,31,207,85.02,0.0,14.98,2019,25169
139,44,25,208,66.83,21.15,12.02,2019,25174
7548,344,1431,9323,80.96,3.69,15.35,2019,25177
251,0,32,283,88.69,0.0,11.31,2019,25193
53,0,0,53,100.0,0.0,0.0,2019,25025
107,0,24,131,81.68,0.0,18.32,2019,25054
190,0,20,210,90.48,0.0,9.52,2019,25214
544,6,64,614,88.6,0.98,10.42,2019,25241
2331,132,678,3141,74.21,4.2,21.59,2019,25306
580,16,153,749,77.44,2.14,20.43,2019,25422
4729,120,901,5750,82.24,2.09,15.67,2019,25427
384,11,548,943,40.72,1.17,58.11,2019,28369
1936,30,488,2454,78.89,1.22,19.89,2019,28371
461,0,132,593,77.74,0.0,22.26,2019,28392
2583,231,218,3032,85.19,7.62,7.19,2019,28428
1122,113,666,1901,59.02,5.94,35.03,2019,28433
683,38,137,858,79.6,4.43,15.97,2019,04346
953,0,260,1213,78.57,0.0,21.43,2019,04256
455,42,121,618,73.62,6.8,19.58,2019,04041
732,20,16,768,95.31,2.6,2.08,2019,04085
1866,100,423,2389,78.11,4.19,17.71,2019,04276
2335,199,211,2745,85.06,7.25,7.69,2019,04280
1984,125,199,2308,85.96,5.42,8.62,2019,04282
479,19,62,560,85.54,3.39,11.07,2019,04290
3857,124,597,4578,84.25,2.71,13.04,2019,04345
179,2,22,203,88.18,0.99,10.84,2019,04360
398,25,97,520,76.54,4.81,18.65,2019,04414
331,39,112,482,68.67,8.09,23.24,2019,04422
519,112,290,921,56.35,12.16,31.49,2019,04443
250,5,83,338,73.96,1.48,24.56,2019,04453
161,24,60,245,65.71,9.8,24.49,2019,04464
2602,202,345,3149,82.63,6.41,10.96,2019,04473
169,18,3,190,88.95,9.47,1.58,2019,04478
635,18,125,778,81.62,2.31,16.07,2019,04493
295,3,50,348,84.77,0.86,14.37,2019,04535
397,20,86,503,78.93,3.98,17.1,2019,04539
508,9,110,627,81.02,1.44,17.54,2019,04563
179,0,50,229,78.17,0.0,21.83,2019,04568
1498,31,340,1869,80.15,1.66,18.19,2019,04578
129,0,23,152,84.87,0.0,15.13,2019,04650
160,13,30,203,78.82,6.4,14.78,2019,04662
445,10,105,560,79.46,1.79,18.75,2019,04666
435,19,119,573,75.92,3.32,20.77,2019,04667
558,30,85,673,82.91,4.46,12.63,2019,04679
707,10,54,771,91.7,1.3,7.0,2019,04684
87,7,0,94,92.55,7.45,0.0,2019,04006
103,0,16,119,86.55,0.0,13.45,2019,04056
38,0,0,38,100.0,0.0,0.0,2019,04057
3969,79,545,4593,86.41,1.72,11.87,2019,04090
511,56,141,708,72.18,7.91,19.92,2019,04289
1762,55,187,2004,87.92,2.74,9.33,2019,04429
155,0,30,185,83.78,0.0,16.22,2019,04495
513,25,112,650,78.92,3.85,17.23,2019,04627
57,0,6,63,90.48,0.0,9.52,2019,04673
266,0,32,298,89.26,0.0,10.74,2019,04063
43,0,0,43,100.0,0.0,0.0,2019,04109
38,0,17,55,69.09,0.0,30.91,2019,04227
27,0,0,27,100.0,0.0,0.0,2019,04234
29,0,4,33,87.88,0.0,12.12,2019,04267
0,0,0,0,,,,2019,04271
15,0,0,15,100.0,0.0,0.0,2019,04286
145,15,117,277,52.35,5.42,42.24,2019,72347
680,58,376,1114,61.04,5.21,33.75,2019,72348
285,46,104,435,65.52,10.57,23.91,2019,72350
0,0,22,22,0.0,0.0,100.0,2019,72377
252,17,113,382,65.97,4.45,29.58,2019,72384
18198,1374,3121,22693,80.19,6.05,13.75,2019,72401
132,4,5,141,93.62,2.84,3.55,2019,72414
1668,94,370,2132,78.24,4.41,17.35,2019,72416
73,0,21,94,77.66,0.0,22.34,2019,72427
988,28,279,1295,76.29,2.16,21.54,2019,72126
90,0,117,207,43.48,0.0,56.52,2019,72123
1533,88,327,1948,78.7,4.52,16.79,2019,72131
33,0,15,48,68.75,0.0,31.25,2019,72166
317,8,294,619,51.21,1.29,47.5,2019,72167
605,7,212,824,73.42,0.85,25.73,2019,28538
1834,59,31,1924,95.32,3.07,1.61,2019,28543
68,6,36,110,61.82,5.45,32.73,2019,28577
3072,99,945,4116,74.64,2.41,22.96,2019,28580
98,0,46,144,68.06,0.0,31.94,2019,28581
8935,242,2406,11583,77.14,2.09,20.77,2019,28602
30,1,2,33,90.91,3.03,6.06,2019,28616
963,0,220,1183,81.4,0.0,18.6,2019,28626
1494,394,485,2373,62.96,16.6,20.44,2019,28642
15814,432,5301,21547,73.39,2.0,24.6,2019,28655
7312,249,2366,9927,73.66,2.51,23.83,2019,28681
471,32,312,815,57.79,3.93,38.28,2019,28685
1363,54,178,1595,85.45,3.39,11.16,2019,28692
4343,130,1226,5699,76.21,2.28,21.51,2019,28697
1000,98,251,1349,74.13,7.26,18.61,2019,28701
1699,110,1083,2892,58.75,3.8,37.45,2019,28719
1070,80,225,1375,77.82,5.82,16.36,2019,28726
2931,95,463,3489,84.01,2.72,13.27,2019,28731
298,43,125,466,63.95,9.23,26.82,2019,28774
5198,98,1310,6606,78.69,1.48,19.83,2019,28801
13601,461,1658,15720,86.52,2.93,10.55,2019,28803
219,0,66,285,76.84,0.0,23.16,2019,28511
3333,110,675,4118,80.94,2.67,16.39,2019,28513
874,52,226,1152,75.87,4.51,19.62,2019,28525
446,6,98,550,81.09,1.09,17.82,2019,28531
15260,446,1420,17126,89.1,2.6,8.29,2019,28546
107,0,23,130,82.31,0.0,17.69,2019,28554
1411,33,138,1582,89.19,2.09,8.72,2019,28605
295,0,186,481,61.33,0.0,38.67,2019,28611
3308,140,1380,4828,68.52,2.9,28.58,2019,28612
465,25,177,667,69.72,3.75,26.54,2019,28619
575,0,184,759,75.76,0.0,24.24,2019,28624
11685,702,2620,15007,77.86,4.68,17.46,2019,28625
3909,120,906,4935,79.21,2.43,18.36,2019,28638
1157,16,360,1533,75.47,1.04,23.48,2019,28643
6626,301,2029,8956,73.98,3.36,22.66,2019,28659
857,5,154,1016,84.35,0.49,15.16,2019,28665
899,0,320,1219,73.75,0.0,26.25,2019,28669
10719,512,2371,13602,78.8,3.76,17.43,2019,28677
525,32,135,692,75.87,4.62,19.51,2019,28679
109,0,70,179,60.89,0.0,39.11,2019,28702
6630,197,1071,7898,83.95,2.49,13.56,2019,28704
2485,26,264,2775,89.55,0.94,9.51,2019,28174
0,0,0,0,,,,2019,28019
1013,22,144,1179,85.92,1.87,12.21,2019,28033
5596,370,2321,8287,67.53,4.46,28.01,2019,28043
6752,426,2333,9511,70.99,4.48,24.53,2019,28086
12755,566,2795,16116,79.14,3.51,17.34,2019,28092
1513,56,316,1885,80.27,2.97,16.76,2019,28135
3178,67,630,3875,82.01,1.73,16.26,2019,28138
5903,628,2066,8597,68.66,7.3,24.03,2019,28152
863,37,166,1066,80.96,3.47,15.57,2019,28159
145,0,16,161,90.06,0.0,9.94,2019,28520
5192,88,640,5920,87.7,1.49,10.81,2019,28539
4603,168,865,5636,81.67,2.98,15.35,2019,28551
1298,26,521,1845,70.35,1.41,28.24,2019,28555
1891,87,525,2503,75.55,3.48,20.97,2019,28572
594,11,248,853,69.64,1.29,29.07,2019,28615
503,21,149,673,74.74,3.12,22.14,2019,28623
596,37,235,868,68.66,4.26,27.07,2019,28435
775,34,196,1005,77.11,3.38,19.5,2019,28450
8080,129,685,8894,90.85,1.45,7.7,2019,28461
4429,187,877,5493,80.63,3.4,15.97,2019,28462
30,0,0,30,100.0,0.0,0.0,2019,28537
1930,41,14,1985,97.23,2.07,0.71,2019,28547
29,0,20,49,59.18,0.0,40.82,2019,28552
5837,215,872,6924,84.3,3.11,12.59,2019,28557
9263,197,2121,11581,79.98,1.7,18.31,2019,28560
13710,215,2429,16354,83.83,1.31,14.85,2019,28562
7347,310,975,8632,85.11,3.59,11.3,2019,28570
5271,256,777,6304,83.61,4.06,12.33,2019,28574
245,0,11,256,95.7,0.0,4.3,2019,28579
913,9,167,1089,83.84,0.83,15.34,2019,28373
2770,154,2215,5139,53.9,3.0,43.1,2019,28364
1332,112,800,2244,59.36,4.99,35.65,2019,28366
2638,73,1424,4135,63.8,1.77,34.44,2019,28377
668,10,304,982,68.02,1.02,30.96,2019,28698
10,0,0,10,100.0,0.0,0.0,2019,28725
9489,324,2685,12498,75.92,2.59,21.48,2019,28734
127,0,45,172,73.84,0.0,26.16,2019,28735
1530,79,306,1915,79.9,4.13,15.98,2019,28741
2884,172,961,4017,71.79,4.28,23.92,2019,28753
1306,133,277,1716,76.11,7.75,16.14,2019,28756
2144,44,807,2995,71.59,1.47,26.94,2019,28762
2782,80,713,3575,77.82,2.24,19.94,2019,28777
2848,113,792,3753,75.89,3.01,21.1,2019,28778
480,0,86,566,84.81,0.0,15.19,2019,28902
375,0,103,478,78.45,0.0,21.55,2019,28909
10038,80,438,10556,95.09,0.76,4.15,2019,28104
20,7,18,45,44.44,15.56,40.0,2019,28109
14411,578,682,15671,91.96,3.69,4.35,2019,28117
705,0,215,920,76.63,0.0,23.37,2019,28125
2426,24,471,2921,83.05,0.82,16.12,2019,28128
3092,146,448,3686,83.88,3.96,12.15,2019,28166
7983,188,535,8706,91.7,2.16,6.15,2019,28203
17882,335,2738,20955,85.34,1.6,13.07,2019,28215
2282,47,485,2814,81.09,1.67,17.24,2019,28305
6651,205,604,7460,89.16,2.75,8.1,2019,28326
141,5,4,150,94.0,3.33,2.67,2019,28332
2160,47,632,2839,76.08,1.66,22.26,2019,28339
1020,107,368,1495,68.23,7.16,24.62,2019,28341
10893,283,1286,12462,87.41,2.27,10.32,2019,28348
5561,225,3339,9125,60.94,2.47,36.59,2019,28352
8421,304,4712,13437,62.67,2.26,35.07,2019,28358
12403,71,838,13312,93.17,0.53,6.3,2019,28409
1183,60,281,1524,77.62,3.94,18.44,2019,28420
7348,498,832,8678,84.67,5.74,9.59,2019,28390
787,18,279,1084,72.6,1.66,25.74,2019,28344
2849,132,1796,4777,59.64,2.76,37.6,2019,28360
1823,67,277,2167,84.13,3.09,12.78,2019,28391
7516,595,2563,10674,70.41,5.57,24.01,2019,28401
108,0,24,132,81.82,0.0,18.18,2019,28708
7066,234,1540,8840,79.93,2.65,17.42,2019,28712
4121,62,1165,5348,77.06,1.16,21.78,2019,19153
10833,226,1335,12394,87.41,1.82,10.77,2019,19154
9339,175,575,10089,92.57,1.73,5.7,2019,19355
1650,44,389,2083,79.21,2.11,18.67,2019,19362
2127,49,408,2584,82.31,1.9,15.79,2019,19365
4635,202,323,5160,89.83,3.91,6.26,2019,72207
8504,266,1085,9855,86.29,2.7,11.01,2019,72211
8780,332,470,9582,91.63,3.46,4.91,2019,72223
7121,306,2334,9761,72.95,3.13,23.91,2019,72301
105,2,37,144,72.92,1.39,25.69,2019,72429
12,1,17,30,40.0,3.33,56.67,2019,72441
1126,49,521,1696,66.39,2.89,30.72,2019,72442
892,53,240,1185,75.27,4.47,20.25,2019,72443
562,29,233,824,68.2,3.52,28.28,2019,72447
36,5,31,72,50.0,6.94,43.06,2019,72457
56,4,23,83,67.47,4.82,27.71,2019,72470
319,18,119,456,69.96,3.95,26.1,2019,72471
93,49,30,172,54.07,28.49,17.44,2019,72536
658,337,313,1308,50.31,25.76,23.93,2019,72556
100,49,79,228,43.86,21.49,34.65,2019,72566
195,0,60,255,76.47,0.0,23.53,2019,72569
80,0,52,132,60.61,0.0,39.39,2019,72571
28,0,36,64,43.75,0.0,56.25,2019,72572
43,27,12,82,52.44,32.93,14.63,2019,72573
150,54,41,245,61.22,22.04,16.73,2019,72577
102,32,25,159,64.15,20.13,15.72,2019,72624
682,62,430,1174,58.09,5.28,36.63,2019,72641
939,105,630,1674,56.09,6.27,37.63,2019,72650
322,47,235,604,53.31,7.78,38.91,2019,72658
172,1,87,260,66.15,0.38,33.46,2019,72660
13,0,27,40,32.5,0.0,67.5,2019,72669
99,5,45,149,66.44,3.36,30.2,2019,72677
4709,432,341,5482,85.9,7.88,6.22,2019,72714
911,159,56,1126,80.91,14.12,4.97,2019,72718
1475,121,633,2229,66.17,5.43,28.4,2019,72727
10299,2492,3091,15882,64.85,15.69,19.46,2019,72756
1877,68,363,2308,81.33,2.95,15.73,2019,72774
139,0,84,223,62.33,0.0,37.67,2019,72333
7,0,0,7,100.0,0.0,0.0,2019,72338
475,18,382,875,54.29,2.06,43.66,2019,72366
0,0,6,6,0.0,0.0,100.0,2019,72379
126,0,6,132,95.45,0.0,4.55,2019,72389
155,0,74,229,67.69,0.0,32.31,2019,72392
33,7,99,139,23.74,5.04,71.22,2019,72425
115,25,30,170,67.65,14.71,17.65,2019,72430
712,98,229,1039,68.53,9.43,22.04,2019,72438
204,0,38,242,84.3,0.0,15.7,2019,72458
238,4,101,343,69.39,1.17,29.45,2019,72460
5,4,19,28,17.86,14.29,67.86,2019,72464
674,12,370,1056,63.83,1.14,35.04,2019,72473
877,53,102,1032,84.98,5.14,9.88,2019,96145
12602,176,630,13408,93.99,1.31,4.7,2019,96707
1938,26,87,2051,94.49,1.27,4.24,2019,96741
4065,13,406,4484,90.66,0.29,9.05,2019,96743
834,39,240,1113,74.93,3.5,21.56,2019,96760
5475,234,847,6556,83.51,3.57,12.92,2019,96768
176,0,92,268,65.67,0.0,34.33,2019,96770
1811,151,900,2862,63.28,5.28,31.45,2019,96771
689,10,304,1003,68.69,1.0,30.31,2019,96772
302,27,159,488,61.89,5.53,32.58,2019,96777
8814,265,1193,10272,85.81,2.58,11.61,2019,96793
4170,182,1446,5798,71.92,3.14,24.94,2019,96021
31,4,22,57,54.39,7.02,38.6,2019,96074
951,41,281,1273,74.71,3.22,22.07,2019,96750
1244,108,340,1692,73.52,6.38,20.09,2019,28634
2628,197,1140,3965,66.28,4.97,28.75,2019,28657
95,39,79,213,44.6,18.31,37.09,2019,28671
2258,162,1177,3597,62.77,4.5,32.72,2019,28713
440,17,19,476,92.44,3.57,3.99,2019,28766
6063,219,1533,7815,77.58,2.8,19.62,2019,28779
392,0,322,714,54.9,0.0,45.1,2019,28783
14967,526,2291,17784,84.16,2.96,12.88,2019,28540
746,28,204,978,76.28,2.86,20.86,2019,28521
624,1,568,1193,52.31,0.08,47.61,2019,28526
971,48,226,1245,77.99,3.86,18.15,2019,28571
202,22,0,224,90.18,9.82,0.0,2019,28575
1625,0,629,2254,72.09,0.0,27.91,2019,28578
880,77,607,1564,56.27,4.92,38.81,2019,28585
51,0,8,59,86.44,0.0,13.56,2019,28589
8671,145,872,9688,89.5,1.5,9.0,2019,28590
462,0,142,604,76.49,0.0,23.51,2019,28606
1833,42,352,2227,82.31,1.89,15.81,2019,28609
3239,142,600,3981,81.36,3.57,15.07,2019,28610
10807,278,660,11745,92.01,2.37,5.62,2019,28031
2117,116,874,3107,68.14,3.73,28.13,2019,28040
12147,537,2766,15450,78.62,3.48,17.9,2019,28054
630,31,196,857,73.51,3.62,22.87,2019,28091
30,0,9,39,76.92,0.0,23.08,2019,28102
6653,160,1135,7948,83.71,2.01,14.28,2019,28630
932,40,341,1313,70.98,3.05,25.97,2019,28635
14189,407,3997,18593,76.31,2.19,21.5,2019,28645
3672,173,551,4396,83.53,3.94,12.53,2019,28650
654,55,120,829,78.89,6.63,14.48,2019,28660
2587,54,925,3566,72.55,1.51,25.94,2019,28690
548,22,260,830,66.02,2.65,31.33,2019,28693
195,15,76,286,68.18,5.24,26.57,2019,23359
19,55,52,126,15.08,43.65,41.27,2019,23416
317,4,67,388,81.7,1.03,17.27,2019,23418
698,29,334,1061,65.79,2.73,31.48,2019,23420
509,34,67,610,83.44,5.57,10.98,2019,23432
1244,72,374,1690,73.61,4.26,22.13,2019,23437
521,0,141,662,78.7,0.0,21.3,2019,23438
166,0,20,186,89.25,0.0,10.75,2019,23423
493,0,45,538,91.64,0.0,8.36,2019,23433
335,54,74,463,72.35,11.66,15.98,2019,23442
17500,416,1997,19913,87.88,2.09,10.03,2019,23455
0,0,0,0,,,,2019,23461
105,0,80,185,56.76,0.0,43.24,2019,23488
5615,383,1759,7757,72.39,4.94,22.68,2019,23504
2039,70,266,2375,85.85,2.95,11.2,2019,23517
12717,823,2276,15816,80.41,5.2,14.39,2019,23669
6718,179,572,7469,89.95,2.4,7.66,2019,23692
8535,75,1055,9665,88.31,0.78,10.92,2019,23703
11308,90,1013,12411,91.11,0.73,8.16,2019,23832
681,0,164,845,80.59,0.0,19.41,2019,23840
198,27,45,270,73.33,10.0,16.67,2019,23845
3310,233,1605,5148,64.3,4.53,31.18,2019,23847
273,7,153,433,63.05,1.62,35.33,2019,23856
281,3,152,436,64.45,0.69,34.86,2019,23874
159,0,10,169,94.08,0.0,5.92,2019,23893
144,16,130,290,49.66,5.52,44.83,2019,23897
92,4,58,154,59.74,2.6,37.66,2019,23899
642,87,314,1043,61.55,8.34,30.11,2019,23917
6545,167,720,7432,88.07,2.25,9.69,2019,19440
10471,495,2068,13034,80.34,3.8,15.87,2019,19152
8736,376,2726,11838,73.8,3.18,23.03,2019,19138
11579,962,4787,17328,66.82,5.55,27.63,2019,19139
13687,636,2877,17200,79.58,3.7,16.73,2019,19146
4013,13,304,4330,92.68,0.3,7.02,2019,19312
16559,220,1196,17975,92.12,1.22,6.65,2019,19335
18651,702,858,20211,92.28,3.47,4.25,2019,19382
8501,184,747,9432,90.13,1.95,7.92,2019,19438
14830,308,1321,16459,90.1,1.87,8.03,2019,19460
1805,31,143,1979,91.21,1.57,7.23,2019,19504
43,0,0,43,100.0,0.0,0.0,2019,19511
5655,88,1128,6871,82.3,1.28,16.42,2019,19512
4996,58,549,5603,89.17,1.04,9.8,2019,19518
5397,22,243,5662,95.32,0.39,4.29,2019,19525
0,0,0,0,,,,2019,19112
17136,720,4753,22609,75.79,3.18,21.02,2019,19124
1059,30,124,1213,87.3,2.47,10.22,2019,19529
1908,8,241,2157,88.46,0.37,11.17,2019,19543
251,0,21,272,92.28,0.0,7.72,2019,19545
7129,179,562,7870,90.58,2.27,7.14,2019,19006
8336,107,1207,9650,86.38,1.11,12.51,2019,19018
1929,106,105,2140,90.14,4.95,4.91,2019,19025
871,17,97,985,88.43,1.73,9.85,2019,19043
6386,210,1186,7782,82.06,2.7,15.24,2019,19061
1665,9,46,1720,96.8,0.52,2.67,2019,19066
2706,69,721,3496,77.4,1.97,20.62,2019,19079
11866,474,2264,14604,81.25,3.25,15.5,2019,19082
13782,316,1079,15177,90.81,2.08,7.11,2019,19103
12310,669,3361,16340,75.34,4.09,20.57,2019,19104
2465,16,276,2757,89.41,0.58,10.01,2019,19939
1635,66,251,1952,83.76,3.38,12.86,2019,19946
5004,169,1606,6779,73.82,2.49,23.69,2019,19947
2458,25,129,2612,94.1,0.96,4.94,2019,19041
11081,469,1414,12964,85.48,3.62,10.91,2019,19114
10142,276,1367,11785,86.06,2.34,11.6,2019,19119
9058,270,1228,10556,85.81,2.56,11.63,2019,19125
2450,73,119,2642,92.73,2.76,4.5,2019,19127
7207,322,2007,9536,75.58,3.38,21.05,2019,19973
654,0,15,669,97.76,0.0,2.24,2019,19372
696,24,240,960,72.5,2.5,25.0,2019,19310
2411,40,459,2910,82.85,1.37,15.77,2019,19311
173,3,49,225,76.89,1.33,21.78,2019,19358
4085,177,798,5060,80.73,3.5,15.77,2019,19390
6825,184,293,7302,93.47,2.52,4.01,2019,19422
12002,80,346,12428,96.57,0.64,2.78,2019,19426
5328,39,275,5642,94.43,0.69,4.87,2019,19096
6683,277,715,7675,87.07,3.61,9.32,2019,19107
4386,214,1227,5827,75.27,3.67,21.06,2019,19126
7762,376,5949,14087,55.1,2.67,42.23,2019,19132
15240,507,4651,20398,74.71,2.49,22.8,2019,19134
2024,24,343,2391,84.65,1.0,14.35,2019,19533
4383,150,1724,6257,70.05,2.4,27.55,2019,19602
5696,65,208,5969,95.43,1.09,3.48,2019,19707
7402,859,854,9115,81.21,9.42,9.37,2019,22150
10012,146,246,10404,96.23,1.4,2.36,2019,22152
2792,67,409,3268,85.43,2.05,12.52,2019,22172
21411,441,986,22838,93.75,1.93,4.32,2019,22191
19425,513,2801,22739,85.43,2.26,12.32,2019,22204
9985,179,1799,11963,83.47,1.5,15.04,2019,96819
0,0,0,0,,,,2019,96863
149,0,0,149,100.0,0.0,0.0,2019,96121
4105,104,680,4889,83.96,2.13,13.91,2019,96766
58,2,25,85,68.24,2.35,29.41,2019,96112
325,0,154,479,67.85,0.0,32.15,2019,96719
1930,81,269,2280,84.65,3.55,11.8,2019,96791
14426,393,1395,16214,88.97,2.42,8.6,2019,96744
15245,309,3469,19023,80.14,1.62,18.24,2019,96817
13,0,14,27,48.15,0.0,51.85,2019,96049
51,0,0,51,100.0,0.0,0.0,2019,96111
138,0,0,138,100.0,0.0,0.0,2019,96129
75,0,50,125,60.0,0.0,40.0,2019,96135
0,0,0,0,,,,2019,96155
89,0,38,127,70.08,0.0,29.92,2019,96726
85,0,28,113,75.22,0.0,24.78,2019,96765
0,0,0,0,,,,2019,96850
0,0,0,0,,,,2019,96853
0,0,0,0,,,,2019,96857
0,0,0,0,,,,2019,96859
0,0,0,0,,,,2019,96860
0,0,0,0,,,,2019,99695
1961,0,100,2061,95.15,0.0,4.85,2019,99703
0,0,0,0,,,,2019,99704
984,44,328,1356,72.57,3.24,24.19,2019,99723
4,0,6,10,40.0,0.0,60.0,2019,99726
22,6,35,63,34.92,9.52,55.56,2019,99758
7,0,25,32,21.88,0.0,78.12,2019,99788
80,5,51,136,58.82,3.68,37.5,2019,99772
35,1,19,55,63.64,1.82,34.55,2019,99783
57,0,39,96,59.38,0.0,40.62,2019,99785
63,5,40,108,58.33,4.63,37.04,2019,99789
1343,29,234,1606,83.62,1.81,14.57,2019,97114
128,0,40,168,76.19,0.0,23.81,2019,97122
6225,115,370,6710,92.77,1.71,5.51,2019,97210
10342,257,789,11388,90.81,2.26,6.93,2019,97225
320,15,76,411,77.86,3.65,18.49,2019,97453
5477,211,965,6653,82.32,3.17,14.5,2019,99701
78,2,13,93,83.87,2.15,13.98,2019,99131
9,0,2,11,81.82,0.0,18.18,2019,99136
388,12,98,498,77.91,2.41,19.68,2019,99139
29,5,13,47,61.7,10.64,27.66,2019,99152
218,23,166,407,53.56,5.65,40.79,2019,99155
238,20,80,338,70.41,5.92,23.67,2019,99157
856,39,196,1091,78.46,3.57,17.97,2019,99169
316,5,85,406,77.83,1.23,20.94,2019,99170
834,29,408,1271,65.62,2.28,32.1,2019,23920
800,8,409,1217,65.74,0.66,33.61,2019,23923
877,13,504,1394,62.91,0.93,36.15,2019,23950
5666,150,1179,6995,81.0,2.14,16.85,2019,23430
310,10,53,373,83.11,2.68,14.21,2019,23436
18036,553,1628,20217,89.21,2.74,8.05,2019,23451
9760,470,1415,11645,83.81,4.04,12.15,2019,23505
2029,137,438,2604,77.92,5.26,16.82,2019,23523
3317,133,803,4253,77.99,3.13,18.88,2019,23702
10852,592,3679,15123,71.76,3.91,24.33,2019,23803
302,20,70,392,77.04,5.1,17.86,2019,23829
4488,142,333,4963,90.43,2.86,6.71,2019,23836
225,21,81,327,68.81,6.42,24.77,2019,23839
894,52,401,1347,66.37,3.86,29.77,2019,23841
8298,277,2217,10792,76.89,2.57,20.54,2019,23860
43,0,24,67,64.18,0.0,35.82,2019,23401
357,15,73,445,80.22,3.37,16.4,2019,23405
778,76,748,1602,48.56,4.74,46.69,2019,23421
27,0,19,46,58.7,0.0,41.3,2019,23426
1570,22,611,2203,71.27,1.0,27.73,2019,23487
6709,290,1126,8125,82.57,3.57,13.86,2019,23502
4286,84,807,5177,82.79,1.62,15.59,2019,23509
3485,194,395,4074,85.54,4.76,9.7,2019,23510
13288,1287,1734,16309,81.48,7.89,10.63,2019,23602
12408,1825,1712,15945,77.82,11.45,10.74,2019,23608
18104,1293,2522,21919,82.6,5.9,11.51,2019,23666
1676,114,671,2461,68.1,4.63,27.27,2019,23824
8265,332,1654,10251,80.63,3.24,16.14,2019,23834
141,0,65,206,68.45,0.0,31.55,2019,23843
642,14,167,823,78.01,1.7,20.29,2019,23866
648,14,422,1084,59.78,1.29,38.93,2019,23872
13760,151,606,14517,94.79,1.04,4.17,2019,27502
1147,16,242,1405,81.64,1.14,17.22,2019,27503
1283,21,296,1600,80.19,1.31,18.5,2019,27509
2038,8,661,2707,75.29,0.3,24.42,2019,27557
615,238,180,1033,59.54,23.04,17.42,2019,27559
2085,9,94,2188,95.29,0.41,4.3,2019,27571
7606,353,1739,9698,78.43,3.64,17.93,2019,27701
677,39,350,1066,63.51,3.66,32.83,2019,27806
1246,3,721,1970,63.25,0.15,36.6,2019,27810
207,16,47,270,76.67,5.93,17.41,2019,27813
1143,63,123,1329,86.0,4.74,9.26,2019,27248
5961,340,447,6748,88.34,5.04,6.62,2019,27282
561,9,99,669,83.86,1.35,14.8,2019,27305
568,23,250,841,67.54,2.73,29.73,2019,27315
1957,147,710,2814,69.55,5.22,25.23,2019,27325
4747,487,1574,6808,69.73,7.15,23.12,2019,27344
665,95,151,911,73.0,10.43,16.58,2019,27355
14534,542,3671,18747,77.53,2.89,19.58,2019,27360
2731,321,408,3460,78.93,9.28,11.79,2019,27377
4563,656,2177,7396,61.7,8.87,29.43,2019,27401
11755,1037,6143,18935,62.08,5.48,32.44,2019,27405
19821,2706,2033,24560,80.7,11.02,8.28,2019,27410
1786,189,636,2611,68.4,7.24,24.36,2019,27505
12632,284,738,13654,92.52,2.08,5.41,2019,27511
9081,308,951,10340,87.82,2.98,9.2,2019,27545
7723,233,2277,10233,75.47,2.28,22.25,2019,27549
113,24,120,257,43.97,9.34,46.69,2019,27555
129,27,104,260,49.62,10.38,40.0,2019,27568
9169,483,1277,10929,83.9,4.42,11.68,2019,22041
6373,97,337,6807,93.62,1.43,4.95,2019,22046
5700,48,38,5786,98.51,0.83,0.66,2019,22066
403,8,10,421,95.72,1.9,2.38,2019,22125
22271,369,849,23489,94.81,1.57,3.61,2019,22193
7455,207,309,7971,93.53,2.6,3.88,2019,22209
1335,9,45,1389,96.11,0.65,3.24,2019,22213
6276,305,612,7193,87.25,4.24,8.51,2019,22305
4434,61,117,4612,96.14,1.32,2.54,2019,22308
794,7,224,1025,77.46,0.68,21.85,2019,22435
100,0,71,171,58.48,0.0,41.52,2019,22438
341,22,124,487,70.02,4.52,25.46,2019,22511
597,0,0,597,100.0,0.0,0.0,2019,22027
5183,154,200,5537,93.61,2.78,3.61,2019,22151
9155,520,1087,10762,85.07,4.83,10.1,2019,22401
968,132,333,1433,67.55,9.21,23.24,2019,22482
107,0,19,126,84.92,0.0,15.08,2019,22504
47,0,15,62,75.81,0.0,24.19,2019,22538
843,0,197,1040,81.06,0.0,18.94,2019,22539
62,0,9,71,87.32,0.0,12.68,2019,22723
2778,269,1110,4157,66.83,6.47,26.7,2019,22827
601,33,337,971,61.89,3.4,34.71,2019,22843
366,94,95,555,65.95,16.94,17.12,2019,22938
4471,108,420,4999,89.44,2.16,8.4,2019,22026
18626,295,559,19480,95.62,1.51,2.87,2019,22030
9889,237,315,10441,94.71,2.27,3.02,2019,22101
10861,87,236,11184,97.11,0.78,2.11,2019,22102
5090,26,159,5275,96.49,0.49,3.01,2019,22181
8536,110,268,8914,95.76,1.23,3.01,2019,22182
19042,169,603,19814,96.1,0.85,3.04,2019,22201
10509,309,998,11816,88.94,2.62,8.45,2019,22306
6680,292,867,7839,85.21,3.72,11.06,2019,22311
10620,131,651,11402,93.14,1.15,5.71,2019,22312
9784,124,626,10534,92.88,1.18,5.94,2019,22405
438,68,204,710,61.69,9.58,28.73,2019,22971
3195,111,606,3912,81.67,2.84,15.49,2019,22942
36,0,8,44,81.82,0.0,18.18,2019,22946
206,0,341,547,37.66,0.0,62.34,2019,22949
0,17,0,17,0.0,100.0,0.0,2019,22989
8349,118,427,8894,93.87,1.33,4.8,2019,22043
7827,127,303,8257,94.79,1.54,3.67,2019,22180
13222,270,582,14074,93.95,1.92,4.14,2019,22202
367,17,131,515,71.26,3.3,25.44,2019,22940
562,0,138,700,80.29,0.0,19.71,2019,22952
1220,49,200,1469,83.05,3.34,13.61,2019,22974
554,34,198,786,70.48,4.33,25.19,2019,22937
1224,76,374,1674,73.12,4.54,22.34,2019,22920
295,0,132,427,69.09,0.0,30.91,2019,22740
11189,1395,1154,13738,81.45,10.15,8.4,2019,22801
311,16,40,367,84.74,4.36,10.9,2019,22834
828,58,193,1079,76.74,5.38,17.89,2019,22841
636,0,158,794,80.1,0.0,19.9,2019,22922
8562,160,474,9196,93.11,1.74,5.15,2019,22406
7624,90,299,8013,95.15,1.12,3.73,2019,22302
49,0,51,100,49.0,0.0,51.0,2019,25437
166,53,160,379,43.8,13.98,42.22,2019,25512
289,0,74,363,79.61,0.0,20.39,2019,25521
6557,330,1507,8394,78.12,3.93,17.95,2019,25526
1256,174,213,1643,76.45,10.59,12.96,2019,25545
477,6,55,538,88.66,1.12,10.22,2019,99185
7401,194,1134,8729,84.79,2.22,12.99,2019,99212
52,0,7,59,88.14,0.0,11.86,2019,99329
88,48,83,219,40.18,21.92,37.9,2019,99346
4572,260,991,5823,78.52,4.47,17.02,2019,99503
2145,7,29,2181,98.35,0.32,1.33,2019,99506
44,13,21,78,56.41,16.67,26.92,2019,99552
83,8,69,160,51.88,5.0,43.12,2019,99554
53,0,7,60,88.33,0.0,11.67,2019,99555
143,6,55,204,70.1,2.94,26.96,2019,99557
43,0,18,61,70.49,0.0,29.51,2019,99585
197,0,65,262,75.19,0.0,24.81,2019,99588
90,2,37,129,69.77,1.55,28.68,2019,99614
60,9,108,177,33.9,5.08,61.02,2019,99620
61,0,21,82,74.39,0.0,25.61,2019,99622
93,1,40,134,69.4,0.75,29.85,2019,99627
4,0,5,9,44.44,0.0,55.56,2019,99638
43,7,22,72,59.72,9.72,30.56,2019,99644
7674,220,723,8617,89.06,2.55,8.39,2019,99645
31,0,14,45,68.89,0.0,31.11,2019,99657
97,0,24,121,80.17,0.0,19.83,2019,99662
8,2,14,24,33.33,8.33,58.33,2019,99665
33,0,19,52,63.46,0.0,36.54,2019,99667
10,0,22,32,31.25,0.0,68.75,2019,99668
14,1,5,20,70.0,5.0,25.0,2019,99670
166,9,61,236,70.34,3.81,25.85,2019,99678
0,0,0,0,,,,2019,99020
383,0,86,469,81.66,0.0,18.34,2019,99029
337,11,91,439,76.77,2.51,20.73,2019,99030
170,7,34,211,80.57,3.32,16.11,2019,99117
210,8,23,241,87.14,3.32,9.54,2019,99125
55,3,31,89,61.8,3.37,34.83,2019,99753
374,0,75,449,83.3,0.0,16.7,2019,99714
32,0,34,66,48.48,0.0,51.52,2019,99738
56,2,19,77,72.73,2.6,24.68,2019,99749
72,14,0,86,83.72,16.28,0.0,2019,99755
121,8,78,207,58.45,3.86,37.68,2019,99760
1218,50,185,1453,83.83,3.44,12.73,2019,99762
126,0,73,199,63.32,0.0,36.68,2019,99769
35,2,23,60,58.33,3.33,38.33,2019,99778
98,5,32,135,72.59,3.7,23.7,2019,99782
10605,270,787,11662,90.94,2.32,6.75,2019,99801
30,0,22,52,57.69,0.0,42.31,2019,99832
8288,153,610,9051,91.57,1.69,6.74,2019,99203
10,2,5,17,58.82,11.76,29.41,2019,99569
0,0,0,0,,,,2019,04343
141,0,38,179,78.77,0.0,21.23,2019,04359
92,8,24,124,74.19,6.45,19.35,2019,04415
5,0,7,12,41.67,0.0,58.33,2019,04454
0,0,0,0,,,,2019,04469
140,18,46,204,68.63,8.82,22.55,2019,04481
37,10,34,81,45.68,12.35,41.98,2019,04485
35,26,33,94,37.23,27.66,35.11,2019,04489
59,0,13,72,81.94,0.0,18.06,2019,04491
34,4,12,50,68.0,8.0,24.0,2019,04492
0,0,0,0,,,,2019,04570
167,0,0,167,100.0,0.0,0.0,2019,04571
39,0,0,39,100.0,0.0,0.0,2019,04575
63,1,26,90,70.0,1.11,28.89,2019,04637
3456,96,1094,4646,74.39,2.07,23.55,2019,27573
4374,169,1914,6457,67.74,2.62,29.64,2019,27576
96,0,75,171,56.14,0.0,43.86,2019,27582
18036,903,1518,20457,88.17,4.41,7.42,2019,27603
16655,633,1534,18822,88.49,3.36,8.15,2019,27604
3245,9,285,3539,91.69,0.25,8.05,2019,27605
424,11,142,577,73.48,1.91,24.61,2019,27938
207,0,0,207,100.0,0.0,0.0,2019,27943
4508,24,413,4945,91.16,0.49,8.35,2019,27948
1100,46,448,1594,69.01,2.89,28.11,2019,27019
3958,86,1372,5416,73.08,1.59,25.33,2019,27055
13465,353,3585,17403,77.37,2.03,20.6,2019,27107
1010,35,297,1342,75.26,2.61,22.13,2019,27207
383,40,194,617,62.07,6.48,31.44,2019,27979
1781,101,372,2254,79.02,4.48,16.5,2019,27013
5660,282,1454,7396,76.53,3.81,19.66,2019,27021
3362,209,948,4519,74.4,4.62,20.98,2019,27025
2856,72,966,3894,73.34,1.85,24.81,2019,27239
1418,19,316,1753,80.89,1.08,18.03,2019,27243
10063,283,2260,12606,79.83,2.24,17.93,2019,27253
6832,357,1460,8649,78.99,4.13,16.88,2019,27262
19115,473,2525,22113,86.44,2.14,11.42,2019,27284
12385,305,3076,15766,78.56,1.93,19.51,2019,27292
1940,167,761,2868,67.64,5.82,26.53,2019,27316
5098,187,1303,6588,77.38,2.84,19.78,2019,27317
1387,73,510,1970,70.41,3.71,25.89,2019,27341
1850,44,426,2320,79.74,1.9,18.36,2019,27349
1948,101,1118,3167,61.51,3.19,35.3,2019,27371
14089,825,883,15797,89.19,5.22,5.59,2019,27516
3433,178,1117,4728,72.61,3.76,23.63,2019,27524
16516,681,1302,18499,89.28,3.68,7.04,2019,27529
5661,247,884,6792,83.35,3.64,13.02,2019,18013
224,0,69,293,76.45,0.0,23.55,2019,18030
15,0,0,15,100.0,0.0,0.0,2019,18035
1674,30,196,1900,88.11,1.58,10.32,2019,18041
9258,305,1577,11140,83.11,2.74,14.16,2019,18052
694,30,122,846,82.03,3.55,14.42,2019,18053
3964,97,647,4708,84.2,2.06,13.74,2019,18055
8231,246,1100,9577,85.95,2.57,11.49,2019,18064
186,0,40,226,82.3,0.0,17.7,2019,18079
14169,310,1956,16435,86.21,1.89,11.9,2019,18104
1426,30,308,1764,80.84,1.7,17.46,2019,18419
1494,85,298,1877,79.6,4.53,15.88,2019,18426
65,0,22,87,74.71,0.0,25.29,2019,18460
3693,154,851,4698,78.61,3.28,18.11,2019,18510
2970,44,603,3617,82.11,1.22,16.67,2019,18518
77,12,28,117,65.81,10.26,23.93,2019,18619
435,11,98,544,79.96,2.02,18.01,2019,18631
5363,158,1451,6972,76.92,2.27,20.81,2019,18706
1034,126,383,1543,67.01,8.17,24.82,2019,18709
390,8,102,500,78.0,1.6,20.4,2019,18831
132,1,10,143,92.31,0.7,6.99,2019,18962
13369,575,1900,15844,84.38,3.63,11.99,2019,18017
5826,361,1195,7382,78.92,4.89,16.19,2019,18067
3546,144,805,4495,78.89,3.2,17.91,2019,18080
345,0,7,352,98.01,0.0,1.99,2019,18435
159,0,19,178,89.33,0.0,10.67,2019,18443
34,0,7,41,82.93,0.0,17.07,2019,18455
518,4,67,589,87.95,0.68,11.38,2019,18464
1520,49,400,1969,77.2,2.49,20.31,2019,23181
673,85,274,1032,65.21,8.24,26.55,2019,23919
698,3,269,970,71.96,0.31,27.73,2019,23922
82,0,27,109,75.23,0.0,24.77,2019,23952
481,83,221,785,61.27,10.57,28.15,2019,23966
136,13,91,240,56.67,5.42,37.92,2019,23968
66,0,65,131,50.38,0.0,49.62,2019,23021
551,15,314,880,62.61,1.7,35.68,2019,23043
510,28,199,737,69.2,3.8,27.0,2019,23047
4201,114,501,4816,87.23,2.37,10.4,2019,23072
636,57,130,823,77.28,6.93,15.8,2019,23083
815,59,382,1256,64.89,4.7,30.41,2019,23086
1764,51,353,2168,81.37,2.35,16.28,2019,23089
1319,52,344,1715,76.91,3.03,20.06,2019,23124
134,0,0,134,100.0,0.0,0.0,2019,23125
234,9,110,353,66.29,2.55,31.16,2019,23138
352,78,301,731,48.15,10.67,41.18,2019,23148
478,68,308,854,55.97,7.96,36.07,2019,23175
100,43,39,182,54.95,23.63,21.43,2019,23395
186,0,49,235,79.15,0.0,20.85,2019,23407
229,0,71,300,76.33,0.0,23.67,2019,23050
187,10,42,239,78.24,4.18,17.57,2019,23023
462,25,77,564,81.91,4.43,13.65,2019,23035
0,0,70,70,0.0,0.0,100.0,2019,23045
235,0,45,280,83.93,0.0,16.07,2019,23055
12258,228,567,13053,93.91,1.75,4.34,2019,23059
12861,180,679,13720,93.74,1.31,4.95,2019,23060
176,38,143,357,49.3,10.64,40.06,2019,23076
4057,147,1052,5256,77.19,2.8,20.02,2019,23093
139,0,31,170,81.76,0.0,18.24,2019,23126
221,0,129,350,63.14,0.0,36.86,2019,23128
66,0,52,118,55.93,0.0,44.07,2019,23130
1733,134,380,2247,77.13,5.96,16.91,2019,23140
2226,77,320,2623,84.86,2.94,12.2,2019,23168
168,4,56,228,73.68,1.75,24.56,2019,23180
6607,59,537,7203,91.73,0.82,7.46,2019,23221
159,0,33,192,82.81,0.0,17.19,2019,23056
1015,21,62,1098,92.44,1.91,5.65,2019,23062
69,0,56,125,55.2,0.0,44.8,2019,23064
165,0,18,183,90.16,0.0,9.84,2019,23085
12368,364,1633,14365,86.1,2.53,11.37,2019,23111
2866,150,645,3661,78.28,4.1,17.62,2019,23117
151,0,0,151,100.0,0.0,0.0,2019,23119
3107,36,221,3364,92.36,1.07,6.57,2019,23120
8385,213,835,9433,88.89,2.26,8.85,2019,23139
894,9,272,1175,76.09,0.77,23.15,2019,23149
19,0,0,19,100.0,0.0,0.0,2019,23163
6486,55,534,7075,91.67,0.78,7.55,2019,23226
8772,90,635,9497,92.37,0.95,6.69,2019,23236
1921,468,491,2880,66.7,16.25,17.05,2019,23219
14194,1384,5807,21385,66.37,6.47,27.15,2019,23223
15122,411,2667,18200,83.09,2.26,14.65,2019,23225
2948,151,430,3529,83.54,4.28,12.18,2019,23314
433,0,104,537,80.63,0.0,19.37,2019,23315
7001,244,2455,9700,72.18,2.52,25.31,2019,27565
2190,93,796,3079,71.13,3.02,25.85,2019,27569
2471,19,305,2795,88.41,0.68,10.91,2019,27583
4762,77,803,5642,84.4,1.36,14.23,2019,27592
16662,698,1087,18447,90.32,3.78,5.89,2019,27606
329,14,77,420,78.33,3.33,18.33,2019,25637
338,0,34,372,90.86,0.0,9.14,2019,25638
303,0,0,303,100.0,0.0,0.0,2019,25647
198,27,125,350,56.57,7.71,35.71,2019,25651
422,62,259,743,56.8,8.34,34.86,2019,25678
62,0,0,62,100.0,0.0,0.0,2019,25119
187,0,86,273,68.5,0.0,31.5,2019,25121
29,0,0,29,100.0,0.0,0.0,2019,25132
299,0,95,394,75.89,0.0,24.11,2019,25133
146,12,65,223,65.47,5.38,29.15,2019,25243
382,0,152,534,71.54,0.0,28.46,2019,25252
97,0,118,215,45.12,0.0,54.88,2019,25259
476,18,227,721,66.02,2.5,31.48,2019,25265
109,14,30,153,71.24,9.15,19.61,2019,25285
120,32,90,242,49.59,13.22,37.19,2019,25287
154,0,36,190,81.05,0.0,18.95,2019,25059
127,0,40,167,76.05,0.0,23.95,2019,25060
1002,29,357,1388,72.19,2.09,25.72,2019,25123
99,0,43,142,69.72,0.0,30.28,2019,25932
101,0,18,119,84.87,0.0,15.13,2019,25848
127,0,0,127,100.0,0.0,0.0,2019,25653
59,0,0,59,100.0,0.0,0.0,2019,25654
220,71,186,477,46.12,14.88,38.99,2019,25669
81,0,42,123,65.85,0.0,34.15,2019,25688
6611,580,2216,9407,70.28,6.17,23.56,2019,25701
2089,58,566,2713,77.0,2.14,20.86,2019,25813
106,0,28,134,79.1,0.0,20.9,2019,25837
502,18,235,755,66.49,2.38,31.13,2019,25033
269,7,84,360,74.72,1.94,23.33,2019,25039
85,0,10,95,89.47,0.0,10.53,2019,25051
0,0,0,0,,,,2019,25002
136,0,22,158,86.08,0.0,13.92,2019,25022
96,9,31,136,70.59,6.62,22.79,2019,25030
113,0,0,113,100.0,0.0,0.0,2019,25057
407,8,26,441,92.29,1.81,5.9,2019,25067
118,14,15,147,80.27,9.52,10.2,2019,25108
171,0,75,246,69.51,0.0,30.49,2019,25109
108,0,73,181,59.67,0.0,40.33,2019,25110
2694,100,614,3408,79.05,2.93,18.02,2019,25143
0,0,17,17,0.0,0.0,100.0,2019,25183
101,25,28,154,65.58,16.23,18.18,2019,25206
34,0,34,68,50.0,0.0,50.0,2019,25261
353,0,71,424,83.25,0.0,16.75,2019,25262
184,16,32,232,79.31,6.9,13.79,2019,25266
215,0,91,306,70.26,0.0,29.74,2019,25270
3219,76,756,4051,79.46,1.88,18.66,2019,25271
5005,420,1125,6550,76.41,6.41,17.18,2019,25302
4488,399,1410,6297,71.27,6.34,22.39,2019,25312
1094,29,333,1456,75.14,1.99,22.87,2019,25315
1601,103,787,2491,64.27,4.13,31.59,2019,25320
3960,172,1126,5258,75.31,3.27,21.41,2019,25411
2762,194,418,3374,81.86,5.75,12.39,2019,25413
3932,235,688,4855,80.99,4.84,14.17,2019,25428
1953,171,304,2428,80.44,7.04,12.52,2019,25438
9678,164,1005,10847,89.22,1.51,9.27,2019,28209
659,20,153,832,79.21,2.4,18.39,2019,28689
206,19,134,359,57.38,5.29,37.33,2019,28736
2429,96,161,2686,90.43,3.57,5.99,2019,28107
1636,50,201,1887,86.7,2.65,10.65,2019,28163
0,0,0,0,,,,2019,04644
43,0,19,62,69.35,0.0,30.65,2019,04686
174,46,96,316,55.06,14.56,30.38,2019,04734
4,0,0,4,100.0,0.0,0.0,2019,04741
169,10,35,214,78.97,4.67,16.36,2019,04761
106,0,23,129,82.17,0.0,17.83,2019,04855
122,0,30,152,80.26,0.0,19.74,2019,04918
43,0,0,43,100.0,0.0,0.0,2019,04926
29,0,0,29,100.0,0.0,0.0,2019,04933
0,0,0,0,,,,2019,04940
20,0,0,20,100.0,0.0,0.0,2019,04944
14,0,0,14,100.0,0.0,0.0,2019,04975
0,29,0,29,0.0,100.0,0.0,2019,04992
764,24,263,1051,72.69,2.28,25.02,2019,04257
20,3,8,31,64.52,9.68,25.81,2019,04985
33,0,23,56,58.93,0.0,41.07,2019,04964
461,30,105,596,77.35,5.03,17.62,2019,04010
7257,247,951,8455,85.83,2.92,11.25,2019,04011
4401,81,501,4983,88.32,1.63,10.05,2019,04043
5481,239,1153,6873,79.75,3.48,16.78,2019,04073
1553,175,299,2027,76.62,8.63,14.75,2019,04083
3297,209,364,3870,85.19,5.4,9.41,2019,04086
6912,221,940,8073,85.62,2.74,11.64,2019,04092
51,0,14,65,78.46,0.0,21.54,2019,04226
824,40,68,932,88.41,4.29,7.3,2019,04258
1370,52,312,1734,79.01,3.0,17.99,2019,04268
142,8,37,187,75.94,4.28,19.79,2019,04275
1121,27,266,1414,79.28,1.91,18.81,2019,04287
422,18,40,480,87.92,3.75,8.33,2019,04349
728,39,192,959,75.91,4.07,20.02,2019,04353
2140,65,226,2431,88.03,2.67,9.3,2019,04843
607,12,115,734,82.7,1.63,15.67,2019,04860
1306,102,83,1491,87.59,6.84,5.57,2019,04864
8851,459,1942,11252,78.66,4.08,17.26,2019,04901
692,63,123,878,78.82,7.18,14.01,2019,04928
2842,79,662,3583,79.32,2.2,18.48,2019,04938
1160,17,218,1395,83.15,1.22,15.63,2019,04953
517,32,72,621,83.25,5.15,11.59,2019,04955
174,10,68,252,69.05,3.97,26.98,2019,04982
667,7,187,861,77.47,0.81,21.72,2019,04988
1493,55,263,1811,82.44,3.04,14.52,2019,04989
925,5,80,1010,91.58,0.5,7.92,2019,04355
253,15,86,354,71.47,4.24,24.29,2019,04424
23,0,0,23,100.0,0.0,0.0,2019,04431
434,21,114,569,76.27,3.69,20.04,2019,04448
477,14,113,604,78.97,2.32,18.71,2019,72479
52,0,53,105,49.52,0.0,50.48,2019,72520
250,0,150,400,62.5,0.0,37.5,2019,72523
38,0,80,118,32.2,0.0,67.8,2019,72524
50,8,31,89,56.18,8.99,34.83,2019,72526
217,101,230,548,39.6,18.43,41.97,2019,72532
116,46,140,302,38.41,15.23,46.36,2019,72550
506,134,316,956,52.93,14.02,33.05,2019,72562
112,14,35,161,69.57,8.7,21.74,2019,72585
500,17,109,626,79.87,2.72,17.41,2019,72611
54,0,84,138,39.13,0.0,60.87,2019,72640
384,30,63,477,80.5,6.29,13.21,2019,72651
67,5,52,124,54.03,4.03,41.94,2019,72655
45,0,0,45,100.0,0.0,0.0,2019,72686
229,0,13,242,94.63,0.0,5.37,2019,18473
217,2,30,249,87.15,0.8,12.05,2019,18616
166,0,11,177,93.79,0.0,6.21,2019,18625
158,9,17,184,85.87,4.89,9.24,2019,18626
378,12,99,489,77.3,2.45,20.25,2019,18636
2543,69,647,3259,78.03,2.12,19.85,2019,18644
2780,66,826,3672,75.71,1.8,22.49,2019,18651
123,0,45,168,73.21,0.0,26.79,2019,18456
115,0,34,149,77.18,0.0,22.82,2019,18461
112,0,18,130,86.15,0.0,13.85,2019,18462
97,0,0,97,100.0,0.0,0.0,2019,18469
222,8,11,241,92.12,3.32,4.56,2019,18471
868,5,186,1059,81.96,0.47,17.56,2019,18623
81,0,68,149,54.36,0.0,45.64,2019,18624
4054,193,1379,5626,72.06,3.43,24.51,2019,18634
58,0,6,64,90.62,0.0,9.38,2019,18653
2861,14,451,3326,86.02,0.42,13.56,2019,18708
35,0,3,38,92.11,0.0,7.89,2019,18825
480,3,115,598,80.27,0.5,19.23,2019,18826
3731,23,293,4047,92.19,0.57,7.24,2019,18031
4740,117,443,5300,89.43,2.21,8.36,2019,18036
5582,103,486,6171,90.46,1.67,7.88,2019,18040
303,20,49,372,81.45,5.38,13.17,2019,18059
3261,74,661,3996,81.61,1.85,16.54,2019,18071
384,2,63,449,85.52,0.45,14.03,2019,18085
2424,15,367,2806,86.39,0.53,13.08,2019,18210
384,15,160,559,68.69,2.68,28.62,2019,18216
169,0,45,214,78.97,0.0,21.03,2019,18248
53,0,0,53,100.0,0.0,0.0,2019,18323
2284,135,301,2720,83.97,4.96,11.07,2019,18328
229,25,101,355,64.51,7.04,28.45,2019,18070
1140,13,51,1204,94.68,1.08,4.24,2019,21738
3001,65,351,3417,87.83,1.9,10.27,2019,21629
281,0,140,421,66.75,0.0,33.25,2019,21636
437,2,139,578,75.61,0.35,24.05,2019,21640
28,0,5,33,84.85,0.0,15.15,2019,21641
1871,68,400,2339,79.99,2.91,17.1,2019,21643
92,0,36,128,71.88,0.0,28.12,2019,21647
407,28,107,542,75.09,5.17,19.74,2019,21649
1595,52,218,1865,85.52,2.79,11.69,2019,21655
258,0,62,320,80.62,0.0,19.38,2019,21657
1313,50,146,1509,87.01,3.31,9.68,2019,21658
1494,21,166,1681,88.88,1.25,9.88,2019,21663
98,0,10,108,90.74,0.0,9.26,2019,21667
551,15,139,705,78.16,2.13,19.72,2019,21668
2983,188,801,3972,75.1,4.73,20.17,2019,21713
56,3,10,69,81.16,4.35,14.49,2019,21718
1064,53,389,1506,70.65,3.52,25.83,2019,21750
1043,16,115,1174,88.84,1.36,9.8,2019,21756
1449,74,451,1974,73.4,3.75,22.85,2019,21758
193,0,74,267,72.28,0.0,27.72,2019,21766
546,22,166,734,74.39,3.0,22.62,2019,21822
1114,9,266,1389,80.2,0.65,19.15,2019,21830
230,2,21,253,90.91,0.79,8.3,2019,21861
15,0,4,19,78.95,0.0,21.05,2019,21866
21,0,0,21,100.0,0.0,0.0,2019,21902
33,1,4,38,86.84,2.63,10.53,2019,21540
561,0,93,654,85.78,0.0,14.22,2019,21557
3105,114,340,3559,87.24,3.2,9.55,2019,21617
2388,97,544,3029,78.84,3.2,17.96,2019,27817
47,3,56,106,44.34,2.83,52.83,2019,27819
527,87,358,972,54.22,8.95,36.83,2019,27820
77,0,113,190,40.53,0.0,59.47,2019,27826
6,0,18,24,25.0,0.0,75.0,2019,27827
415,55,253,723,57.4,7.61,34.99,2019,27849
1807,350,599,2756,65.57,12.7,21.73,2019,27043
314,90,120,524,59.92,17.18,22.9,2019,27047
6545,331,1986,8862,73.85,3.74,22.41,2019,27203
430,0,179,609,70.61,0.0,29.39,2019,27212
848,19,244,1111,76.33,1.71,21.96,2019,27229
667,5,130,802,83.17,0.62,16.21,2019,27231
2130,55,582,2767,76.98,1.99,21.03,2019,27258
3015,251,989,4255,70.86,5.9,23.24,2019,27298
2280,157,627,3064,74.41,5.12,20.46,2019,27051
1145,115,319,1579,72.51,7.28,20.2,2019,27233
612,32,239,883,69.31,3.62,27.07,2019,27046
494,7,178,679,72.75,1.03,26.22,2019,27252
15058,2430,2776,20264,74.31,11.99,13.7,2019,27407
468,21,471,960,48.75,2.19,49.06,2019,27553
640,24,408,1072,59.7,2.24,38.06,2019,27812
2034,43,399,2476,82.15,1.74,16.11,2019,27837
153,83,172,408,37.5,20.34,42.16,2019,27843
590,46,236,872,67.66,5.28,27.06,2019,27888
5090,118,1141,6349,80.17,1.86,17.97,2019,27856
194,27,65,286,67.83,9.44,22.73,2019,27942
1347,3,624,1974,68.24,0.15,31.61,2019,27809
14032,406,1300,15738,89.16,2.58,8.26,2019,27609
12052,53,379,12484,96.54,0.42,3.04,2019,27614
18152,420,842,19414,93.5,2.16,4.34,2019,27616
624,16,188,828,75.36,1.93,22.71,2019,27816
504,177,516,1197,42.11,14.79,43.11,2019,27839
519,23,177,719,72.18,3.2,24.62,2019,27842
606,52,501,1159,52.29,4.49,43.23,2019,27844
78,0,112,190,41.05,0.0,58.95,2019,27853
383,27,446,856,44.74,3.15,52.1,2019,27869
17232,335,1018,18585,92.72,1.8,5.48,2019,27615
1866,19,622,2507,74.43,0.76,24.81,2019,27807
697,55,144,896,77.79,6.14,16.07,2019,27007
292,0,177,469,62.26,0.0,37.74,2019,27022
4744,81,334,5159,91.96,1.57,6.47,2019,27023
744,106,286,1136,65.49,9.33,25.18,2019,27024
126,51,113,290,43.45,17.59,38.97,2019,27042
12654,382,2569,15605,81.09,2.45,16.46,2019,27103
1123,72,235,1430,78.53,5.03,16.43,2019,27209
17838,876,1481,20195,88.33,4.34,7.33,2019,27265
1835,25,786,2646,69.35,0.94,29.71,2019,27306
897,49,533,1479,60.65,3.31,36.04,2019,27311
10274,1676,2604,14554,70.59,11.52,17.89,2019,27330
16960,1545,5730,24235,69.98,6.38,23.64,2019,27406
5927,1273,813,8013,73.97,15.89,10.15,2019,27409
5960,187,1159,7306,81.58,2.56,15.86,2019,27501
426,13,28,467,91.22,2.78,6.0,2019,27927
646,48,64,758,85.22,6.33,8.44,2019,27929
4872,48,541,5461,89.21,0.88,9.91,2019,18337
49,0,0,49,100.0,0.0,0.0,2019,18340
159,0,0,159,100.0,0.0,0.0,2019,18349
7660,116,1002,8778,87.26,1.32,11.41,2019,18411
1852,16,252,2120,87.36,0.75,11.89,2019,18414
61,0,4,65,93.85,0.0,6.15,2019,28342
0,0,0,0,,,,2019,28629
2217,50,319,2586,85.73,1.93,12.34,2019,28673
3017,152,1251,4420,68.26,3.44,28.3,2019,28721
4,14,14,32,12.5,43.75,43.75,2019,28039
47,0,0,47,100.0,0.0,0.0,2019,28108
0,0,0,0,,,,2019,28244
0,0,0,0,,,,2019,28280
0,0,0,0,,,,2019,28282
26,0,0,26,100.0,0.0,0.0,2019,28308
0,0,0,0,,,,2019,28310
5624,228,1572,7424,75.75,3.07,21.17,2019,28312
23,2,65,90,25.56,2.22,72.22,2019,28375
18,0,10,28,64.29,0.0,35.71,2019,28424
18,0,0,18,100.0,0.0,0.0,2019,28533
102,0,49,151,67.55,0.0,32.45,2019,28583
83,7,28,118,70.34,5.93,23.73,2019,28587
119,0,39,158,75.32,0.0,24.68,2019,28628
9,0,0,9,100.0,0.0,0.0,2019,28647
0,0,0,0,,,,2019,28652
102,0,65,167,61.08,0.0,38.92,2019,28667
0,0,15,15,0.0,0.0,100.0,2019,28672
75,0,6,81,92.59,0.0,7.41,2019,28720
2710,103,363,3176,85.33,3.24,11.43,2019,28759
47,0,63,110,42.73,0.0,57.27,2019,28775
2477,147,600,3224,76.83,4.56,18.61,2019,28785
150,22,15,187,80.21,11.76,8.02,2019,28553
205,0,49,254,80.71,0.0,19.29,2019,28663
7670,190,2485,10345,74.14,1.84,24.02,2019,28379
1027,88,432,1547,66.39,5.69,27.93,2019,28456
1647,49,1363,3059,53.84,1.6,44.56,2019,28383
1195,59,754,2008,59.51,2.94,37.55,2019,28386
1756,161,1040,2957,59.38,5.44,35.17,2019,28398
2775,65,1139,3979,69.74,1.63,28.63,2019,28425
2416,23,419,2858,84.53,0.8,14.66,2019,28429
1774,154,306,2234,79.41,6.89,13.7,2019,28544
4095,205,879,5179,79.07,3.96,16.97,2019,28470
113,0,11,124,91.13,0.0,8.87,2019,28524
1952,192,712,2856,68.35,6.72,24.93,2019,28530
343,0,102,445,77.08,0.0,22.92,2019,28556
515,30,267,812,63.42,3.69,32.88,2019,28573
2927,341,875,4143,70.65,8.23,21.12,2019,28621
276,0,83,359,76.88,0.0,23.12,2019,28631
373,0,176,549,67.94,0.0,32.06,2019,28644
2226,66,670,2962,75.15,2.23,22.62,2019,28675
670,33,213,916,73.14,3.6,23.25,2019,28684
12378,452,1211,14041,88.16,3.22,8.62,2019,28405
479,16,143,638,75.08,2.51,22.41,2019,28442
815,15,175,1005,81.09,1.49,17.41,2019,28444
2700,131,1041,3872,69.73,3.38,26.89,2019,28466
149,0,18,167,89.22,0.0,10.78,2019,28718
2050,168,663,2881,71.16,5.83,23.01,2019,28722
1493,111,674,2278,65.54,4.87,29.59,2019,28073
1167,38,116,1321,88.34,2.88,8.78,2019,28098
0,0,0,0,,,,2019,19902
11814,150,1682,13646,86.57,1.1,12.33,2019,19904
2751,111,868,3730,73.75,2.98,23.27,2019,19933
5289,9,881,6179,85.6,0.15,14.26,2019,19508
2744,57,459,3260,84.17,1.75,14.08,2019,19560
15055,3492,2148,20695,72.75,16.87,10.38,2019,72712
203,33,47,283,71.73,11.66,16.61,2019,72717
2748,178,318,3244,84.71,5.49,9.8,2019,72730
235,0,56,291,80.76,0.0,19.24,2019,72047
1007,39,603,1649,61.07,2.37,36.57,2019,72021
171,0,108,279,61.29,0.0,38.71,2019,72025
121,14,186,321,37.69,4.36,57.94,2019,72036
291,25,25,341,85.34,7.33,7.33,2019,72044
692,105,259,1056,65.53,9.94,24.53,2019,72512
47,0,16,63,74.6,0.0,25.4,2019,72539
4025,238,989,5252,76.64,4.53,18.83,2019,72543
230,40,46,316,72.78,12.66,14.56,2019,72544
50,0,41,91,54.95,0.0,45.05,2019,72567
344,41,79,464,74.14,8.84,17.03,2019,72568
832,0,119,951,87.49,0.0,12.51,2019,72619
611,58,240,909,67.22,6.38,26.4,2019,72645
99,28,17,144,68.75,19.44,11.81,2019,72648
39,0,25,64,60.94,0.0,39.06,2019,72666
98,0,21,119,82.35,0.0,17.65,2019,72682
326,0,157,483,67.49,0.0,32.51,2019,72685
3343,741,435,4519,73.98,16.4,9.63,2019,72719
1196,276,518,1990,60.1,13.87,26.03,2019,72732
210,26,71,307,68.4,8.47,23.13,2019,72739
196,8,53,257,76.26,3.11,20.62,2019,72742
1920,224,502,2646,72.56,8.47,18.97,2019,72751
12692,1728,4252,18672,67.97,9.25,22.77,2019,72764
1023,21,335,1379,74.18,1.52,24.29,2019,72833
453,50,348,851,53.23,5.88,40.89,2019,72840
322,14,114,450,71.56,3.11,25.33,2019,72842
22,0,12,34,64.71,0.0,35.29,2019,72048
59,1,5,65,90.77,1.54,7.69,2019,72061
133,2,11,146,91.1,1.37,7.53,2019,72068
10980,372,3141,14493,75.76,2.57,21.67,2019,72076
599,39,167,805,74.41,4.84,20.75,2019,72082
5547,388,2691,8626,64.31,4.5,31.2,2019,72104
1358,48,516,1922,70.66,2.5,26.85,2019,72106
2335,195,1082,3612,64.65,5.4,29.96,2019,72112
1100,76,250,1426,77.14,5.33,17.53,2019,72011
11410,330,1862,13602,83.88,2.43,13.69,2019,72023
141,0,160,301,46.84,0.0,53.16,2019,72030
1851,171,894,2916,63.48,5.86,30.66,2019,72031
758,86,381,1225,61.88,7.02,31.1,2019,72040
3518,80,945,4543,77.44,1.76,20.8,2019,72103
25,2,18,45,55.56,4.44,40.0,2019,72107
183,0,146,329,55.62,0.0,44.38,2019,72001
1237,96,286,1619,76.41,5.93,17.67,2019,99009
782,17,5,804,97.26,2.11,0.62,2019,99011
437,11,238,686,63.7,1.6,34.69,2019,99013
74,0,24,98,75.51,0.0,24.49,2019,99018
4453,150,316,4919,90.53,3.05,6.42,2019,99019
267,20,27,314,85.03,6.37,8.6,2019,99033
16,0,0,16,100.0,0.0,0.0,2019,99034
564,36,44,644,87.58,5.59,6.83,2019,99036
4112,147,868,5127,80.2,2.87,16.93,2019,99114
249,4,66,319,78.06,1.25,20.69,2019,99118
103,0,35,138,74.64,0.0,25.36,2019,99124
294,18,63,375,78.4,4.8,16.8,2019,99126
285,30,54,369,77.24,8.13,14.63,2019,99130
589,16,208,813,72.45,1.97,25.58,2019,99133
521,16,105,642,81.15,2.49,16.36,2019,21623
64,0,0,64,100.0,0.0,0.0,2019,21930
156,0,71,227,68.72,0.0,31.28,2019,21864
201,0,0,201,100.0,0.0,0.0,2019,21865
312,4,125,441,70.75,0.91,28.34,2019,21869
540,6,208,754,71.62,0.8,27.59,2019,21874
6452,122,934,7508,85.94,1.62,12.44,2019,21231
121,0,7,128,94.53,0.0,5.47,2019,21156
12829,301,1687,14817,86.58,2.03,11.39,2019,21208
13063,2260,6753,22076,59.17,10.24,30.59,2019,21215
12966,307,2854,16127,80.4,1.9,17.7,2019,21221
13728,416,1394,15538,88.35,2.68,8.97,2019,21236
14728,333,1395,16456,89.5,2.02,8.48,2019,21401
4445,11,188,4644,95.71,0.24,4.05,2019,21774
3403,56,572,4031,84.42,1.39,14.19,2019,21787
8517,342,1868,10727,79.4,3.19,17.41,2019,21801
4370,162,652,5184,84.3,3.12,12.58,2019,21842
243,13,14,270,90.0,4.81,5.19,2019,21856
1073,31,71,1175,91.32,2.64,6.04,2019,21915
682,0,86,768,88.8,0.0,11.2,2019,21917
64,0,0,64,100.0,0.0,0.0,2019,21624
1661,116,574,2351,70.65,4.93,24.42,2019,21632
1779,84,147,2010,88.51,4.18,7.31,2019,21638
31,0,0,31,100.0,0.0,0.0,2019,21644
368,0,43,411,89.54,0.0,10.46,2019,21671
56,0,45,101,55.45,0.0,44.55,2019,21672
8954,232,1042,10228,87.54,2.27,10.19,2019,21811
1249,11,130,1390,89.86,0.79,9.35,2019,21849
2028,132,692,2852,71.11,4.63,24.26,2019,21851
15,0,0,15,100.0,0.0,0.0,2019,21862
2162,27,548,2737,78.99,0.99,20.02,2019,21875
508,59,271,838,60.62,7.04,32.34,2019,23883
645,70,287,1002,64.37,6.99,28.64,2019,23888
174,0,22,196,88.78,0.0,11.22,2019,23894
658,0,170,828,79.47,0.0,20.53,2019,23898
588,5,260,853,68.93,0.59,30.48,2019,23308
12402,335,945,13682,90.64,2.45,6.91,2019,23323
5647,62,688,6397,88.28,0.97,10.76,2019,23325
1057,70,384,1511,69.95,4.63,25.41,2019,23350
469,4,113,586,80.03,0.68,19.28,2019,23410
320,37,275,632,50.63,5.85,43.51,2019,23415
67,2,42,111,60.36,1.8,37.84,2019,23427
20,11,19,50,40.0,22.0,38.0,2019,23441
20314,329,1838,22481,90.36,1.46,8.18,2019,23452
1293,37,266,1596,81.02,2.32,16.67,2019,23457
164,8,47,219,74.89,3.65,21.46,2019,23651
8415,147,299,8861,94.97,1.66,3.37,2019,23693
1304,20,15,1339,97.39,1.49,1.12,2019,23801
212,13,128,353,60.06,3.68,36.26,2019,23004
108,0,106,214,50.47,0.0,49.53,2019,23440
16874,319,677,17870,94.43,1.79,3.79,2019,23456
281,0,10,291,96.56,0.0,3.44,2019,23459
8675,585,1422,10682,81.21,5.48,13.31,2019,23601
9228,1001,1127,11356,81.26,8.81,9.92,2019,23606
1133,33,195,1361,83.25,2.42,14.33,2019,23690
5433,347,1677,7457,72.86,4.65,22.49,2019,23704
6,0,0,6,100.0,0.0,0.0,2019,23708
105,42,93,240,43.75,17.5,38.75,2019,23844
244,0,108,352,69.32,0.0,30.68,2019,23846
73,0,16,89,82.02,0.0,17.98,2019,18437
1170,35,283,1488,78.63,2.35,19.02,2019,18326
9661,125,717,10503,91.98,1.19,6.83,2019,18045
98,0,8,106,92.45,0.0,7.55,2019,18221
1266,78,181,1525,83.02,5.11,11.87,2019,18334
2020,74,449,2543,79.43,2.91,17.66,2019,18072
2502,96,506,3104,80.61,3.09,16.3,2019,18106
1209,35,408,1652,73.18,2.12,24.7,2019,18232
3590,38,270,3898,92.1,0.97,6.93,2019,18073
267,0,127,394,67.77,0.0,32.23,2019,18241
3694,93,484,4271,86.49,2.18,11.33,2019,18353
1676,27,298,2001,83.76,1.35,14.89,2019,18421
43,0,12,55,78.18,0.0,21.82,2019,18816
3050,41,121,3212,94.96,1.28,3.77,2019,18954
0,0,0,0,,,,2019,18016
0,0,0,0,,,,2019,18046
0,0,0,0,,,,2019,18068
0,0,0,0,,,,2019,18105
5444,255,1050,6749,80.66,3.78,15.56,2019,18109
0,0,0,0,,,,2019,18195
3501,193,1026,4720,74.17,4.09,21.74,2019,18202
60,0,0,60,100.0,0.0,0.0,2019,18212
93,0,0,93,100.0,0.0,0.0,2019,18223
5237,256,521,6014,87.08,4.26,8.66,2019,18302
187,0,16,203,92.12,0.0,7.88,2019,18335
262,0,47,309,84.79,0.0,15.21,2019,18342
271,0,23,294,92.18,0.0,7.82,2019,18352
248,15,0,263,94.3,5.7,0.0,2019,18371
29,0,0,29,100.0,0.0,0.0,2019,18427
10,0,0,10,100.0,0.0,0.0,2019,18454
60,4,9,73,82.19,5.48,12.33,2019,18463
93,0,0,93,100.0,0.0,0.0,2019,18843
7432,46,257,7735,96.08,0.59,3.32,2019,18902
50,0,0,50,100.0,0.0,0.0,2019,18912
17,0,0,17,100.0,0.0,0.0,2019,18913
20,0,0,20,100.0,0.0,0.0,2019,18935
75,0,10,85,88.24,0.0,11.76,2019,18950
31,0,0,31,100.0,0.0,0.0,2019,18225
3057,104,498,3659,83.55,2.84,13.61,2019,18229
2177,9,190,2376,91.62,0.38,8.0,2019,18947
6726,64,555,7345,91.57,0.87,7.56,2019,18976
198,20,0,218,90.83,9.17,0.0,2019,18980
0,0,17,17,0.0,0.0,100.0,2019,18251
3226,53,246,3525,91.52,1.5,6.98,2019,18324
146,0,50,196,74.49,0.0,25.51,2019,18331
747,43,64,854,87.47,5.04,7.49,2019,18346
768,59,93,920,83.48,6.41,10.11,2019,18445
1039,14,254,1307,79.5,1.07,19.43,2019,18446
51,0,13,64,79.69,0.0,20.31,2019,18457
4733,101,642,5476,86.43,1.84,11.72,2019,18466
813,8,103,924,87.99,0.87,11.15,2019,18470
1848,60,248,2156,85.71,2.78,11.5,2019,18507
789,46,250,1085,72.72,4.24,23.04,2019,18614
657,13,89,759,86.56,1.71,11.73,2019,18615
14177,362,2068,16607,85.37,2.18,12.45,2019,21921
31,0,15,46,67.39,0.0,32.61,2019,21675
365,5,44,414,88.16,1.21,10.63,2019,21719
277,0,0,277,100.0,0.0,0.0,2019,21723
81,0,0,81,100.0,0.0,0.0,2019,21762
16964,288,852,18104,93.7,1.59,4.71,2019,22314
9405,128,777,10310,91.22,1.24,7.54,2019,22408
98,0,33,131,74.81,0.0,25.19,2019,22433
191,40,63,294,64.97,13.61,21.43,2019,22437
265,0,141,406,65.27,0.0,34.73,2019,22488
17477,120,551,18148,96.3,0.66,3.04,2019,22554
8317,674,1964,10955,75.92,6.15,17.93,2019,22601
123,0,12,135,91.11,0.0,8.89,2019,22931
118,0,49,167,70.66,0.0,29.34,2019,22943
61,0,23,84,72.62,0.0,27.38,2019,22948
5837,157,498,6492,89.91,2.42,7.67,2019,22963
39,27,42,108,36.11,25.0,38.89,2019,22972
12,0,0,12,100.0,0.0,0.0,2019,22711
71,0,48,119,59.66,0.0,40.34,2019,22722
2778,121,714,3613,76.89,3.35,19.76,2019,22815
72,10,35,117,61.54,8.55,29.91,2019,22820
385,54,244,683,56.37,7.91,35.72,2019,22830
327,62,60,449,72.83,13.81,13.36,2019,22832
3202,95,1179,4476,71.54,2.12,26.34,2019,22835
1506,51,458,2015,74.74,2.53,22.73,2019,22844
1446,102,506,2054,70.4,4.97,24.63,2019,22849
3617,74,285,3976,90.97,1.86,7.17,2019,22968
6617,53,254,6924,95.57,0.77,3.67,2019,22303
4008,106,287,4401,91.07,2.41,6.52,2019,22307
862,36,423,1321,65.25,2.73,32.02,2019,22427
449,16,112,577,77.82,2.77,19.41,2019,22460
1146,30,470,1646,69.62,1.82,28.55,2019,22503
4550,258,605,5413,84.06,4.77,11.18,2019,22508
984,12,276,1272,77.36,0.94,21.7,2019,22578
4235,403,1127,5765,73.46,6.99,19.55,2019,22603
9949,301,1730,11980,83.05,2.51,14.44,2019,22630
1210,76,321,1607,75.3,4.73,19.98,2019,22645
3188,186,922,4296,74.21,4.33,21.46,2019,22657
2802,93,831,3726,75.2,2.5,22.3,2019,22664
375,23,21,419,89.5,5.49,5.01,2019,22715
27,28,23,78,34.62,35.9,29.49,2019,22719
254,0,52,306,83.01,0.0,16.99,2019,22726
1777,16,621,2414,73.61,0.66,25.72,2019,22727
29,0,46,75,38.67,0.0,61.33,2019,22730
204,0,61,265,76.98,0.0,23.02,2019,22716
11,33,29,73,15.07,45.21,39.73,2019,22732
956,46,151,1153,82.91,3.99,13.1,2019,22734
211,0,69,280,75.36,0.0,24.64,2019,22810
1417,57,529,2003,70.74,2.85,26.41,2019,22821
273,0,82,355,76.9,0.0,23.1,2019,22850
1396,80,939,2415,57.81,3.31,38.88,2019,22851
13300,316,1587,15203,87.48,2.08,10.44,2019,22901
12423,995,1193,14611,85.02,6.81,8.17,2019,22903
14154,195,265,14614,96.85,1.33,1.81,2019,22015
12329,77,623,13029,94.63,0.59,4.78,2019,22031
11857,247,754,12858,92.21,1.92,5.86,2019,22042
11237,135,248,11620,96.7,1.16,2.13,2019,22079
9913,51,212,10176,97.42,0.5,2.08,2019,22153
10393,401,1465,12259,84.78,3.27,11.95,2019,22203
6354,58,295,6707,94.74,0.86,4.4,2019,22205
11306,86,521,11913,94.9,0.72,4.37,2019,22207
41,0,4,45,91.11,0.0,8.89,2019,22211
18143,377,1280,19800,91.63,1.9,6.46,2019,22407
3662,98,1002,4762,76.9,2.06,21.04,2019,25901
125,3,36,164,76.22,1.83,21.95,2019,99137
84,7,79,170,49.41,4.12,46.47,2019,99140
261,16,46,323,80.8,4.95,14.24,2019,99143
507,5,141,653,77.64,0.77,21.59,2019,99159
33,0,37,70,47.14,0.0,52.86,2019,99160
599,12,45,656,91.31,1.83,6.86,2019,99161
435,1,206,642,67.76,0.16,32.09,2019,99173
6139,347,1048,7534,81.48,4.61,13.91,2019,99202
5946,130,729,6805,87.38,1.91,10.71,2019,99217
77,2,23,102,75.49,1.96,22.55,2019,99335
236,1,58,295,80.0,0.34,19.66,2019,99341
33,2,9,44,75.0,4.55,20.45,2019,99345
532,6,17,555,95.86,1.08,3.06,2019,99360
6760,186,195,7141,94.66,2.6,2.73,2019,99516
11,0,12,23,47.83,0.0,52.17,2019,99548
30,11,24,65,46.15,16.92,36.92,2019,99553
23,2,0,25,92.0,8.0,0.0,2019,99565
5,3,13,21,23.81,14.29,61.9,2019,99583
720,38,142,900,80.0,4.22,15.78,2019,99685
1211,36,312,1559,77.68,2.31,20.01,2019,99686
8,3,10,21,38.1,14.29,47.62,2019,99733
18,3,4,25,72.0,12.0,16.0,2019,99756
80,4,32,116,68.97,3.45,27.59,2019,99763
39,0,19,58,67.24,0.0,32.76,2019,99773
12,2,34,48,25.0,4.17,70.83,2019,99781
79,2,53,134,58.96,1.49,39.55,2019,99820
7189,107,904,8200,87.67,1.3,11.02,2019,99705
34,6,21,61,55.74,9.84,34.43,2019,99721
10,3,41,54,18.52,5.56,75.93,2019,99722
48,0,19,67,71.64,0.0,28.36,2019,99739
88,1,63,152,57.89,0.66,41.45,2019,99742
32,5,15,52,61.54,9.62,28.85,2019,99759
75,3,15,93,80.65,3.23,16.13,2019,99761
39,6,29,74,52.7,8.11,39.19,2019,99765
0,0,16,16,0.0,0.0,100.0,2019,99767
73,4,8,85,85.88,4.71,9.41,2019,99771
2885,20,127,3032,95.15,0.66,4.19,2019,99005
234,0,0,234,100.0,0.0,0.0,2019,99023
322,84,147,553,58.23,15.19,26.58,2019,99119
115,0,29,144,79.86,0.0,20.14,2019,99128
1464,102,561,2127,68.83,4.8,26.38,2019,99141
90,3,20,113,79.65,2.65,17.7,2019,99149
173,24,38,235,73.62,10.21,16.17,2019,99153
2707,217,738,3662,73.92,5.93,20.15,2019,99156
417,2,89,508,82.09,0.39,17.52,2019,99171
124,2,83,209,59.33,0.96,39.71,2019,99581
680,24,108,812,83.74,2.96,13.3,2019,99610
55,13,53,121,45.45,10.74,43.8,2019,99634
342,5,89,436,78.44,1.15,20.41,2019,99639
31,0,21,52,59.62,0.0,40.38,2019,99640
80,7,48,135,59.26,5.19,35.56,2019,99641
3,0,5,8,37.5,0.0,62.5,2019,99656
58,9,22,89,65.17,10.11,24.72,2019,99659
89,7,23,119,74.79,5.88,19.33,2019,99660
88,12,41,141,62.41,8.51,29.08,2019,99680
68,2,40,110,61.82,1.82,36.36,2019,99682
22,2,11,35,62.86,5.71,31.43,2019,99690
48,0,15,63,76.19,0.0,23.81,2019,99692
107,1,16,124,86.29,0.81,12.9,2019,99693
1230,66,456,1752,70.21,3.77,26.03,2019,23927
119,0,50,169,70.41,0.0,29.59,2019,23934
1520,84,663,2267,67.05,3.71,29.25,2019,23936
959,63,398,1420,67.54,4.44,28.03,2019,23947
684,50,336,1070,63.93,4.67,31.4,2019,23958
875,52,685,1612,54.28,3.23,42.49,2019,23974
1983,11,368,2362,83.95,0.47,15.58,2019,23009
12760,248,1856,14864,85.84,1.67,12.49,2019,23228
11774,137,1061,12972,90.76,1.06,8.18,2019,23229
115,8,45,168,68.45,4.76,26.79,2019,23070
1343,75,489,1907,70.42,3.93,25.64,2019,23868
4194,210,1495,5899,71.1,3.56,25.34,2019,23901
10,0,24,34,29.41,0.0,70.59,2019,23976
503,45,81,629,79.97,7.15,12.88,2019,23921
56,5,79,140,40.0,3.57,56.43,2019,23876
617,13,224,854,72.25,1.52,26.23,2019,23882
209,21,100,330,63.33,6.36,30.3,2019,23889
1373,86,740,2199,62.44,3.91,33.65,2019,23930
13,0,0,13,100.0,0.0,0.0,2019,23943
748,46,508,1302,57.45,3.53,39.02,2019,23944
367,36,205,608,60.36,5.92,33.72,2019,23954
8931,415,1970,11316,78.92,3.67,17.41,2019,23513
5482,947,2306,8735,62.76,10.84,26.4,2019,23607
5560,82,290,5932,93.73,1.38,4.89,2019,23838
449,0,207,656,68.45,0.0,31.55,2019,23065
1168,10,218,1396,83.67,0.72,15.62,2019,23015
1260,112,649,2021,62.35,5.54,32.11,2019,23030
1070,13,549,1632,65.56,0.8,33.64,2019,23063
74,0,11,85,87.06,0.0,12.94,2019,23066
101,0,0,101,100.0,0.0,0.0,2019,23068
838,31,218,1087,77.09,2.85,20.06,2019,23069
2194,175,1093,3462,63.37,5.05,31.57,2019,27542
873,49,606,1528,57.13,3.21,39.66,2019,27831
566,85,614,1265,44.74,6.72,48.54,2019,27832
6,5,0,11,54.55,45.45,0.0,2019,27841
390,71,177,638,61.13,11.13,27.74,2019,27860
172,52,127,351,49.0,14.81,36.18,2019,27862
544,9,200,753,72.24,1.2,26.56,2019,27865
105,55,71,231,45.45,23.81,30.74,2019,27872
376,0,103,479,78.5,0.0,21.5,2019,27884
10501,569,4361,15431,68.05,3.69,28.26,2019,27893
250,25,53,328,76.22,7.62,16.16,2019,27915
1457,89,216,1762,82.69,5.05,12.26,2019,27921
510,5,250,765,66.67,0.65,32.68,2019,27829
1399,95,453,1947,71.85,4.88,23.27,2019,27830
532,160,350,1042,51.06,15.36,33.59,2019,27845
203,9,105,317,64.04,2.84,33.12,2019,27847
18639,1849,1938,22426,83.11,8.24,8.64,2019,27858
295,30,218,543,54.33,5.52,40.15,2019,27876
2070,64,780,2914,71.04,2.2,26.77,2019,27882
7782,287,3086,11155,69.76,2.57,27.66,2019,27889
299,6,16,321,93.15,1.87,4.98,2019,27923
4052,75,519,4646,87.21,1.61,11.17,2019,27040
6859,56,624,7539,90.98,0.74,8.28,2019,27591
1428,28,499,1955,73.04,1.43,25.52,2019,27544
600,125,149,874,68.65,14.3,17.05,2019,27562
916,0,283,1199,76.4,0.0,23.6,2019,27581
2150,287,759,3196,67.27,8.98,23.75,2019,27041
1377,38,209,1624,84.79,2.34,12.87,2019,27050
168,0,180,348,48.28,0.0,51.72,2019,21767
1700,25,209,1934,87.9,1.29,10.81,2019,21773
571,10,18,599,95.33,1.67,3.01,2019,21777
280,24,78,382,73.3,6.28,20.42,2019,21778
15502,822,2054,18378,84.35,4.47,11.18,2019,21228
82,0,11,93,88.17,0.0,11.83,2019,21522
115,7,7,129,89.15,5.43,5.43,2019,21010
3430,67,254,3751,91.44,1.79,6.77,2019,21090
3583,45,472,4100,87.39,1.1,11.51,2019,21102
6482,83,987,7552,85.83,1.1,13.07,2019,21078
5487,50,599,6136,89.42,0.81,9.76,2019,21085
20846,423,1528,22797,91.44,1.86,6.7,2019,21117
2459,12,60,2531,97.16,0.47,2.37,2019,21131
777,16,141,934,83.19,1.71,15.1,2019,21132
6674,209,765,7648,87.26,2.73,10.0,2019,21211
12888,610,4077,17575,73.33,3.47,23.2,2019,21229
11976,346,1124,13446,89.07,2.57,8.36,2019,21244
142,1,49,192,73.96,0.52,25.52,2019,21538
9464,178,170,9812,96.45,1.81,1.73,2019,21114
10327,172,1037,11536,89.52,1.49,8.99,2019,21133
896,0,207,1103,81.23,0.0,18.77,2019,21561
172,2,42,216,79.63,0.93,19.44,2019,21607
500,20,36,556,89.93,3.6,6.47,2019,21654
772,23,298,1093,70.63,2.1,27.26,2019,21661
81,0,17,98,82.65,0.0,17.35,2019,21669
8119,220,2745,11084,73.25,1.98,24.77,2019,21213
8743,761,4111,13615,64.22,5.59,30.19,2019,21217
2950,82,544,3576,82.49,2.29,15.21,2019,21219
13090,467,1674,15231,85.94,3.07,10.99,2019,21220
23528,1541,3256,28325,83.06,5.44,11.5,2019,21234
12137,632,3354,16123,75.28,3.92,20.8,2019,21502
1239,66,267,1572,78.82,4.2,16.98,2019,21660
850,31,125,1006,84.49,3.08,12.43,2019,21625
0,0,0,0,,,,2019,21627
818,16,207,1041,78.58,1.54,19.88,2019,21631
4356,201,330,4887,89.13,4.11,6.75,2019,21666
352,0,82,434,81.11,0.0,18.89,2019,21711
283,29,122,434,65.21,6.68,28.11,2019,21734
1796,29,27,1852,96.98,1.57,1.46,2019,21770
36,50,6,92,39.13,54.35,6.52,2019,21790
611,69,126,806,75.81,8.56,15.63,2019,21798
948,12,90,1050,90.29,1.14,8.57,2019,21813
1468,51,500,2019,72.71,2.53,24.76,2019,21817
273,17,129,419,65.16,4.06,30.79,2019,21821
31,5,11,47,65.96,10.64,23.4,2019,21824
513,8,230,751,68.31,1.07,30.63,2019,21838
406,14,67,487,83.37,2.87,13.76,2019,21841
148,0,26,174,85.06,0.0,14.94,2019,21872
5160,184,667,6011,85.84,3.06,11.1,2019,21901
627,12,200,839,74.73,1.43,23.84,2019,21871
299,16,25,340,87.94,4.71,7.35,2019,21779
85,0,19,104,81.73,0.0,18.27,2019,21920
0,0,0,0,,,,2019,21031
2288,16,146,2450,93.39,0.65,5.96,2019,21120
57,0,0,57,100.0,0.0,0.0,2019,23389
6910,10,277,7197,96.01,0.14,3.85,2019,23114
0,0,0,0,,,,2019,23160
0,0,0,0,,,,2019,23173
0,0,0,0,,,,2019,23187
900,40,172,1112,80.94,3.6,15.47,2019,28137
6299,266,1635,8200,76.82,3.24,19.94,2019,28139
13255,356,2732,16343,81.11,2.18,16.72,2019,28212
8644,85,1944,10673,80.99,0.8,18.21,2019,28217
18439,243,1361,20043,92.0,1.21,6.79,2019,28227
1456,18,506,1980,73.54,0.91,25.56,2019,28338
20270,331,1398,21999,92.14,1.5,6.35,2019,28078
7814,150,1270,9234,84.62,1.62,13.75,2019,28083
816,26,13,855,95.44,3.04,1.52,2019,28088
340,2,30,372,91.4,0.54,8.06,2019,28101
7890,87,1464,9441,83.57,0.92,15.51,2019,28112
834,21,112,967,86.25,2.17,11.58,2019,28133
7052,135,1627,8814,80.01,1.53,18.46,2019,28147
811,97,499,1407,57.64,6.89,35.47,2019,28160
5229,181,762,6172,84.72,2.93,12.35,2019,28164
614,105,169,888,69.14,11.82,19.03,2019,28617
1391,103,375,1869,74.42,5.51,20.06,2019,28636
480,11,278,769,62.42,1.43,36.15,2019,28637
2136,106,697,2939,72.68,3.61,23.72,2019,28651
3238,86,1162,4486,72.18,1.92,25.9,2019,28170
18224,412,1694,20330,89.64,2.03,8.33,2019,28210
14683,790,953,16426,89.39,4.81,5.8,2019,28262
3583,93,250,3926,91.26,2.37,6.37,2019,28204
10335,330,4106,14771,69.97,2.23,27.8,2019,28208
14863,347,901,16111,92.25,2.15,5.59,2019,28226
12322,556,1561,14439,85.34,3.85,10.81,2019,28304
13169,340,1965,15474,85.1,2.2,12.7,2019,28306
5212,170,1374,6756,77.15,2.52,20.34,2019,28327
6284,279,2829,9392,66.91,2.97,30.12,2019,28334
3119,63,1056,4238,73.6,1.49,24.92,2019,28337
341,6,199,546,62.45,1.1,36.45,2019,28343
326,23,118,467,69.81,4.93,25.27,2019,28363
7256,205,401,7862,92.29,2.61,5.1,2019,28374
12407,304,2148,14859,83.5,2.05,14.46,2019,28376
487,0,288,775,62.84,0.0,37.16,2019,28393
645,25,316,986,65.42,2.54,32.05,2019,28396
15368,358,1813,17539,87.62,2.04,10.34,2019,28412
762,72,320,1154,66.03,6.24,27.73,2019,28453
2671,83,213,2967,90.02,2.8,7.18,2019,28469
8393,216,1831,10440,80.39,2.07,17.54,2019,28658
114,0,0,114,100.0,0.0,0.0,2019,28662
171,0,18,189,90.48,0.0,9.52,2019,28668
1119,132,325,1576,71.0,8.38,20.62,2019,28676
1896,48,895,2839,66.78,1.69,31.53,2019,28705
2253,590,394,3237,69.6,18.23,12.17,2019,28723
194,5,216,415,46.75,1.2,52.05,2019,28740
566,63,241,870,65.06,7.24,27.7,2019,28743
11,0,47,58,18.97,0.0,81.03,2019,28749
34,9,0,43,79.07,20.93,0.0,2019,28757
2131,167,812,3110,68.52,5.37,26.11,2019,28761
1836,205,1180,3221,57.0,6.36,36.63,2019,28771
405,0,65,470,86.17,0.0,13.83,2019,28772
1130,28,138,1296,87.19,2.16,10.65,2019,28773
2653,138,456,3247,81.71,4.25,14.04,2019,28782
1607,172,635,2414,66.57,7.13,26.3,2019,28789
1069,42,198,1309,81.67,3.21,15.13,2019,28790
5843,179,718,6740,86.69,2.66,10.65,2019,28791
7854,241,792,8887,88.38,2.71,8.91,2019,28804
7768,219,1847,9834,78.99,2.23,18.78,2019,19150
10613,312,965,11890,89.26,2.62,8.12,2019,99709
870,9,152,1031,84.38,0.87,14.74,2019,99357
15838,375,2008,18221,86.92,2.06,11.02,2019,99205
5264,249,676,6189,85.05,4.02,10.92,2019,99218
337,3,128,468,72.01,0.64,27.35,2019,99348
35,4,55,94,37.23,4.26,58.51,2019,99359
6843,177,1318,8338,82.07,2.12,15.81,2019,99403
12809,402,585,13796,92.85,2.91,4.24,2019,99507
2781,41,214,3036,91.6,1.35,7.05,2019,99567
14,0,0,14,100.0,0.0,0.0,2019,99923
20334,789,2815,23938,84.94,3.3,11.76,2019,99301
1105,0,34,1139,97.01,0.0,2.99,2019,99505
10541,205,1458,12204,86.37,1.68,11.95,2019,99207
299,3,22,324,92.28,0.93,6.79,2019,99113
703,28,161,892,78.81,3.14,18.05,2019,99148
15000,1055,2760,18815,79.72,5.61,14.67,2019,99336
3939,63,278,4280,92.03,1.47,6.5,2019,99518
83,0,13,96,86.46,0.0,13.54,2019,99609
42,0,0,42,100.0,0.0,0.0,2019,99605
1030,61,241,1332,77.33,4.58,18.09,2019,99672
24,0,5,29,82.76,0.0,17.24,2019,99549
47,23,32,102,46.08,22.55,31.37,2019,99586
438,8,107,553,79.2,1.45,19.35,2019,99674
29,2,28,59,49.15,3.39,47.46,2019,99768
343,42,102,487,70.43,8.62,20.94,2019,99926
653,15,82,750,87.07,2.0,10.93,2019,99361
2,0,7,9,22.22,0.0,77.78,2019,99579
6,1,30,37,16.22,2.7,81.08,2019,99754
27,0,5,32,84.38,0.0,15.62,2019,99039
11,0,0,11,100.0,0.0,0.0,2019,99144
64,0,9,73,87.67,0.0,12.33,2019,99147
0,0,0,0,,,,2019,99164
20,2,2,24,83.33,8.33,8.33,2019,99174
14,3,0,17,82.35,17.65,0.0,2019,99333
8188,507,480,9175,89.24,5.53,5.23,2019,99354
0,0,0,0,,,,2019,99510
0,0,0,0,,,,2019,99519
1,0,2,3,33.33,0.0,66.67,2019,99706
0,0,0,0,,,,2019,99734
11,0,4,15,73.33,0.0,26.67,2019,99790
27,3,3,33,81.82,9.09,9.09,2019,99836
10704,481,1273,12458,85.92,3.86,10.22,2019,99508
196,0,5,201,97.51,0.0,2.49,2019,99540
776,34,206,1016,76.38,3.35,20.28,2019,99556
1899,22,301,2222,85.46,0.99,13.55,2019,99559
86,4,26,116,74.14,3.45,22.41,2019,04451
206,17,43,266,77.44,6.39,16.17,2019,04455
161,6,49,216,74.54,2.78,22.69,2019,04923
617,68,188,873,70.68,7.79,21.53,2019,04924
256,9,62,327,78.29,2.75,18.96,2019,04929
529,17,201,747,70.82,2.28,26.91,2019,04943
267,5,72,344,77.62,1.45,20.93,2019,04956
3279,191,800,4270,76.79,4.47,18.74,2019,04976
153,14,66,233,65.67,6.01,28.33,2019,04984
3032,46,259,3337,90.86,1.38,7.76,2019,04046
2634,45,210,2889,91.17,1.56,7.27,2019,04002
178,7,47,232,76.72,3.02,20.26,2019,04017
1800,72,210,2082,86.46,3.46,10.09,2019,04042
634,46,140,820,77.32,5.61,17.07,2019,04047
3319,59,1098,4476,74.15,1.32,24.53,2019,27052
9784,550,4329,14663,66.73,3.75,29.52,2019,27105
0,0,0,0,,,,2019,27109
308,0,284,592,52.03,0.0,47.97,2019,27242
3439,264,904,4607,74.65,5.73,19.62,2019,27249
6120,458,2371,8949,68.39,5.12,26.49,2019,27260
1057,12,360,1429,73.97,0.84,25.19,2019,27281
11635,415,3281,15331,75.89,2.71,21.4,2019,27295
259,24,86,369,70.19,6.5,23.31,2019,27314
2427,296,387,3110,78.04,9.52,12.44,2019,27357
360,0,133,493,73.02,0.0,26.98,2019,27508
4397,92,566,5055,86.98,1.82,11.2,2019,27522
14918,513,1344,16775,88.93,3.06,8.01,2019,27526
983,134,856,1973,49.82,6.79,43.39,2019,27563
1645,114,1083,2842,57.88,4.01,38.11,2019,27589
6044,68,661,6773,89.24,1.0,9.76,2019,27596
17336,653,1973,19962,86.85,3.27,9.88,2019,27705
21555,700,980,23235,92.77,3.01,4.22,2019,27713
58,0,75,133,43.61,0.0,56.39,2019,27821
339,63,244,646,52.48,9.75,37.77,2019,27824
982,12,227,1221,80.43,0.98,18.59,2019,27846
1551,37,769,2357,65.8,1.57,32.63,2019,27855
2049,268,85,2402,85.3,11.16,3.54,2019,27310
4556,209,487,5252,86.75,3.98,9.27,2019,27358
3366,74,479,3919,85.89,1.89,12.22,2019,27376
6090,645,927,7662,79.48,8.42,12.1,2019,27403
9960,659,1399,12018,82.88,5.48,11.64,2019,27455
6473,99,515,7087,91.34,1.4,7.27,2019,27510
1587,201,531,2319,68.43,8.67,22.9,2019,27521
5275,240,1121,6636,79.49,3.62,16.89,2019,27546
444,22,229,695,63.88,3.17,32.95,2019,27551
935,14,253,1202,77.79,1.16,21.05,2019,18076
2498,82,385,2965,84.25,2.77,12.98,2019,18078
96,0,38,134,71.64,0.0,28.36,2019,18081
270,0,22,292,92.47,0.0,7.53,2019,18087
1093,64,143,1300,84.08,4.92,11.0,2019,18092
7237,277,2540,10054,71.98,2.76,25.26,2019,18201
470,0,23,493,95.33,0.0,4.67,2019,18211
55,0,0,55,100.0,0.0,0.0,2019,18357
4073,108,697,4878,83.5,2.21,14.29,2019,18428
3798,104,805,4707,80.69,2.21,17.1,2019,18431
3645,58,803,4506,80.89,1.29,17.82,2019,18447
244,0,42,286,85.31,0.0,14.69,2019,18451
492,5,56,553,88.97,0.9,10.13,2019,18465
4017,107,1201,5325,75.44,2.01,22.55,2019,18508
1673,46,324,2043,81.89,2.25,15.86,2019,18519
82,2,15,99,82.83,2.02,15.15,2019,18602
101,5,10,116,87.07,4.31,8.62,2019,18441
4592,108,667,5367,85.56,2.01,12.43,2019,18444
1683,70,570,2323,72.45,3.01,24.54,2019,18452
1185,50,348,1583,74.86,3.16,21.98,2019,18472
6806,103,1990,8899,76.48,1.16,22.36,2019,18504
7123,222,1596,8941,79.67,2.48,17.85,2019,18505
4933,212,1041,6186,79.74,3.43,16.83,2019,18612
74,9,24,107,69.16,8.41,22.43,2019,18628
143,4,83,230,62.17,1.74,36.09,2019,18632
682,39,183,904,75.44,4.31,20.24,2019,18656
10833,241,2533,13607,79.61,1.77,18.62,2019,18704
2813,54,577,3444,81.68,1.57,16.75,2019,18801
9364,304,1177,10845,86.34,2.8,10.85,2019,23238
0,0,0,0,,,,2019,23250
40,0,58,98,40.82,0.0,59.18,2019,23313
17,0,8,25,68.0,0.0,32.0,2019,23398
49,0,0,49,100.0,0.0,0.0,2019,23408
95,0,0,95,100.0,0.0,0.0,2019,23414
34,0,19,53,64.15,0.0,35.85,2019,23422
11176,165,860,12201,91.6,1.35,7.05,2019,23453
0,0,0,0,,,,2019,23460
23,0,0,23,100.0,0.0,0.0,2019,23486
132,11,0,143,92.31,7.69,0.0,2019,23511
0,0,0,0,,,,2019,23551
0,0,0,0,,,,2019,23709
0,0,0,0,,,,2019,23806
0,0,0,0,,,,2019,23884
0,0,0,0,,,,2019,23891
0,0,0,0,,,,2019,23909
3749,302,318,4369,85.81,6.91,7.28,2019,23875
2151,146,1008,3305,65.08,4.42,30.5,2019,23970
20619,459,1697,22775,90.53,2.02,7.45,2019,23454
12065,467,996,13528,89.19,3.45,7.36,2019,23831
342,19,259,620,55.16,3.06,41.77,2019,23937
1005,153,650,1808,55.59,8.46,35.95,2019,23040
518,0,174,692,74.86,0.0,25.14,2019,23071
417,0,229,646,64.55,0.0,35.45,2019,23156
2929,53,1053,4035,72.59,1.31,26.1,2019,23002
19458,274,831,20563,94.63,1.33,4.04,2019,23322
3372,195,957,4524,74.54,4.31,21.15,2019,24084
205,0,13,218,94.04,0.0,5.96,2019,24185
4469,179,1395,6043,73.95,2.96,23.08,2019,24382
77,0,13,90,85.56,0.0,14.44,2019,24058
9177,325,3149,12651,72.54,2.57,24.89,2019,24112
2755,38,427,3220,85.56,1.18,13.26,2019,24175
213,19,82,314,67.83,6.05,26.11,2019,24280
89,7,7,103,86.41,6.8,6.8,2019,24413
165,29,52,246,67.07,11.79,21.14,2019,24474
1018,167,61,1246,81.7,13.4,4.9,2019,24083
141,9,88,238,59.24,3.78,36.97,2019,24916
353,0,66,419,84.25,0.0,15.75,2019,24578
1224,61,188,1473,83.1,4.14,12.76,2019,24637
35,0,14,49,71.43,0.0,28.57,2019,24843
310,13,153,476,65.13,2.73,32.14,2019,24460
859,51,303,1213,70.82,4.2,24.98,2019,24527
169,0,3,172,98.26,0.0,1.74,2019,25173
105,22,247,374,28.07,5.88,66.04,2019,25187
258,13,101,372,69.35,3.49,27.15,2019,25234
500,15,175,690,72.46,2.17,25.36,2019,25239
183,11,45,239,76.57,4.6,18.83,2019,25247
76,0,43,119,63.87,0.0,36.13,2019,25251
740,4,245,989,74.82,0.4,24.77,2019,25253
492,4,189,685,71.82,0.58,27.59,2019,25260
109,0,130,239,45.61,0.0,54.39,2019,25267
5541,105,491,6137,90.29,1.71,8.0,2019,25314
1309,20,233,1562,83.8,1.28,14.92,2019,25420
3837,238,1167,5242,73.2,4.54,22.26,2019,27944
307,62,122,491,62.53,12.63,24.85,2019,27946
350,0,26,376,93.09,0.0,6.91,2019,27953
170,0,7,177,96.05,0.0,3.95,2019,27956
298,17,168,483,61.7,3.52,34.78,2019,27957
5589,282,1000,6871,81.34,4.1,14.55,2019,19804
3662,118,618,4398,83.27,2.68,14.05,2019,19975
1032,0,218,1250,82.56,0.0,17.44,2019,19022
18878,264,1172,20314,92.93,1.3,5.77,2019,19067
10378,353,1912,12643,82.08,2.79,15.12,2019,19116
1188,18,225,1431,83.02,1.26,15.72,2019,19555
2872,124,532,3528,81.41,3.51,15.08,2019,19565
8467,243,2623,11333,74.71,2.14,23.14,2019,19601
7492,77,669,8238,90.94,0.93,8.12,2019,19608
544,41,78,663,82.05,6.18,11.76,2019,19706
18398,471,2930,21799,84.4,2.16,13.44,2019,19020
4175,117,715,5007,83.38,2.34,14.28,2019,19943
10914,386,2233,13533,80.65,2.85,16.5,2019,19115
17236,877,5332,23445,73.52,3.74,22.74,2019,19120
366,18,87,471,77.71,3.82,18.47,2019,19501
1741,163,175,2079,83.74,7.84,8.42,2019,19074
49,0,21,70,70.0,0.0,30.0,2019,19017
3401,132,191,3724,91.33,3.54,5.13,2019,19060
0,0,0,0,,,,2019,19109
0,0,0,0,,,,2019,19375
0,0,0,0,,,,2019,19383
0,0,0,0,,,,2019,19442
250,0,0,250,100.0,0.0,0.0,2019,19456
0,0,0,0,,,,2019,19477
5,0,0,5,100.0,0.0,0.0,2019,19535
16,0,7,23,69.57,0.0,30.43,2019,19538
25,0,0,25,100.0,0.0,0.0,2019,19542
61,0,0,61,100.0,0.0,0.0,2019,19564
0,0,0,0,,,,2019,19716
0,0,0,0,,,,2019,19717
0,9,0,9,0.0,100.0,0.0,2019,19735
70,0,55,125,56.0,0.0,44.0,2019,19936
669,20,153,842,79.45,2.38,18.17,2019,19951
2813,138,942,3893,72.26,3.54,24.2,2019,19952
1383,39,236,1658,83.41,2.35,14.23,2019,19953
9,0,6,15,60.0,0.0,40.0,2019,19955
4044,103,780,4927,82.08,2.09,15.83,2019,19968
1585,3,224,1812,87.47,0.17,12.36,2019,19547
104,10,29,143,72.73,6.99,20.28,2019,19559
1482,78,479,2039,72.68,3.83,23.49,2019,19567
2884,81,777,3742,77.07,2.16,20.76,2019,19611
26,0,0,26,100.0,0.0,0.0,2019,19736
13495,424,1233,15152,89.06,2.8,8.14,2019,19808
12279,203,1672,14154,86.75,1.43,11.81,2019,19901
322,3,39,364,88.46,0.82,10.71,2019,19944
4229,159,1305,5693,74.28,2.79,22.92,2019,19956
6455,160,1534,8149,79.21,1.96,18.82,2019,19963
228,28,95,351,64.96,7.98,27.07,2019,19964
3650,26,59,3735,97.72,0.7,1.58,2019,19317
16826,624,2731,20181,83.38,3.09,13.53,2019,19320
1615,54,237,1906,84.73,2.83,12.43,2019,19330
6271,341,882,7494,83.68,4.55,11.77,2019,19342
2518,38,69,2625,95.92,1.45,2.63,2019,19343
7258,388,1039,8685,83.57,4.47,11.96,2019,19348
10502,204,949,11655,90.11,1.75,8.14,2019,22309
112,6,22,140,80.0,4.29,15.71,2019,04050
1499,69,148,1716,87.35,4.02,8.62,2019,04055
6129,214,511,6854,89.42,3.12,7.46,2019,04062
7285,142,557,7984,91.24,1.78,6.98,2019,04074
6795,318,750,7863,86.42,4.04,9.54,2019,04102
11486,382,1118,12986,88.45,2.94,8.61,2019,04103
9715,375,919,11009,88.25,3.41,8.35,2019,04106
3440,66,208,3714,92.62,1.78,5.6,2019,04107
8558,397,1487,10442,81.96,3.8,14.24,2019,04210
226,3,79,308,73.38,0.97,25.65,2019,04221
91,2,18,111,81.98,1.8,16.22,2019,04231
1550,106,276,1932,80.23,5.49,14.29,2019,04281
294,4,60,358,82.12,1.12,16.76,2019,04292
511,12,104,627,81.5,1.91,16.59,2019,04352
519,12,89,620,83.71,1.94,14.35,2019,04354
193,22,10,225,85.78,9.78,4.44,2019,04421
630,38,145,813,77.49,4.67,17.84,2019,04430
9,0,0,9,100.0,0.0,0.0,2019,04442
450,14,42,506,88.93,2.77,8.3,2019,04450
1885,47,532,2464,76.5,1.91,21.59,2019,04462
894,64,309,1267,70.56,5.05,24.39,2019,04463
3333,124,462,3919,85.05,3.16,11.79,2019,04468
257,22,101,380,67.63,5.79,26.58,2019,04487
366,15,55,436,83.94,3.44,12.61,2019,04547
474,17,70,561,84.49,3.03,12.48,2019,04556
861,9,120,990,86.97,0.91,12.12,2019,04562
207,25,20,252,82.14,9.92,7.94,2019,04564
210,9,59,278,75.54,3.24,21.22,2019,04576
33,0,0,33,100.0,0.0,0.0,2019,04613
248,12,59,319,77.74,3.76,18.5,2019,04616
276,3,63,342,80.7,0.88,18.42,2019,04617
164,29,21,214,76.64,13.55,9.81,2019,04626
210,13,33,256,82.03,5.08,12.89,2019,04628
876,0,144,1020,85.88,0.0,14.12,2019,04640
122,18,23,163,74.85,11.04,14.11,2019,04657
411,5,73,489,84.05,1.02,14.93,2019,04664
340,24,98,462,73.59,5.19,21.21,2019,04676
3058,52,940,4050,75.51,1.28,23.21,2019,04730
145,16,64,225,64.44,7.11,28.44,2019,04762
209,6,90,305,68.52,1.97,29.51,2019,04763
174,26,100,300,58.0,8.67,33.33,2019,04773
190,0,19,209,90.91,0.0,9.09,2019,04853
1272,59,25,1356,93.81,4.35,1.84,2019,04856
562,18,174,754,74.54,2.39,23.08,2019,04920
1158,90,223,1471,78.72,6.12,15.16,2019,04927
6026,132,819,6977,86.37,1.89,11.74,2019,72022
888,104,439,1431,62.05,7.27,30.68,2019,72024
60,0,48,108,55.56,0.0,44.44,2019,72026
314,71,199,584,53.77,12.16,34.08,2019,72041
1022,56,538,1616,63.24,3.47,33.29,2019,72046
255,5,155,415,61.45,1.2,37.35,2019,72055
420,37,307,764,54.97,4.84,40.18,2019,72063
109,19,87,215,50.7,8.84,40.47,2019,72072
101,0,154,255,39.61,0.0,60.39,2019,72079
65,0,18,83,78.31,0.0,21.69,2019,72085
635,0,89,724,87.71,0.0,12.29,2019,72087
711,18,527,1256,56.61,1.43,41.96,2019,72101
11259,244,1292,12795,88.0,1.91,10.1,2019,72120
887,29,315,1231,72.06,2.36,25.59,2019,72121
496,10,87,593,83.64,1.69,14.67,2019,18824
5695,239,1465,7399,76.97,3.23,19.8,2019,18640
4579,22,750,5351,85.57,0.41,14.02,2019,18964
142,2,13,157,90.45,1.27,8.28,2019,18083
331,16,92,439,75.4,3.64,20.96,2019,18254
1691,34,335,2060,82.09,1.65,16.26,2019,18621
97,4,5,106,91.51,3.77,4.72,2019,18817
1201,32,170,1403,85.6,2.28,12.12,2019,18834
9423,288,838,10549,89.33,2.73,7.94,2019,18901
1916,16,116,2048,93.55,0.78,5.66,2019,18011
2602,36,400,3038,85.65,1.18,13.17,2019,18037
939,38,206,1183,79.37,3.21,17.41,2019,18038
11861,331,2811,15003,79.06,2.21,18.74,2019,18042
6451,163,748,7362,87.63,2.21,10.16,2019,18049
8898,331,1831,11060,80.45,2.99,16.56,2019,18015
3438,164,851,4453,77.21,3.68,19.11,2019,18014
10968,358,1907,13233,82.88,2.71,14.41,2019,18018
6691,207,665,7563,88.47,2.74,8.79,2019,18020
3219,71,483,3773,85.32,1.88,12.8,2019,18032
1288,32,74,1394,92.4,2.3,5.31,2019,18051
325,0,97,422,77.01,0.0,22.99,2019,18056
246,0,25,271,90.77,0.0,9.23,2019,18086
2716,79,465,3260,83.31,2.42,14.26,2019,18088
12058,721,3437,16216,74.36,4.45,21.2,2019,18102
1882,52,693,2627,71.64,1.98,26.38,2019,18224
60,0,21,81,74.07,0.0,25.93,2019,18242
98,0,54,152,64.47,0.0,35.53,2019,18245
1301,49,117,1467,88.68,3.34,7.98,2019,18249
972,64,183,1219,79.74,5.25,15.01,2019,18250
746,12,42,800,93.25,1.5,5.25,2019,18325
3,0,0,3,100.0,0.0,0.0,2019,18430
2075,4,335,2414,85.96,0.17,13.88,2019,21904
198,1,57,256,77.34,0.39,22.27,2019,21542
108,0,10,118,91.53,0.0,8.47,2019,21543
981,34,345,1360,72.13,2.5,25.37,2019,21562
238,6,72,316,75.32,1.9,22.78,2019,21622
1394,14,283,1691,82.44,0.83,16.74,2019,21639
207,10,3,220,94.09,4.55,1.36,2019,21662
183,0,14,197,92.89,0.0,7.11,2019,21677
134,0,0,134,100.0,0.0,0.0,2019,21679
30,0,0,30,100.0,0.0,0.0,2019,21717
306,0,50,356,85.96,0.0,14.04,2019,21733
3893,37,200,4130,94.26,0.9,4.84,2019,21769
1816,24,180,2020,89.9,1.19,8.91,2019,21755
3947,100,680,4727,83.5,2.12,14.39,2019,21788
1496,103,385,1984,75.4,5.19,19.41,2019,21791
98,0,14,112,87.5,0.0,12.5,2019,21814
1661,0,305,1966,84.49,0.0,15.51,2019,21826
822,62,226,1110,74.05,5.59,20.36,2019,21837
9183,151,623,9957,92.23,1.52,6.26,2019,21771
1510,12,237,1759,85.84,0.68,13.47,2019,21782
12360,233,806,13399,92.25,1.74,6.02,2019,21784
3218,110,429,3757,85.65,2.93,11.42,2019,21793
103,0,98,201,51.24,0.0,48.76,2019,21829
130,0,27,157,82.8,0.0,17.2,2019,21835
153,0,19,172,88.95,0.0,11.05,2019,21840
861,39,147,1047,82.23,3.72,14.04,2019,21850
2966,193,621,3780,78.47,5.11,16.43,2019,21853
23,0,0,23,100.0,0.0,0.0,2019,21867
289,0,35,324,89.2,0.0,10.8,2019,27964
77,4,0,81,95.06,4.94,0.0,2019,27968
618,0,304,922,67.03,0.0,32.97,2019,27980
572,7,104,683,83.75,1.02,15.23,2019,27981
1990,98,1199,3287,60.54,2.98,36.48,2019,27983
7992,187,510,8689,91.98,2.15,5.87,2019,27607
22009,1179,2687,25875,85.06,4.56,10.38,2019,27610
12417,474,2410,15301,81.15,3.1,15.75,2019,27704
7636,104,587,8327,91.7,1.25,7.05,2019,27712
5809,112,1740,7661,75.83,1.46,22.71,2019,27803
9604,237,1982,11823,81.23,2.0,16.76,2019,27804
1542,39,473,2054,75.07,1.9,23.03,2019,27851
290,31,139,460,63.04,6.74,30.22,2019,27857
3946,66,653,4665,84.59,1.41,14.0,2019,27863
57,0,167,224,25.45,0.0,74.55,2019,27875
1110,51,152,1313,84.54,3.88,11.58,2019,27880
305,0,61,366,83.33,0.0,16.67,2019,27916
360,0,84,444,81.08,0.0,18.92,2019,27919
536,32,28,596,89.93,5.37,4.7,2019,27920
460,44,205,709,64.88,6.21,28.91,2019,27897
3024,146,1368,4538,66.64,3.22,30.15,2019,27910
132,28,58,218,60.55,12.84,26.61,2019,27917
3164,19,146,3329,95.04,0.57,4.39,2019,27949
274,0,78,352,77.84,0.0,22.16,2019,27966
13,0,11,24,54.17,0.0,45.83,2019,27982
326,32,136,494,65.99,6.48,27.53,2019,27986
648,8,58,714,90.76,1.12,8.12,2019,27507
8662,970,333,9965,86.92,9.73,3.34,2019,27514
1241,50,242,1533,80.95,3.26,15.79,2019,27541
2495,65,395,2955,84.43,2.2,13.37,2019,27572
7350,115,1480,8945,82.17,1.29,16.55,2019,27597
3138,355,634,4127,76.04,8.6,15.36,2019,27601
18364,501,1971,20836,88.14,2.4,9.46,2019,27703
1037,56,556,1649,62.89,3.4,33.72,2019,27805
771,17,137,925,83.35,1.84,14.81,2019,27808
2950,50,616,3616,81.58,1.38,17.04,2019,27828
5265,82,462,5809,90.64,1.41,7.95,2019,27006
2429,35,686,3150,77.11,1.11,21.78,2019,27018
1657,103,337,2097,79.02,4.91,16.07,2019,27299
7087,594,1257,8938,79.29,6.65,14.06,2019,27312
10544,795,4695,16034,65.76,4.96,29.28,2019,27320
4569,73,277,4919,92.88,1.48,5.63,2019,27608
16664,543,1050,18257,91.27,2.97,5.75,2019,27612
16454,323,411,17188,95.73,1.88,2.39,2019,27613
17316,570,2431,20317,85.23,2.81,11.97,2019,27707
5147,304,2516,7967,64.6,3.82,31.58,2019,27801
1376,166,1575,3117,44.15,5.33,50.53,2019,27823
102,16,51,169,60.36,9.47,30.18,2019,27840
805,24,353,1182,68.1,2.03,29.86,2019,27852
1328,29,586,1943,68.35,1.49,30.16,2019,27864
5408,301,2605,8314,65.05,3.62,31.33,2019,27886
1330,28,606,1964,67.72,1.43,30.86,2019,27891
7354,159,809,8322,88.37,1.91,9.72,2019,27896
428,0,78,506,84.58,0.0,15.42,2019,28009
525,0,232,757,69.35,0.0,30.65,2019,18617
1092,36,376,1504,72.61,2.39,25.0,2019,18635
2435,63,404,2902,83.91,2.17,13.92,2019,18641
1222,20,349,1591,76.81,1.26,21.94,2019,18344
195,0,30,225,86.67,0.0,13.33,2019,18351
125,0,98,223,56.05,0.0,43.95,2019,25928
303,8,95,406,74.63,1.97,23.4,2019,25971
31,31,0,62,50.0,50.0,0.0,2019,25977
117,0,136,253,46.25,0.0,53.75,2019,25981
242,0,89,331,73.11,0.0,26.89,2019,25118
216,10,50,276,78.26,3.62,18.12,2019,25086
204,9,44,257,79.38,3.5,17.12,2019,25111
92,0,44,136,67.65,0.0,32.35,2019,25114
140,0,30,170,82.35,0.0,17.65,2019,25148
38,12,42,92,41.3,13.04,45.65,2019,25149
264,0,10,274,96.35,0.0,3.65,2019,25154
42,0,21,63,66.67,0.0,33.33,2019,25160
762,55,257,1074,70.95,5.12,23.93,2019,25168
266,0,144,410,64.88,0.0,35.12,2019,25181
359,17,58,434,82.72,3.92,13.36,2019,25186
45,0,128,173,26.01,0.0,73.99,2019,25205
40,0,0,40,100.0,0.0,0.0,2019,25211
1054,79,428,1561,67.52,5.06,27.42,2019,25301
2925,65,507,3497,83.64,1.86,14.5,2019,25304
4777,378,1010,6165,77.49,6.13,16.38,2019,25401
76,0,11,87,87.36,0.0,12.64,2019,25444
272,58,182,512,53.12,11.33,35.55,2019,25503
1556,11,325,1892,82.24,0.58,17.18,2019,25510
143,7,193,343,41.69,2.04,56.27,2019,25511
294,0,137,431,68.21,0.0,31.79,2019,25547
338,15,66,419,80.67,3.58,15.75,2019,25646
1896,37,548,2481,76.42,1.49,22.09,2019,25661
71,0,99,170,41.76,0.0,58.24,2019,25672
10757,340,2688,13785,78.03,2.47,19.5,2019,25801
669,27,166,862,77.61,3.13,19.26,2019,25825
153,0,48,201,76.12,0.0,23.88,2019,25839
14,0,0,14,100.0,0.0,0.0,2019,25853
2627,83,346,3056,85.96,2.72,11.32,2019,25560
1264,244,787,2295,55.08,10.63,34.29,2019,25570
671,0,242,913,73.49,0.0,26.51,2019,25571
579,10,55,644,89.91,1.55,8.54,2019,25635
157,0,46,203,77.34,0.0,22.66,2019,25639
8,0,33,41,19.51,0.0,80.49,2019,25699
1513,148,467,2128,71.1,6.95,21.95,2019,25703
468,21,150,639,73.24,3.29,23.47,2019,25812
298,35,42,375,79.47,9.33,11.2,2019,25125
467,15,239,721,64.77,2.08,33.15,2019,25136
100,0,33,133,75.19,0.0,24.81,2019,25139
1478,31,503,2012,73.46,1.54,25.0,2019,25159
13,0,0,13,100.0,0.0,0.0,2019,25870
63,0,17,80,78.75,0.0,21.25,2019,25902
30,12,30,72,41.67,16.67,41.67,2019,25916
3890,226,920,5036,77.24,4.49,18.27,2019,25313
2437,94,226,2757,88.39,3.41,8.2,2019,25443
4204,93,1009,5306,79.23,1.75,19.02,2019,25504
48,11,34,93,51.61,11.83,36.56,2019,25505
1549,61,520,2130,72.72,2.86,24.41,2019,25506
283,47,288,618,45.79,7.61,46.6,2019,25517
37,0,58,95,38.95,0.0,61.05,2019,25972
724,56,326,1106,65.46,5.06,29.48,2019,25976
87,0,52,139,62.59,0.0,37.41,2019,25152
114,11,65,190,60.0,5.79,34.21,2019,25244
551,0,164,715,77.06,0.0,22.94,2019,25275
2224,86,402,2712,82.01,3.17,14.82,2019,28127
151,13,68,232,65.09,5.6,29.31,2019,72122
73,2,47,122,59.84,1.64,38.52,2019,72139
52,15,134,201,25.87,7.46,66.67,2019,72152
123,10,100,233,52.79,4.29,42.92,2019,72156
35,0,18,53,66.04,0.0,33.96,2019,72165
2496,33,630,3159,79.01,1.04,19.94,2019,72173
4374,147,202,4723,92.61,3.11,4.28,2019,72212
10,0,0,10,100.0,0.0,0.0,2019,72320
19,0,0,19,100.0,0.0,0.0,2019,72328
3933,59,1602,5594,70.31,1.05,28.64,2019,72830
1483,97,321,1901,78.01,5.1,16.89,2019,72631
808,70,139,1017,79.45,6.88,13.67,2019,72642
71,0,28,99,71.72,0.0,28.28,2019,72729
230,67,165,462,49.78,14.5,35.71,2019,72769
393,30,360,783,50.19,3.83,45.98,2019,72821
222,12,167,401,55.36,2.99,41.65,2019,72832
276,0,73,349,79.08,0.0,20.92,2019,72835
145,8,185,338,42.9,2.37,54.73,2019,72854
940,20,308,1268,74.13,1.58,24.29,2019,72944
1072,88,413,1573,68.15,5.59,26.26,2019,72947
1050,61,436,1547,67.87,3.94,28.18,2019,72461
495,59,227,781,63.38,7.55,29.07,2019,72434
83,19,79,181,45.86,10.5,43.65,2019,72435
498,44,207,749,66.49,5.87,27.64,2019,72444
390,0,81,471,82.8,0.0,17.2,2019,72111
179,9,89,277,64.62,3.25,32.13,2019,72125
226,0,49,275,82.18,0.0,17.82,2019,72130
198,16,54,268,73.88,5.97,20.15,2019,72141
6471,1109,2411,9991,64.77,11.1,24.13,2019,72501
531,128,307,966,54.97,13.25,31.78,2019,72513
1193,232,675,2100,56.81,11.05,32.14,2019,72521
99,0,0,99,100.0,0.0,0.0,2019,72527
378,89,168,635,59.53,14.02,26.46,2019,72419
55,1,18,74,74.32,1.35,24.32,2019,72426
1115,46,261,1422,78.41,3.23,18.35,2019,72437
23,32,11,66,34.85,48.48,16.67,2019,72555
433,67,273,773,56.02,8.67,35.32,2019,72583
7,9,10,26,26.92,34.62,38.46,2019,72587
253,37,85,375,67.47,9.87,22.67,2019,72623
93,19,93,205,45.37,9.27,45.37,2019,72394
362,2,110,474,76.37,0.42,23.21,2019,72415
94,8,44,146,64.38,5.48,30.14,2019,72431
1985,59,514,2558,77.6,2.31,20.09,2019,72432
302,49,33,384,78.65,12.76,8.59,2019,72436
13,0,7,20,65.0,0.0,35.0,2019,72445
11851,397,1269,13517,87.67,2.94,9.39,2019,99223
232,52,36,320,72.5,16.25,11.25,2019,99330
9855,316,1089,11260,87.52,2.81,9.67,2019,99337
1829,41,346,2216,82.54,1.85,15.61,2019,99349
11483,640,754,12877,89.17,4.97,5.86,2019,99352
38,2,41,81,46.91,2.47,50.62,2019,99777
1434,16,156,1606,89.29,1.0,9.71,2019,99001
29,1,22,52,55.77,1.92,42.31,2019,99017
3290,96,323,3709,88.7,2.59,8.71,2019,99021
398,24,250,672,59.23,3.57,37.2,2019,99110
1266,48,375,1689,74.96,2.84,22.2,2019,99111
351,10,31,392,89.54,2.55,7.91,2019,99123
100,2,11,113,88.5,1.77,9.73,2019,99135
3,5,13,21,14.29,23.81,61.9,2019,99146
3339,115,474,3928,85.01,2.93,12.07,2019,21911
266,5,115,386,68.91,1.3,29.79,2019,21913
283,16,58,357,79.27,4.48,16.25,2019,21914
984,66,134,1184,83.11,5.57,11.32,2019,21919
6974,345,1173,8492,82.12,4.06,13.81,2019,21040
13381,167,514,14062,95.16,1.19,3.66,2019,21042
107,0,0,107,100.0,0.0,0.0,2019,21051
3809,87,289,4185,91.02,2.08,6.91,2019,21054
17834,575,2539,20948,85.13,2.74,12.12,2019,21061
1721,27,156,1904,90.39,1.42,8.19,2019,21087
1105,19,174,1298,85.13,1.46,13.41,2019,21034
4001,64,295,4360,91.77,1.47,6.77,2019,21047
5991,42,454,6487,92.35,0.65,7.0,2019,21050
13,0,32,45,28.89,0.0,71.11,2019,21626
127,0,51,178,71.35,0.0,28.65,2019,21628
578,31,188,797,72.52,3.89,23.59,2019,21678
12533,219,843,13595,92.19,1.61,6.2,2019,21703
17539,728,4626,22893,76.61,3.18,20.21,2019,21740
2207,50,121,2378,92.81,2.1,5.09,2019,21754
793,52,242,1087,72.95,4.78,22.26,2019,21757
1727,46,197,1970,87.66,2.34,10.0,2019,21776
476,5,90,571,83.36,0.88,15.76,2019,21780
2703,85,384,3172,85.21,2.68,12.11,2019,21783
752,55,0,807,93.18,6.82,0.0,2019,21794
3010,93,625,3728,80.74,2.49,16.77,2019,21795
2726,76,138,2940,92.72,2.59,4.69,2019,21797
12310,675,2270,15255,80.69,4.42,14.88,2019,21804
237,0,0,237,100.0,0.0,0.0,2019,21810
1304,68,415,1787,72.97,3.81,23.22,2019,21863
1825,119,353,2297,79.45,5.18,15.37,2019,21903
298,0,125,423,70.45,0.0,29.55,2019,21912
1036,5,146,1187,87.28,0.42,12.3,2019,23102
182,88,143,413,44.07,21.31,34.62,2019,23106
18537,277,722,19536,94.89,1.42,3.7,2019,23112
448,12,51,511,87.67,2.35,9.98,2019,23153
32,0,32,64,50.0,0.0,50.0,2019,23161
51,0,0,51,100.0,0.0,0.0,2019,18356
4493,119,1145,5757,78.04,2.07,19.89,2019,18407
17,0,0,17,100.0,0.0,0.0,2019,18420
478,19,51,548,87.23,3.47,9.31,2019,18425
2155,67,395,2617,82.35,2.56,15.09,2019,18433
7569,168,1615,9352,80.93,1.8,17.27,2019,18360
1009,13,22,1044,96.65,1.25,2.11,2019,18372
2267,32,499,2798,81.02,1.14,17.83,2019,18403
106,0,0,106,100.0,0.0,0.0,2019,18413
770,65,171,1006,76.54,6.46,17.0,2019,18218
74,0,49,123,60.16,0.0,39.84,2019,18220
1217,41,447,1705,71.38,2.4,26.22,2019,18101
486,0,72,558,87.1,0.0,12.9,2019,18321
235,10,30,275,85.45,3.64,10.91,2019,18327
2737,153,259,3149,86.92,4.86,8.22,2019,18034
1536,22,108,1666,92.2,1.32,6.48,2019,18054
319,5,76,400,79.75,1.25,19.0,2019,18846
2852,72,781,3705,76.98,1.94,21.08,2019,18848
1465,12,224,1701,86.13,0.71,13.17,2019,18853
356,0,5,361,98.61,0.0,1.39,2019,18923
990,28,159,1177,84.11,2.38,13.51,2019,18930
11543,187,1675,13405,86.11,1.4,12.5,2019,18951
258,11,17,286,90.21,3.85,5.94,2019,18970
621,3,72,696,89.22,0.43,10.34,2019,18812
51,4,37,92,55.43,4.35,40.22,2019,18823
966,33,214,1213,79.64,2.72,17.64,2019,18837
643,9,96,748,85.96,1.2,12.83,2019,18844
2238,23,79,2340,95.64,0.98,3.38,2019,18925
162,0,18,180,90.0,0.0,10.0,2019,18932
489,31,83,603,81.09,5.14,13.76,2019,18955
1394,21,172,1587,87.84,1.32,10.84,2019,18972
1569,16,31,1616,97.09,0.99,1.92,2019,18977
2757,141,494,3392,81.28,4.16,14.56,2019,18058
9228,223,786,10237,90.14,2.18,7.68,2019,18062
158,0,65,223,70.85,0.0,29.15,2019,18063
829,24,94,947,87.54,2.53,9.93,2019,18077
556,0,102,658,84.5,0.0,15.5,2019,18219
3265,9,373,3647,89.53,0.25,10.23,2019,18222
6283,98,1428,7809,80.46,1.25,18.29,2019,18235
102,0,114,216,47.22,0.0,52.78,2019,18239
78,0,16,94,82.98,0.0,17.02,2019,18246
3535,80,1142,4757,74.31,1.68,24.01,2019,18252
123,0,33,156,78.85,0.0,21.15,2019,18256
1329,30,328,1687,78.78,1.78,19.44,2019,18336
1190,0,133,1323,89.95,0.0,10.05,2019,18347
319,0,21,340,93.82,0.0,6.18,2019,18354
137,8,54,199,68.84,4.02,27.14,2019,18231
78,0,17,95,82.11,0.0,17.89,2019,18234
1248,105,257,1610,77.52,6.52,15.96,2019,18240
1367,22,336,1725,79.25,1.28,19.48,2019,18255
8032,206,1456,9694,82.86,2.13,15.02,2019,18301
755,9,50,814,92.75,1.11,6.14,2019,18332
1310,28,277,1615,81.11,1.73,17.15,2019,18343
150,3,35,188,79.79,1.6,18.62,2019,18439
137,14,34,185,74.05,7.57,18.38,2019,21610
344,34,85,463,74.3,7.34,18.36,2019,21645
12587,241,1349,14177,88.78,1.7,9.52,2019,21014
2522,0,131,2653,95.06,0.0,4.94,2019,21035
65,0,11,76,85.53,0.0,14.47,2019,21052
0,0,0,0,,,,2019,19345
856,11,12,879,97.38,1.25,1.37,2019,19373
19141,169,1339,20649,92.7,0.82,6.48,2019,19380
2134,32,202,2368,90.12,1.35,8.53,2019,19405
7318,151,601,8070,90.68,1.87,7.45,2019,19428
249,74,84,407,61.18,18.18,20.64,2019,19436
3626,88,542,4256,85.2,2.07,12.73,2019,19475
72,9,163,244,29.51,3.69,66.8,2019,19492
6411,178,680,7269,88.2,2.45,9.35,2019,19008
3294,51,508,3853,85.49,1.32,13.18,2019,19021
7811,124,568,8503,91.86,1.46,6.68,2019,19027
1253,4,165,1422,88.12,0.28,11.6,2019,19029
1479,47,132,1658,89.2,2.83,7.96,2019,19031
9167,364,1643,11174,82.04,3.26,14.7,2019,19050
5245,68,914,6227,84.23,1.09,14.68,2019,19057
11825,146,882,12853,92.0,1.14,6.86,2019,19083
1796,21,7,1824,98.46,1.15,0.38,2019,19085
1432,0,175,1607,89.11,0.0,10.89,2019,19094
4224,138,546,4908,86.06,2.81,11.12,2019,19055
4752,160,596,5508,86.27,2.9,10.82,2019,19056
3842,72,662,4576,83.96,1.57,14.47,2019,19078
6357,114,578,7049,90.18,1.62,8.2,2019,19090
5601,104,503,6208,90.22,1.68,8.1,2019,19001
3604,48,249,3901,92.39,1.23,6.38,2019,19004
6628,290,1294,8212,80.71,3.53,15.76,2019,19007
206,16,17,239,86.19,6.69,7.11,2019,19009
8931,339,2946,12216,73.11,2.78,24.12,2019,19013
5819,402,1146,7367,78.99,5.46,15.56,2019,19023
2055,40,250,2345,87.63,1.71,10.66,2019,19032
4489,70,768,5327,84.27,1.31,14.42,2019,19036
6190,46,472,6708,92.28,0.69,7.04,2019,19044
5287,147,519,5953,88.81,2.47,8.72,2019,19054
2563,91,212,2866,89.43,3.18,7.4,2019,19070
3803,32,241,4076,93.3,0.79,5.91,2019,19072
7243,114,661,8018,90.33,1.42,8.24,2019,19073
11284,136,423,11843,95.28,1.15,3.57,2019,19087
20090,506,3655,24251,82.84,2.09,15.07,2019,19111
6589,417,1015,8021,82.15,5.2,12.65,2019,19123
6276,680,2873,9829,63.85,6.92,29.23,2019,19142
16325,2403,6374,25102,65.03,9.57,25.39,2019,19143
15327,864,3070,19261,79.58,4.49,15.94,2019,19148
14999,682,3165,18846,79.59,3.62,16.79,2019,19149
8897,550,2333,11780,75.53,4.67,19.8,2019,19151
11548,887,2421,14856,77.73,5.97,16.3,2019,19805
3448,100,348,3896,88.5,2.57,8.93,2019,19970
7838,66,720,8624,90.89,0.77,8.35,2019,19977
10203,114,681,10998,92.77,1.04,6.19,2019,19406
5143,11,127,5281,97.39,0.21,2.4,2019,19425
2103,45,167,2315,90.84,1.94,7.21,2019,19520
126,0,14,140,90.0,0.0,10.0,2019,19523
1459,1,238,1698,85.92,0.06,14.02,2019,19541
42,0,3,45,93.33,0.0,6.67,2019,19544
100,14,20,134,74.63,10.45,14.93,2019,19549
95,0,23,118,80.51,0.0,19.49,2019,19550
757,27,276,1060,71.42,2.55,26.04,2019,19941
3778,83,349,4210,89.74,1.97,8.29,2019,19734
4041,677,1675,6393,63.21,10.59,26.2,2019,19801
7713,216,613,8542,90.3,2.53,7.18,2019,19803
158,0,8,166,95.18,0.0,4.82,2019,22448
114,0,32,146,78.08,0.0,21.92,2019,99150
14,0,35,49,28.57,0.0,71.43,2019,99151
172,13,39,224,76.79,5.8,17.41,2019,99158
185,4,62,251,73.71,1.59,24.7,2019,99167
301,14,151,466,64.59,3.0,32.4,2019,99180
529,28,155,712,74.3,3.93,21.77,2019,99181
3092,92,298,3482,88.8,2.64,8.56,2019,99204
13560,167,1647,15374,88.2,1.09,10.71,2019,99206
19030,451,1913,21394,88.95,2.11,8.94,2019,95355
95,0,32,127,74.8,0.0,25.2,2019,95450
465,0,70,535,86.92,0.0,13.08,2019,95589
1273,52,418,1743,73.03,2.98,23.98,2019,98851
85,0,31,116,73.28,0.0,26.72,2019,98860
790,59,212,1061,74.46,5.56,19.98,2019,98935
1828,31,122,1981,92.28,1.56,6.16,2019,98936
1356,23,279,1658,81.79,1.39,16.83,2019,98937
325,28,40,393,82.7,7.12,10.18,2019,98943
745,42,180,967,77.04,4.34,18.61,2019,98947
11490,376,1609,13475,85.27,2.79,11.94,2019,98002
8557,137,584,9278,92.23,1.48,6.29,2019,98008
2456,30,170,2656,92.47,1.13,6.4,2019,98014
8002,150,450,8602,93.02,1.74,5.23,2019,98020
15734,334,618,16686,94.29,2.0,3.7,2019,98042
1964,79,273,2316,84.8,3.41,11.79,2019,98047
21280,742,900,22922,92.84,3.24,3.93,2019,98115
774,21,159,954,81.13,2.2,16.67,2019,98295
15,0,10,25,60.0,0.0,40.0,2019,98297
581,0,47,628,92.52,0.0,7.48,2019,98303
7866,160,955,8981,87.58,1.78,10.63,2019,98310
554,13,17,584,94.86,2.23,2.91,2019,98342
129,0,11,140,92.14,0.0,7.86,2019,98381
11930,248,1383,13561,87.97,1.83,10.2,2019,98382
492,49,19,560,87.86,8.75,3.39,2019,98394
8281,391,1081,9753,84.91,4.01,11.08,2019,98406
3573,67,546,4186,85.36,1.6,13.04,2019,98424
13805,420,1585,15810,87.32,2.66,10.03,2019,98503
43,3,30,76,56.58,3.95,39.47,2019,98526
3483,91,535,4109,84.77,2.21,13.02,2019,98528
7750,224,1160,9134,84.85,2.45,12.7,2019,98532
133,0,50,183,72.68,0.0,27.32,2019,98552
1249,8,298,1555,80.32,0.51,19.16,2019,98570
987,0,108,1095,90.14,0.0,9.86,2019,98595
2195,100,444,2739,80.14,3.65,16.21,2019,98596
333,18,103,454,73.35,3.96,22.69,2019,98605
7691,90,726,8507,90.41,1.06,8.53,2019,98597
48,12,23,83,57.83,14.46,27.71,2019,99561
13,1,4,18,72.22,5.56,22.22,2019,99564
163,3,40,206,79.13,1.46,19.42,2019,99573
698,2,118,818,85.33,0.24,14.43,2019,99576
27,0,31,58,46.55,0.0,53.45,2019,99590
142,0,62,204,69.61,0.0,30.39,2019,99604
996,7,0,1003,99.3,0.7,0.0,2019,99702
341,8,16,365,93.42,2.19,4.38,2019,99743
13,0,19,32,40.62,0.0,59.38,2019,99776
181,4,31,216,83.8,1.85,14.35,2019,99103
10424,975,769,12168,85.67,8.01,6.32,2019,99163
781,5,53,839,93.09,0.6,6.32,2019,99343
1523,103,191,1817,83.82,5.67,10.51,2019,99003
10,2,22,34,29.41,5.88,64.71,2019,99730
11567,280,458,12305,94.0,2.28,3.72,2019,21075
109,18,0,127,85.83,14.17,0.0,2019,21077
230,7,8,245,93.88,2.86,3.27,2019,21082
13830,351,1219,15400,89.81,2.28,7.92,2019,21093
6074,50,404,6528,93.05,0.77,6.19,2019,21108
6637,157,798,7592,87.42,2.07,10.51,2019,21158
7414,472,1490,9376,79.07,5.03,15.89,2019,21202
13541,2085,3110,18736,72.27,11.13,16.6,2019,21207
16573,450,3714,20737,79.92,2.17,17.91,2019,21222
8657,580,2974,12211,70.9,4.75,24.36,2019,21225
1103,51,165,1319,83.62,3.87,12.51,2019,21918
189,0,0,189,100.0,0.0,0.0,2019,21071
1262,0,70,1332,94.74,0.0,5.26,2019,21140
7100,216,710,8026,88.46,2.69,8.85,2019,21286
114,0,55,169,67.46,0.0,32.54,2019,21153
0,0,0,0,,,,2019,21240
0,0,0,0,,,,2019,21250
0,0,0,0,,,,2019,21251
0,0,0,0,,,,2019,21252
7139,62,227,7428,96.11,0.83,3.06,2019,21409
68,0,0,68,100.0,0.0,0.0,2019,21652
0,0,0,0,,,,2019,21705
62,0,0,62,100.0,0.0,0.0,2019,21714
0,0,0,0,,,,2019,21746
16,0,0,16,100.0,0.0,0.0,2019,21781
0,0,0,0,,,,2019,21802
0,0,0,0,,,,2019,21890
0,0,0,0,,,,2019,21916
1786,34,88,1908,93.61,1.78,4.61,2019,21104
7002,261,479,7742,90.44,3.37,6.19,2019,21204
384,14,153,551,69.69,2.54,27.77,2019,21521
4805,116,606,5527,86.94,2.1,10.96,2019,21074
3659,231,1454,5344,68.47,4.32,27.21,2019,21205
9908,410,1928,12246,80.91,3.35,15.74,2019,21227
7492,104,362,7958,94.14,1.31,4.55,2019,21037
7044,609,1741,9394,74.98,6.48,18.53,2019,21201
4577,154,1223,5954,76.87,2.59,20.54,2019,21550
106,0,0,106,100.0,0.0,0.0,2019,22643
794,121,138,1053,75.4,11.49,13.11,2019,22624
255,0,39,294,86.73,0.0,13.27,2019,22627
780,0,181,961,81.17,0.0,18.83,2019,22644
10191,304,1638,12133,83.99,2.51,13.5,2019,22701
112,0,45,157,71.34,0.0,28.66,2019,22718
301,13,22,336,89.58,3.87,6.55,2019,22720
11,0,0,11,100.0,0.0,0.0,2019,22731
750,0,59,809,92.71,0.0,7.29,2019,22735
138,9,137,284,48.59,3.17,48.24,2019,22736
554,10,60,624,88.78,1.6,9.62,2019,22742
25,0,45,70,35.71,0.0,64.29,2019,22743
441,13,114,568,77.64,2.29,20.07,2019,22713
2593,54,661,3308,78.39,1.63,19.98,2019,22812
1792,60,46,1898,94.42,3.16,2.42,2019,22936
2001,31,297,2329,85.92,1.33,12.75,2019,22939
1004,0,46,1050,95.62,0.0,4.38,2019,22958
4215,246,558,5019,83.98,4.9,11.12,2019,25425
74,0,22,96,77.08,0.0,22.92,2019,25431
38,16,66,120,31.67,13.33,55.0,2019,25534
2920,204,1058,4182,69.82,4.88,25.3,2019,25541
135,24,21,180,75.0,13.33,11.67,2019,25841
3547,72,787,4406,80.5,1.63,17.86,2019,97741
114,3,36,153,74.51,1.96,23.53,2019,97750
13568,323,1078,14969,90.64,2.16,7.2,2019,97756
2520,40,337,2897,86.99,1.38,11.63,2019,97760
82,1,23,106,77.36,0.94,21.7,2019,97906
1333,31,414,1778,74.97,1.74,23.28,2019,97913
7872,327,704,8903,88.42,3.67,7.91,2019,97015
370,0,61,431,85.85,0.0,14.15,2019,97037
227,3,44,274,82.85,1.09,16.06,2019,97065
3839,199,427,4465,85.98,4.46,9.56,2019,97113
14453,746,1073,16272,88.82,4.58,6.59,2019,97123
1570,45,151,1766,88.9,2.55,8.55,2019,97133
3471,212,685,4368,79.46,4.85,15.68,2019,97138
400,0,46,446,89.69,0.0,10.31,2019,97326
257,10,117,384,66.93,2.6,30.47,2019,97204
10172,171,565,10908,93.25,1.57,5.18,2019,97212
7212,159,479,7850,91.87,2.03,6.1,2019,97215
9526,221,846,10593,89.93,2.09,7.99,2019,97321
53,0,29,82,64.63,0.0,35.37,2019,97350
3970,243,937,5150,77.09,4.72,18.19,2019,97814
116,3,2,121,95.87,2.48,1.65,2019,97835
196,18,81,295,66.44,6.1,27.46,2019,97867
161,6,26,193,83.42,3.11,13.47,2019,97874
45,0,0,45,100.0,0.0,0.0,2019,97905
147,20,68,235,62.55,8.51,28.94,2019,97907
1219,64,272,1555,78.39,4.12,17.49,2019,97918
5830,233,950,7013,83.13,3.32,13.55,2019,97850
78,0,34,112,69.64,0.0,30.36,2019,97864
145,9,53,207,70.05,4.35,25.6,2019,97910
1434,9,264,1707,84.01,0.53,15.47,2019,97004
961,25,78,1064,90.32,2.35,7.33,2019,97017
352,34,76,462,76.19,7.36,16.45,2019,97021
1077,7,253,1337,80.55,0.52,18.92,2019,97845
97,3,16,116,83.62,2.59,13.79,2019,97825
7556,322,1398,9276,81.46,3.47,15.07,2019,97838
52,0,13,65,80.0,0.0,20.0,2019,97842
63,2,11,76,82.89,2.63,14.47,2019,97848
844,28,150,1022,82.58,2.74,14.68,2019,97883
421,23,154,598,70.4,3.85,25.75,2019,97885
4324,232,1392,5948,72.7,3.9,23.4,2019,97914
97,5,3,105,92.38,4.76,2.86,2019,97029
59,0,10,69,85.51,0.0,14.49,2019,97001
7468,299,951,8718,85.66,3.43,10.91,2019,97013
1065,0,276,1341,79.42,0.0,20.58,2019,97022
2171,63,179,2413,89.97,2.61,7.42,2019,97002
604,4,70,678,89.09,0.59,10.32,2019,04411
1656,29,195,1880,88.09,1.54,10.37,2019,04239
95,10,7,112,84.82,8.93,6.25,2019,04490
441,32,112,585,75.38,5.47,19.15,2019,04747
1928,39,175,2142,90.01,1.82,8.17,2019,04027
721,0,95,816,88.36,0.0,11.64,2019,04087
2894,225,939,4058,71.32,5.54,23.14,2019,04769
731,19,87,837,87.34,2.27,10.39,2019,04253
438,21,94,553,79.2,3.8,17.0,2019,04219
1364,10,218,1592,85.68,0.63,13.69,2019,04236
418,20,38,476,87.82,4.2,7.98,2019,04238
174,21,42,237,73.42,8.86,17.72,2019,04255
1748,84,385,2217,78.85,3.79,17.37,2019,04270
132,4,43,179,73.74,2.23,24.02,2019,04285
1038,80,289,1407,73.77,5.69,20.54,2019,99737
281,3,51,335,83.88,0.9,15.22,2019,99012
5540,203,464,6207,89.25,3.27,7.48,2019,99016
139,5,44,188,73.94,2.66,23.4,2019,99683
15,4,31,50,30.0,8.0,62.0,2019,99691
987,29,343,1359,72.63,2.13,25.24,2019,99166
46,0,31,77,59.74,0.0,40.26,2019,99176
161,0,17,178,90.45,0.0,9.55,2019,99179
142,2,28,172,82.56,1.16,16.28,2019,99663
58,0,29,87,66.67,0.0,33.33,2019,99630
89,0,32,121,73.55,0.0,26.45,2019,99637
173,0,63,236,73.31,0.0,26.69,2019,99658
81,8,41,130,62.31,6.15,31.54,2019,99671
13,6,47,66,19.7,9.09,71.21,2019,99679
63,0,19,82,76.83,0.0,23.17,2019,99681
113,2,55,170,66.47,1.18,32.35,2019,99684
704,53,224,981,71.76,5.4,22.83,2019,99688
405,21,87,513,78.95,4.09,16.96,2019,99694
5186,63,314,5563,93.22,1.13,5.64,2019,01007
10506,308,1984,12798,82.09,2.41,15.5,2019,01020
3953,70,393,4416,89.52,1.59,8.9,2019,01030
712,32,111,855,83.27,3.74,12.98,2019,01034
2045,42,207,2294,89.15,1.83,9.02,2019,01035
488,46,31,565,86.37,8.14,5.49,2019,01053
3073,48,405,3526,87.15,1.36,11.49,2019,01057
3893,72,622,4587,84.87,1.57,13.56,2019,01082
13272,522,1757,15551,85.34,3.36,11.3,2019,01085
172,0,70,242,71.07,0.0,28.93,2019,01088
5895,906,2109,8910,66.16,10.17,23.67,2019,01104
5302,125,342,5769,91.91,2.17,5.93,2019,01106
2673,82,333,3088,86.56,2.66,10.78,2019,01226
290,2,61,353,82.15,0.57,17.28,2019,01255
175,3,36,214,81.78,1.4,16.82,2019,01258
6797,286,1081,8164,83.26,3.5,13.24,2019,01301
444,9,94,547,81.17,1.65,17.18,2019,01339
1488,48,275,1811,82.16,2.65,15.18,2019,01370
1475,128,74,1677,87.95,7.63,4.41,2019,01375
1573,0,124,1697,92.69,0.0,7.31,2019,01452
2224,12,213,2449,90.81,0.49,8.7,2019,01464
670,7,30,707,94.77,0.99,4.24,2019,01474
5533,244,857,6634,83.4,3.68,12.92,2019,01501
1021,57,101,1179,86.6,4.83,8.57,2019,01503
3212,61,253,3526,91.09,1.73,7.18,2019,01504
4843,161,590,5594,86.57,2.88,10.55,2019,01510
4,38,0,42,9.52,90.48,0.0,2019,01003
69,11,22,102,67.65,10.78,21.57,2019,04936
406,13,151,570,71.23,2.28,26.49,2019,04942
330,46,105,481,68.61,9.56,21.83,2019,04945
1362,19,285,1666,81.75,1.14,17.11,2019,04957
2562,73,448,3083,83.1,2.37,14.53,2019,04963
706,81,108,895,78.88,9.05,12.07,2019,04543
1168,22,89,1279,91.32,1.72,6.96,2019,04579
47,0,11,58,81.03,0.0,18.97,2019,04642
654,13,169,836,78.23,1.56,20.22,2019,04652
1033,92,264,1389,74.37,6.62,19.01,2019,04654
473,19,40,532,88.91,3.57,7.52,2019,04660
64,0,8,72,88.89,0.0,11.11,2019,04669
359,41,151,551,65.15,7.44,27.4,2019,04758
268,4,196,468,57.26,0.85,41.88,2019,04765
37,0,58,95,38.95,0.0,61.05,2019,25696
7119,700,1395,9214,77.26,7.6,15.14,2019,25705
136,18,32,186,73.12,9.68,17.2,2019,25820
10,0,39,49,20.41,0.0,79.59,2019,25855
417,7,109,533,78.24,1.31,20.45,2019,25865
227,0,22,249,91.16,0.0,8.84,2019,25875
255,28,45,328,77.74,8.54,13.72,2019,25878
400,28,225,653,61.26,4.29,34.46,2019,25555
350,0,89,439,79.73,0.0,20.27,2019,25607
129,0,110,239,53.97,0.0,46.03,2019,25630
412,0,26,438,94.06,0.0,5.94,2019,25649
86,0,14,100,86.0,0.0,14.0,2019,25879
2191,159,464,2814,77.86,5.65,16.49,2019,25880
49,0,0,49,100.0,0.0,0.0,2019,25908
519,88,352,959,54.12,9.18,36.7,2019,25921
0,2,11,13,0.0,15.38,84.62,2019,25936
61,0,0,61,100.0,0.0,0.0,2019,25942
160,14,7,181,88.4,7.73,3.87,2019,25007
64,0,17,81,79.01,0.0,20.99,2019,25008
146,3,105,254,57.48,1.18,41.34,2019,25011
1348,24,214,1586,84.99,1.51,13.49,2019,25015
141,33,63,237,59.49,13.92,26.58,2019,25024
275,18,21,314,87.58,5.73,6.69,2019,25031
208,0,44,252,82.54,0.0,17.46,2019,25040
33,43,10,86,38.37,50.0,11.63,2019,25047
3544,106,650,4300,82.42,2.47,15.12,2019,25064
433,6,224,663,65.31,0.9,33.79,2019,25070
3176,128,767,4071,78.02,3.14,18.84,2019,25508
790,13,315,1118,70.66,1.16,28.18,2019,25523
1590,54,546,2190,72.6,2.47,24.93,2019,25530
476,40,181,697,68.29,5.74,25.97,2019,25537
93,0,35,128,72.66,0.0,27.34,2019,25540
2561,237,752,3550,72.14,6.68,21.18,2019,25550
454,63,134,651,69.74,9.68,20.58,2019,25557
160,17,68,245,65.31,6.94,27.76,2019,25567
211,27,66,304,69.41,8.88,21.71,2019,25573
470,43,76,589,79.8,7.3,12.9,2019,25652
1755,25,613,2393,73.34,1.04,25.62,2019,25670
271,14,150,435,62.3,3.22,34.48,2019,25692
124,0,22,146,84.93,0.0,15.07,2019,25049
3693,180,994,4867,75.88,3.7,20.42,2019,25071
82,0,28,110,74.55,0.0,25.45,2019,25088
177,0,108,285,62.11,0.0,37.89,2019,25107
152,31,82,265,57.36,11.7,30.94,2019,25113
291,0,225,516,56.4,0.0,43.6,2019,25124
933,42,193,1168,79.88,3.6,16.52,2019,25003
166,0,41,207,80.19,0.0,19.81,2019,25019
80,0,93,173,46.24,0.0,53.76,2019,25134
264,10,223,497,53.12,2.01,44.87,2019,25140
115,0,39,154,74.68,0.0,25.32,2019,25161
39,0,12,51,76.47,0.0,23.53,2019,25204
216,4,81,301,71.76,1.33,26.91,2019,25208
345,24,88,457,75.49,5.25,19.26,2019,25209
787,58,411,1256,62.66,4.62,32.72,2019,25248
3744,204,1044,4992,75.0,4.09,20.91,2019,28016
4944,179,1280,6403,77.21,2.8,19.99,2019,28034
7695,130,588,8413,91.47,1.55,6.99,2019,28037
11237,219,1514,12970,86.64,1.69,11.67,2019,28056
776,6,285,1067,72.73,0.56,26.71,2019,28071
9358,283,2078,11719,79.85,2.41,17.73,2019,04330
15885,755,2146,18786,84.56,4.02,11.42,2019,04401
111,3,61,175,63.43,1.71,34.86,2019,04417
354,15,97,466,75.97,3.22,20.82,2019,04438
255,0,54,309,82.52,0.0,17.48,2019,04471
425,11,139,575,73.91,1.91,24.17,2019,04476
403,31,151,585,68.89,5.3,25.81,2019,04479
703,24,224,951,73.92,2.52,23.55,2019,04538
415,13,30,458,90.61,2.84,6.55,2019,04548
676,41,79,796,84.92,5.15,9.92,2019,04553
88,0,7,95,92.63,0.0,7.37,2019,04558
475,40,78,593,80.1,6.75,13.15,2019,04574
410,35,60,505,81.19,6.93,11.88,2019,04607
424,26,131,581,72.98,4.48,22.55,2019,04630
30,8,0,38,78.95,21.05,0.0,2019,04646
479,8,120,607,78.91,1.32,19.77,2019,04658
460,18,149,627,73.37,2.87,23.76,2019,04668
51,0,0,51,100.0,0.0,0.0,2019,04683
123,0,17,140,87.86,0.0,12.14,2019,04691
441,46,258,745,59.19,6.17,34.63,2019,04732
213,35,76,324,65.74,10.8,23.46,2019,04739
985,118,349,1452,67.84,8.13,24.04,2019,04742
445,0,87,532,83.65,0.0,16.35,2019,04973
1088,126,325,1539,70.7,8.19,21.12,2019,04619
147,11,31,189,77.78,5.82,16.4,2019,04685
441,3,86,530,83.21,0.57,16.23,2019,04932
1922,54,156,2132,90.15,2.53,7.32,2019,04071
81,0,8,89,91.01,0.0,8.99,2019,04237
958,34,256,1248,76.76,2.72,20.51,2019,04348
1100,88,89,1277,86.14,6.89,6.97,2019,04461
770,54,88,912,84.43,5.92,9.65,2019,04472
1325,37,104,1466,90.38,2.52,7.09,2019,04474
109,10,40,159,68.55,6.29,25.16,2019,04497
23,0,0,23,100.0,0.0,0.0,2019,04541
262,16,46,324,80.86,4.94,14.2,2019,04551
299,0,69,368,81.25,0.0,18.75,2019,04554
1980,81,275,2336,84.76,3.47,11.77,2019,04609
129,0,51,180,71.67,0.0,28.33,2019,04611
348,21,166,535,65.05,3.93,31.03,2019,04622
302,11,83,396,76.26,2.78,20.96,2019,04643
11,3,0,14,78.57,21.43,0.0,2019,04645
300,6,33,339,88.5,1.77,9.73,2019,04655
55,0,9,64,85.94,0.0,14.06,2019,04675
98,0,14,112,87.5,0.0,12.5,2019,04677
363,34,161,558,65.05,6.09,28.85,2019,04680
552,50,264,866,63.74,5.77,30.48,2019,72738
10,0,30,40,25.0,0.0,75.0,2019,72749
107,1,20,128,83.59,0.78,15.62,2019,72760
4844,1257,1432,7533,64.3,16.69,19.01,2019,72761
343,30,136,509,67.39,5.89,26.72,2019,72773
223,46,59,328,67.99,14.02,17.99,2019,72776
1495,92,732,2319,64.47,3.97,31.57,2019,72823
11,0,5,16,68.75,0.0,31.25,2019,72826
47,0,9,56,83.93,0.0,16.07,2019,72838
168,11,12,191,87.96,5.76,6.28,2019,72851
8,15,15,38,21.05,39.47,39.47,2019,72852
570,44,332,946,60.25,4.65,35.1,2019,72853
406,10,88,504,80.56,1.98,17.46,2019,72865
4863,99,538,5500,88.42,1.8,9.78,2019,72908
239,14,40,293,81.57,4.78,13.65,2019,04848
1512,51,160,1723,87.75,2.96,9.29,2019,04849
625,23,301,949,65.86,2.42,31.72,2019,04911
562,9,79,650,86.46,1.38,12.15,2019,04947
312,14,80,406,76.85,3.45,19.7,2019,04961
129,8,20,157,82.17,5.1,12.74,2019,04779
1032,83,128,1243,83.02,6.68,10.3,2019,04008
382,29,34,445,85.84,6.52,7.64,2019,04022
954,90,168,1212,78.71,7.43,13.86,2019,04048
959,60,142,1161,82.6,5.17,12.23,2019,04220
12197,548,2872,15617,78.1,3.51,18.39,2019,04240
1605,47,214,1866,86.01,2.52,11.47,2019,04250
1218,21,132,1371,88.84,1.53,9.63,2019,04259
1887,84,78,2049,92.09,4.1,3.81,2019,04260
111,5,38,154,72.08,3.25,24.68,2019,04261
1853,106,275,2234,82.95,4.74,12.31,2019,04274
848,33,171,1052,80.61,3.14,16.25,2019,04363
1044,64,0,1108,94.22,5.78,0.0,2019,04061
952,51,192,1195,79.67,4.27,16.07,2019,04037
292,36,86,414,70.53,8.7,20.77,2019,04051
7058,198,697,7953,88.75,2.49,8.76,2019,04072
391,0,89,480,81.46,0.0,18.54,2019,04095
393,12,21,426,92.25,2.82,4.93,2019,04108
678,20,217,915,74.1,2.19,23.72,2019,04224
739,32,64,835,88.5,3.83,7.66,2019,04263
378,0,42,420,90.0,0.0,10.0,2019,04265
1198,11,133,1342,89.27,0.82,9.91,2019,04344
1324,32,161,1517,87.28,2.11,10.61,2019,04350
1455,43,240,1738,83.72,2.47,13.81,2019,04358
67,0,14,81,82.72,0.0,17.28,2019,04408
1946,18,378,2342,83.09,0.77,16.14,2019,04416
510,34,126,670,76.12,5.07,18.81,2019,04418
945,98,162,1205,78.42,8.13,13.44,2019,04428
347,8,47,402,86.32,1.99,11.69,2019,04434
3290,16,293,3599,91.41,0.44,8.14,2019,04444
943,22,109,1074,87.8,2.05,10.15,2019,04456
169,10,54,233,72.53,4.29,23.18,2019,04475
469,5,81,555,84.5,0.9,14.59,2019,04488
1454,0,172,1626,89.42,0.0,10.58,2019,04496
4106,74,906,5086,80.73,1.45,17.81,2019,04530
893,32,64,989,90.29,3.24,6.47,2019,04537
647,22,92,761,85.02,2.89,12.09,2019,04555
1898,116,387,2401,79.05,4.83,16.12,2019,04572
386,14,94,494,78.14,2.83,19.03,2019,04606
213,0,24,237,89.87,0.0,10.13,2019,04612
150,9,65,224,66.96,4.02,29.02,2019,72456
371,6,181,558,66.49,1.08,32.44,2019,72459
341,34,187,562,60.68,6.05,33.27,2019,72466
476,8,213,697,68.29,1.15,30.56,2019,72530
31,13,4,48,64.58,27.08,8.33,2019,72540
982,219,495,1696,57.9,12.91,29.19,2019,72542
141,18,216,375,37.6,4.8,57.6,2019,72004
27,0,24,51,52.94,0.0,47.06,2019,72005
9,0,13,22,40.91,0.0,59.09,2019,72014
8282,318,1912,10512,78.79,3.03,18.19,2019,72015
10114,591,1851,12556,80.55,4.71,14.74,2019,72032
1434,84,595,2113,67.87,3.98,28.16,2019,72042
173,13,19,205,84.39,6.34,9.27,2019,72051
1894,141,800,2835,66.81,4.97,28.22,2019,72081
5930,97,120,6147,96.47,1.58,1.95,2019,28075
12097,160,691,12948,93.43,1.24,5.34,2019,28079
2263,92,588,2943,76.89,3.13,19.98,2019,28080
19,0,12,31,61.29,0.0,38.71,2019,28089
11541,508,1588,13637,84.63,3.73,11.64,2019,28115
7151,101,1030,8282,86.34,1.22,12.44,2019,28120
25,13,33,71,35.21,18.31,46.48,2019,28169
6395,378,485,7258,88.11,5.21,6.68,2019,28202
3458,141,1412,5011,69.01,2.81,28.18,2019,28206
3660,46,154,3860,94.82,1.19,3.99,2019,28207
12744,139,466,13349,95.47,1.04,3.49,2019,28270
4561,173,2040,6774,67.33,2.55,30.12,2019,28301
12438,416,1718,14572,85.36,2.85,11.79,2019,28311
613,8,316,937,65.42,0.85,33.72,2019,28385
1217,25,186,1428,85.22,1.75,13.03,2019,28323
171,15,65,251,68.13,5.98,25.9,2019,28325
2675,230,1648,4553,58.75,5.05,36.2,2019,28372
5666,257,925,6848,82.74,3.75,13.51,2019,28387
542,26,290,858,63.17,3.03,33.8,2019,28399
490,0,75,565,86.73,0.0,13.27,2019,28447
750,17,86,853,87.92,1.99,10.08,2019,28454
674,17,272,963,69.99,1.77,28.25,2019,28455
3011,126,754,3891,77.38,3.24,19.38,2019,28457
4083,181,200,4464,91.47,4.05,4.48,2019,28460
3171,89,251,3511,90.32,2.53,7.15,2019,28465
4398,67,458,4923,89.34,1.36,9.3,2019,28467
73,0,17,90,81.11,0.0,18.89,2019,28707
707,55,114,876,80.71,6.28,13.01,2019,28709
544,14,633,1191,45.68,1.18,53.15,2019,28464
110,6,57,173,63.58,3.47,32.95,2019,28519
252,0,180,432,58.33,0.0,41.67,2019,28527
209,0,5,214,97.66,0.0,2.34,2019,28528
664,11,158,833,79.71,1.32,18.97,2019,28529
7778,195,1066,9039,86.05,2.16,11.79,2019,28012
21495,472,1827,23794,90.34,1.98,7.68,2019,28027
1009,44,153,1206,83.67,3.65,12.69,2019,28032
9272,422,3016,12710,72.95,3.32,23.73,2019,28052
83,20,50,153,54.25,13.07,32.68,2019,28076
8495,241,1385,10121,83.93,2.38,13.68,2019,28081
1871,155,1036,3062,61.1,5.06,33.83,2019,28090
1752,14,389,2155,81.3,0.65,18.05,2019,28129
9220,119,1657,10996,83.85,1.08,15.07,2019,28146
713,0,273,986,72.31,0.0,27.69,2019,28167
11469,243,969,12681,90.44,1.92,7.64,2019,28211
13490,359,2547,16396,82.28,2.19,15.53,2019,28213
16568,466,2905,19939,83.09,2.34,14.57,2019,28216
26287,161,753,27201,96.64,0.59,2.77,2019,28277
9343,121,284,9748,95.85,1.24,2.91,2019,28278
11044,371,2132,13547,81.52,2.74,15.74,2019,28303
21105,418,1831,23354,90.37,1.79,7.84,2019,28314
158,0,36,194,81.44,0.0,18.56,2019,28330
341,7,118,466,73.18,1.5,25.32,2019,28347
1187,108,538,1833,64.76,5.89,29.35,2019,28351
774,39,249,1062,72.88,3.67,23.45,2019,28357
933,23,95,1051,88.77,2.19,9.04,2019,18458
3,0,0,3,100.0,0.0,0.0,2019,18459
394,34,174,602,65.45,5.65,28.9,2019,18503
4071,155,717,4943,82.36,3.14,14.51,2019,18509
4200,101,969,5270,79.7,1.92,18.39,2019,18512
2162,98,869,3129,69.1,3.13,27.77,2019,72927
1410,128,404,1942,72.61,6.59,20.8,2019,72933
143,4,193,340,42.06,1.18,56.76,2019,72934
1035,52,309,1396,74.14,3.72,22.13,2019,72937
2415,162,1134,3711,65.08,4.37,30.56,2019,72949
244,22,158,424,57.55,5.19,37.26,2019,72358
0,0,0,0,,,,2019,72467
165,18,47,230,71.74,7.83,20.43,2019,72413
123,2,51,176,69.89,1.14,28.98,2019,72421
11616,703,2601,14920,77.86,4.71,17.43,2019,72450
256,13,143,412,62.14,3.16,34.71,2019,72469
1642,92,726,2460,66.75,3.74,29.51,2019,72010
956,62,497,1515,63.1,4.09,32.81,2019,72020
486,0,61,547,88.85,0.0,11.15,2019,72045
285,0,75,360,79.17,0.0,20.83,2019,72057
581,17,460,1058,54.91,1.61,43.48,2019,72064
354,23,264,641,55.23,3.59,41.19,2019,72069
40,3,24,67,59.7,4.48,35.82,2019,72083
909,52,264,1225,74.2,4.24,21.55,2019,72088
24,0,14,38,63.16,0.0,36.84,2019,72108
2329,377,2039,4745,49.08,7.95,42.97,2019,72114
7870,262,1200,9332,84.33,2.81,12.86,2019,72116
551,20,321,892,61.77,2.24,35.99,2019,72127
3718,247,917,4882,76.16,5.06,18.78,2019,72150
2854,171,1052,4077,70.0,4.19,25.8,2019,72160
2805,34,376,3215,87.25,1.06,11.7,2019,72176
541,25,102,668,80.99,3.74,15.27,2019,72201
3355,264,1068,4687,71.58,5.63,22.79,2019,72202
55,0,6,61,90.16,0.0,9.84,2019,72321
193,17,62,272,70.96,6.25,22.79,2019,72351
49,0,0,49,100.0,0.0,0.0,2019,72353
351,17,219,587,59.8,2.9,37.31,2019,72368
365,73,272,710,51.41,10.28,38.31,2019,72372
11,0,31,42,26.19,0.0,73.81,2019,72383
662,69,150,881,75.14,7.83,17.03,2019,72411
4945,210,1323,6478,76.34,3.24,20.42,2019,72801
16,0,9,25,64.0,0.0,36.0,2019,72828
1964,107,780,2851,68.89,3.75,27.36,2019,72837
41,11,76,128,32.03,8.59,59.38,2019,72839
8465,613,1899,10977,77.12,5.58,17.3,2019,72903
3027,156,407,3590,84.32,4.35,11.34,2019,72916
4390,227,1047,5664,77.51,4.01,18.49,2019,72936
353,0,106,459,76.91,0.0,23.09,2019,72938
1607,79,393,2079,77.3,3.8,18.9,2019,72941
2766,102,616,3484,79.39,2.93,17.68,2019,72753
10490,370,1767,12627,83.08,2.93,13.99,2019,96002
3225,89,577,3891,82.88,2.29,14.83,2019,96019
331,30,142,503,65.81,5.96,28.23,2019,96023
323,10,106,439,73.58,2.28,24.15,2019,96039
243,0,125,368,66.03,0.0,33.97,2019,96048
134,0,77,211,63.51,0.0,36.49,2019,96050
471,4,95,570,82.63,0.7,16.67,2019,96051
11639,579,1774,13992,83.18,4.14,12.68,2019,96001
37,8,5,50,74.0,16.0,10.0,2019,96010
39,5,35,79,49.37,6.33,44.3,2019,96011
41,6,14,61,67.21,9.84,22.95,2019,96029
900,56,315,1271,70.81,4.41,24.78,2019,96041
57,0,0,57,100.0,0.0,0.0,2019,96046
11,0,0,11,100.0,0.0,0.0,2019,96061
822,15,191,1028,79.96,1.46,18.58,2019,72102
3228,158,1136,4522,71.38,3.49,25.12,2019,72110
3614,318,1326,5258,68.73,6.05,25.22,2019,72117
6223,382,1961,8566,72.65,4.46,22.89,2019,72118
220,11,87,318,69.18,3.46,27.36,2019,72128
571,33,273,877,65.11,3.76,31.13,2019,72137
543,52,324,919,59.09,5.66,35.26,2019,72153
39,11,98,148,26.35,7.43,66.22,2019,72168
27,3,11,41,65.85,7.32,26.83,2019,72169
52,0,82,134,38.81,0.0,61.19,2019,72175
113,24,44,181,62.43,13.26,24.31,2019,72330
842,52,279,1173,71.78,4.43,23.79,2019,72331
62,0,30,92,67.39,0.0,32.61,2019,72341
1174,42,602,1818,64.58,2.31,33.11,2019,72342
149,0,93,242,61.57,0.0,38.43,2019,72346
1675,155,555,2385,70.23,6.5,23.27,2019,72529
60,13,25,98,61.22,13.27,25.51,2019,72453
2749,92,814,3655,75.21,2.52,22.27,2019,72472
1770,154,459,2383,74.28,6.46,19.26,2019,72476
1052,25,535,1612,65.26,1.55,33.19,2019,72846
5638,402,2212,8252,68.32,4.87,26.81,2019,72904
151,6,112,269,56.13,2.23,41.64,2019,72926
107,5,54,166,64.46,3.01,32.53,2019,72935
1064,49,382,1495,71.17,3.28,25.55,2019,72946
120,0,14,134,89.55,0.0,10.45,2019,72948
20,0,48,68,29.41,0.0,70.59,2019,72322
37,0,0,37,100.0,0.0,0.0,2019,72329
725,3,248,976,74.28,0.31,25.41,2019,72355
1953,227,853,3033,64.39,7.48,28.12,2019,72370
229,4,178,411,55.72,0.97,43.31,2019,72373
608,14,136,758,80.21,1.85,17.94,2019,72386
120,0,39,159,75.47,0.0,24.53,2019,72538
2832,91,213,3136,90.31,2.9,6.79,2019,72007
5536,169,626,6331,87.44,2.67,9.89,2019,72002
4606,396,1122,6124,75.21,6.47,18.32,2019,72058
828,22,314,1164,71.13,1.89,26.98,2019,72067
420,10,214,644,65.22,1.55,33.23,2019,72070
38,0,34,72,52.78,0.0,47.22,2019,72074
3135,103,887,4125,76.0,2.5,21.5,2019,72086
0,0,0,0,,,,2019,72099
287,22,119,428,67.06,5.14,27.8,2019,72129
13,1,6,20,65.0,5.0,30.0,2019,72553
113,30,105,248,45.56,12.1,42.34,2019,72561
132,58,77,267,49.44,21.72,28.84,2019,72565
296,60,133,489,60.53,12.27,27.2,2019,72579
370,27,106,503,73.56,5.37,21.07,2019,98603
57,0,29,86,66.28,0.0,33.72,2019,98614
100,5,30,135,74.07,3.7,22.22,2019,98628
2884,72,157,3113,92.64,2.31,5.04,2019,98629
10852,434,1076,12362,87.79,3.51,8.7,2019,98662
10328,180,252,10760,95.99,1.67,2.34,2019,98685
13278,314,2406,15998,83.0,1.96,15.04,2019,98801
508,29,280,817,62.18,3.55,34.27,2019,98813
87,0,0,87,100.0,0.0,0.0,2019,98817
185,24,76,285,64.91,8.42,26.67,2019,98830
1586,67,441,2094,75.74,3.2,21.06,2019,98844
436,28,64,528,82.58,5.3,12.12,2019,98849
337,24,99,460,73.26,5.22,21.52,2019,98934
15186,464,1934,17584,86.36,2.64,11.0,2019,98226
4125,44,617,4786,86.19,0.92,12.89,2019,18657
12128,379,3299,15806,76.73,2.4,20.87,2019,18702
5014,163,1144,6321,79.32,2.58,18.1,2019,18705
71,5,3,79,89.87,6.33,3.8,2019,18814
440,29,107,576,76.39,5.03,18.58,2019,18821
1106,54,279,1439,76.86,3.75,19.39,2019,18822
117,4,34,155,75.48,2.58,21.94,2019,18828
556,25,151,732,75.96,3.42,20.63,2019,18832
97,6,0,103,94.17,5.83,0.0,2019,18842
121,0,12,133,90.98,0.0,9.02,2019,18845
1777,31,491,2299,77.29,1.35,21.36,2019,18847
493,0,119,612,80.56,0.0,19.44,2019,18854
1077,66,96,1239,86.92,5.33,7.75,2019,18942
8515,179,488,9182,92.74,1.95,5.31,2019,18944
14250,345,1899,16494,86.4,2.09,11.51,2019,18974
5692,104,413,6209,91.67,1.67,6.65,2019,18938
10691,200,486,11377,93.97,1.76,4.27,2019,18940
1479,58,305,1842,80.29,3.15,16.56,2019,18642
1905,69,435,2409,79.08,2.86,18.06,2019,18655
1212,39,274,1525,79.48,2.56,17.97,2019,18660
1323,39,243,1605,82.43,2.43,15.14,2019,18618
1784,0,409,2193,81.35,0.0,18.65,2019,18517
6179,357,1855,8391,73.64,4.25,22.11,2019,18603
1531,0,134,1665,91.95,0.0,8.05,2019,18610
45,0,19,64,70.31,0.0,29.69,2019,18622
573,29,93,695,82.45,4.17,13.38,2019,18629
1017,49,142,1208,84.19,4.06,11.75,2019,18630
1756,41,368,2165,81.11,1.89,17.0,2019,18661
5099,57,595,5751,88.66,0.99,10.35,2019,18707
235,0,64,299,78.6,0.0,21.4,2019,18829
3801,39,724,4564,83.28,0.85,15.86,2019,18840
747,36,143,926,80.67,3.89,15.44,2019,18850
248,2,39,289,85.81,0.69,13.49,2019,18851
810,7,67,884,91.63,0.79,7.58,2019,18917
0,0,0,0,,,,2019,18936
5036,218,605,5859,85.95,3.72,10.33,2019,18969
225,3,50,278,80.94,1.08,17.99,2019,18830
651,18,162,831,78.34,2.17,19.49,2019,18833
7216,62,468,7746,93.16,0.8,6.04,2019,18914
1763,69,441,2273,77.56,3.04,19.4,2019,18091
2093,63,199,2355,88.87,2.68,8.45,2019,18066
2599,87,287,2973,87.42,2.93,9.65,2019,18069
2110,46,64,2220,95.05,2.07,2.88,2019,18074
14579,583,2655,17817,81.83,3.27,14.9,2019,18103
651,79,71,801,81.27,9.86,8.86,2019,18214
32,0,10,42,76.19,0.0,23.81,2019,18230
1075,22,352,1449,74.19,1.52,24.29,2019,18237
65,14,32,111,58.56,12.61,28.83,2019,18244
736,0,189,925,79.57,0.0,20.43,2019,18322
2568,79,145,2792,91.98,2.83,5.19,2019,18330
100,0,31,131,76.34,0.0,23.66,2019,18333
417,0,10,427,97.66,0.0,2.34,2019,18355
334,0,45,379,88.13,0.0,11.87,2019,18370
837,0,140,977,85.67,0.0,14.33,2019,18405
2912,186,528,3626,80.31,5.13,14.56,2019,22960
522,58,242,822,63.5,7.06,29.44,2019,22967
1841,36,472,2349,78.37,1.53,20.09,2019,22973
120,11,32,163,73.62,6.75,19.63,2019,22976
9616,134,562,10312,93.25,1.3,5.45,2019,22206
90,0,69,159,56.6,0.0,43.4,2019,96075
161,13,15,189,85.19,6.88,7.94,2019,96084
1265,92,409,1766,71.63,5.21,23.16,2019,96013
5155,103,985,6243,82.57,1.65,15.78,2019,96022
944,17,130,1091,86.53,1.56,11.92,2019,96032
251,0,99,350,71.71,0.0,28.29,2019,96047
506,16,118,640,79.06,2.5,18.44,2019,96052
106,10,28,144,73.61,6.94,19.44,2019,96054
93,0,42,135,68.89,0.0,31.11,2019,96076
589,59,42,690,85.36,8.55,6.09,2019,96103
277,6,65,348,79.6,1.72,18.68,2019,96104
97,0,25,122,79.51,0.0,20.49,2019,96106
240,0,114,354,67.8,0.0,32.2,2019,96109
336,0,55,391,85.93,0.0,14.07,2019,96113
51,0,9,60,85.0,0.0,15.0,2019,96125
46,0,24,70,65.71,0.0,34.29,2019,96133
1302,13,320,1635,79.63,0.8,19.57,2019,96137
2111,188,182,2481,85.09,7.58,7.34,2019,96712
136,29,29,194,70.1,14.95,14.95,2019,96728
2442,61,196,2699,90.48,2.26,7.26,2019,96738
944,23,52,1019,92.64,2.26,5.1,2019,96754
6425,290,667,7382,87.04,3.93,9.04,2019,96761
663,36,482,1181,56.14,3.05,40.81,2019,96763
332,35,135,502,66.14,6.97,26.89,2019,96776
285,32,91,408,69.85,7.84,22.3,2019,96781
1180,165,148,1493,79.04,11.05,9.91,2019,96785
17053,293,1027,18373,92.82,1.59,5.59,2019,96818
5925,121,477,6523,90.83,1.85,7.31,2019,96821
257,2,96,355,72.39,0.56,27.04,2019,96091
219,13,54,286,76.57,4.55,18.88,2019,96096
80,0,124,204,39.22,0.0,60.78,2019,96105
5,0,14,19,26.32,0.0,73.68,2019,96119
172,14,28,214,80.37,6.54,13.08,2019,96148
128,0,63,191,67.02,0.0,32.98,2019,96006
6888,417,1805,9110,75.61,4.58,19.81,2019,96007
337,27,70,434,77.65,6.22,16.13,2019,96062
123,0,14,137,89.78,0.0,10.22,2019,96063
1705,16,371,2092,81.5,0.76,17.73,2019,96088
153,6,60,219,69.86,2.74,27.4,2019,96090
1055,0,589,1644,64.17,0.0,35.83,2019,96093
31,0,24,55,56.36,0.0,43.64,2019,96108
31,0,22,53,58.49,0.0,41.51,2019,96110
59,0,16,75,78.67,0.0,21.33,2019,96115
37,0,72,109,33.94,0.0,66.06,2019,96116
129,5,20,154,83.77,3.25,12.99,2019,96117
9510,377,1399,11286,84.26,3.34,12.4,2019,97005
273,59,50,382,71.47,15.45,13.09,2019,97011
675,12,76,763,88.47,1.57,9.96,2019,97018
877,34,188,1099,79.8,3.09,17.11,2019,97456
425,14,126,565,75.22,2.48,22.3,2019,97632
439,11,84,534,82.21,2.06,15.73,2019,97865
120,0,24,144,83.33,0.0,16.67,2019,97873
314,9,36,359,87.47,2.51,10.03,2019,97876
82,6,38,126,65.08,4.76,30.16,2019,97880
342,10,67,419,81.62,2.39,15.99,2019,97886
200,5,81,286,69.93,1.75,28.32,2019,97901
25,0,0,25,100.0,0.0,0.0,2019,97903
9258,372,2001,11631,79.6,3.2,17.2,2019,97420
498,23,71,592,84.12,3.89,11.99,2019,97040
916,61,144,1121,81.71,5.44,12.85,2019,98244
9836,245,909,10990,89.5,2.23,8.27,2019,98271
554,53,61,668,82.93,7.93,9.13,2019,98325
239,0,0,239,100.0,0.0,0.0,2019,98345
3099,63,349,3511,88.27,1.79,9.94,2019,98337
8878,245,766,9889,89.78,2.48,7.75,2019,98338
1331,14,89,1434,92.82,0.98,6.21,2019,98340
3546,54,298,3898,90.97,1.39,7.64,2019,98346
791,15,80,886,89.28,1.69,9.03,2019,98376
146,0,29,175,83.43,0.0,16.57,2019,98385
6457,354,914,7725,83.59,4.58,11.83,2019,98408
8620,500,1147,10267,83.96,4.87,11.17,2019,98409
10425,762,1763,12950,80.5,5.88,13.61,2019,98444
10073,172,992,11237,89.64,1.53,8.83,2019,98445
6282,416,968,7666,81.95,5.43,12.63,2019,98506
12475,269,637,13381,93.23,2.01,4.76,2019,98513
194,4,36,234,82.91,1.71,15.38,2019,98530
104,7,33,144,72.22,4.86,22.92,2019,98538
70,0,17,87,80.46,0.0,19.54,2019,98834
7,0,0,7,100.0,0.0,0.0,2019,98853
2047,18,527,2592,78.97,0.69,20.33,2019,98855
860,50,194,1104,77.9,4.53,17.57,2019,98856
2465,168,395,3028,81.41,5.55,13.04,2019,98922
11598,662,1067,13327,87.03,4.97,8.01,2019,98926
176,0,16,192,91.67,0.0,8.33,2019,98643
478,6,76,560,85.36,1.07,13.57,2019,98645
1035,44,221,1300,79.62,3.38,17.0,2019,98648
8294,240,654,9188,90.27,2.61,7.12,2019,98664
8989,163,909,10061,89.34,1.62,9.03,2019,98665
19491,403,960,20854,93.46,1.93,4.6,2019,98682
7262,183,467,7912,91.78,2.31,5.9,2019,98686
71,25,0,96,73.96,26.04,0.0,2019,98821
582,37,130,749,77.7,4.94,17.36,2019,98822
12855,471,1761,15087,85.21,3.12,11.67,2019,98837
5434,339,832,6605,82.27,5.13,12.6,2019,98942
8928,175,515,9618,92.83,1.82,5.35,2019,98055
5033,58,98,5189,96.99,1.12,1.89,2019,98065
23446,687,861,24994,93.81,2.75,3.44,2019,98103
10894,434,320,11648,93.53,3.73,2.75,2019,98112
12143,387,1417,13947,87.07,2.77,10.16,2019,98144
18559,654,1477,20690,89.7,3.16,7.14,2019,98208
240,0,0,240,100.0,0.0,0.0,2019,98220
8348,301,942,9591,87.04,3.14,9.82,2019,98221
16401,221,448,17070,96.08,1.29,2.62,2019,98004
7577,104,327,8008,94.62,1.3,4.08,2019,98005
103,0,11,114,90.35,0.0,9.65,2019,01009
0,0,0,0,,,,2019,01063
0,31,0,31,0.0,100.0,0.0,2019,01066
95,0,0,95,100.0,0.0,0.0,2019,01074
249,12,81,342,72.81,3.51,23.68,2019,01079
0,0,0,0,,,,2019,01086
99,15,3,117,84.62,12.82,2.56,2019,01093
148,25,32,205,72.2,12.2,15.61,2019,01094
20,0,0,20,100.0,0.0,0.0,2019,01097
0,0,0,0,,,,2019,01199
64,0,0,64,100.0,0.0,0.0,2019,01224
30,0,18,48,62.5,0.0,37.5,2019,01229
115,22,7,144,79.86,15.28,4.86,2019,01243
130,0,10,140,92.86,0.0,7.14,2019,01260
33,0,0,33,100.0,0.0,0.0,2019,22509
5490,52,171,5713,96.1,0.91,2.99,2019,22301
8168,194,686,9048,90.27,2.14,7.58,2019,22485
310,20,64,394,78.68,5.08,16.24,2019,22654
547,0,275,822,66.55,0.0,33.45,2019,22469
36,0,0,36,100.0,0.0,0.0,2019,22646
1413,35,504,1952,72.39,1.79,25.82,2019,22580
39,0,64,103,37.86,0.0,62.14,2019,22729
273,37,52,362,75.41,10.22,14.36,2019,22847
383,0,214,597,64.15,0.0,35.85,2019,22969
472,8,84,564,83.69,1.42,14.89,2019,22747
143,0,129,272,52.57,0.0,47.43,2019,22436
18923,221,532,19676,96.17,1.12,2.7,2019,22192
570,44,127,741,76.92,5.94,17.14,2019,22610
6261,37,109,6407,97.72,0.58,1.7,2019,22025
0,0,0,0,,,,2019,22035
0,0,0,0,,,,2019,22185
0,0,0,0,,,,2019,22214
91,0,0,91,100.0,0.0,0.0,2019,22530
5553,172,750,6475,85.76,2.66,11.58,2019,22551
8681,85,431,9197,94.39,0.92,4.69,2019,22556
249,13,37,299,83.28,4.35,12.37,2019,22623
0,0,0,0,,,,2019,22807
4,20,0,24,16.67,83.33,0.0,2019,22904
99,0,0,99,100.0,0.0,0.0,2019,22964
2564,67,392,3023,84.82,2.22,12.97,2019,22712
269,0,50,319,84.33,0.0,15.67,2019,22714
3184,70,609,3863,82.42,1.81,15.76,2019,22443
513,7,123,643,79.78,1.09,19.13,2019,22454
1786,63,438,2287,78.09,2.75,19.15,2019,22473
4535,81,402,5018,90.37,1.61,8.01,2019,22553
1660,161,1017,2838,58.49,5.67,35.84,2019,22560
211,0,40,251,84.06,0.0,15.94,2019,22639
372,0,158,530,70.19,0.0,29.81,2019,22663
5030,203,919,6152,81.76,3.3,14.94,2019,22546
877,17,358,1252,70.05,1.36,28.59,2019,22567
1624,66,838,2528,64.24,2.61,33.15,2019,22572
29,0,0,29,100.0,0.0,0.0,2019,22579
2649,110,562,3321,79.77,3.31,16.92,2019,22611
102,0,54,156,65.38,0.0,34.62,2019,22641
1028,38,181,1247,82.44,3.05,14.51,2019,22656
391,0,76,467,83.73,0.0,16.27,2019,22709
662,0,71,733,90.31,0.0,9.69,2019,22724
326,0,144,470,69.36,0.0,30.64,2019,22738
28,12,11,51,54.9,23.53,21.57,2019,22741
53,0,40,93,56.99,0.0,43.01,2019,22749
8154,591,2055,10800,75.5,5.47,19.03,2019,22802
628,17,129,774,81.14,2.2,16.67,2019,22846
2671,92,465,3228,82.74,2.85,14.41,2019,22932
312,14,74,400,78.0,3.5,18.5,2019,22935
17026,287,1604,18917,90.0,1.52,8.48,2019,22003
9627,50,228,9905,97.19,0.5,2.3,2019,22032
14551,202,322,15075,96.52,1.34,2.14,2019,22033
4472,202,678,5352,83.56,3.77,12.67,2019,22044
2179,97,884,3160,68.96,3.07,27.97,2019,25276
654,37,57,748,87.43,4.95,7.62,2019,25442
255,0,99,354,72.03,0.0,27.97,2019,25502
702,38,284,1024,68.55,3.71,27.73,2019,25524
272,33,60,365,74.52,9.04,16.44,2019,25529
9164,414,773,10351,88.53,4.0,7.47,2019,97132
6355,371,510,7236,87.82,5.13,7.05,2019,97232
25,3,7,35,71.43,8.57,20.0,2019,97033
8633,371,493,9497,90.9,3.91,5.19,2019,97333
261,0,55,316,82.59,0.0,17.41,2019,97377
2260,98,569,2927,77.21,3.35,19.44,2019,97423
19,5,14,38,50.0,13.16,36.84,2019,97837
146,1,59,206,70.87,0.49,28.64,2019,97856
3978,336,755,5069,78.48,6.63,14.89,2019,97205
15263,527,2768,18558,82.24,2.84,14.92,2019,97301
315,7,119,441,71.43,1.59,26.98,2019,97375
241,3,57,301,80.07,1.0,18.94,2019,97429
1780,57,380,2217,80.29,2.57,17.14,2019,97467
495,15,118,628,78.82,2.39,18.79,2019,97541
1153,52,246,1451,79.46,3.58,16.95,2019,97828
1860,140,539,2539,73.26,5.51,21.23,2019,97016
11772,286,1368,13426,87.68,2.13,10.19,2019,97267
248,0,21,269,92.19,0.0,7.81,2019,97461
47,4,20,71,66.2,5.63,28.17,2019,97884
931,16,225,1172,79.44,1.37,19.2,2019,97449
14986,717,2152,17855,83.93,4.02,12.05,2019,97501
143,34,93,270,52.96,12.59,34.44,2019,97531
207,26,33,266,77.82,9.77,12.41,2019,97627
19,2,20,41,46.34,4.88,48.78,2019,97758
367,8,85,460,79.78,1.74,18.48,2019,97063
2487,100,321,2908,85.52,3.44,11.04,2019,97009
501,16,68,585,85.64,2.74,11.62,2019,97014
12050,479,2271,14800,81.42,3.24,15.34,2019,97030
165,25,49,239,69.04,10.46,20.5,2019,97039
982,56,48,1086,90.42,5.16,4.42,2019,97042
637,14,21,672,94.79,2.08,3.12,2019,97049
499,18,63,580,86.03,3.1,10.86,2019,97054
268,4,63,335,80.0,1.19,18.81,2019,97118
4456,162,729,5347,83.34,3.03,13.63,2019,97141
285,11,49,345,82.61,3.19,14.2,2019,97149
7835,625,720,9180,85.35,6.81,7.84,2019,97201
5473,198,981,6652,82.28,2.98,14.75,2019,97216
0,0,0,0,,,,2019,97331
915,9,129,1053,86.89,0.85,12.25,2019,97358
7212,166,393,7771,92.81,2.14,5.06,2019,97034
2310,51,343,2704,85.43,1.89,12.68,2019,97048
4121,66,440,4627,89.06,1.43,9.51,2019,97056
13866,335,1198,15399,90.04,2.18,7.78,2019,97080
6138,167,1075,7380,83.17,2.26,14.57,2019,97103
420,37,48,505,83.17,7.33,9.5,2019,97110
179,8,76,263,68.06,3.04,28.9,2019,04735
368,32,171,571,64.45,5.6,29.95,2019,04740
127,9,67,203,62.56,4.43,33.0,2019,04746
984,54,172,1210,81.32,4.46,14.21,2019,04757
120,5,47,172,69.77,2.91,27.33,2019,04777
161,0,46,207,77.78,0.0,22.22,2019,04783
479,19,50,548,87.41,3.47,9.12,2019,04858
688,16,134,838,82.1,1.91,15.99,2019,04910
370,10,95,475,77.89,2.11,20.0,2019,04951
680,46,125,851,79.91,5.41,14.69,2019,04952
5096,278,805,6179,82.47,4.5,13.03,2019,04605
189,3,45,237,79.75,1.27,18.99,2019,04671
2150,52,118,2320,92.67,2.24,5.09,2019,04021
1207,54,239,1500,80.47,3.6,15.93,2019,04254
294,2,47,343,85.71,0.58,13.7,2019,01270
23,0,6,29,79.31,0.0,20.69,2019,01343
70,0,8,78,89.74,0.0,10.26,2019,01347
511,28,40,579,88.26,4.84,6.91,2019,01354
232,7,0,239,97.07,2.93,0.0,2019,01434
217,0,0,217,100.0,0.0,0.0,2019,01525
45,0,37,82,54.88,0.0,45.12,2019,01561
752,10,255,1017,73.94,0.98,25.07,2019,01901
0,0,0,0,,,,2019,01937
10382,275,1948,12605,82.36,2.18,15.45,2019,01089
215,7,64,286,75.17,2.45,22.38,2019,01259
4379,67,618,5064,86.47,1.32,12.2,2019,01507
6567,48,454,7069,92.9,0.68,6.42,2019,01581
17722,684,3135,21541,82.27,3.18,14.55,2019,01960
2039,21,150,2210,92.26,0.95,6.79,2019,01969
2004,13,189,2206,90.84,0.59,8.57,2019,01983
513,24,6,543,94.48,4.42,1.1,2019,01039
11286,415,3577,15278,73.87,2.72,23.41,2019,01040
1225,64,158,1447,84.66,4.42,10.92,2019,01010
1821,44,135,2000,91.05,2.2,6.75,2019,01036
3076,212,486,3774,81.51,5.62,12.88,2019,01220
9152,172,390,9714,94.21,1.77,4.01,2019,01824
3810,72,189,4071,93.59,1.77,4.64,2019,01450
1322,27,150,1499,88.19,1.8,10.01,2019,01612
7000,197,1050,8247,84.88,2.39,12.73,2019,01905
867,34,105,1006,86.18,3.38,10.44,2019,01521
780,0,161,941,82.89,0.0,17.11,2019,01537
798,0,91,889,89.76,0.0,10.24,2019,01542
5476,122,1215,6813,80.38,1.79,17.83,2019,01550
5722,204,1803,7729,74.03,2.64,23.33,2019,01610
234,0,8,242,96.69,0.0,3.31,2019,01718
9575,259,1212,11046,86.68,2.34,10.97,2019,01757
6186,10,190,6386,96.87,0.16,2.98,2019,01776
9194,211,596,10001,91.93,2.11,5.96,2019,01803
12162,177,462,12801,95.01,1.38,3.61,2019,01810
7367,369,1165,8901,82.77,4.15,13.09,2019,01832
2283,177,250,2710,84.24,6.53,9.23,2019,01860
3298,22,192,3512,93.91,0.63,5.47,2019,01862
7411,51,422,7884,94.0,0.65,5.35,2019,01890
688,27,41,756,91.01,3.57,5.42,2019,01081
4984,167,541,5692,87.56,2.93,9.5,2019,01118
2517,130,166,2813,89.48,4.62,5.9,2019,01469
2016,34,142,2192,91.97,1.55,6.48,2019,01566
879,11,264,1154,76.17,0.95,22.88,2019,01022
5911,70,323,6304,93.77,1.11,5.12,2019,01748
338,18,144,500,67.6,3.6,28.8,2019,28006
0,0,0,0,,,,2019,28017
4073,189,1312,5574,73.07,3.39,23.54,2019,28021
5141,62,859,6062,84.81,1.02,14.17,2019,28023
5647,68,398,6113,92.38,1.11,6.51,2019,28036
7214,403,1037,8654,83.36,4.66,11.98,2019,28787
287,7,165,459,62.53,1.53,35.95,2019,28434
1945,131,875,2951,65.91,4.44,29.65,2019,28431
330,10,305,645,51.16,1.55,47.29,2019,28438
295,61,141,497,59.36,12.27,28.37,2019,28439
12439,638,1619,14696,84.64,4.34,11.02,2019,28451
5166,252,1947,7365,70.14,3.42,26.44,2019,28472
1107,12,635,1754,63.11,0.68,36.2,2019,28478
2418,47,772,3237,74.7,1.45,23.85,2019,28518
3137,142,464,3743,83.81,3.79,12.4,2019,32409
6528,227,469,7224,90.37,3.14,6.49,2019,32459
1053,34,396,1483,71.0,2.29,26.7,2019,32460
68,0,20,88,77.27,0.0,22.73,2019,32463
1581,234,391,2206,71.67,10.61,17.72,2019,32531
11566,942,2311,14819,78.05,6.36,15.59,2019,32547
4001,62,140,4203,95.19,1.48,3.33,2019,32561
1497,109,466,2072,72.25,5.26,22.49,2019,32565
10561,293,1095,11949,88.38,2.45,9.16,2019,32570
8567,151,738,9456,90.6,1.6,7.8,2019,32606
4584,38,622,5244,87.41,0.72,11.86,2019,32615
1322,40,345,1707,77.45,2.34,20.21,2019,32617
34,0,63,97,35.05,0.0,64.95,2019,32639
5383,140,451,5974,90.11,2.34,7.55,2019,32653
2709,228,1487,4424,61.23,5.15,33.61,2019,32680
2667,152,1504,4323,61.69,3.52,34.79,2019,32693
10623,354,1837,12814,82.9,2.76,14.34,2019,32127
2988,308,653,3949,75.66,7.8,16.54,2019,32136
216,3,88,307,70.36,0.98,28.66,2019,32193
953,71,191,1215,78.44,5.84,15.72,2019,32195
1910,122,463,2495,76.55,4.89,18.56,2019,32040
596,21,130,747,79.79,2.81,17.4,2019,32044
1890,60,997,2947,64.13,2.04,33.83,2019,32112
535,13,12,560,95.54,2.32,2.14,2019,32140
156,35,23,214,72.9,16.36,10.75,2019,32147
535,0,10,545,98.17,0.0,1.83,2019,32508
1232,106,499,1837,67.07,5.77,27.16,2019,32535
727,11,0,738,98.51,1.49,0.0,2019,32542
7541,210,1092,8843,85.28,2.37,12.35,2019,32583
6453,541,913,7907,81.61,6.84,11.55,2019,32601
2399,93,1121,3613,66.4,2.57,31.03,2019,32626
3666,112,780,4558,80.43,2.46,17.11,2019,32643
4691,135,707,5533,84.78,2.44,12.78,2019,32656
137,0,44,181,75.69,0.0,24.31,2019,32664
2198,8,539,2745,80.07,0.29,19.64,2019,32666
43,6,50,99,43.43,6.06,50.51,2019,32697
14274,588,2087,16949,84.22,3.47,12.31,2019,32725
7665,175,512,8352,91.77,2.1,6.13,2019,32751
7258,425,1613,9296,78.08,4.57,17.35,2019,32763
5056,40,151,5247,96.36,0.76,2.88,2019,32766
1179,13,243,1435,82.16,0.91,16.93,2019,32798
877,51,243,1171,74.89,4.36,20.75,2019,30663
3015,67,357,3439,87.67,1.95,10.38,2019,30666
13275,73,605,13953,95.14,0.52,4.34,2019,30115
10553,720,2059,13332,79.16,5.4,15.44,2019,30117
20678,272,1679,22629,91.38,1.2,7.42,2019,30127
11790,785,1660,14235,82.82,5.51,11.66,2019,30132
7212,409,851,8472,85.13,4.83,10.04,2019,30141
10003,407,3023,13433,74.47,3.03,22.5,2019,30161
1631,31,365,2027,80.46,1.53,18.01,2019,30175
7446,302,2166,9914,75.11,3.05,21.85,2019,30501
4226,60,700,4986,84.76,1.2,14.04,2019,30513
13599,150,728,14477,93.94,1.04,5.03,2019,30519
313,17,89,419,74.7,4.06,21.24,2019,30545
6941,261,1333,8535,81.32,3.06,15.62,2019,30549
1524,15,228,1767,86.25,0.85,12.9,2019,30571
0,0,0,0,,,,2019,30602
746,88,883,1717,43.45,5.13,51.43,2019,30828
16412,443,1708,18563,88.41,2.39,9.2,2019,30016
5870,623,1134,7627,76.96,8.17,14.87,2019,33181
4977,74,1014,6065,82.06,1.22,16.72,2019,33184
13050,379,1765,15194,85.89,2.49,11.62,2019,33308
8306,43,895,9244,89.85,0.47,9.68,2019,33314
11018,380,1270,12668,86.98,3.0,10.03,2019,33317
12502,1438,2738,16678,74.96,8.62,16.42,2019,33322
8401,247,489,9137,91.94,2.7,5.35,2019,33325
3463,319,3716,7498,46.19,4.25,49.56,2019,33430
8218,483,1148,9849,83.44,4.9,11.66,2019,33434
17663,583,1841,20087,87.93,2.9,9.17,2019,33467
9088,314,584,9986,91.01,3.14,5.85,2019,33496
9451,300,703,10454,90.41,2.87,6.72,2019,33510
7304,463,1552,9319,78.38,4.97,16.65,2019,33541
7532,109,246,7887,95.5,1.38,3.12,2019,33572
8640,103,2042,10785,80.11,0.96,18.93,2019,33607
7525,118,668,8311,90.54,1.42,8.04,2019,33609
14805,638,2769,18212,81.29,3.5,15.2,2019,33617
23563,408,883,24854,94.81,1.64,3.55,2019,33647
11195,372,1885,13452,83.22,2.77,14.01,2019,33702
8551,561,1807,10919,78.31,5.14,16.55,2019,33705
10135,441,1551,12127,83.57,3.64,12.79,2019,33707
4999,364,1606,6969,71.73,5.22,23.04,2019,33711
10494,466,592,11552,90.84,4.03,5.12,2019,33073
13450,428,2289,16167,83.19,2.65,14.16,2019,33134
3627,146,2495,6268,57.87,2.33,39.81,2019,33136
8946,424,2270,11640,76.86,3.64,19.5,2019,33145
10324,411,372,11107,92.95,3.7,3.35,2019,33156
1956,21,20,1997,97.95,1.05,1.0,2019,33158
5875,1191,909,7975,73.67,14.93,11.4,2019,33811
1824,403,790,3017,60.46,13.36,26.18,2019,33841
13766,987,4411,19164,71.83,5.15,23.02,2019,33160
10076,290,1428,11794,85.43,2.46,12.11,2019,33183
1510,130,68,1708,88.41,7.61,3.98,2019,33306
15514,1648,6332,23494,66.03,7.01,26.95,2019,33311
10199,172,423,10794,94.49,1.59,3.92,2019,33326
4342,124,149,4615,94.08,2.69,3.23,2019,33330
9189,1472,1287,11948,76.91,12.32,10.77,2019,33351
7501,196,1079,8776,85.47,2.23,12.29,2019,33406
12475,515,846,13836,90.16,3.72,6.11,2019,33428
9588,338,621,10547,90.91,3.2,5.89,2019,33432
105,0,0,105,100.0,0.0,0.0,2019,33438
8160,215,2629,11004,74.15,1.95,23.89,2019,33460
176,53,71,300,58.67,17.67,23.67,2019,33849
2627,297,713,3637,72.23,8.17,19.6,2019,33868
6187,345,2164,8696,71.15,3.97,24.89,2019,33870
8615,471,1625,10711,80.43,4.4,15.17,2019,33903
10198,661,1711,12570,81.13,5.26,13.61,2019,33917
6036,157,812,7005,86.17,2.24,11.59,2019,33948
7097,192,433,7722,91.91,2.49,5.61,2019,33991
7442,226,1090,8758,84.97,2.58,12.45,2019,33761
4783,108,1263,6154,77.72,1.75,20.52,2019,33765
3545,115,316,3976,89.16,2.89,7.95,2019,33767
4613,48,303,4964,92.93,0.97,6.1,2019,33776
7828,181,1763,9772,80.11,1.85,18.04,2019,33781
2617,332,1133,4082,64.11,8.13,27.76,2019,33853
8577,177,205,8959,95.74,1.98,2.29,2019,33913
7423,123,539,8085,91.81,1.52,6.67,2019,33556
5136,148,874,6158,83.4,2.4,14.19,2019,33565
2952,175,614,3741,78.91,4.68,16.41,2019,33567
1629,44,489,2162,75.35,2.04,22.62,2019,36521
203,14,196,413,49.15,3.39,47.46,2019,36471
0,0,7,7,0.0,0.0,100.0,2019,36476
273,20,308,601,45.42,3.33,51.25,2019,36480
85,64,0,149,57.05,42.95,0.0,2019,36513
3428,158,1481,5067,67.65,3.12,29.23,2019,36703
1808,80,317,2205,82.0,3.63,14.38,2019,36572
6165,162,1045,7372,83.63,2.2,14.18,2019,36575
0,0,12,12,0.0,0.0,100.0,2019,36727
300,45,114,459,65.36,9.8,24.84,2019,36736
252,11,209,472,53.39,2.33,44.28,2019,36740
535,0,208,743,72.01,0.0,27.99,2019,36742
73,5,158,236,30.93,2.12,66.95,2019,36751
116,22,50,188,61.7,11.7,26.6,2019,36754
322,0,197,519,62.04,0.0,37.96,2019,36758
549,35,431,1015,54.09,3.45,42.46,2019,36850
461,6,445,912,50.55,0.66,48.79,2019,36003
3998,126,583,4707,84.94,2.68,12.39,2019,36022
339,17,121,477,71.07,3.56,25.37,2019,36026
559,76,344,979,57.1,7.76,35.14,2019,36032
284,18,111,413,68.77,4.36,26.88,2019,36020
218,26,100,344,63.37,7.56,29.07,2019,36029
376,3,269,648,58.02,0.46,41.51,2019,36432
42,0,89,131,32.06,0.0,67.94,2019,36435
5742,94,497,6333,90.67,1.48,7.85,2019,36106
479,0,115,594,80.64,0.0,19.36,2019,36258
2578,27,552,3157,81.66,0.86,17.48,2019,36345
1682,53,465,2200,76.45,2.41,21.14,2019,36271
584,33,243,860,67.91,3.84,28.26,2019,36276
583,14,214,811,71.89,1.73,26.39,2019,36316
1616,18,302,1936,83.47,0.93,15.6,2019,36352
206,12,139,357,57.7,3.36,38.94,2019,36370
129,21,151,301,42.86,6.98,50.17,2019,36444
53,0,102,155,34.19,0.0,65.81,2019,36446
1115,38,434,1587,70.26,2.39,27.35,2019,36477
417,0,76,493,84.58,0.0,15.42,2019,36505
503,7,173,683,73.65,1.02,25.33,2019,36509
3043,29,999,4071,74.75,0.71,24.54,2019,36544
288,0,64,352,81.82,0.0,18.18,2019,36574
1347,71,335,1753,76.84,4.05,19.11,2019,36576
897,15,706,1618,55.44,0.93,43.63,2019,36612
6515,227,940,7682,84.81,2.95,12.24,2019,36693
52,0,52,104,50.0,0.0,50.0,2019,36728
118,18,109,245,48.16,7.35,44.49,2019,36738
404,72,135,611,66.12,11.78,22.09,2019,36752
29,9,28,66,43.94,13.64,42.42,2019,36763
286,13,352,651,43.93,2.0,54.07,2019,36767
216,0,128,344,62.79,0.0,37.21,2019,36768
2701,110,614,3425,78.86,3.21,17.93,2019,36874
1131,72,435,1638,69.05,4.4,26.56,2019,36875
860,7,36,903,95.24,0.78,3.99,2019,36879
373,7,356,736,50.68,0.95,48.37,2019,36907
798,50,519,1367,58.38,3.66,37.97,2019,36033
1526,59,426,2011,75.88,2.93,21.18,2019,36277
1233,46,17,1296,95.14,3.55,1.31,2019,36362
4043,34,1009,5086,79.49,0.67,19.84,2019,36541
296,0,90,386,76.68,0.0,23.32,2019,36482
56,0,126,182,30.77,0.0,69.23,2019,36538
277,24,133,434,63.82,5.53,30.65,2019,36548
0,0,0,0,,,,2019,38958
2040,58,684,2782,73.33,2.08,24.59,2019,38544
571,26,254,851,67.1,3.06,29.85,2019,38573
871,41,364,1276,68.26,3.21,28.53,2019,38229
4149,338,1663,6150,67.46,5.5,27.04,2019,38019
152,0,92,244,62.3,0.0,37.7,2019,38352
775,5,409,1189,65.18,0.42,34.4,2019,39040
873,77,394,1344,64.96,5.73,29.32,2019,39044
0,0,0,0,,,,2019,39061
372,7,135,514,72.37,1.36,26.26,2019,39067
2098,260,1350,3708,56.58,7.01,36.41,2019,39114
712,0,269,981,72.58,0.0,27.42,2019,39364
832,17,562,1411,58.97,1.2,39.83,2019,39459
603,8,493,1104,54.62,0.72,44.66,2019,39464
5970,188,1375,7533,79.25,2.5,18.25,2019,39465
3461,38,268,3767,91.88,1.01,7.11,2019,39525
2279,126,894,3299,69.08,3.82,27.1,2019,39556
809,18,149,976,82.89,1.84,15.27,2019,39561
2992,113,968,4073,73.46,2.77,23.77,2019,39567
32,2,13,47,68.09,4.26,27.66,2019,39771
375,29,215,619,60.58,4.68,34.73,2019,39772
528,27,302,857,61.61,3.15,35.24,2019,39664
1102,35,261,1398,78.83,2.5,18.67,2019,39735
1761,63,210,2034,86.58,3.1,10.32,2019,39740
596,22,300,918,64.92,2.4,32.68,2019,39750
337,0,338,675,49.93,0.0,50.07,2019,39756
7972,257,2383,10612,75.12,2.42,22.46,2019,39046
13136,254,1050,14440,90.97,1.76,7.27,2019,39047
1032,46,592,1670,61.8,2.75,35.45,2019,39066
172,37,234,443,38.83,8.35,52.82,2019,39079
1392,400,1595,3387,41.1,11.81,47.09,2019,39083
81,0,0,81,100.0,0.0,0.0,2019,39156
120,4,85,209,57.42,1.91,40.67,2019,39166
265,24,193,482,54.98,4.98,40.04,2019,39192
4155,162,1814,6131,67.77,2.64,29.59,2019,39194
1211,43,644,1898,63.8,2.27,33.93,2019,39203
1666,35,644,2345,71.04,1.49,27.46,2019,39325
4987,327,2885,8199,60.82,3.99,35.19,2019,39213
303,0,132,435,69.66,0.0,30.34,2019,39320
429,10,232,671,63.93,1.49,34.58,2019,39323
794,114,196,1104,71.92,10.33,17.75,2019,39335
3764,148,1958,5870,64.12,2.52,33.36,2019,39339
1367,114,867,2348,58.22,4.86,36.93,2019,39345
253,9,252,514,49.22,1.75,49.03,2019,39363
465,48,353,866,53.7,5.54,40.76,2019,39739
462,10,150,622,74.28,1.61,24.12,2019,39751
457,38,325,820,55.73,4.63,39.63,2019,39057
596,120,592,1308,45.57,9.17,45.26,2019,39063
5624,310,1585,7519,74.8,4.12,21.08,2019,39073
380,20,173,573,66.32,3.49,30.19,2019,39086
511,58,449,1018,50.2,5.7,44.11,2019,39092
1162,0,710,1872,62.07,0.0,37.93,2019,39150
1304,118,1133,2555,51.04,4.62,44.34,2019,39168
7005,278,2251,9534,73.47,2.92,23.61,2019,39209
78,0,76,154,50.65,0.0,49.35,2019,39054
212,0,137,349,60.74,0.0,39.26,2019,39082
474,11,165,650,72.92,1.69,25.38,2019,39108
290,74,597,961,30.18,7.7,62.12,2019,39169
9132,335,1761,11228,81.33,2.98,15.68,2019,39212
2330,189,608,3127,74.51,6.04,19.44,2019,29449
682,20,407,1109,61.5,1.8,36.7,2019,29458
10414,469,2807,13690,76.07,3.43,20.5,2019,29461
19557,307,1829,21693,90.15,1.42,8.43,2019,29464
1099,139,468,1706,64.42,8.15,27.43,2019,29470
665,63,144,872,76.26,7.22,16.51,2019,29474
9534,397,5417,15348,62.12,2.59,35.29,2019,29203
11572,233,1682,13487,85.8,1.73,12.47,2019,29209
5808,57,1046,6911,84.04,0.82,15.14,2019,29302
5971,345,1653,7969,74.93,4.33,20.74,2019,29307
8625,216,1268,10109,85.32,2.14,12.54,2019,29316
818,14,283,1115,73.36,1.26,25.38,2019,29321
363,0,322,685,52.99,0.0,47.01,2019,29014
587,35,166,788,74.49,4.44,21.07,2019,29038
4954,267,1721,6942,71.36,3.85,24.79,2019,29053
890,184,570,1644,54.14,11.19,34.67,2019,29055
20173,375,1509,22057,91.46,1.7,6.84,2019,29072
50,0,45,95,52.63,0.0,47.37,2019,29074
18905,219,879,20003,94.51,1.09,4.39,2019,30101
1434,16,396,1846,77.68,0.87,21.45,2019,30582
18,0,9,27,66.67,0.0,33.33,2019,30665
830,146,363,1339,61.99,10.9,27.11,2019,30734
15905,231,1040,17176,92.6,1.34,6.05,2019,30328
9319,330,778,10427,89.37,3.16,7.46,2019,30345
516,29,621,1166,44.25,2.49,53.26,2019,30411
436,3,203,642,67.91,0.47,31.62,2019,30413
2366,25,331,2722,86.92,0.92,12.16,2019,30415
19,22,26,67,28.36,32.84,38.81,2019,30423
151,0,120,271,55.72,0.0,44.28,2019,30426
10,0,7,17,58.82,0.0,41.18,2019,30438
245,19,96,360,68.06,5.28,26.67,2019,30446
84,4,59,147,57.14,2.72,40.14,2019,30470
602,15,338,955,63.04,1.57,35.39,2019,30473
6794,50,191,7035,96.57,0.71,2.71,2019,30017
2862,52,501,3415,83.81,1.52,14.67,2019,30025
12632,544,1695,14871,84.94,3.66,11.4,2019,30038
20208,355,1973,22536,89.67,1.58,8.75,2019,30052
1007,15,170,1192,84.48,1.26,14.26,2019,30055
5848,76,1603,7527,77.69,1.01,21.3,2019,30071
13707,121,454,14282,95.97,0.85,3.18,2019,30019
13107,163,256,13526,96.9,1.21,1.89,2019,30005
9477,237,1506,11220,84.47,2.11,13.42,2019,30008
22867,338,667,23872,95.79,1.42,2.79,2019,30022
23464,278,596,24338,96.41,1.14,2.45,2019,30024
22152,249,856,23257,95.25,1.07,3.68,2019,30041
19258,306,845,20409,94.36,1.5,4.14,2019,30066
10764,294,517,11575,92.99,2.54,4.47,2019,30082
16251,493,2981,19725,82.39,2.5,15.11,2019,30083
9981,301,1068,11350,87.94,2.65,9.41,2019,30094
1719,32,549,2300,74.74,1.39,23.87,2019,30113
6436,316,2143,8895,72.36,3.55,24.09,2019,30125
2015,191,548,2754,73.17,6.94,19.9,2019,30145
129,11,73,213,60.56,5.16,34.27,2019,30148
14520,214,359,15093,96.2,1.42,2.38,2019,30152
3097,320,1091,4508,68.7,7.1,24.2,2019,30204
11520,189,693,12402,92.89,1.52,5.59,2019,30215
2633,48,970,3651,72.12,1.31,26.57,2019,30217
303,143,300,746,40.62,19.17,40.21,2019,30218
8857,1034,3826,13717,64.57,7.54,27.89,2019,30223
5796,494,1842,8132,71.27,6.07,22.65,2019,30233
7926,401,453,8780,90.27,4.57,5.16,2019,30248
17606,216,1175,18997,92.68,1.14,6.19,2019,30253
854,12,124,990,86.26,1.21,12.53,2019,30256
3089,63,621,3773,81.87,1.67,16.46,2019,30268
4133,101,835,5069,81.53,1.99,16.47,2019,30273
10091,801,1923,12815,78.74,6.25,15.01,2019,30274
2478,169,558,3205,77.32,5.27,17.41,2019,30288
7627,417,1057,9101,83.8,4.58,11.61,2019,30296
909,134,271,1314,69.18,10.2,20.62,2019,30303
18252,636,3449,22337,81.71,2.85,15.44,2019,30263
18214,632,1272,20118,90.54,3.14,6.32,2019,30319
26,0,19,45,57.78,0.0,42.22,2019,30429
6578,98,253,6929,94.93,1.41,3.65,2019,30009
8199,48,742,8989,91.21,0.53,8.25,2019,30028
10569,356,1945,12870,82.12,2.77,15.11,2019,30046
0,0,0,0,,,,2019,30118
39,11,9,59,66.1,18.64,15.25,2019,30149
8087,283,847,9217,87.74,3.07,9.19,2019,33584
12742,282,2196,15220,83.72,1.85,14.43,2019,33604
10398,320,794,11512,90.32,2.78,6.9,2019,33618
5986,93,350,6429,93.11,1.45,5.44,2019,33637
7097,509,1272,8878,79.94,5.73,14.33,2019,33701
6940,204,470,7614,91.15,2.68,6.17,2019,33704
1808,74,188,2070,87.34,3.57,9.08,2019,33070
12296,856,5090,18242,67.4,4.69,27.9,2019,33126
5804,28,713,6545,88.68,0.43,10.89,2019,33129
8353,1419,4235,14007,59.63,10.13,30.23,2019,33130
9157,923,269,10349,88.48,8.92,2.6,2019,33131
8360,498,1276,10134,82.49,4.91,12.59,2019,33137
12543,432,1496,14471,86.68,2.99,10.34,2019,33155
12528,579,3181,16288,76.92,3.55,19.53,2019,33165
7028,318,822,8168,86.04,3.89,10.06,2019,33708
5567,270,814,6651,83.7,4.06,12.24,2019,33760
7461,251,1586,9298,80.24,2.7,17.06,2019,33763
6655,182,2113,8950,74.36,2.03,23.61,2019,33030
4132,216,215,4563,90.55,4.73,4.71,2019,33035
17374,1091,2296,20761,83.69,5.26,11.06,2019,33064
12211,254,386,12851,95.02,1.98,3.0,2019,33071
5422,1111,403,6936,78.17,16.02,5.81,2019,33132
16671,1727,2442,20840,80.0,8.29,11.72,2019,33139
13682,1791,2096,17569,77.88,10.19,11.93,2019,33141
5096,321,4362,9779,52.11,3.28,44.61,2019,33150
5349,269,567,6185,86.48,4.35,9.17,2019,33154
6474,79,1370,7923,81.71,1.0,17.29,2019,33166
3555,637,1594,5786,61.44,11.01,27.55,2019,33167
15011,739,1478,17228,87.13,4.29,8.58,2019,33176
11254,1985,1588,14827,75.9,13.39,10.71,2019,33177
14360,317,595,15272,94.03,2.08,3.9,2019,33178
11216,615,2654,14485,77.43,4.25,18.32,2019,33180
12122,504,1307,13933,87.0,3.62,9.38,2019,33919
2675,45,209,2929,91.33,1.54,7.14,2019,33953
107,57,21,185,57.84,30.81,11.35,2019,33001
11591,419,2558,14568,79.56,2.88,17.56,2019,33014
18434,557,2232,21223,86.86,2.62,10.52,2019,33015
12291,263,2794,15348,80.08,1.71,18.2,2019,33016
10149,170,911,11230,90.37,1.51,8.11,2019,33026
8127,361,2641,11129,73.03,3.24,23.73,2019,33055
6673,687,2431,9791,68.15,7.02,24.83,2019,33056
8146,226,937,9309,87.51,2.43,10.07,2019,33716
5910,122,771,6803,86.87,1.79,11.33,2019,33777
4866,133,982,5981,81.36,2.22,16.42,2019,33778
7474,1415,2305,11194,66.77,12.64,20.59,2019,33823
6191,238,2139,8568,72.26,2.78,24.96,2019,33852
6416,378,1907,8701,73.74,4.34,21.92,2019,33901
11041,529,1825,13395,82.43,3.95,13.62,2019,33904
6127,396,2030,8553,71.64,4.63,23.73,2019,33916
10129,90,1444,11663,86.85,0.77,12.38,2019,33950
159,0,132,291,54.64,0.0,45.36,2019,33960
70,0,0,70,100.0,0.0,0.0,2019,33944
1074,0,9,1083,99.17,0.0,0.83,2019,33946
6281,347,768,7396,84.92,4.69,10.38,2019,33971
4048,126,482,4656,86.94,2.71,10.35,2019,33981
10169,480,768,11417,89.07,4.2,6.73,2019,33990
7776,316,496,8588,90.54,3.68,5.78,2019,33993
9655,431,901,10987,87.88,3.92,8.2,2019,33173
7383,181,2401,9965,74.09,1.82,24.09,2019,33174
1793,78,397,2268,79.06,3.44,17.5,2019,36549
49,0,60,109,44.95,0.0,55.05,2019,36550
721,59,483,1263,57.09,4.67,38.24,2019,36560
2728,320,173,3221,84.69,9.93,5.37,2019,36561
1442,94,364,1900,75.89,4.95,19.16,2019,36580
5223,270,1160,6653,78.51,4.06,17.44,2019,36618
213,14,115,342,62.28,4.09,33.63,2019,36720
612,67,303,982,62.32,6.82,30.86,2019,36750
495,56,363,914,54.16,6.13,39.72,2019,36769
122,0,63,185,65.95,0.0,34.05,2019,36773
226,21,155,402,56.22,5.22,38.56,2019,36775
478,18,425,921,51.9,1.95,46.15,2019,36786
262,18,217,497,52.72,3.62,43.66,2019,36041
421,62,211,694,60.66,8.93,30.4,2019,36053
7484,251,646,8381,89.3,2.99,7.71,2019,36066
108,42,57,207,52.17,20.29,27.54,2019,36071
387,0,185,572,67.66,0.0,32.34,2019,36035
325,33,207,565,57.52,5.84,36.64,2019,36048
1495,74,476,2045,73.11,3.62,23.28,2019,36049
7771,104,2140,10015,77.59,1.04,21.37,2019,36067
576,76,212,864,66.67,8.8,24.54,2019,36069
530,34,365,929,57.05,3.66,39.29,2019,36075
4014,109,1951,6074,66.08,1.79,32.12,2019,36081
798,126,280,1204,66.28,10.47,23.26,2019,36088
933,50,555,1538,60.66,3.25,36.09,2019,36091
8473,235,1442,10150,83.48,2.32,14.21,2019,36109
1664,49,441,2154,77.25,2.27,20.47,2019,36266
336,33,332,701,47.93,4.71,47.36,2019,36017
452,33,187,672,67.26,4.91,27.83,2019,36036
761,58,595,1414,53.82,4.1,42.08,2019,36040
573,46,234,853,67.17,5.39,27.43,2019,36051
3364,42,207,3613,93.11,1.16,5.73,2019,36064
2077,171,1067,3315,62.65,5.16,32.19,2019,36083
2212,101,771,3084,71.73,3.27,25.0,2019,36107
2803,113,1321,4237,66.16,2.67,31.18,2019,36110
216,9,106,331,65.26,2.72,32.02,2019,36205
3755,248,1333,5336,70.37,4.65,24.98,2019,36272
1340,39,395,1774,75.54,2.2,22.27,2019,36278
1865,103,653,2621,71.16,3.93,24.91,2019,36310
1549,17,710,2276,68.06,0.75,31.2,2019,36312
63,0,35,98,64.29,0.0,35.71,2019,36313
1542,39,493,2074,74.35,1.88,23.77,2019,36344
68,0,123,191,35.6,0.0,64.4,2019,36373
1893,90,778,2761,68.56,3.26,28.18,2019,36375
7469,231,2154,9854,75.8,2.34,21.86,2019,36801
5611,287,1029,6927,81.0,4.14,14.85,2019,36804
13398,778,1261,15437,86.79,5.04,8.17,2019,36830
653,19,284,956,68.31,1.99,29.71,2019,36852
398,36,234,668,59.58,5.39,35.03,2019,36860
5637,192,1455,7284,77.39,2.64,19.98,2019,36870
447,43,339,829,53.92,5.19,40.89,2019,36912
253,5,158,416,60.82,1.2,37.98,2019,36921
150,0,80,230,65.22,0.0,34.78,2019,36922
57,0,78,135,42.22,0.0,57.78,2019,36481
187,0,38,225,83.11,0.0,16.89,2019,36569
1818,255,945,3018,60.24,8.45,31.31,2019,36732
0,0,0,0,,,,2019,36849
385,21,316,722,53.32,2.91,43.77,2019,36919
372,5,106,483,77.02,1.04,21.95,2019,36006
485,144,782,1411,34.37,10.21,55.42,2019,39338
118,0,41,159,74.21,0.0,25.79,2019,39356
618,120,401,1139,54.26,10.54,35.21,2019,39421
3547,457,2166,6170,57.49,7.41,35.11,2019,39429
769,21,478,1268,60.65,1.66,37.7,2019,39451
2316,51,912,3279,70.63,1.56,27.81,2019,39530
4957,94,1244,6295,78.75,1.49,19.76,2019,39553
5517,114,1221,6852,80.52,1.66,17.82,2019,39565
2101,91,658,2850,73.72,3.19,23.09,2019,39573
17,0,113,130,13.08,0.0,86.92,2019,39635
4647,177,442,5266,88.25,3.36,8.39,2019,39705
7999,501,1638,10138,78.9,4.94,16.16,2019,39466
122,2,133,257,47.47,0.78,51.75,2019,39477
339,24,223,586,57.85,4.1,38.05,2019,39481
561,4,331,896,62.61,0.45,36.94,2019,39346
5934,510,2412,8856,67.01,5.76,27.24,2019,39350
628,43,530,1201,52.29,3.58,44.13,2019,39360
5238,133,1028,6399,81.86,2.08,16.07,2019,39426
6058,134,947,7139,84.86,1.88,13.27,2019,39560
151,40,202,393,38.42,10.18,51.4,2019,39643
2595,228,1877,4700,55.21,4.85,39.94,2019,39667
877,3,902,1782,49.21,0.17,50.62,2019,39669
466,0,212,678,68.73,0.0,31.27,2019,39741
1314,19,772,2105,62.42,0.9,36.67,2019,39744
718,4,391,1113,64.51,0.36,35.13,2019,39752
466,39,178,683,68.23,5.71,26.06,2019,39769
4453,145,1409,6007,74.13,2.41,23.46,2019,39773
844,65,325,1234,68.4,5.27,26.34,2019,39480
301,39,206,546,55.13,7.14,37.73,2019,39427
961,91,643,1695,56.7,5.37,37.94,2019,39439
4111,257,3467,7835,52.47,3.28,44.25,2019,39440
1834,123,813,2770,66.21,4.44,29.35,2019,39476
5772,373,1562,7707,74.89,4.84,20.27,2019,39531
4914,105,1110,6129,80.18,1.71,18.11,2019,39562
369,0,98,467,79.01,0.0,20.99,2019,39572
1531,110,1170,2811,54.46,3.91,41.62,2019,39629
265,10,84,359,73.82,2.79,23.4,2019,39630
841,90,438,1369,61.43,6.57,31.99,2019,39189
287,7,253,547,52.47,1.28,46.25,2019,39045
8076,286,864,9226,87.54,3.1,9.36,2019,39056
46,6,109,161,28.57,3.73,67.7,2019,39113
1151,65,696,1912,60.2,3.4,36.4,2019,39119
8182,164,2822,11168,73.26,1.47,25.27,2019,39120
1422,233,1000,2655,53.56,8.78,37.66,2019,39191
260,5,15,280,92.86,1.79,5.36,2019,39201
4304,193,1467,5964,72.17,3.24,24.6,2019,39204
9537,315,1776,11628,82.02,2.71,15.27,2019,39208
6953,412,1183,8548,81.34,4.82,13.84,2019,39305
4003,410,1865,6278,63.76,6.53,29.71,2019,39307
369,0,240,609,60.59,0.0,39.41,2019,39322
618,89,332,1039,59.48,8.57,31.95,2019,39330
263,57,303,623,42.22,9.15,48.64,2019,39347
214,19,218,451,47.45,4.21,48.34,2019,39366
115,9,152,276,41.67,3.26,55.07,2019,39461
3316,251,1278,4845,68.44,5.18,26.38,2019,39470
369,15,366,750,49.2,2.0,48.8,2019,39478
1397,80,1012,2489,56.13,3.21,40.66,2019,39483
3607,180,1315,5102,70.7,3.53,25.77,2019,39563
4170,282,814,5266,79.19,5.36,15.46,2019,39571
418,0,235,653,64.01,0.0,35.99,2019,29114
2228,102,649,2979,74.79,3.42,21.79,2019,29123
969,11,302,1282,75.59,0.86,23.56,2019,29178
16492,394,3768,20654,79.85,1.91,18.24,2019,29223
4826,167,1826,6819,70.77,2.45,26.78,2019,29306
2522,106,728,3356,75.15,3.16,21.69,2019,29322
2299,49,347,2695,85.31,1.82,12.88,2019,29376
6370,186,1981,8537,74.62,2.18,23.2,2019,29403
9196,875,2627,12698,72.42,6.89,20.69,2019,29406
13794,2597,1459,17850,77.28,14.55,8.17,2019,29414
255,0,319,574,44.43,0.0,55.57,2019,29471
7321,330,1773,9424,77.68,3.5,18.81,2019,29527
588,28,312,928,63.36,3.02,33.62,2019,29530
1092,33,707,1832,59.61,1.8,38.59,2019,29032
1015,70,544,1629,62.31,4.3,33.39,2019,29047
3835,131,1068,5034,76.18,2.6,21.22,2019,29061
1478,70,317,1865,79.25,3.75,17.0,2019,29384
11546,1578,2067,15191,76.01,10.39,13.61,2019,29407
6418,1408,2055,9881,64.95,14.25,20.8,2019,29418
859,46,388,1293,66.43,3.56,30.01,2019,29432
173,20,47,240,72.08,8.33,19.58,2019,29434
666,27,387,1080,61.67,2.5,35.83,2019,29437
7234,601,2913,10748,67.31,5.59,27.1,2019,29440
956,77,287,1320,72.42,5.83,21.74,2019,29450
158,0,13,171,92.4,0.0,7.6,2019,29452
9196,518,1396,11110,82.77,4.66,12.57,2019,29456
1405,83,989,2477,56.72,3.35,39.93,2019,29477
445,8,315,768,57.94,1.04,41.02,2019,29525
4807,483,2067,7357,65.34,6.57,28.1,2019,29340
963,59,607,1629,59.12,3.62,37.26,2019,29353
102,13,102,217,47.0,5.99,47.0,2019,29364
5009,100,491,5600,89.45,1.79,8.77,2019,29369
272,9,32,313,86.9,2.88,10.22,2019,29370
857,34,409,1300,65.92,2.62,31.46,2019,29374
2203,102,491,2796,78.79,3.65,17.56,2019,29385
374,47,402,823,45.44,5.71,48.85,2019,29448
13205,68,548,13821,95.54,0.49,3.96,2019,29466
2181,34,535,2750,79.31,1.24,19.45,2019,29472
6613,513,1310,8436,78.39,6.08,15.53,2019,29488
14821,574,3280,18675,79.36,3.07,17.56,2019,29501
2248,323,1298,3869,58.1,8.35,33.55,2019,29510
2544,78,693,3315,76.74,2.35,20.9,2019,29541
130,0,64,194,67.01,0.0,32.99,2019,29943
4973,105,1197,6275,79.25,1.67,19.08,2019,29388
3106,166,362,3634,85.47,4.57,9.96,2019,29401
7186,316,2827,10329,69.57,3.06,27.37,2019,29405
13181,2173,1019,16373,80.5,13.27,6.22,2019,29412
0,0,0,0,,,,2019,29423
345,76,168,589,58.57,12.9,28.52,2019,29426
1567,34,891,2492,62.88,1.36,35.75,2019,29003
510,32,200,742,68.73,4.31,26.95,2019,29030
129,0,65,194,66.49,0.0,33.51,2019,29051
2857,91,547,3495,81.75,2.6,15.65,2019,29054
13228,177,1007,14412,91.78,1.23,6.99,2019,29063
802,34,427,1263,63.5,2.69,33.81,2019,29018
4619,118,869,5606,82.39,2.1,15.5,2019,29033
509,44,115,668,76.2,6.59,17.22,2019,29052
1038,71,810,1919,54.09,3.7,42.21,2019,29069
9,0,5,14,64.29,0.0,35.71,2019,29079
0,0,0,0,,,,2019,30164
20,0,8,28,71.43,0.0,28.57,2019,30284
15,0,1,16,93.75,0.0,6.25,2019,30289
0,0,0,0,,,,2019,30332
0,0,0,0,,,,2019,30334
1913,161,36,2110,90.66,7.63,1.71,2019,30363
31,0,11,42,73.81,0.0,26.19,2019,30449
6391,336,1679,8406,76.03,4.0,19.97,2019,31024
2246,30,122,2398,93.66,1.25,5.09,2019,31028
0,0,0,0,,,,2019,31039
477,21,196,694,68.73,3.03,28.24,2019,31049
155,18,6,179,86.59,10.06,3.35,2019,31772
216,25,52,293,73.72,8.53,17.75,2019,31784
171,0,92,263,65.02,0.0,34.98,2019,31812
391,6,271,668,58.53,0.9,40.57,2019,31824
644,23,360,1027,62.71,2.24,35.05,2019,31825
105,8,26,139,75.54,5.76,18.71,2019,31832
14,9,14,37,37.84,24.32,37.84,2019,31003
236,4,190,430,54.88,0.93,44.19,2019,31007
423,14,187,624,67.79,2.24,29.97,2019,31022
3495,160,1876,5531,63.19,2.89,33.92,2019,31023
455,13,370,838,54.3,1.55,44.15,2019,31057
219,0,109,328,66.77,0.0,33.23,2019,31307
2370,58,135,2563,92.47,2.26,5.27,2019,31315
3559,196,414,4169,85.37,4.7,9.93,2019,31316
2556,79,465,3100,82.45,2.55,15.0,2019,31320
2614,217,744,3575,73.12,6.07,20.81,2019,31329
11299,430,2188,13917,81.19,3.09,15.72,2019,31405
11275,405,1770,13450,83.83,3.01,13.16,2019,31406
4056,139,124,4319,93.91,3.22,2.87,2019,31411
493,39,284,816,60.42,4.78,34.8,2019,31512
815,131,333,1279,63.72,10.24,26.04,2019,31557
1731,67,648,2446,70.77,2.74,26.49,2019,31031
682,35,297,1014,67.26,3.45,29.29,2019,31002
446,0,280,726,61.43,0.0,38.57,2019,31020
502,0,219,721,69.63,0.0,30.37,2019,31033
4471,223,424,5118,87.36,4.36,8.28,2019,31047
19,3,35,57,33.33,5.26,61.4,2019,31051
2610,103,488,3201,81.54,3.22,15.25,2019,31052
2242,162,964,3368,66.57,4.81,28.62,2019,31201
19121,382,2397,21900,87.31,1.74,10.95,2019,31419
2281,157,931,3369,67.71,4.66,27.63,2019,31510
5850,466,2754,9070,64.5,5.14,30.36,2019,31520
1998,186,820,3004,66.51,6.19,27.3,2019,31537
1090,237,500,1827,59.66,12.97,27.37,2019,31553
739,70,155,964,76.66,7.26,16.08,2019,31560
281,17,221,519,54.14,3.28,42.58,2019,31563
347,58,392,797,43.54,7.28,49.18,2019,31622
1098,28,383,1509,72.76,1.86,25.38,2019,31626
963,173,444,1580,60.95,10.95,28.1,2019,31642
0,0,0,0,,,,2019,31699
106,2,56,164,64.63,1.22,34.15,2019,31722
46,0,80,126,36.51,0.0,63.49,2019,31083
330,0,189,519,63.58,0.0,36.42,2019,31733
193,5,216,414,46.62,1.21,52.17,2019,31783
418,82,191,691,60.49,11.87,27.64,2019,31641
1704,67,292,2063,82.6,3.25,14.15,2019,31569
2705,264,913,3882,69.68,6.8,23.52,2019,31620
71,9,34,114,62.28,7.89,29.82,2019,31627
4485,254,584,5323,84.26,4.77,10.97,2019,33187
12755,176,1496,14427,88.41,1.22,10.37,2019,33193
1686,0,167,1853,90.99,0.0,9.01,2019,33031
11614,222,1358,13194,88.02,1.68,10.29,2019,33032
1829,89,170,2088,87.6,4.26,8.14,2019,33043
4041,103,188,4332,93.28,2.38,4.34,2019,33146
8385,1378,4548,14311,58.59,9.63,31.78,2019,33147
4128,120,180,4428,93.22,2.71,4.07,2019,33149
11453,1084,4097,16634,68.85,6.52,24.63,2019,33161
11116,342,2559,14017,79.3,2.44,18.26,2019,33172
12437,489,2717,15643,79.51,3.13,17.37,2019,33175
4161,142,372,4675,89.01,3.04,7.96,2019,33190
5346,116,606,6068,88.1,1.91,9.99,2019,33315
5649,221,1122,6992,80.79,3.16,16.05,2019,33405
9425,227,1295,10947,86.1,2.07,11.83,2019,33409
4566,10,462,5038,90.63,0.2,9.17,2019,33413
8739,355,873,9967,87.68,3.56,8.76,2019,33426
5796,137,660,6593,87.91,2.08,10.01,2019,33469
1248,64,896,2208,56.52,2.9,40.58,2019,33471
11298,401,2478,14177,79.69,2.83,17.48,2019,33484
5141,295,1152,6588,78.04,4.48,17.49,2019,33004
9632,469,5193,15294,62.98,3.07,33.95,2019,33010
15083,650,2602,18335,82.26,3.55,14.19,2019,33021
15934,915,3727,20576,77.44,4.45,18.11,2019,33023
21963,1264,2237,25464,86.25,4.96,8.78,2019,33025
365,15,611,991,36.83,1.51,61.65,2019,33857
3794,64,321,4179,90.79,1.53,7.68,2019,33947
6728,489,1102,8319,80.88,5.88,13.25,2019,33066
4619,413,1705,6737,68.56,6.13,25.31,2019,33168
12752,2149,5058,19959,63.89,10.77,25.34,2019,33313
15648,747,1917,18312,85.45,4.08,10.47,2019,33437
7842,82,263,8187,95.79,1.0,3.21,2019,33185
12940,427,3219,16586,78.02,2.57,19.41,2019,33415
2630,241,932,3803,69.16,6.34,24.51,2019,33540
10672,365,2171,13208,80.8,2.76,16.44,2019,33619
7274,421,2041,9736,74.71,4.32,20.96,2019,33755
689,6,47,742,92.86,0.81,6.33,2019,33786
3424,82,438,3944,86.82,2.08,11.11,2019,33954
3480,72,219,3771,92.28,1.91,5.81,2019,33182
100,0,0,100,100.0,0.0,0.0,2019,33039
300,20,0,320,93.75,6.25,0.0,2019,33051
0,0,0,0,,,,2019,33101
3822,66,82,3970,96.27,1.66,2.07,2019,33449
6945,381,641,7967,87.17,4.78,8.05,2019,33472
3799,142,28,3969,95.72,3.58,0.71,2019,33473
57,0,0,57,100.0,0.0,0.0,2019,33503
7770,314,1926,10010,77.62,3.14,19.24,2019,33542
5743,133,248,6124,93.78,2.17,4.05,2019,33545
2492,13,100,2605,95.66,0.5,3.84,2019,33548
8312,190,545,9047,91.88,2.1,6.02,2019,33558
6011,274,458,6743,89.14,4.06,6.79,2019,33559
7765,504,1670,9939,78.13,5.07,16.8,2019,33563
18397,352,1099,19848,92.69,1.77,5.54,2019,33578
10697,157,242,11096,96.4,1.41,2.18,2019,33579
9642,177,200,10019,96.24,1.77,2.0,2019,33596
0,0,0,0,,,,2019,33744
3619,465,244,4328,83.62,10.74,5.64,2019,33812
77,0,111,188,40.96,0.0,59.04,2019,33854
0,0,0,0,,,,2019,33855
238,25,78,341,69.79,7.33,22.87,2019,36374
5468,195,1644,7307,74.83,2.67,22.5,2019,36507
159,7,25,191,83.25,3.66,13.09,2019,36052
5819,240,1442,7501,77.58,3.2,19.22,2019,36092
781,50,449,1280,61.02,3.91,35.08,2019,36273
13,0,0,13,100.0,0.0,0.0,2019,36038
0,0,0,0,,,,2019,36082
0,0,0,0,,,,2019,36112
449,7,166,622,72.19,1.13,26.69,2019,36321
2893,90,835,3818,75.77,2.36,21.87,2019,36421
99,4,89,192,51.56,2.08,46.35,2019,36439
5,0,0,5,100.0,0.0,0.0,2019,36454
0,0,20,20,0.0,0.0,100.0,2019,36512
28,0,13,41,68.29,0.0,31.71,2019,36543
287,12,48,347,82.71,3.46,13.83,2019,36555
22,0,46,68,32.35,0.0,67.65,2019,36568
0,0,0,0,,,,2019,36590
0,0,0,0,,,,2019,36615
8,0,0,8,100.0,0.0,0.0,2019,36616
0,0,0,0,,,,2019,36688
0,0,8,8,0.0,0.0,100.0,2019,36753
9,0,7,16,56.25,0.0,43.75,2019,36766
0,0,8,8,0.0,0.0,100.0,2019,36859
11,0,1,12,91.67,0.0,8.33,2019,36865
8,0,9,17,47.06,0.0,52.94,2019,36913
3709,781,2753,7243,51.21,10.78,38.01,2019,36108
456,11,198,665,68.57,1.65,29.77,2019,36256
285,10,0,295,96.61,3.39,0.0,2019,36115
2067,104,836,3007,68.74,3.46,27.8,2019,36323
495,18,72,585,84.62,3.08,12.31,2019,36528
14144,703,2885,17732,79.77,3.96,16.27,2019,37918
11231,305,1646,13182,85.2,2.31,12.49,2019,37919
13401,723,3046,17170,78.05,4.21,17.74,2019,37920
415,2,146,563,73.71,0.36,25.93,2019,37059
3481,45,514,4040,86.16,1.11,12.72,2019,37062
6889,48,80,7017,98.18,0.68,1.14,2019,37069
10777,413,1343,12533,85.99,3.3,10.72,2019,37072
1969,89,268,2326,84.65,3.83,11.52,2019,37082
14055,926,2652,17633,79.71,5.25,15.04,2019,37087
380,0,0,380,100.0,0.0,0.0,2019,37118
18053,673,917,19643,91.91,3.43,4.67,2019,37128
8072,199,993,9264,87.13,2.15,10.72,2019,37138
12,0,15,27,44.44,0.0,55.56,2019,37140
1282,32,561,1875,68.37,1.71,29.92,2019,37150
1024,117,264,1405,72.88,8.33,18.79,2019,37180
382,14,180,576,66.32,2.43,31.25,2019,37181
10366,1287,3256,14909,69.53,8.63,21.84,2019,37207
6013,262,1699,7974,75.41,3.29,21.31,2019,37208
344,15,227,586,58.7,2.56,38.74,2019,37337
1055,78,374,1507,70.01,5.18,24.82,2019,37342
681,22,34,737,92.4,2.99,4.61,2019,37350
7442,683,2093,10218,72.83,6.68,20.48,2019,37355
951,11,446,1408,67.54,0.78,31.68,2019,37362
927,72,532,1531,60.55,4.7,34.75,2019,37410
5369,187,1765,7321,73.34,2.55,24.11,2019,37411
17270,482,3008,20760,83.19,2.32,14.49,2019,37421
649,62,284,995,65.23,6.23,28.54,2019,37332
477,19,288,784,60.84,2.42,36.73,2019,37339
14844,311,2125,17280,85.9,1.8,12.3,2019,37343
4182,67,1359,5608,74.57,1.19,24.23,2019,41056
6188,113,843,7144,86.62,1.58,11.8,2019,41076
1051,36,173,1260,83.41,2.86,13.73,2019,41092
259,8,35,302,85.76,2.65,11.59,2019,41203
119,27,83,229,51.97,11.79,36.24,2019,41204
286,10,104,400,71.5,2.5,26.0,2019,41332
1091,0,253,1344,81.18,0.0,18.82,2019,41514
385,30,12,427,90.16,7.03,2.81,2019,41531
31,0,0,31,100.0,0.0,0.0,2019,41538
216,21,89,326,66.26,6.44,27.3,2019,41666
149,0,8,157,94.9,0.0,5.1,2019,41712
500,0,95,595,84.03,0.0,15.97,2019,41719
486,0,222,708,68.64,0.0,31.36,2019,41723
379,37,106,522,72.61,7.09,20.31,2019,41776
109,43,11,163,66.87,26.38,6.75,2019,41810
65,0,60,125,52.0,0.0,48.0,2019,41812
66,0,27,93,70.97,0.0,29.03,2019,41817
202,23,36,261,77.39,8.81,13.79,2019,41232
437,20,169,626,69.81,3.19,27.0,2019,41043
218,0,210,428,50.93,0.0,49.07,2019,41554
177,8,25,210,84.29,3.81,11.9,2019,41804
1639,41,1059,2739,59.84,1.5,38.66,2019,41311
177,0,34,211,83.89,0.0,16.11,2019,41663
107,0,32,139,76.98,0.0,23.02,2019,41832
9667,341,2159,12167,79.45,2.8,17.74,2019,41011
701,32,270,1003,69.89,3.19,26.92,2019,41002
7751,108,664,8523,90.94,1.27,7.79,2019,41005
1876,104,877,2857,65.66,3.64,30.7,2019,41008
1803,62,498,2363,76.3,2.62,21.07,2019,41030
215,11,77,303,70.96,3.63,25.41,2019,41034
9,5,39,53,16.98,9.43,73.58,2019,41135
74,92,34,200,37.0,46.0,17.0,2019,41360
230,4,65,299,76.92,1.34,21.74,2019,41512
0,0,12,12,0.0,0.0,100.0,2019,41062
0,0,0,0,,,,2019,41099
66,0,0,66,100.0,0.0,0.0,2019,41271
194,4,72,270,71.85,1.48,26.67,2019,41352
4,0,15,19,21.05,0.0,78.95,2019,41366
63,13,0,76,82.89,17.11,0.0,2019,41517
65,0,11,76,85.53,0.0,14.47,2019,41526
26,0,6,32,81.25,0.0,18.75,2019,41643
70,0,0,70,100.0,0.0,0.0,2019,41713
0,0,0,0,,,,2019,41848
1661,71,419,2151,77.22,3.3,19.48,2019,41074
682,30,286,998,68.34,3.01,28.66,2019,41086
921,34,256,1211,76.05,2.81,21.14,2019,41093
875,85,399,1359,64.39,6.25,29.36,2019,41095
1818,82,449,2349,77.39,3.49,19.11,2019,41097
6284,175,1163,7622,82.45,2.3,15.26,2019,41102
3062,117,527,3706,82.62,3.16,14.22,2019,41129
547,35,158,740,73.92,4.73,21.35,2019,41141
2654,425,1403,4482,59.21,9.48,31.3,2019,41164
1145,28,499,1672,68.48,1.67,29.84,2019,41171
88,29,25,142,61.97,20.42,17.61,2019,41264
125,50,68,243,51.44,20.58,27.98,2019,41616
81,0,0,81,100.0,0.0,0.0,2019,42022
376,20,76,472,79.66,4.24,16.1,2019,42024
507,26,180,713,71.11,3.65,25.25,2019,42020
77,0,66,143,53.85,0.0,46.15,2019,42047
5057,265,2744,8066,62.7,3.29,34.02,2019,29108
1044,23,645,1712,60.98,1.34,37.68,2019,29112
2681,111,731,3523,76.1,3.15,20.75,2019,29127
1849,88,624,2561,72.2,3.44,24.37,2019,29130
2266,80,1272,3618,62.63,2.21,35.16,2019,29138
10976,653,3573,15202,72.2,4.3,23.5,2019,29150
5027,171,1905,7103,70.77,2.41,26.82,2019,29204
2645,125,1085,3855,68.61,3.24,28.15,2019,29006
2499,171,1691,4361,57.3,3.92,38.78,2019,29010
273,12,183,468,58.33,2.56,39.1,2019,29031
1166,108,737,2011,57.98,5.37,36.65,2019,29048
26,0,28,54,48.15,0.0,51.85,2019,29062
180,17,58,255,70.59,6.67,22.75,2019,29065
2247,265,934,3446,65.21,7.69,27.1,2019,29067
15029,396,2124,17549,85.64,2.26,12.1,2019,29073
723,0,426,1149,62.92,0.0,37.08,2019,29107
3475,362,2161,5998,57.94,6.04,36.03,2019,29536
1565,81,373,2019,77.51,4.01,18.47,2019,29544
1238,272,1106,2616,47.32,10.4,42.28,2019,29565
7174,452,648,8274,86.71,5.46,7.83,2019,29575
6101,203,667,6971,87.52,2.91,9.57,2019,29585
5361,442,1277,7080,75.72,6.24,18.04,2019,29630
881,68,232,1181,74.6,5.76,19.64,2019,29638
7347,393,3360,11100,66.19,3.54,30.27,2019,29646
14911,149,2729,17789,83.82,0.84,15.34,2019,29651
2446,95,1107,3648,67.05,2.6,30.35,2019,29654
5458,202,552,6212,87.86,3.25,8.89,2019,29662
3380,162,1182,4724,71.55,3.43,25.02,2019,29669
230,0,143,373,61.66,0.0,38.34,2019,29828
8208,256,2346,10810,75.93,2.37,21.7,2019,29801
228,0,162,390,58.46,0.0,41.54,2019,29816
43,3,55,101,42.57,2.97,54.46,2019,29826
37,0,55,92,40.22,0.0,59.78,2019,29850
903,54,171,1128,80.05,4.79,15.16,2019,29856
6634,786,1510,8930,74.29,8.8,16.91,2019,29906
555,28,86,669,82.96,4.19,12.86,2019,29916
7153,293,372,7818,91.49,3.75,4.76,2019,29928
277,16,98,391,70.84,4.09,25.06,2019,29929
2171,59,1026,3256,66.68,1.81,31.51,2019,29160
4287,151,1492,5930,72.29,2.55,25.16,2019,29070
356,0,163,519,68.59,0.0,31.41,2019,29113
133,0,111,244,54.51,0.0,45.49,2019,29133
1314,9,735,2058,63.85,0.44,35.71,2019,29164
9278,231,1341,10850,85.51,2.13,12.36,2019,29205
10827,521,2125,13473,80.36,3.87,15.77,2019,29301
1410,101,332,1843,76.51,5.48,18.01,2019,29335
5973,234,2029,8236,72.52,2.84,24.64,2019,29360
1778,176,426,2380,74.71,7.39,17.9,2019,29431
1677,87,104,1868,89.78,4.66,5.57,2019,29451
50,0,9,59,84.75,0.0,15.25,2019,29493
7626,336,1794,9756,78.17,3.44,18.39,2019,29505
149,35,22,206,72.33,16.99,10.68,2019,29543
370,68,429,867,42.68,7.84,49.48,2019,29563
223,12,138,373,59.79,3.22,37.0,2019,29564
3322,590,2349,6261,53.06,9.42,37.52,2019,29624
4871,418,1906,7195,67.7,5.81,26.49,2019,29627
11934,234,1248,13416,88.95,1.74,9.3,2019,29650
1250,57,444,1751,71.39,3.26,25.36,2019,29653
3583,216,2302,6101,58.73,3.54,37.73,2019,29512
189,71,194,454,41.63,15.64,42.73,2019,31649
7305,418,3136,10859,67.27,3.85,28.88,2019,31705
1443,12,808,2263,63.76,0.53,35.7,2019,31714
811,45,217,1073,75.58,4.19,20.22,2019,31716
85,0,16,101,84.16,0.0,15.84,2019,31743
803,33,379,1215,66.09,2.72,31.19,2019,31744
615,48,318,981,62.69,4.89,32.42,2019,31749
1399,114,887,2400,58.29,4.75,36.96,2019,31774
400,19,311,730,54.79,2.6,42.6,2019,31795
947,15,105,1067,88.75,1.41,9.84,2019,31807
407,32,328,767,53.06,4.17,42.76,2019,31815
79,0,0,79,100.0,0.0,0.0,2019,31821
297,0,46,343,86.59,0.0,13.41,2019,31823
10237,359,2148,12744,80.33,2.82,16.85,2019,31904
13312,552,1227,15091,88.21,3.66,8.13,2019,31909
3034,166,1094,4294,70.66,3.87,25.48,2019,31415
647,27,380,1054,61.39,2.56,36.05,2019,31044
549,21,333,903,60.8,2.33,36.88,2019,31079
8712,87,856,9655,90.23,0.9,8.87,2019,31322
2636,198,1163,3997,65.95,4.95,29.1,2019,31639
26,0,52,78,33.33,0.0,66.67,2019,31747
1410,111,560,2081,67.76,5.33,26.91,2019,31816
0,0,0,0,,,,2019,31062
17,8,11,36,47.22,22.22,30.56,2019,31084
0,0,0,0,,,,2019,31207
0,0,0,0,,,,2019,31213
35,0,0,35,100.0,0.0,0.0,2019,31304
43,0,0,43,100.0,0.0,0.0,2019,31409
0,0,0,0,,,,2019,31524
67,0,0,67,100.0,0.0,0.0,2019,31547
21,5,6,32,65.62,15.62,18.75,2019,31556
17,0,13,30,56.67,0.0,43.33,2019,31561
501,34,224,759,66.01,4.48,29.51,2019,31562
0,0,0,0,,,,2019,31698
2139,101,1145,3385,63.19,2.98,33.83,2019,31719
287,0,190,477,60.17,0.0,39.83,2019,31796
1050,247,833,2130,49.3,11.6,39.11,2019,31803
1345,50,456,1851,72.66,2.7,24.64,2019,31806
2437,112,110,2659,91.65,4.21,4.14,2019,31808
1860,28,235,2123,87.61,1.32,11.07,2019,31811
904,37,317,1258,71.86,2.94,25.2,2019,31831
3833,452,2658,6943,55.21,6.51,38.28,2019,31903
3378,68,92,3538,95.48,1.92,2.6,2019,31905
6176,175,1181,7532,82.0,2.32,15.68,2019,31069
0,16,0,16,0.0,100.0,0.0,2019,31081
1451,168,881,2500,58.04,6.72,35.24,2019,31096
358,47,67,472,75.85,9.96,14.19,2019,31097
4610,169,1573,6352,72.58,2.66,24.76,2019,31211
97,0,12,109,88.99,0.0,11.01,2019,31318
3525,227,1666,5418,65.06,4.19,30.75,2019,31516
832,75,480,1387,59.99,5.41,34.61,2019,31519
7064,130,428,7622,92.68,1.71,5.62,2019,31522
8755,376,2356,11487,76.22,3.27,20.51,2019,31525
2091,84,466,2641,79.17,3.18,17.64,2019,31546
6575,323,898,7796,84.34,4.14,11.52,2019,31548
948,3,49,1000,94.8,0.3,4.9,2019,31098
6079,105,748,6932,87.69,1.51,10.79,2019,31312
93,0,60,153,60.78,0.0,39.22,2019,31327
3770,113,236,4119,91.53,2.74,5.73,2019,31820
153,29,9,191,80.1,15.18,4.71,2019,33856
3270,132,930,4332,75.48,3.05,21.47,2019,33859
166,0,0,166,100.0,0.0,0.0,2019,33867
3844,138,719,4701,81.77,2.94,15.29,2019,33875
1645,40,348,2033,80.91,1.97,17.12,2019,33876
2688,583,339,3610,74.46,16.15,9.39,2019,33896
5242,1188,579,7009,74.79,16.95,8.26,2019,33897
4840,298,1180,6318,76.61,4.72,18.68,2019,33898
0,0,0,0,,,,2019,33965
4059,17,173,4249,95.53,0.4,4.07,2019,33966
7342,286,562,8190,89.65,3.49,6.86,2019,33967
3094,392,611,4097,75.52,9.57,14.91,2019,33973
4118,178,396,4692,87.77,3.79,8.44,2019,33974
3875,171,509,4555,85.07,3.75,11.17,2019,33976
11352,82,572,12006,94.55,0.68,4.76,2019,33076
3111,13,769,3893,79.91,0.33,19.75,2019,33170
4464,106,491,5061,88.2,2.09,9.7,2019,33316
7348,155,656,8159,90.06,1.9,8.04,2019,33470
3507,119,1118,4744,73.92,2.51,23.57,2019,33034
10525,425,1219,12169,86.49,3.49,10.02,2019,33334
11333,498,1625,13456,84.22,3.7,12.08,2019,33446
8277,343,1248,9868,83.88,3.48,12.65,2019,33570
6698,137,603,7438,90.05,1.84,8.11,2019,33634
827,62,594,1483,55.77,4.18,40.05,2019,33890
2375,235,893,3503,67.8,6.71,25.49,2019,33843
6921,2811,2421,12153,56.95,23.13,19.92,2019,33844
39,5,3,47,82.98,10.64,6.38,2019,33847
5651,1063,1427,8141,69.41,13.06,17.53,2019,33860
2781,181,1527,4489,61.95,4.03,34.02,2019,33873
8712,2247,1014,11973,72.76,18.77,8.47,2019,33884
292,0,39,331,88.22,0.0,11.78,2019,33921
30,11,4,45,66.67,24.44,8.89,2019,33924
10179,95,420,10694,95.18,0.89,3.93,2019,33629
10001,139,703,10843,92.23,1.28,6.48,2019,33703
7082,553,1561,9196,77.01,6.01,16.97,2019,33712
2578,214,868,3660,70.44,5.85,23.72,2019,33513
1287,131,565,1983,64.9,6.61,28.49,2019,33538
7248,120,627,7995,90.66,1.5,7.84,2019,33547
7784,162,460,8406,92.6,1.93,5.47,2019,33606
6109,94,594,6797,89.88,1.38,8.74,2019,33616
14525,698,1618,16841,86.25,4.14,9.61,2019,33068
193,17,0,210,91.9,8.1,0.0,2019,33109
10326,1419,7970,19715,52.38,7.2,40.43,2019,33142
7038,173,2051,9262,75.99,1.87,22.14,2019,33144
6325,93,1479,7897,80.09,1.18,18.73,2019,33189
6667,409,262,7338,90.86,5.57,3.57,2019,33323
3082,58,33,3173,97.13,1.83,1.04,2019,33332
22003,561,1991,24555,89.61,2.28,8.11,2019,33411
7088,214,672,7974,88.89,2.68,8.43,2019,33431
9315,246,1543,11104,83.89,2.22,13.9,2019,33441
11484,250,956,12690,90.5,1.97,7.53,2019,33594
6171,156,489,6816,90.54,2.29,7.17,2019,33549
9152,70,579,9801,93.38,0.71,5.91,2019,33569
10718,370,1828,12916,82.98,2.86,14.15,2019,33573
7306,318,928,8552,85.43,3.72,10.85,2019,33602
14311,214,665,15190,94.21,1.41,4.38,2019,33624
11791,356,1564,13711,86.0,2.6,11.41,2019,33710
6491,210,1232,7933,81.82,2.65,15.53,2019,33759
2437,74,182,2693,90.49,2.75,6.76,2019,33762
97,0,33,130,74.62,0.0,25.38,2019,37351
1470,70,509,2049,71.74,3.42,24.84,2019,37370
972,3,124,1099,88.44,0.27,11.28,2019,37373
64,0,75,139,46.04,0.0,53.96,2019,37376
843,19,363,1225,68.82,1.55,29.63,2019,37387
2765,54,964,3783,73.09,1.43,25.48,2019,37397
3571,128,1249,4948,72.17,2.59,25.24,2019,37404
4964,177,1335,6476,76.65,2.73,20.61,2019,37416
4636,96,815,5547,83.58,1.73,14.69,2019,37617
4321,223,1002,5546,77.91,4.02,18.07,2019,37618
2672,172,1064,3908,68.37,4.4,27.23,2019,37641
3428,228,1708,5364,63.91,4.25,31.84,2019,37650
1187,36,379,1602,74.09,2.25,23.66,2019,37656
3491,165,1348,5004,69.76,3.3,26.94,2019,37854
2130,48,465,2643,80.59,1.82,17.59,2019,37885
1321,14,403,1738,76.01,0.81,23.19,2019,37886
1483,38,469,1990,74.52,1.91,23.57,2019,37887
1018,4,393,1415,71.94,0.28,27.77,2019,37891
9363,430,1438,11231,83.37,3.83,12.8,2019,37659
1639,104,735,2478,66.14,4.2,29.66,2019,37665
1371,32,217,1620,84.63,1.98,13.4,2019,37705
1837,102,557,2496,73.6,4.09,22.32,2019,37708
1138,42,347,1527,74.53,2.75,22.72,2019,37709
8494,264,2031,10789,78.73,2.45,18.82,2019,37716
3963,216,926,5105,77.63,4.23,18.14,2019,37721
4743,269,1689,6701,70.78,4.01,25.21,2019,37748
708,41,298,1047,67.62,3.92,28.46,2019,37809
5709,688,2288,8685,65.73,7.92,26.34,2019,37821
2201,94,1409,3704,59.42,2.54,38.04,2019,37825
140,0,72,212,66.04,0.0,33.96,2019,37845
8852,144,1090,10086,87.77,1.43,10.81,2019,37849
519,14,114,647,80.22,2.16,17.62,2019,37866
988,161,887,2036,48.53,7.91,43.57,2019,37869
2088,240,543,2871,72.73,8.36,18.91,2019,37890
6253,265,832,7350,85.07,3.61,11.32,2019,37909
950,28,41,1019,93.23,2.75,4.02,2019,37014
1341,51,331,1723,77.83,2.96,19.21,2019,37031
1206,66,444,1716,70.28,3.85,25.87,2019,37032
18948,585,1832,21365,88.69,2.74,8.57,2019,37129
207,25,105,337,61.42,7.42,31.16,2019,37057
2041,64,742,2847,71.69,2.25,26.06,2019,37074
5488,100,1419,7007,78.32,1.43,20.25,2019,38351
818,2,230,1050,77.9,0.19,21.9,2019,38357
107,5,16,128,83.59,3.91,12.5,2019,38359
461,24,204,689,66.91,3.48,29.61,2019,38856
686,98,302,1086,63.17,9.02,27.81,2019,38873
159,5,51,215,73.95,2.33,23.72,2019,38947
123,0,68,191,64.4,0.0,35.6,2019,38950
260,0,104,364,71.43,0.0,28.57,2019,38454
280,40,180,500,56.0,8.0,36.0,2019,38461
1443,41,484,1968,73.32,2.08,24.59,2019,38468
1156,39,395,1590,72.7,2.45,24.84,2019,38469
264,20,95,379,69.66,5.28,25.07,2019,38487
258,0,69,327,78.9,0.0,21.1,2019,38548
1021,5,233,1259,81.1,0.4,18.51,2019,38563
594,0,67,661,89.86,0.0,10.14,2019,38580
396,0,243,639,61.97,0.0,38.03,2019,38587
711,98,488,1297,54.82,7.56,37.63,2019,38620
195,21,110,326,59.82,6.44,33.74,2019,38622
3159,112,1091,4362,72.42,2.57,25.01,2019,39581
788,57,515,1360,57.94,4.19,37.87,2019,39631
3912,442,2965,7319,53.45,6.04,40.51,2019,39648
444,0,119,563,78.86,0.0,21.14,2019,39096
14380,288,749,15417,93.27,1.87,4.86,2019,39110
1863,272,897,3032,61.44,8.97,29.58,2019,39111
20,0,0,20,100.0,0.0,0.0,2019,39115
494,100,359,953,51.84,10.49,37.67,2019,39140
144,10,36,190,75.79,5.26,18.95,2019,39144
1363,31,647,2041,66.78,1.52,31.7,2019,39145
9438,155,1114,10707,88.15,1.45,10.4,2019,39157
761,47,419,1227,62.02,3.83,34.15,2019,39159
9484,513,2580,12577,75.41,4.08,20.51,2019,39180
2741,49,775,3565,76.89,1.37,21.74,2019,39202
8084,111,1763,9958,81.18,1.11,17.7,2019,39206
481,4,305,790,60.89,0.51,38.61,2019,39039
1091,66,336,1493,73.07,4.42,22.51,2019,39041
3609,351,1829,5789,62.34,6.06,31.59,2019,39051
69,51,164,284,24.3,17.96,57.75,2019,39078
27,0,5,32,84.38,0.0,15.62,2019,39088
521,136,563,1220,42.7,11.15,46.15,2019,39663
117,0,168,285,41.05,0.0,58.95,2019,39348
0,0,0,0,,,,2019,39269
1048,98,357,1503,69.73,6.52,23.75,2019,39327
423,63,240,726,58.26,8.68,33.06,2019,39337
237,57,189,483,49.07,11.8,39.13,2019,39358
96,7,23,126,76.19,5.56,18.25,2019,39359
905,38,354,1297,69.78,2.93,27.29,2019,39362
3653,247,1829,5729,63.76,4.31,31.93,2019,39367
1021,97,746,1864,54.77,5.2,40.02,2019,39422
2323,168,1177,3668,63.33,4.58,32.09,2019,39117
414,0,147,561,73.8,0.0,26.2,2019,39149
9382,124,793,10299,91.1,1.2,7.7,2019,39211
1445,42,254,1741,83.0,2.41,14.59,2019,39216
6927,589,2887,10403,66.59,5.66,27.75,2019,39301
873,77,878,1828,47.76,4.21,48.03,2019,39328
469,17,74,560,83.75,3.04,13.21,2019,39332
1380,137,926,2443,56.49,5.61,37.9,2019,39341
1804,105,824,2733,66.01,3.84,30.15,2019,39355
382,38,201,621,61.51,6.12,32.37,2019,39361
13884,250,1443,15577,89.13,1.6,9.26,2019,39402
32,0,48,80,40.0,0.0,60.0,2019,41367
604,10,243,857,70.48,1.17,28.35,2019,41049
9234,258,714,10206,90.48,2.53,7.0,2019,41051
563,9,133,705,79.86,1.28,18.87,2019,41055
4885,238,320,5443,89.75,4.37,5.88,2019,41094
2689,86,488,3263,82.41,2.64,14.96,2019,41139
117,0,71,188,62.23,0.0,37.77,2019,41149
537,22,63,622,86.33,3.54,10.13,2019,41183
486,14,281,781,62.23,1.79,35.98,2019,41219
2741,348,1179,4268,64.22,8.15,27.62,2019,41230
373,12,102,487,76.59,2.46,20.94,2019,41250
78,6,80,164,47.56,3.66,48.78,2019,41254
170,8,41,219,77.63,3.65,18.72,2019,41257
1121,49,680,1850,60.59,2.65,36.76,2019,41314
118,11,17,146,80.82,7.53,11.64,2019,41563
156,0,151,307,50.81,0.0,49.19,2019,41564
256,0,52,308,83.12,0.0,16.88,2019,41566
287,0,158,445,64.49,0.0,35.51,2019,41568
9583,399,2534,12516,76.57,3.19,20.25,2019,29550
15511,328,800,16639,93.22,1.97,4.81,2019,29579
667,15,287,969,68.83,1.55,29.62,2019,29584
1058,108,722,1888,56.04,5.72,38.24,2019,29591
5524,268,2279,8071,68.44,3.32,28.24,2019,29532
1034,81,631,1746,59.22,4.64,36.14,2019,29540
414,14,175,603,68.66,2.32,29.02,2019,29545
478,45,479,1002,47.7,4.49,47.8,2019,29546
576,0,249,825,69.82,0.0,30.18,2019,29834
2202,80,651,2933,75.08,2.73,22.2,2019,29835
51,5,16,72,70.83,6.94,22.22,2019,29844
1692,81,756,2529,66.9,3.2,29.89,2019,29853
5349,131,588,6068,88.15,2.16,9.69,2019,29860
57,0,18,75,76.0,0.0,24.0,2019,29921
1189,33,513,1735,68.53,1.9,29.57,2019,29924
303,0,98,401,75.56,0.0,24.44,2019,29934
80,31,190,301,26.58,10.3,63.12,2019,29592
22,0,56,78,28.21,0.0,71.79,2019,29594
4341,163,1197,5701,76.14,2.86,21.0,2019,29601
3594,255,1346,5195,69.18,4.91,25.91,2019,29620
301,43,33,377,79.84,11.41,8.75,2019,29639
5010,78,1642,6730,74.44,1.16,24.4,2019,29671
6742,410,2184,9336,72.22,4.39,23.39,2019,29678
4411,462,2739,7612,57.95,6.07,35.98,2019,29706
11439,153,745,12337,92.72,1.24,6.04,2019,29715
973,36,532,1541,63.14,2.34,34.52,2019,29718
12174,850,4434,17458,69.73,4.87,25.4,2019,29720
1527,211,1823,3561,42.88,5.93,51.19,2019,29554
1487,45,498,2030,73.25,2.22,24.53,2019,29555
2631,494,1900,5025,52.36,9.83,37.81,2019,29556
6978,461,609,8048,86.7,5.73,7.57,2019,29566
3859,243,540,4642,83.13,5.23,11.63,2019,29572
12622,629,1326,14577,86.59,4.32,9.1,2019,29576
1328,0,705,2033,65.32,0.0,34.68,2019,29583
540,114,282,936,57.69,12.18,30.13,2019,29596
10859,355,2993,14207,76.43,2.5,21.07,2019,29605
9884,229,1988,12101,81.68,1.89,16.43,2019,29609
7789,321,3333,11443,68.07,2.81,29.13,2019,29611
683,47,246,976,69.98,4.82,25.2,2019,29628
2803,109,830,3742,74.91,2.91,22.18,2019,29645
35,2,10,47,74.47,4.26,21.28,2019,29659
81,0,24,105,77.14,0.0,22.86,2019,51648
2136,79,426,2641,80.88,2.99,16.13,2019,51632
110,7,27,144,76.39,4.86,18.75,2019,51631
161,13,31,205,78.54,6.34,15.12,2019,51636
430,33,86,549,78.32,6.01,15.66,2019,51577
338,15,72,425,79.53,3.53,16.94,2019,51557
66,0,32,98,67.35,0.0,32.65,2019,51637
722,77,133,932,77.47,8.26,14.27,2019,51579
1756,227,781,2764,63.53,8.21,28.26,2019,29655
1169,73,361,1603,72.93,4.55,22.52,2019,29684
2455,266,1176,3897,63.0,6.83,30.18,2019,29702
495,42,383,920,53.8,4.57,41.63,2019,29590
3344,219,1551,5114,65.39,4.28,30.33,2019,29560
57,3,85,145,39.31,2.07,58.62,2019,29567
2195,226,1546,3967,55.33,5.7,38.97,2019,29574
6712,433,614,7759,86.51,5.58,7.91,2019,29582
9232,787,2022,12041,76.67,6.54,16.79,2019,29625
354,42,147,543,65.19,7.73,27.07,2019,29635
509,72,269,850,59.88,8.47,31.65,2019,31826
417,47,423,887,47.01,5.3,47.69,2019,31827
6205,274,1996,8475,73.22,3.23,23.55,2019,31906
144,34,120,298,48.32,11.41,40.27,2019,31567
4502,45,865,5412,83.19,0.83,15.98,2019,31523
422,26,21,469,89.98,5.54,4.48,2019,31527
6938,190,714,7842,88.47,2.42,9.1,2019,31721
2510,42,827,3379,74.28,1.24,24.47,2019,31788
2455,55,766,3276,74.94,1.68,23.38,2019,31793
839,42,520,1401,59.89,3.0,37.12,2019,31091
2653,65,768,3486,76.1,1.86,22.03,2019,31331
1308,139,369,1816,72.03,7.65,20.32,2019,31554
406,18,189,613,66.23,2.94,30.83,2019,31787
293,24,212,529,55.39,4.54,40.08,2019,31054
4894,159,615,5668,86.34,2.81,10.85,2019,31220
324,23,25,372,87.1,6.18,6.72,2019,31025
351,12,368,731,48.02,1.64,50.34,2019,31060
4652,90,800,5542,83.94,1.62,14.44,2019,31032
305,46,150,501,60.88,9.18,29.94,2019,31042
749,34,332,1115,67.17,3.05,29.78,2019,31078
263,5,128,396,66.41,1.26,32.32,2019,31309
2670,184,1096,3950,67.59,4.66,27.75,2019,31535
238,12,105,355,67.04,3.38,29.58,2019,31544
252,3,39,294,85.71,1.02,13.27,2019,31629
72,0,55,127,56.69,0.0,43.31,2019,31720
1861,33,224,2118,87.87,1.56,10.58,2019,31804
15970,1010,3372,20352,78.47,4.96,16.57,2019,31907
652,17,441,1110,58.74,1.53,39.73,2019,31805
644,73,174,891,72.28,8.19,19.53,2019,31542
131,32,140,303,43.23,10.56,46.2,2019,31551
806,140,305,1251,64.43,11.19,24.38,2019,31606
1434,55,429,1918,74.77,2.87,22.37,2019,31645
139,20,214,373,37.27,5.36,57.37,2019,31648
124,4,151,279,44.44,1.43,54.12,2019,31711
2169,75,1067,3311,65.51,2.27,32.23,2019,31730
201,0,169,370,54.32,0.0,45.68,2019,31735
634,18,184,836,75.84,2.15,22.01,2019,31738
3954,593,2268,6815,58.02,8.7,33.28,2019,31750
817,16,276,1109,73.67,1.44,24.89,2019,31765
3451,78,1115,4644,74.31,1.68,24.01,2019,31791
6631,229,3642,10502,63.14,2.18,34.68,2019,31794
1020,54,275,1349,75.61,4.0,20.39,2019,31801
105,0,12,117,89.74,0.0,10.26,2019,31814
264,4,115,383,68.93,1.04,30.03,2019,31011
4939,367,2738,8044,61.4,4.56,34.04,2019,31015
6471,380,3129,9980,64.84,3.81,31.35,2019,31021
2843,88,1034,3965,71.7,2.22,26.08,2019,31036
177,0,21,198,89.39,0.0,10.61,2019,31038
441,0,317,758,58.18,0.0,41.82,2019,31058
248,0,243,491,50.51,0.0,49.49,2019,31065
69,7,28,104,66.35,6.73,26.92,2019,31067
251,43,164,458,54.8,9.39,35.81,2019,31094
737,74,331,1142,64.54,6.48,28.98,2019,31775
237,12,218,467,50.75,2.57,46.68,2019,31789
491,17,245,753,65.21,2.26,32.54,2019,31790
203,0,71,274,74.09,0.0,25.91,2019,31798
1658,140,385,2183,75.95,6.41,17.64,2019,31822
5462,90,598,6150,88.81,1.46,9.72,2019,31005
272,21,202,495,54.95,4.24,40.81,2019,31012
10480,583,2341,13404,78.19,4.35,17.46,2019,33771
6077,107,931,7115,85.41,1.5,13.09,2019,33773
6492,207,1046,7745,83.82,2.67,13.51,2019,33774
14550,943,2052,17545,82.93,5.37,11.7,2019,33810
10449,1707,899,13055,80.04,13.08,6.89,2019,33813
6424,1170,2093,9687,66.32,12.08,21.61,2019,33830
1102,61,573,1736,63.48,3.51,33.01,2019,33834
6689,1892,1096,9677,69.12,19.55,11.33,2019,33837
670,170,353,1193,56.16,14.25,29.59,2019,33838
14673,1014,1890,17577,83.48,5.77,10.75,2019,33908
1501,46,157,1704,88.09,2.7,9.21,2019,33922
4568,438,461,5467,83.56,8.01,8.43,2019,33931
4718,352,1841,6911,68.27,5.09,26.64,2019,33935
0,0,0,0,,,,2019,33945
10783,331,2323,13437,80.25,2.46,17.29,2019,33952
4620,98,1057,5775,80.0,1.7,18.3,2019,33980
17308,970,3242,21520,80.43,4.51,15.07,2019,33027
6498,245,2955,9698,67.0,2.53,30.47,2019,33013
13694,342,1602,15638,87.57,2.19,10.24,2019,33033
3473,90,552,4115,84.4,2.19,13.41,2019,33050
18899,789,3219,22907,82.5,3.44,14.05,2019,33063
8365,122,266,8753,95.57,1.39,3.04,2019,33067
8872,255,1367,10494,84.54,2.43,13.03,2019,33069
10875,1237,9237,21349,50.94,5.79,43.27,2019,33125
5657,609,3941,10207,55.42,5.97,38.61,2019,33127
8717,137,263,9117,95.61,1.5,2.88,2019,34638
2632,80,384,3096,85.01,2.58,12.4,2019,34688
6675,269,886,7830,85.25,3.44,11.32,2019,34714
5205,135,308,5648,92.16,2.39,5.45,2019,34715
8266,186,501,8953,92.33,2.08,5.6,2019,34772
11655,650,2524,14829,78.6,4.38,17.02,2019,34653
7936,379,1685,10000,79.36,3.79,16.85,2019,34982
6268,527,1096,7891,79.43,6.68,13.89,2019,34233
5859,133,1081,7073,82.84,1.88,15.28,2019,34951
1780,58,460,2298,77.46,2.52,20.02,2019,34956
3156,259,2342,5757,54.82,4.5,40.68,2019,34972
6484,746,2554,9784,66.27,7.62,26.1,2019,34974
13539,743,1881,16163,83.77,4.6,11.64,2019,34744
1447,59,203,1709,84.67,3.45,11.88,2019,34753
21287,615,1641,23543,90.42,2.61,6.97,2019,34787
6208,297,746,7251,85.62,4.1,10.29,2019,34236
9201,291,2175,11667,78.86,2.49,18.64,2019,36303
598,46,349,993,60.22,4.63,35.15,2019,36311
2096,63,487,2646,79.21,2.38,18.41,2019,36350
3186,98,966,4250,74.96,2.31,22.73,2019,36420
1020,125,575,1720,59.3,7.27,33.43,2019,36451
0,0,51,51,0.0,0.0,100.0,2019,36470
14,0,25,39,35.9,0.0,64.1,2019,36473
536,95,415,1046,51.24,9.08,39.67,2019,36518
11338,130,837,12305,92.14,1.06,6.8,2019,36526
5039,113,572,5724,88.03,1.97,9.99,2019,36527
2408,161,566,3135,76.81,5.14,18.05,2019,36551
566,50,210,826,68.52,6.05,25.42,2019,36553
6690,256,1602,8548,78.26,2.99,18.74,2019,36582
164,0,160,324,50.62,0.0,49.38,2019,36584
206,0,132,338,60.95,0.0,39.05,2019,36585
1425,100,1322,2847,50.05,3.51,46.43,2019,36603
6336,256,3783,10375,61.07,2.47,36.46,2019,36605
1463,134,940,2537,57.67,5.28,37.05,2019,36744
503,41,151,695,72.37,5.9,21.73,2019,38629
204,0,195,399,51.13,0.0,48.87,2019,38639
321,8,206,535,60.0,1.5,38.5,2019,38645
2892,294,1221,4407,65.62,6.67,27.71,2019,38663
1503,53,1179,2735,54.95,1.94,43.11,2019,38666
439,43,172,654,67.13,6.57,26.3,2019,38388
762,17,388,1167,65.3,1.46,33.25,2019,38367
626,4,358,988,63.36,0.4,36.23,2019,38463
6455,287,2083,8825,73.14,3.25,23.6,2019,38464
5451,87,1656,7194,75.77,1.21,23.02,2019,38478
1495,101,515,2111,70.82,4.78,24.4,2019,38483
556,0,127,683,81.41,0.0,18.59,2019,38577
237,0,134,371,63.88,0.0,36.12,2019,38579
3718,286,1526,5530,67.23,5.17,27.59,2019,38606
535,118,413,1066,50.19,11.07,38.74,2019,38610
660,8,96,764,86.39,1.05,12.57,2019,38641
42,0,25,67,62.69,0.0,37.31,2019,38644
13869,936,1722,16527,83.92,5.66,10.42,2019,38655
618,14,334,966,63.98,1.45,34.58,2019,38659
3741,259,860,4860,76.98,5.33,17.7,2019,38668
4159,171,500,4830,86.11,3.54,10.35,2019,38672
123,10,122,255,48.24,3.92,47.84,2019,38744
14,0,41,55,25.45,0.0,74.55,2019,38765
24,0,5,29,82.76,0.0,17.24,2019,38767
75,0,0,75,100.0,0.0,0.0,2019,38768
787,36,328,1151,68.38,3.13,28.5,2019,38841
811,64,344,1219,66.53,5.25,28.22,2019,38847
231,0,80,311,74.28,0.0,25.72,2019,38859
11,0,0,11,100.0,0.0,0.0,2019,38021
227,0,81,308,73.7,0.0,26.3,2019,38042
1026,44,397,1467,69.94,3.0,27.06,2019,38049
2494,417,6221,9132,27.31,4.57,68.12,2019,38106
14492,413,2036,16941,85.54,2.44,12.02,2019,38115
0,0,0,0,,,,2019,38131
485,9,194,688,70.49,1.31,28.2,2019,38871
4990,240,2123,7353,67.86,3.26,28.87,2019,38901
1246,120,652,2018,61.74,5.95,32.31,2019,38916
681,37,462,1180,57.71,3.14,39.15,2019,38922
6639,208,759,7606,87.29,2.73,9.98,2019,38133
1254,29,308,1591,78.82,1.82,19.36,2019,38451
284,0,135,419,67.78,0.0,32.22,2019,38452
1527,22,758,2307,66.19,0.95,32.86,2019,37184
2255,51,439,2745,82.15,1.86,15.99,2019,37187
9791,371,1388,11550,84.77,3.21,12.02,2019,37206
5028,351,1588,6967,72.17,5.04,22.79,2019,37210
153,13,62,228,67.11,5.7,27.19,2019,37765
4452,219,2800,7471,59.59,2.93,37.48,2019,37766
1681,66,536,2283,73.63,2.89,23.48,2019,37769
10565,346,1762,12673,83.37,2.73,13.9,2019,37803
2613,139,1160,3912,66.79,3.55,29.65,2019,37807
1306,42,347,1695,77.05,2.48,20.47,2019,37846
742,0,308,1050,70.67,0.0,29.33,2019,37847
9262,153,583,9998,92.64,1.53,5.83,2019,37215
7815,236,2554,10605,73.69,2.23,24.08,2019,37311
520,5,134,659,78.91,0.76,20.33,2019,37391
1714,39,650,2403,71.33,1.62,27.05,2019,37681
4010,427,1364,5801,69.13,7.36,23.51,2019,37083
2236,192,950,3378,66.19,5.68,28.12,2019,37190
1394,37,242,1673,83.32,2.21,14.47,2019,37010
142,6,156,304,46.71,1.97,51.32,2019,41601
88,15,67,170,51.76,8.82,39.41,2019,41607
115,13,55,183,62.84,7.1,30.05,2019,41632
476,43,140,659,72.23,6.53,21.24,2019,41647
191,0,40,231,82.68,0.0,17.32,2019,41660
203,26,77,306,66.34,8.5,25.16,2019,41828
241,7,113,361,66.76,1.94,31.3,2019,41836
191,24,139,354,53.95,6.78,39.27,2019,41843
110,0,32,142,77.46,0.0,22.54,2019,41845
47,0,19,66,71.21,0.0,28.79,2019,41861
2045,42,769,2856,71.6,1.47,26.93,2019,41041
285,59,125,469,60.77,12.58,26.65,2019,41045
6916,298,1727,8941,77.35,3.33,19.32,2019,41071
5807,209,693,6709,86.56,3.12,10.33,2019,41075
66,6,57,129,51.16,4.65,44.19,2019,41132
307,32,146,485,63.3,6.6,30.1,2019,41174
1980,131,951,3062,64.66,4.28,31.06,2019,41179
257,30,178,465,55.27,6.45,38.28,2019,41180
525,0,44,569,92.27,0.0,7.73,2019,41216
784,64,103,951,82.44,6.73,10.83,2019,41222
51,0,17,68,75.0,0.0,25.0,2019,41226
255,0,82,337,75.67,0.0,24.33,2019,41255
848,31,183,1062,79.85,2.92,17.23,2019,41256
167,7,90,264,63.26,2.65,34.09,2019,41260
303,0,116,419,72.32,0.0,27.68,2019,41262
181,0,119,300,60.33,0.0,39.67,2019,41267
122,15,61,198,61.62,7.58,30.81,2019,41408
2454,58,1049,3561,68.91,1.63,29.46,2019,41472
6983,234,2234,9451,73.89,2.48,23.64,2019,41501
149,0,71,220,67.73,0.0,32.27,2019,41535
457,21,143,621,73.59,3.38,23.03,2019,41539
58,0,0,58,100.0,0.0,0.0,2019,41540
237,0,60,297,79.8,0.0,20.2,2019,41544
217,0,158,375,57.87,0.0,42.13,2019,41547
3285,151,921,4357,75.4,3.47,21.14,2019,41653
250,0,80,330,75.76,0.0,24.24,2019,41655
188,0,58,246,76.42,0.0,23.58,2019,41669
209,15,135,359,58.22,4.18,37.6,2019,41777
91,0,43,134,67.91,0.0,32.09,2019,41821
279,73,230,582,47.94,12.54,39.52,2019,41824
473,23,76,572,82.69,4.02,13.29,2019,41839
490,36,337,863,56.78,4.17,39.05,2019,39870
120,6,67,193,62.18,3.11,34.72,2019,39877
24,0,10,34,70.59,0.0,29.41,2019,39885
411,21,179,611,67.27,3.44,29.3,2019,39886
912,35,403,1350,67.56,2.59,29.85,2019,39897
493,83,382,958,51.46,8.66,39.87,2019,39354
6069,382,2691,9142,66.39,4.18,29.44,2019,39501
2923,100,1388,4411,66.27,2.27,31.47,2019,39730
919,122,280,1321,69.57,9.24,21.2,2019,40507
7835,279,3329,11443,68.47,2.44,29.09,2019,40701
15,0,0,15,100.0,0.0,0.0,2019,40363
15,0,21,36,41.67,0.0,58.33,2019,40376
145,0,87,232,62.5,0.0,37.5,2019,40943
112,0,44,156,71.79,0.0,28.21,2019,40927
52,15,66,133,39.1,11.28,49.62,2019,40940
94,0,47,141,66.67,0.0,33.33,2019,40941
46,13,39,98,46.94,13.27,39.8,2019,40946
44,0,47,91,48.35,0.0,51.65,2019,40958
75,0,52,127,59.06,0.0,40.94,2019,29683
346,0,66,412,83.98,0.0,16.02,2019,29686
3911,388,813,5112,76.51,7.59,15.9,2019,29697
407,38,319,764,53.27,4.97,41.75,2019,29001
427,5,233,665,64.21,0.75,35.04,2019,29481
1615,54,943,2612,61.83,2.07,36.1,2019,29824
822,77,326,1225,67.1,6.29,26.61,2019,29827
269,42,150,461,58.35,9.11,32.54,2019,29845
155,0,200,355,43.66,0.0,56.34,2019,29922
9983,190,878,11051,90.34,1.72,7.94,2019,29926
52,0,7,59,88.14,0.0,11.86,2019,29932
7998,100,865,8963,89.23,1.12,9.65,2019,29036
278,0,111,389,71.47,0.0,28.53,2019,29037
1126,66,325,1517,74.23,4.35,21.42,2019,29039
3067,178,583,3828,80.12,4.65,15.23,2019,29040
983,77,570,1630,60.31,4.72,34.97,2019,29042
434,167,316,917,47.33,18.21,34.46,2019,29056
1268,51,299,1618,78.37,3.15,18.48,2019,29058
1116,173,891,2180,51.19,7.94,40.87,2019,29059
127,4,24,155,81.94,2.58,15.48,2019,29838
10905,152,2454,13511,80.71,1.13,18.16,2019,29841
453,4,82,539,84.04,0.74,15.21,2019,29911
984,126,439,1549,63.52,8.13,28.34,2019,29918
3037,268,1109,4414,68.8,6.07,25.12,2019,29920
2227,80,997,3304,67.4,2.42,30.18,2019,29927
12601,241,479,13321,94.6,1.81,3.6,2019,29708
444,3,245,692,64.16,0.43,35.4,2019,29726
2312,320,1059,3691,62.64,8.67,28.69,2019,29728
14080,524,1612,16216,86.83,3.23,9.94,2019,29803
1740,81,577,2398,72.56,3.38,24.06,2019,29805
812,9,310,1131,71.79,0.8,27.41,2019,29809
283,71,237,591,47.88,12.01,40.1,2019,29163
3127,71,769,3967,78.83,1.79,19.38,2019,29172
3561,343,1762,5666,62.85,6.05,31.1,2019,29180
4,0,0,4,100.0,0.0,0.0,2019,29207
3793,201,1568,5562,68.19,3.61,28.19,2019,29325
4515,85,616,5216,86.56,1.63,11.81,2019,29334
13,0,0,13,100.0,0.0,0.0,2019,29338
444,19,369,832,53.37,2.28,44.35,2019,29009
293,21,298,612,47.88,3.43,48.69,2019,29015
6667,123,637,7427,89.77,1.66,8.58,2019,29016
4935,230,1095,6260,78.83,3.67,17.49,2019,29078
5278,226,1463,6967,75.76,3.24,21.0,2019,29102
291,0,154,445,65.39,0.0,34.61,2019,29105
7762,283,2432,10477,74.09,2.7,23.21,2019,29115
671,42,355,1068,62.83,3.93,33.24,2019,29125
2305,96,862,3263,70.64,2.94,26.42,2019,29135
146,15,95,256,57.03,5.86,37.11,2019,29145
9856,331,1792,11979,82.28,2.76,14.96,2019,29154
111,14,63,188,59.04,7.45,33.51,2019,29175
6801,643,688,8132,83.63,7.91,8.46,2019,29201
14110,293,1959,16362,86.24,1.79,11.97,2019,29210
716,48,265,1029,69.58,4.66,25.75,2019,29332
9640,349,2126,12115,79.57,2.88,17.55,2019,29349
22,0,3,25,88.0,0.0,12.0,2019,29375
170,59,219,448,37.95,13.17,48.88,2019,29377
5934,1514,901,8349,71.07,18.13,10.79,2019,29420
1022,142,268,1432,71.37,9.92,18.72,2019,29429
1014,86,633,1733,58.51,4.96,36.53,2019,29436
3038,151,1127,4316,70.39,3.5,26.11,2019,31014
408,31,257,696,58.62,4.45,36.93,2019,31017
1675,80,1609,3364,49.79,2.38,47.83,2019,31027
211,41,156,408,51.72,10.05,38.24,2019,31035
1065,52,238,1355,78.6,3.84,17.56,2019,31046
271,0,55,326,83.13,0.0,16.87,2019,31050
11821,608,3329,15758,75.02,3.86,21.13,2019,31061
1426,157,1428,3011,47.36,5.21,47.43,2019,31087
880,60,567,1507,58.39,3.98,37.62,2019,31068
178,25,104,307,57.98,8.14,33.88,2019,31550
9130,1910,2422,13462,67.82,14.19,17.99,2019,31602
317,25,134,476,66.6,5.25,28.15,2019,31624
63,46,48,157,40.13,29.3,30.57,2019,31630
1266,240,854,2360,53.64,10.17,36.19,2019,31635
232,34,148,414,56.04,8.21,35.75,2019,31066
597,68,361,1026,58.19,6.63,35.19,2019,31075
789,37,476,1302,60.6,2.84,36.56,2019,31076
2545,331,1014,3890,65.42,8.51,26.07,2019,31082
1149,68,584,1801,63.8,3.78,32.43,2019,31089
8177,383,2579,11139,73.41,3.44,23.15,2019,31093
1779,191,886,2856,62.29,6.69,31.02,2019,31901
669,15,291,975,68.62,1.54,29.85,2019,31555
7004,358,758,8120,86.26,4.41,9.33,2019,31558
678,47,173,898,75.5,5.23,19.27,2019,31565
949,106,502,1557,60.95,6.81,32.24,2019,31566
6108,1192,4217,11517,53.03,10.35,36.62,2019,31601
6372,905,936,8213,77.58,11.02,11.4,2019,31605
21,5,9,35,60.0,14.29,25.71,2019,31623
102,14,66,182,56.04,7.69,36.26,2019,31631
2418,332,1338,4088,59.15,8.12,32.73,2019,31636
4995,305,2049,7349,67.97,4.15,27.88,2019,31701
239,6,208,453,52.76,1.32,45.92,2019,31712
1031,5,435,1471,70.09,0.34,29.57,2019,31773
641,66,242,949,67.54,6.95,25.5,2019,31778
2232,73,866,3171,70.39,2.3,27.31,2019,31779
273,6,204,483,56.52,1.24,42.24,2019,31009
428,24,155,607,70.51,3.95,25.54,2019,31016
4187,85,1341,5613,74.59,1.51,23.89,2019,31029
4312,221,1789,6322,68.21,3.5,28.3,2019,31030
320,4,750,1074,29.8,0.37,69.83,2019,31037
139,7,127,273,50.92,2.56,46.52,2019,31041
7269,129,370,7768,93.58,1.66,4.76,2019,33301
8162,497,890,9549,85.47,5.2,9.32,2019,33304
8844,722,1840,11406,77.54,6.33,16.13,2019,33401
7817,375,2541,10733,72.83,3.49,23.67,2019,33407
13221,234,928,14383,91.92,1.63,6.45,2019,33410
11382,402,2018,13802,82.47,2.91,14.62,2019,33442
11805,440,2835,15080,78.28,2.92,18.8,2019,33461
5853,312,395,6560,89.22,4.76,6.02,2019,33019
12414,376,334,13124,94.59,2.86,2.54,2019,33029
2715,141,214,3070,88.44,4.59,6.97,2019,33042
16155,356,1346,17857,90.47,1.99,7.54,2019,33065
19378,755,1513,21646,89.52,3.49,6.99,2019,33458
8278,277,506,9061,91.36,3.06,5.58,2019,33486
5066,125,59,5250,96.5,2.38,1.12,2019,33498
20163,509,1429,22101,91.23,2.3,6.47,2019,33511
4357,63,697,5117,85.15,1.23,13.62,2019,33534
2857,696,2137,5690,50.21,12.23,37.56,2019,33815
544,332,243,1119,48.61,29.67,21.72,2019,33839
103,49,222,374,27.54,13.1,59.36,2019,36761
157,0,411,568,27.64,0.0,72.36,2019,36765
198,35,129,362,54.7,9.67,35.64,2019,36783
231,0,297,528,43.75,0.0,56.25,2019,36785
320,0,172,492,65.04,0.0,34.96,2019,36792
4799,37,975,5811,82.58,0.64,16.78,2019,36854
1037,15,299,1351,76.76,1.11,22.13,2019,36861
145,21,75,241,60.17,8.71,31.12,2019,36915
3080,215,774,4069,75.69,5.28,19.02,2019,36604
2805,157,430,3392,82.69,4.63,12.68,2019,36322
1366,207,708,2281,59.89,9.07,31.04,2019,36340
289,6,206,501,57.68,1.2,41.12,2019,36343
5670,341,1781,7792,72.77,4.38,22.86,2019,36360
512,19,256,787,65.06,2.41,32.53,2019,36376
129,52,232,413,31.23,12.59,56.17,2019,36425
3558,103,2223,5884,60.47,1.75,37.78,2019,36426
71,4,47,122,58.2,3.28,38.52,2019,36436
10029,1135,2057,13221,75.86,8.58,15.56,2019,36535
1961,237,1215,3413,57.46,6.94,35.6,2019,36545
176,43,10,229,76.86,18.78,4.37,2019,36556
432,0,101,533,81.05,0.0,18.95,2019,36578
97,9,0,106,91.51,8.49,0.0,2019,36581
1787,106,846,2739,65.24,3.87,30.89,2019,36607
12401,415,2143,14959,82.9,2.77,14.33,2019,36608
3028,150,995,4173,72.56,3.59,23.84,2019,36613
4493,295,1043,5831,77.05,5.06,17.89,2019,36619
76,0,96,172,44.19,0.0,55.81,2019,36722
498,5,170,673,74.0,0.74,25.26,2019,36759
1723,123,1017,2863,60.18,4.3,35.52,2019,36784
447,53,149,649,68.88,8.17,22.96,2019,36855
2276,100,255,2631,86.51,3.8,9.69,2019,36856
7138,494,1796,9428,75.71,5.24,19.05,2019,36867
331,74,91,496,66.73,14.92,18.35,2019,36871
0,0,31,31,0.0,0.0,100.0,2019,36910
170,15,149,334,50.9,4.49,44.61,2019,36916
919,23,529,1471,62.47,1.56,35.96,2019,36441
796,21,435,1252,63.58,1.68,34.74,2019,36442
687,191,990,1868,36.78,10.22,53.0,2019,36445
289,29,227,545,53.03,5.32,41.65,2019,36456
685,66,363,1114,61.49,5.92,32.59,2019,36474
435,42,401,878,49.54,4.78,45.67,2019,36475
11388,1057,913,13358,85.25,7.91,6.83,2019,34683
3427,398,1562,5387,63.62,7.39,29.0,2019,34690
8772,311,1597,10680,82.13,2.91,14.95,2019,34758
1724,112,561,2397,71.92,4.67,23.4,2019,34946
9314,457,1242,11013,84.57,4.15,11.28,2019,34957
10809,286,711,11806,91.56,2.42,6.02,2019,34990
7324,257,930,8511,86.05,3.02,10.93,2019,34613
2284,33,311,2628,86.91,1.26,11.83,2019,34614
9356,191,483,10030,93.28,1.9,4.82,2019,34639
7297,337,1246,8880,82.17,3.8,14.03,2019,34654
11067,263,1807,13137,84.24,2.0,13.76,2019,34746
14235,437,106,14778,96.33,2.96,0.72,2019,34786
2980,65,1249,4294,69.4,1.51,29.09,2019,34947
3665,128,461,4254,86.15,3.01,10.84,2019,34949
7264,304,333,7901,91.94,3.85,4.21,2019,34105
16960,728,1478,19166,88.49,3.8,7.71,2019,34135
143,16,0,159,89.94,10.06,0.0,2019,34137
7169,422,788,8379,85.56,5.04,9.4,2019,34145
5209,149,1315,6673,78.06,2.23,19.71,2019,37015
2174,38,307,2519,86.3,1.51,12.19,2019,37029
24688,1001,2893,28582,86.38,3.5,10.12,2019,37042
803,55,119,977,82.19,5.63,12.18,2019,37060
1432,125,502,2059,69.55,6.07,24.38,2019,37025
2119,8,189,2316,91.49,0.35,8.16,2019,37220
537,59,289,885,60.68,6.67,32.66,2019,37306
1261,10,313,1584,79.61,0.63,19.76,2019,37310
11255,294,1854,13403,83.97,2.19,13.83,2019,37312
902,20,304,1226,73.57,1.63,24.8,2019,37317
125,0,38,163,76.69,0.0,23.31,2019,37326
353,0,329,682,51.76,0.0,48.24,2019,37328
12958,302,1638,14898,86.98,2.03,10.99,2019,37363
334,0,61,395,84.56,0.0,15.44,2019,37366
216,0,59,275,78.55,0.0,21.45,2019,37369
1185,127,610,1922,61.65,6.61,31.74,2019,37687
309,9,151,469,65.88,1.92,32.2,2019,37688
237,16,115,368,64.4,4.35,31.25,2019,37710
295,49,202,546,54.03,8.97,37.0,2019,37713
1416,129,860,2405,58.88,5.36,35.76,2019,37722
272,17,119,408,66.67,4.17,29.17,2019,37723
0,0,0,0,,,,2019,37730
1902,131,367,2400,79.25,5.46,15.29,2019,37742
862,32,305,1199,71.89,2.67,25.44,2019,37755
668,39,408,1115,59.91,3.5,36.59,2019,37756
2988,182,664,3834,77.93,4.75,17.32,2019,37757
15872,658,2095,18625,85.22,3.53,11.25,2019,37040
7133,324,2514,9971,71.54,3.25,25.21,2019,37743
66,0,100,166,39.76,0.0,60.24,2019,37731
16335,364,1260,17959,90.96,2.03,7.02,2019,37221
149,0,116,265,56.23,0.0,43.77,2019,37333
1567,44,391,2002,78.27,2.2,19.53,2019,37692
4728,173,846,5747,82.27,3.01,14.72,2019,37090
2317,27,286,2630,88.1,1.03,10.87,2019,37146
4861,168,1081,6110,79.56,2.75,17.69,2019,37763
244,5,123,372,65.59,1.34,33.06,2019,37175
2360,66,896,3322,71.04,1.99,26.97,2019,37185
1382,15,201,1598,86.48,0.94,12.58,2019,37191
13296,788,1800,15884,83.71,4.96,11.33,2019,37209
11134,399,937,12470,89.29,3.2,7.51,2019,37217
810,19,0,829,97.71,2.29,0.0,2019,37219
275,0,120,395,69.62,0.0,30.38,2019,37301
190,24,111,325,58.46,7.38,34.15,2019,37305
890,25,180,1095,81.28,2.28,16.44,2019,37308
455,8,211,674,67.51,1.19,31.31,2019,37810
1226,22,288,1536,79.82,1.43,18.75,2019,37811
9852,480,2691,13023,75.65,3.69,20.66,2019,37814
378,14,139,531,71.19,2.64,26.18,2019,37828
5172,291,2326,7789,66.4,3.74,29.86,2019,37857
1209,162,623,1994,60.63,8.12,31.24,2019,37870
1267,53,240,1560,81.22,3.4,15.38,2019,37902
1285,234,1073,2592,49.58,9.03,41.4,2019,37915
65,0,10,75,86.67,0.0,13.33,2019,37719
879,82,258,1219,72.11,6.73,21.16,2019,37724
5011,397,1180,6588,76.06,6.03,17.91,2019,37725
4163,50,826,5039,82.62,0.99,16.39,2019,37777
2237,198,681,3116,71.79,6.35,21.85,2019,37820
449,76,163,688,65.26,11.05,23.69,2019,37829
1164,89,400,1653,70.42,5.38,24.2,2019,37843
4458,106,1875,6439,69.23,1.65,29.12,2019,40962
69,9,58,136,50.74,6.62,42.65,2019,40982
10323,334,1288,11945,86.42,2.8,10.78,2019,40004
808,83,341,1232,65.58,6.74,27.68,2019,40008
705,40,271,1016,69.39,3.94,26.67,2019,40037
546,9,136,691,79.02,1.3,19.68,2019,40046
310,51,178,539,57.51,9.46,33.02,2019,40050
3991,56,497,4544,87.83,1.23,10.94,2019,40108
863,3,86,952,90.65,0.32,9.03,2019,40117
388,8,148,544,71.32,1.47,27.21,2019,40144
1263,33,240,1536,82.23,2.15,15.62,2019,40150
258,14,136,408,63.24,3.43,33.33,2019,40152
26,0,26,52,50.0,0.0,50.0,2019,40020
1870,11,41,1922,97.29,0.57,2.13,2019,40026
362,13,85,460,78.7,2.83,18.48,2019,40060
8773,207,1323,10303,85.15,2.01,12.84,2019,40258
1481,33,730,2244,66.0,1.47,32.53,2019,40312
232,4,147,383,60.57,1.04,38.38,2019,40328
6089,134,1711,7934,76.75,1.69,21.57,2019,40330
0,0,0,0,,,,2019,40339
964,14,173,1151,83.75,1.22,15.03,2019,40347
6284,79,1277,7640,82.25,1.03,16.71,2019,40351
6503,183,1747,8433,77.11,2.17,20.72,2019,40353
1983,99,543,2625,75.54,3.77,20.69,2019,40360
7786,234,1191,9211,84.53,2.54,12.93,2019,40383
1404,36,645,2085,67.34,1.73,30.94,2019,40437
4365,202,1038,5605,77.88,3.6,18.52,2019,40444
455,15,173,643,70.76,2.33,26.91,2019,40472
661,79,315,1055,62.65,7.49,29.86,2019,40486
5837,84,217,6138,95.1,1.37,3.54,2019,40514
676,106,603,1385,48.81,7.65,43.54,2019,40734
124,0,24,148,83.78,0.0,16.22,2019,40170
5596,424,1928,7948,70.41,5.33,24.26,2019,40215
9,0,0,9,100.0,0.0,0.0,2019,40816
0,0,46,46,0.0,0.0,100.0,2019,40844
100,6,19,125,80.0,4.8,15.2,2019,40849
506,53,472,1031,49.08,5.14,45.78,2019,40935
12,14,14,40,30.0,35.0,35.0,2019,40995
1424,59,528,2011,70.81,2.93,26.26,2019,40729
6846,279,170,7295,93.85,3.82,2.33,2019,40059
11214,509,1935,13658,82.11,3.73,14.17,2019,40165
12954,495,2226,15675,82.64,3.16,14.2,2019,40219
1825,132,335,2292,79.62,5.76,14.62,2019,40162
128,25,37,190,67.37,13.16,19.47,2019,40923
3179,194,1533,4906,64.8,3.95,31.25,2019,40965
109,0,99,208,52.4,0.0,47.6,2019,40988
5487,110,1275,6872,79.85,1.6,18.55,2019,40744
555,12,314,881,63.0,1.36,35.64,2019,40759
1000,127,473,1600,62.5,7.94,29.56,2019,40823
106,14,139,259,40.93,5.41,53.67,2019,40863
322,0,174,496,64.92,0.0,35.08,2019,40902
4746,122,767,5635,84.22,2.17,13.61,2019,40071
381,0,48,429,88.81,0.0,11.19,2019,40104
2261,53,159,2473,91.43,2.14,6.43,2019,40121
741,0,153,894,82.89,0.0,17.11,2019,40142
140,0,65,205,68.29,0.0,31.71,2019,40145
6261,249,819,7329,85.43,3.4,11.17,2019,40204
96,0,34,130,73.85,0.0,26.15,2019,40209
3664,356,1404,5424,67.55,6.56,25.88,2019,40210
944,31,122,1097,86.05,2.83,11.12,2019,29438
17700,544,2158,20402,86.76,2.67,10.58,2019,29445
236,9,107,352,67.05,2.56,30.4,2019,29446
7290,998,1237,9525,76.54,10.48,12.99,2019,29455
571,90,269,930,61.4,9.68,28.92,2019,29468
495,35,297,827,59.85,4.23,35.91,2019,29475
471,58,260,789,59.7,7.35,32.95,2019,29729
20988,566,1946,23500,89.31,2.41,8.28,2019,29732
657,60,307,1024,64.16,5.86,29.98,2019,29742
473,30,194,697,67.86,4.3,27.83,2019,29819
414,22,200,636,65.09,3.46,31.45,2019,29821
1171,36,797,2004,58.43,1.8,39.77,2019,29832
107,17,61,185,57.84,9.19,32.97,2019,29836
172,5,39,216,79.63,2.31,18.06,2019,29082
327,30,150,507,64.5,5.92,29.59,2019,29104
1210,51,673,1934,62.56,2.64,34.8,2019,29128
882,46,369,1297,68.0,3.55,28.45,2019,29129
787,0,34,821,95.86,0.0,4.14,2019,29482
17960,1082,1706,20748,86.56,5.21,8.22,2019,29485
260,48,180,488,53.28,9.84,36.89,2019,29518
599,63,411,1073,55.82,5.87,38.3,2019,29547
5539,94,798,6431,86.13,1.46,12.41,2019,29568
15336,363,1509,17208,89.12,2.11,8.77,2019,29615
9377,119,2772,12268,76.43,0.97,22.6,2019,29640
743,78,172,993,74.82,7.85,17.32,2019,29643
8558,129,1799,10486,81.61,1.23,17.16,2019,29649
1341,96,593,2030,66.06,4.73,29.21,2019,29661
630,8,167,805,78.26,0.99,20.75,2019,29664
2033,62,462,2557,79.51,2.42,18.07,2019,29666
8748,194,1404,10346,84.55,1.88,13.57,2019,29673
2072,82,324,2478,83.62,3.31,13.08,2019,29676
1130,47,336,1513,74.69,3.11,22.21,2019,29682
13769,195,2004,15968,86.23,1.22,12.55,2019,29687
3916,155,1785,5856,66.87,2.65,30.48,2019,29693
12200,266,1351,13817,88.3,1.93,9.78,2019,29710
736,123,333,1192,61.74,10.32,27.94,2019,29714
411,4,128,543,75.69,0.74,23.57,2019,29717
718,415,98,1231,58.33,33.71,7.96,2019,29439
86,16,58,160,53.75,10.0,36.25,2019,29373
496,0,7,503,98.61,0.0,1.39,2019,29404
1542,9,175,1726,89.34,0.52,10.14,2019,29435
809,104,227,1140,70.96,9.12,19.91,2019,30178
668,17,158,843,79.24,2.02,18.74,2019,30216
112,13,249,374,29.95,3.48,66.58,2019,30660
10743,738,2897,14378,74.72,5.13,20.15,2019,30701
74,21,0,95,77.89,22.11,0.0,2019,30708
1003,19,451,1473,68.09,1.29,30.62,2019,30808
535,20,191,746,71.72,2.68,25.6,2019,30810
1782,176,1426,3384,52.66,5.2,42.14,2019,30817
1513,73,188,1774,85.29,4.11,10.6,2019,30292
588,17,506,1111,52.93,1.53,45.54,2019,30293
11139,485,1775,13399,83.13,3.62,13.25,2019,30316
9579,583,1422,11584,82.69,5.03,12.28,2019,30329
4612,497,1281,6390,72.18,7.78,20.05,2019,30354
996,61,200,1257,79.24,4.85,15.91,2019,30421
1023,16,804,1843,55.51,0.87,43.62,2019,30434
3004,160,1253,4417,68.01,3.62,28.37,2019,30436
458,13,224,695,65.9,1.87,32.23,2019,30441
17,0,7,24,70.83,0.0,29.17,2019,30448
144,25,0,169,85.21,14.79,0.0,2019,33848
208,91,51,350,59.43,26.0,14.57,2019,33851
122,0,102,224,54.46,0.0,45.54,2019,33865
8176,2250,3260,13686,59.74,16.44,23.82,2019,33880
9588,653,2818,13059,73.42,5.0,21.58,2019,33881
9126,466,2186,11778,77.48,3.96,18.56,2019,33905
8864,306,1045,10215,86.77,3.0,10.23,2019,33909
13647,527,742,14916,91.49,3.53,4.97,2019,33914
316,0,41,357,88.52,0.0,11.48,2019,33930
3939,96,409,4444,88.64,2.16,9.2,2019,33955
1380,65,235,1680,82.14,3.87,13.99,2019,33956
3870,128,508,4506,85.89,2.84,11.27,2019,33972
5167,191,539,5897,87.62,3.24,9.14,2019,33983
9002,383,2778,12163,74.01,3.15,22.84,2019,33169
12210,318,874,13402,91.11,2.37,6.52,2019,33309
14187,1513,2615,18315,77.46,8.26,14.28,2019,33319
16093,585,2848,19526,82.42,3.0,14.59,2019,33321
3650,47,511,4208,86.74,1.12,12.14,2019,33403
7351,377,2253,9981,73.65,3.78,22.57,2019,33404
16029,323,611,16963,94.49,1.9,3.6,2019,33418
10843,556,2297,13696,79.17,4.06,16.77,2019,33435
4061,187,2248,6496,62.52,2.88,34.61,2019,33440
8066,297,1250,9613,83.91,3.09,13.0,2019,33455
1184,124,1357,2665,44.43,4.65,50.92,2019,33476
6194,269,527,6990,88.61,3.85,7.54,2019,33477
4481,26,116,4623,96.93,0.56,2.51,2019,33478
3928,127,683,4738,82.9,2.68,14.42,2019,33527
405,14,52,471,85.99,2.97,11.04,2019,33585
1856,131,646,2633,70.49,4.98,24.53,2019,33597
7299,163,1082,8544,85.43,1.91,12.66,2019,33603
11162,1199,2193,14554,76.69,8.24,15.07,2019,33613
555,15,0,570,97.37,2.63,0.0,2019,33621
11046,167,306,11519,95.89,1.45,2.66,2019,33626
7697,329,1288,9314,82.64,3.53,13.83,2019,33782
8176,1477,2069,11722,69.75,12.6,17.65,2019,33803
5631,653,2757,9041,62.28,7.22,30.49,2019,33805
8011,350,1175,9536,84.01,3.67,12.32,2019,33907
7387,199,393,7979,92.58,2.49,4.93,2019,33912
1866,65,167,2098,88.94,3.1,7.96,2019,33920
10287,252,551,11090,92.76,2.27,4.97,2019,33928
6365,341,1548,8254,77.11,4.13,18.75,2019,33936
4477,261,2606,7344,60.96,3.55,35.48,2019,32805
10322,500,771,11593,89.04,4.31,6.65,2019,32817
13941,351,3191,17483,79.74,2.01,18.25,2019,32839
1274,0,575,1849,68.9,0.0,31.1,2019,32948
7534,99,633,8266,91.14,1.2,7.66,2019,32952
8659,311,687,9657,89.67,3.22,7.11,2019,32953
14167,197,953,15317,92.49,1.29,6.22,2019,32955
6093,217,1576,7886,77.26,2.75,19.98,2019,32967
2812,40,487,3339,84.22,1.2,14.59,2019,32456
7783,314,853,8950,86.96,3.51,9.53,2019,32504
7488,687,2852,11027,67.91,6.23,25.86,2019,32505
12065,354,1791,14210,84.9,2.49,12.6,2019,32506
11040,381,1493,12914,85.49,2.95,11.56,2019,32507
7209,595,370,8174,88.19,7.28,4.53,2019,32541
801,71,140,1012,79.15,7.02,13.83,2019,32564
792,89,234,1115,71.03,7.98,20.99,2019,32568
3512,284,553,4349,80.75,6.53,12.72,2019,32579
5577,265,1311,7153,77.97,3.7,18.33,2019,32609
11410,613,2585,14608,78.11,4.2,17.7,2019,34207
11659,733,3337,15729,74.12,4.66,21.22,2019,34741
14700,480,2710,17890,82.17,2.68,15.15,2019,34748
9585,549,1848,11982,79.99,4.58,15.42,2019,34759
5550,107,514,6171,89.94,1.73,8.33,2019,34771
5178,41,344,5563,93.08,0.74,6.18,2019,34984
6810,286,526,7622,89.35,3.75,6.9,2019,34134
5600,304,1012,6916,80.97,4.4,14.63,2019,34237
5545,188,382,6115,90.68,3.07,6.25,2019,34103
9561,333,1124,11018,86.78,3.02,10.2,2019,34110
9853,292,557,10702,92.07,2.73,5.2,2019,34120
1838,0,8,1846,99.57,0.0,0.43,2019,34201
11739,675,1864,14278,82.22,4.73,13.06,2019,34203
9430,851,2032,12313,76.59,6.91,16.5,2019,34205
11589,1198,2482,15269,75.9,7.85,16.26,2019,34221
890,83,443,1416,62.85,5.86,31.29,2019,34449
7692,264,2061,10017,76.79,2.64,20.58,2019,34601
6856,739,429,8024,85.44,9.21,5.35,2019,34747
7011,185,1128,8324,84.23,2.22,13.55,2019,34788
15333,497,2045,17875,85.78,2.78,11.44,2019,34997
3205,92,538,3835,83.57,2.4,14.03,2019,34429
3236,181,393,3810,84.93,4.75,10.31,2019,34607
12415,633,1620,14668,84.64,4.32,11.04,2019,34209
5580,74,309,5963,93.58,1.24,5.18,2019,34241
23,0,29,52,44.23,0.0,55.77,2019,34661
1271,11,150,1432,88.76,0.77,10.47,2019,34945
0,0,0,0,,,,2019,34101
98,0,0,98,100.0,0.0,0.0,2019,34140
3367,246,117,3730,90.27,6.6,3.14,2019,34211
6864,355,330,7549,90.93,4.7,4.37,2019,34212
1524,137,351,2012,75.75,6.81,17.45,2019,34269
3920,145,174,4239,92.47,3.42,4.1,2019,34288
1134,165,38,1337,84.82,12.34,2.84,2019,34289
1773,75,45,1893,93.66,3.96,2.38,2019,34291
0,0,0,0,,,,2019,34445
3492,54,558,4104,85.09,1.32,13.6,2019,34604
1902,66,206,2174,87.49,3.04,9.48,2019,34637
3223,107,936,4266,75.55,2.51,21.94,2019,35951
4414,204,1037,5655,78.05,3.61,18.34,2019,35957
287,14,213,514,55.84,2.72,41.44,2019,35963
285,22,130,437,65.22,5.03,29.75,2019,35972
796,28,303,1127,70.63,2.48,26.89,2019,35973
7319,148,1113,8580,85.3,1.72,12.97,2019,35022
53,18,17,88,60.23,20.45,19.32,2019,35036
3756,57,189,4002,93.85,1.42,4.72,2019,35043
2334,174,938,3446,67.73,5.05,27.22,2019,35058
323,16,78,417,77.46,3.84,18.71,2019,35061
2360,113,576,3049,77.4,3.71,18.89,2019,35062
53,0,0,53,100.0,0.0,0.0,2019,35074
3820,127,1315,5262,72.6,2.41,24.99,2019,35077
5750,89,535,6374,90.21,1.4,8.39,2019,35080
444,11,348,803,55.29,1.37,43.34,2019,35089
969,14,91,1074,90.22,1.3,8.47,2019,35091
2549,76,486,3111,81.94,2.44,15.62,2019,35096
76,0,48,124,61.29,0.0,38.71,2019,35112
6333,204,1025,7562,83.75,2.7,13.55,2019,35126
755,48,488,1291,58.48,3.72,37.8,2019,35130
844,0,377,1221,69.12,0.0,30.88,2019,35133
2284,43,629,2956,77.27,1.45,21.28,2019,35151
1197,92,205,1494,80.12,6.16,13.72,2019,37860
6411,597,1532,8540,75.07,6.99,17.94,2019,37862
423,40,170,633,66.82,6.32,26.86,2019,37872
2510,189,708,3407,73.67,5.55,20.78,2019,37877
856,27,296,1179,72.6,2.29,25.11,2019,37882
6168,309,2073,8550,72.14,3.61,24.25,2019,37914
19104,355,491,19950,95.76,1.78,2.46,2019,37027
982,42,229,1253,78.37,3.35,18.28,2019,37035
1761,0,195,1956,90.03,0.0,9.97,2019,37046
394,33,169,596,66.11,5.54,28.36,2019,37050
7750,156,2352,10258,75.55,1.52,22.93,2019,37055
2010,26,858,2894,69.45,0.9,29.65,2019,37058
16236,533,2894,19663,82.57,2.71,14.72,2019,37066
143,0,20,163,87.73,0.0,12.27,2019,37078
17603,1562,2788,21953,80.18,7.12,12.7,2019,37130
3811,177,1307,5295,71.97,3.34,24.68,2019,37166
570,5,227,802,71.07,0.62,28.3,2019,37178
2722,103,725,3550,76.68,2.9,20.42,2019,37186
5185,146,350,5681,91.27,2.57,6.16,2019,37188
1360,31,118,1509,90.13,2.05,7.82,2019,37189
555,133,363,1051,52.81,12.65,34.54,2019,37228
1555,102,616,2273,68.41,4.49,27.1,2019,37329
920,31,314,1265,72.73,2.45,24.82,2019,37338
568,47,331,946,60.04,4.97,34.99,2019,37345
2483,42,786,3311,74.99,1.27,23.74,2019,37347
974,101,271,1346,72.36,7.5,20.13,2019,37352
5120,238,1563,6921,73.98,3.44,22.58,2019,37354
629,23,243,895,70.28,2.57,27.15,2019,37356
469,40,148,657,71.39,6.09,22.53,2019,37360
488,0,229,717,68.06,0.0,31.94,2019,37361
5422,113,277,5812,93.29,1.94,4.77,2019,37377
1761,61,738,2560,68.79,2.38,28.83,2019,37380
2584,208,921,3713,69.59,5.6,24.8,2019,37381
7667,761,2041,10469,73.24,7.27,19.5,2019,37388
4407,275,1286,5968,73.84,4.61,21.55,2019,37398
1343,53,135,1531,87.72,3.46,8.82,2019,37403
6622,282,2117,9021,73.41,3.13,23.47,2019,37412
13839,716,1951,16506,83.84,4.34,11.82,2019,37604
9231,856,4012,14099,65.47,6.07,28.46,2019,37643
5297,120,545,5962,88.85,2.01,9.14,2019,37663
283,11,314,608,46.55,1.81,51.64,2019,37729
1850,108,400,2358,78.46,4.58,16.96,2019,37737
4821,81,1239,6141,78.51,1.32,20.18,2019,37771
1435,50,506,1991,72.07,2.51,25.41,2019,37826
10397,261,1551,12209,85.16,2.14,12.7,2019,37830
2995,93,847,3935,76.11,2.36,21.52,2019,37840
2740,130,1114,3984,68.78,3.26,27.96,2019,37841
29,0,45,74,39.19,0.0,60.81,2019,37848
947,33,575,1555,60.9,2.12,36.98,2019,37853
687,163,266,1116,61.56,14.61,23.84,2019,37888
504,69,247,820,61.46,8.41,30.12,2019,37892
12620,304,534,13458,93.77,2.26,3.97,2019,37922
12006,355,1064,13425,89.43,2.64,7.93,2019,37923
1113,25,448,1586,70.18,1.58,28.25,2019,37061
21646,529,2100,24275,89.17,2.18,8.65,2019,37075
727,1,238,966,75.26,0.1,24.64,2019,37095
8239,350,2799,11388,72.35,3.07,24.58,2019,37917
287,20,88,395,72.66,5.06,22.28,2019,37016
2240,233,287,2760,81.16,8.44,10.4,2019,37037
1837,84,882,2803,65.54,3.0,31.47,2019,40311
15572,493,1981,18046,86.29,2.73,10.98,2019,40324
1149,27,264,1440,79.79,1.88,18.33,2019,40379
1597,132,703,2432,65.67,5.43,28.91,2019,40380
11220,228,2876,14324,78.33,1.59,20.08,2019,40391
26,0,0,26,100.0,0.0,0.0,2019,40448
1144,56,183,1383,82.72,4.05,13.23,2019,40461
18807,810,3603,23220,80.99,3.49,15.52,2019,40475
17,0,12,29,58.62,0.0,41.38,2019,40481
3236,106,1182,4524,71.53,2.34,26.13,2019,40484
15603,303,968,16874,92.47,1.8,5.74,2019,40509
1299,68,703,2070,62.75,3.29,33.96,2019,40831
1215,18,92,1325,91.7,1.36,6.94,2019,40056
8555,289,780,9624,88.89,3.0,8.1,2019,40206
4116,55,84,4255,96.73,1.29,1.97,2019,40513
91,12,56,159,57.23,7.55,35.22,2019,40801
32,0,0,32,100.0,0.0,0.0,2019,40025
122,116,66,304,40.13,38.16,21.71,2019,40041
0,0,0,0,,,,2019,40048
0,0,0,0,,,,2019,40049
0,0,0,0,,,,2019,40063
293,22,73,388,75.52,5.67,18.81,2019,40075
11,0,27,38,28.95,0.0,71.05,2019,40110
68,0,0,68,100.0,0.0,0.0,2019,40161
0,0,0,0,,,,2019,40231
108,7,0,115,93.91,6.09,0.0,2019,40280
0,0,0,0,,,,2019,40404
0,0,0,0,,,,2019,40434
0,0,0,0,,,,2019,40506
0,0,0,0,,,,2019,40604
66,0,0,66,100.0,0.0,0.0,2019,40743
50,0,28,78,64.1,0.0,35.9,2019,40829
79,0,41,120,65.83,0.0,34.17,2019,40939
35,0,0,35,100.0,0.0,0.0,2019,40964
125,14,120,259,48.26,5.41,46.33,2019,40346
707,0,394,1101,64.21,0.0,35.79,2019,40402
861,41,290,1192,72.23,3.44,24.33,2019,40371
1212,0,563,1775,68.28,0.0,31.72,2019,40489
136,0,20,156,87.18,0.0,12.82,2019,40077
4383,203,590,5176,84.68,3.92,11.4,2019,40175
195,0,0,195,100.0,0.0,0.0,2019,40010
6351,178,411,6940,91.51,2.56,5.92,2019,40014
318,5,18,341,93.26,1.47,5.28,2019,40022
128,3,47,178,71.91,1.69,26.4,2019,40115
535,61,190,786,68.07,7.76,24.17,2019,40119
278,33,116,427,65.11,7.73,27.17,2019,40155
7168,577,1678,9423,76.07,6.12,17.81,2019,40160
44,0,46,90,48.89,0.0,51.11,2019,40171
127,15,13,155,81.94,9.68,8.39,2019,40178
5254,710,2707,8671,60.59,8.19,31.22,2019,40203
9232,167,1028,10427,88.54,1.6,9.86,2019,40205
11783,246,271,12300,95.8,2.0,2.2,2019,40245
890,43,151,1084,82.1,3.97,13.93,2019,40313
809,11,245,1065,75.96,1.03,23.0,2019,40011
1704,31,292,2027,84.07,1.53,14.41,2019,40013
6617,223,775,7615,86.89,2.93,10.18,2019,40031
81,12,28,121,66.94,9.92,23.14,2019,40040
60,0,43,103,58.25,0.0,41.75,2019,40062
9121,505,1656,11282,80.85,4.48,14.68,2019,40065
531,13,260,804,66.04,1.62,32.34,2019,30456
4341,146,980,5467,79.4,2.67,17.93,2019,30461
1102,76,530,1708,64.52,4.45,31.03,2019,30471
6962,376,1617,8955,77.74,4.2,18.06,2019,30512
317,19,113,449,70.6,4.23,25.17,2019,30522
1884,48,555,2487,75.75,1.93,22.32,2019,30530
1975,20,906,2901,68.08,0.69,31.23,2019,30535
6352,113,412,6877,92.37,1.64,5.99,2019,30548
550,20,110,680,80.88,2.94,16.18,2019,30552
12042,705,1274,14021,85.89,5.03,9.09,2019,30294
6746,251,2282,9279,72.7,2.71,24.59,2019,30297
14095,1121,349,15565,90.56,7.2,2.24,2019,30309
1884,139,226,2249,83.77,6.18,10.05,2019,30313
17964,847,3359,22170,81.03,3.82,15.15,2019,30318
3730,122,204,4056,91.96,3.01,5.03,2019,30326
8823,188,459,9470,93.17,1.99,4.85,2019,30327
10388,658,2159,13205,78.67,4.98,16.35,2019,30344
2988,99,1128,4215,70.89,2.35,26.76,2019,30427
243,28,472,743,32.71,3.77,63.53,2019,30428
544,46,449,1039,52.36,4.43,43.21,2019,30477
12437,428,1002,13867,89.69,3.09,7.23,2019,30228
1392,35,377,1804,77.16,1.94,20.9,2019,30147
488,8,384,880,55.45,0.91,43.64,2019,30251
463,20,269,752,61.57,2.66,35.77,2019,30733
597,29,270,896,66.63,3.24,30.13,2019,30805
27,1,10,38,71.05,2.63,26.32,2019,30807
220,7,188,415,53.01,1.69,45.3,2019,30820
4311,220,2111,6642,64.91,3.31,31.78,2019,30824
3624,221,2375,6220,58.26,3.55,38.18,2019,30901
6951,732,2358,10041,69.23,7.29,23.48,2019,30904
15543,376,2221,18140,85.68,2.07,12.24,2019,30907
7155,519,2258,9932,72.04,5.23,22.73,2019,30012
8191,435,958,9584,85.47,4.54,10.0,2019,30013
13341,407,1045,14793,90.18,2.75,7.06,2019,30092
18615,283,1841,20739,89.76,1.36,8.88,2019,30047
23627,404,1583,25614,92.24,1.58,6.18,2019,30080
12773,191,1198,14162,90.19,1.35,8.46,2019,30087
4844,217,743,5804,83.46,3.74,12.8,2019,30103
4116,24,719,4859,84.71,0.49,14.8,2019,30107
17435,436,1702,19573,89.08,2.23,8.7,2019,30114
2162,199,989,3350,64.54,5.94,29.52,2019,30662
49,0,52,101,48.51,0.0,51.49,2019,29665
4492,104,804,5400,83.19,1.93,14.89,2019,29672
693,8,112,813,85.24,0.98,13.78,2019,29685
3482,123,885,4490,77.55,2.74,19.71,2019,29691
1160,27,242,1429,81.18,1.89,16.93,2019,29704
222,10,141,373,59.52,2.68,37.8,2019,29743
3613,130,740,4483,80.59,2.9,16.51,2019,29829
1201,30,587,1818,66.06,1.65,32.29,2019,29847
63,22,56,141,44.68,15.6,39.72,2019,29849
2306,15,503,2824,81.66,0.53,17.81,2019,29851
13949,796,719,15464,90.2,5.15,4.65,2019,29910
67,0,83,150,44.67,0.0,55.33,2019,29923
105,23,84,212,49.53,10.85,39.62,2019,29941
1452,170,226,1848,78.57,9.2,12.23,2019,29935
3283,96,1551,4930,66.59,1.95,31.46,2019,29936
740,61,170,971,76.21,6.28,17.51,2019,29075
307,18,154,479,64.09,3.76,32.15,2019,29081
343,10,187,540,63.52,1.85,34.63,2019,29111
836,23,678,1537,54.39,1.5,44.11,2019,32628
4380,173,414,4967,88.18,3.48,8.34,2019,32669
42,0,26,68,61.76,0.0,38.24,2019,32692
8618,335,957,9910,86.96,3.38,9.66,2019,32701
601,0,126,727,82.67,0.0,17.33,2019,32709
1690,76,701,2467,68.5,3.08,28.42,2019,32052
813,30,375,1218,66.75,2.46,30.79,2019,32058
3244,139,561,3944,82.25,3.52,14.22,2019,32038
603,38,362,1003,60.12,3.79,36.09,2019,32059
774,39,249,1062,72.88,3.67,23.45,2019,32102
8738,342,4386,13466,64.89,2.54,32.57,2019,32114
7435,399,2840,10674,69.66,3.74,26.61,2019,32117
6669,356,2027,9052,73.67,3.93,22.39,2019,32118
2670,83,612,3365,79.35,2.47,18.19,2019,32132
13694,1818,1686,17198,79.63,10.57,9.8,2019,32137
18885,438,3158,22481,84.0,1.95,14.05,2019,32174
2915,122,778,3815,76.41,3.2,20.39,2019,32204
10609,483,1928,13020,81.48,3.71,14.81,2019,32205
10296,432,2584,13312,77.34,3.25,19.41,2019,32211
13196,577,1850,15623,84.47,3.69,11.84,2019,32216
14714,293,1082,16089,91.45,1.82,6.73,2019,32224
5122,30,425,5577,91.84,0.54,7.62,2019,32226
67,0,24,91,73.63,0.0,26.37,2019,32323
2367,82,501,2950,80.24,2.78,16.98,2019,32347
7181,203,586,7970,90.1,2.55,7.35,2019,32408
7091,258,975,8324,85.19,3.1,11.71,2019,32713
14213,127,1110,15450,91.99,0.82,7.18,2019,32714
3438,81,801,4320,79.58,1.88,18.54,2019,32784
9821,217,1157,11195,87.73,1.94,10.33,2019,32789
6953,278,812,8043,86.45,3.46,10.1,2019,32796
9679,248,1058,10985,88.11,2.26,9.63,2019,32806
18144,415,1625,20184,89.89,2.06,8.05,2019,32825
6655,421,568,7644,87.06,5.51,7.43,2019,32826
1208,105,292,1605,75.26,6.54,18.19,2019,32421
4951,220,1224,6395,77.42,3.44,19.14,2019,32433
206,13,111,330,62.42,3.94,33.64,2019,32437
1124,48,345,1517,74.09,3.16,22.74,2019,32438
7430,71,532,8033,92.49,0.88,6.62,2019,32444
3227,85,704,4016,80.35,2.12,17.53,2019,32446
126,0,35,161,78.26,0.0,21.74,2019,32449
561,15,49,625,89.76,2.4,7.84,2019,32062
85,0,24,109,77.98,0.0,22.02,2019,32072
13796,329,1259,15384,89.68,2.14,8.18,2019,32073
10400,689,1926,13015,79.91,5.29,14.8,2019,32084
9600,539,1468,11607,82.71,4.64,12.65,2019,32086
3288,261,550,4099,80.21,6.37,13.42,2019,32095
604,47,411,1062,56.87,4.43,38.7,2019,32096
6079,175,583,6837,88.91,2.56,8.53,2019,32097
6338,297,970,7605,83.34,3.91,12.75,2019,32141
158,0,0,158,100.0,0.0,0.0,2019,32157
13106,1877,1981,16964,77.26,11.06,11.68,2019,32164
9663,394,1632,11689,82.67,3.37,13.96,2019,32168
1881,81,669,2631,71.49,3.08,25.43,2019,32189
1490,107,389,1986,75.03,5.39,19.59,2019,32202
213,0,18,231,92.21,0.0,7.79,2019,32212
3316,84,1428,4828,68.68,1.74,29.58,2019,32333
2322,139,1424,3885,59.77,3.58,36.65,2019,32340
3717,137,1193,5047,73.65,2.71,23.64,2019,32344
561,40,250,851,65.92,4.7,29.38,2019,32358
859,53,328,1240,69.27,4.27,26.45,2019,35172
983,69,196,1248,78.77,5.53,15.71,2019,35178
194,37,73,304,63.82,12.17,24.01,2019,35183
4862,156,1083,6101,79.69,2.56,17.75,2019,35210
7765,608,3068,11441,67.87,5.31,26.82,2019,35211
5648,293,1367,7308,77.29,4.01,18.71,2019,35214
20821,374,961,22156,93.97,1.69,4.34,2019,35242
1307,27,516,1850,70.65,1.46,27.89,2019,35470
953,2,495,1450,65.72,0.14,34.14,2019,35481
3854,135,960,4949,77.87,2.73,19.4,2019,35504
2911,43,993,3947,73.75,1.09,25.16,2019,35555
1126,118,735,1979,56.9,5.96,37.14,2019,35581
1050,68,652,1770,59.32,3.84,36.84,2019,35582
7355,422,2062,9839,74.75,4.29,20.96,2019,35611
2723,153,469,3345,81.41,4.57,14.02,2019,35620
801,56,267,1124,71.26,4.98,23.75,2019,35621
139,3,76,218,63.76,1.38,34.86,2019,35755
3662,189,855,4706,77.82,4.02,18.17,2019,35773
9054,339,899,10292,87.97,3.29,8.73,2019,35802
6965,475,1706,9146,76.15,5.19,18.65,2019,35805
3814,147,1372,5333,71.52,2.76,25.73,2019,35904
1316,84,400,1800,73.11,4.67,22.22,2019,35980
1907,76,823,2806,67.96,2.71,29.33,2019,35031
2510,186,574,3270,76.76,5.69,17.55,2019,35956
1136,74,432,1642,69.18,4.51,26.31,2019,35966
472,0,181,653,72.28,0.0,27.72,2019,35981
6193,174,1620,7987,77.54,2.18,20.28,2019,35010
2902,270,1409,4581,63.35,5.89,30.76,2019,35064
1487,50,523,2060,72.18,2.43,25.39,2019,35046
756,9,127,892,84.75,1.01,14.24,2019,35053
908,71,285,1264,71.84,5.62,22.55,2019,35063
1103,30,567,1700,64.88,1.76,33.35,2019,35072
532,22,179,733,72.58,3.0,24.42,2019,35078
672,48,260,980,68.57,4.9,26.53,2019,35087
511,3,117,631,80.98,0.48,18.54,2019,35097
2741,89,152,2982,91.92,2.98,5.1,2019,35114
1888,55,214,2157,87.53,2.55,9.92,2019,35117
28,0,61,89,31.46,0.0,68.54,2019,35119
3153,12,445,3610,87.34,0.33,12.33,2019,35127
635,2,147,784,80.99,0.26,18.75,2019,35136
79,0,53,132,59.85,0.0,40.15,2019,35149
4207,162,1299,5668,74.22,2.86,22.92,2019,35180
707,11,176,894,79.08,1.23,19.69,2019,35188
2565,113,1103,3781,67.84,2.99,29.17,2019,35228
7648,607,3116,11371,67.26,5.34,27.4,2019,35401
563,57,544,1164,48.37,4.9,46.74,2019,35447
3003,68,601,3672,81.78,1.85,16.37,2019,35453
0,0,0,0,,,,2019,35457
892,2,883,1777,50.2,0.11,49.69,2019,35462
1407,37,678,2122,66.31,1.74,31.95,2019,35466
2056,29,647,2732,75.26,1.06,23.68,2019,35476
229,21,161,411,55.72,5.11,39.17,2019,35543
1699,77,528,2304,73.74,3.34,22.92,2019,35550
463,0,95,558,82.97,0.0,17.03,2019,35585
149,6,126,281,53.02,2.14,44.84,2019,35587
1877,132,526,2535,74.04,5.21,20.75,2019,35622
6456,239,1654,8349,77.33,2.86,19.81,2019,35633
816,220,469,1505,54.22,14.62,31.16,2019,35643
868,22,408,1298,66.87,1.69,31.43,2019,35648
990,51,302,1343,73.72,3.8,22.49,2019,37049
637,13,220,870,73.22,1.49,25.29,2019,37052
725,23,275,1023,70.87,2.25,26.88,2019,37079
1578,94,316,1988,79.38,4.73,15.9,2019,37085
19301,529,1082,20912,92.3,2.53,5.17,2019,37122
1350,20,182,1552,86.98,1.29,11.73,2019,37143
744,62,258,1064,69.92,5.83,24.25,2019,37144
7117,153,1355,8625,82.52,1.77,15.71,2019,37148
25701,662,3087,29450,87.27,2.25,10.48,2019,37211
6320,175,462,6957,90.84,2.52,6.64,2019,37212
6682,179,1062,7923,84.34,2.26,13.4,2019,37216
4324,290,1240,5854,73.86,4.95,21.18,2019,37218
7267,412,2022,9701,74.91,4.25,20.84,2019,37303
5424,231,1371,7026,77.2,3.29,19.51,2019,37321
3175,205,1019,4399,72.18,4.66,23.16,2019,37327
4919,493,1409,6821,72.12,7.23,20.66,2019,37813
1426,60,507,1993,71.55,3.01,25.44,2019,37818
587,77,283,947,61.99,8.13,29.88,2019,37852
1534,36,601,2171,70.66,1.66,27.68,2019,37098
798,39,203,1040,76.73,3.75,19.52,2019,37134
815,73,166,1054,77.32,6.93,15.75,2019,37149
171,0,71,242,70.66,0.0,29.34,2019,37151
8906,706,2458,12070,73.79,5.85,20.36,2019,37160
11841,50,577,12468,94.97,0.4,4.63,2019,37174
633,124,503,1260,50.24,9.84,39.92,2019,37762
812,28,319,1159,70.06,2.42,27.52,2019,37770
6088,327,1675,8090,75.25,4.04,20.7,2019,37774
893,23,219,1135,78.68,2.03,19.3,2019,37806
639,42,200,881,72.53,4.77,22.7,2019,37309
2141,140,1139,3420,62.6,4.09,33.3,2019,37322
145,12,77,234,61.97,5.13,32.91,2019,37340
3749,155,574,4478,83.72,3.46,12.82,2019,37341
143,80,175,398,35.93,20.1,43.97,2019,37348
1297,108,454,1859,69.77,5.81,24.42,2019,37357
19,0,17,36,52.78,0.0,47.22,2019,37394
1311,56,944,2311,56.73,2.42,40.85,2019,37402
7953,171,1084,9208,86.37,1.86,11.77,2019,37615
1316,80,565,1961,67.11,4.08,28.81,2019,37616
509,53,225,787,64.68,6.73,28.59,2019,37694
5331,202,429,5962,89.42,3.39,7.2,2019,37204
2000,106,274,2380,84.03,4.45,11.51,2019,37738
2464,236,687,3387,72.75,6.97,20.28,2019,37861
5586,182,760,6528,85.57,2.79,11.64,2019,37938
1085,80,588,1753,61.89,4.56,33.54,2019,37658
69,0,96,165,41.82,0.0,58.18,2019,37878
0,0,0,0,,,,2019,37132
11,0,11,22,50.0,0.0,50.0,2019,37165
0,0,0,0,,,,2019,37240
0,0,0,0,,,,2019,37243
0,0,0,0,,,,2019,37246
0,0,0,0,,,,2019,37315
70,0,40,110,63.64,0.0,36.36,2019,37682
20,0,8,28,71.43,0.0,28.57,2019,37733
0,0,12,12,0.0,0.0,100.0,2019,37851
9322,208,704,10234,91.09,2.03,6.88,2019,37934
2141,209,476,2826,75.76,7.4,16.84,2019,37330
9310,261,1597,11168,83.36,2.34,14.3,2019,37379
9395,195,1708,11298,83.16,1.73,15.12,2019,37415
161,0,8,169,95.27,0.0,4.73,2019,38030
1779,38,205,2022,87.98,1.88,10.14,2019,40067
631,27,164,822,76.76,3.28,19.95,2019,40068
1695,64,561,2320,73.06,2.76,24.18,2019,40143
276,0,106,382,72.25,0.0,27.75,2019,40176
12432,245,1186,13863,89.68,1.77,8.56,2019,40207
4331,343,1663,6337,68.34,5.41,26.24,2019,40212
4767,271,1021,6059,78.68,4.47,16.85,2019,40217
10843,454,2105,13402,80.91,3.39,15.71,2019,40218
8878,341,950,10169,87.3,3.35,9.34,2019,40222
8968,138,365,9471,94.69,1.46,3.85,2019,40223
11500,397,892,12789,89.92,3.1,6.97,2019,40241
4109,113,351,4573,89.85,2.47,7.68,2019,40242
13514,441,1023,14978,90.23,2.94,6.83,2019,40291
0,0,11,11,0.0,0.0,100.0,2019,40334
1597,45,421,2063,77.41,2.18,20.41,2019,40337
1537,225,770,2532,60.7,8.89,30.41,2019,40359
5664,165,1611,7440,76.13,2.22,21.65,2019,40361
141,0,43,184,76.63,0.0,23.37,2019,40813
91,15,181,287,31.71,5.23,63.07,2019,40826
25,7,35,67,37.31,10.45,52.24,2019,40830
33,0,60,93,35.48,0.0,64.52,2019,40840
93,10,37,140,66.43,7.14,26.43,2019,40870
567,9,366,942,60.19,0.96,38.85,2019,40873
77,7,114,198,38.89,3.54,57.58,2019,40316
3277,178,1439,4894,66.96,3.64,29.4,2019,40336
1369,195,352,1916,71.45,10.18,18.37,2019,40006
1155,73,291,1519,76.04,4.81,19.16,2019,40019
39,0,65,104,37.5,0.0,62.5,2019,40036
617,34,272,923,66.85,3.68,29.47,2019,40078
576,48,143,767,75.1,6.26,18.64,2019,40109
2748,94,590,3432,80.07,2.74,17.19,2019,40118
6031,654,2150,8835,68.26,7.4,24.34,2019,40211
14179,545,2979,17703,80.09,3.08,16.83,2019,40214
12890,285,1401,14576,88.43,1.96,9.61,2019,40220
12262,536,1408,14206,86.32,3.77,9.91,2019,40229
3988,123,571,4682,85.18,2.63,12.2,2019,40243
119,51,85,255,46.67,20.0,33.33,2019,40348
13730,365,2081,16176,84.88,2.26,12.86,2019,40356
980,44,342,1366,71.74,3.22,25.04,2019,40409
745,41,139,925,80.54,4.43,15.03,2019,40440
155,33,112,300,51.67,11.0,37.33,2019,40445
301,31,13,345,87.25,8.99,3.77,2019,40510
13535,413,690,14638,92.46,2.82,4.71,2019,40515
122,0,12,134,91.04,0.0,8.96,2019,40824
100,0,38,138,72.46,0.0,27.54,2019,40843
136,0,0,136,100.0,0.0,0.0,2019,40847
151,40,72,263,57.41,15.21,27.38,2019,40903
287,16,233,536,53.54,2.99,43.47,2019,40972
12,0,0,12,100.0,0.0,0.0,2019,40979
155,8,5,168,92.26,4.76,2.98,2019,40983
977,98,343,1418,68.9,6.91,24.19,2019,40057
145,0,106,251,57.77,0.0,42.23,2019,40012
6603,213,885,7701,85.74,2.77,11.49,2019,40047
172,0,36,208,82.69,0.0,17.31,2019,40052
2482,70,667,3219,77.1,2.17,20.72,2019,40069
745,51,67,863,86.33,5.91,7.76,2019,40107
494,20,130,644,76.71,3.11,20.19,2019,40111
134,16,99,249,53.82,6.43,39.76,2019,40140
1013,51,416,1480,68.45,3.45,28.11,2019,40146
17,0,4,21,80.95,0.0,19.05,2019,29122
1060,159,759,1978,53.59,8.04,38.37,2019,29142
669,0,11,680,98.38,0.0,1.62,2019,29152
2733,202,1338,4273,63.96,4.73,31.31,2019,29161
187,1,104,292,64.04,0.34,35.62,2019,29166
7299,150,1111,8560,85.27,1.75,12.98,2019,29170
7244,167,825,8236,87.96,2.03,10.02,2019,29206
16076,232,1532,17840,90.11,1.3,8.59,2019,29229
3809,217,1306,5332,71.44,4.07,24.49,2019,29323
2563,189,567,3319,77.22,5.69,17.08,2019,29330
5249,333,1917,7499,70.0,4.44,25.56,2019,29341
371,0,113,484,76.65,0.0,23.35,2019,29351
174,7,147,328,53.05,2.13,44.82,2019,29355
2752,142,647,3541,77.72,4.01,18.27,2019,29356
5102,225,2209,7536,67.7,2.99,29.31,2019,29379
3021,107,665,3793,79.65,2.82,17.53,2019,29670
11070,316,596,11982,92.39,2.64,4.97,2019,29680
19363,306,1034,20703,93.53,1.48,4.99,2019,29681
1840,150,634,2624,70.12,5.72,24.16,2019,29709
7,0,0,7,100.0,0.0,0.0,2019,29724
19083,683,2658,22424,85.1,3.05,11.85,2019,29730
9548,476,1796,11820,80.78,4.03,15.19,2019,29745
2900,260,1257,4417,65.66,5.89,28.46,2019,29812
1407,61,311,1779,79.09,3.43,17.48,2019,29831
2119,121,692,2932,72.27,4.13,23.6,2019,29842
238,10,190,438,54.34,2.28,43.38,2019,29843
11139,170,893,12202,91.29,1.39,7.32,2019,29212
6053,521,2168,8742,69.24,5.96,24.8,2019,29303
3725,73,362,4160,89.54,1.75,8.7,2019,29365
520,26,213,759,68.51,3.43,28.06,2019,29137
4320,304,1438,6062,71.26,5.01,23.72,2019,29153
763,13,319,1095,69.68,1.19,29.13,2019,29162
8743,318,2117,11178,78.22,2.84,18.94,2019,29169
167,10,6,183,91.26,5.46,3.28,2019,29202
1911,156,816,2883,66.29,5.41,28.3,2019,29148
243,0,0,243,100.0,0.0,0.0,2019,29320
241,10,171,422,57.11,2.37,40.52,2019,29453
973,155,613,1741,55.89,8.9,35.21,2019,29581
4290,175,1488,5953,72.06,2.94,25.0,2019,29657
4572,190,1710,6472,70.64,2.94,26.42,2019,29569
15076,544,2031,17651,85.41,3.08,11.51,2019,29607
619,10,333,962,64.35,1.04,34.62,2019,29741
4929,207,774,5910,83.4,3.5,13.1,2019,29902
1256,25,385,1666,75.39,1.5,23.11,2019,29944
1248,182,868,2298,54.31,7.92,37.77,2019,29945
614,75,224,913,67.25,8.21,24.53,2019,29712
370,14,70,454,81.5,3.08,15.42,2019,29469
1721,253,630,2604,66.09,9.72,24.19,2019,29479
26588,739,4080,31407,84.66,2.35,12.99,2019,29483
701,173,211,1085,64.61,15.94,19.45,2019,29487
4579,285,2170,7034,65.1,4.05,30.85,2019,29506
1440,29,520,1989,72.4,1.46,26.14,2019,29511
174,18,144,336,51.79,5.36,42.86,2019,29516
63,26,77,166,37.95,15.66,46.39,2019,29519
13898,684,2006,16588,83.78,4.12,12.09,2019,29526
818,17,551,1386,59.02,1.23,39.75,2019,29570
2643,650,2280,5573,47.43,11.66,40.91,2019,29571
10791,541,2062,13394,80.57,4.04,15.39,2019,29577
282,4,249,535,52.71,0.75,46.54,2019,29580
1314,199,436,1949,67.42,10.21,22.37,2019,32008
806,50,379,1235,65.26,4.05,30.69,2019,32053
344,61,299,704,48.86,8.66,42.47,2019,32359
7194,101,2038,9333,77.08,1.08,21.84,2019,32401
5932,187,435,6554,90.51,2.85,6.64,2019,32413
262,0,168,430,60.93,0.0,39.07,2019,32423
202,1,116,319,63.32,0.31,36.36,2019,32426
2619,100,1152,3871,67.66,2.58,29.76,2019,32448
10081,339,1666,12086,83.41,2.8,13.78,2019,32503
223,81,0,304,73.36,26.64,0.0,2019,32544
11295,313,1145,12753,88.57,2.45,8.98,2019,32571
17090,1120,908,19118,89.39,5.86,4.75,2019,32608
1272,57,647,1976,64.37,2.88,32.74,2019,32621
3074,123,1196,4393,69.97,2.8,27.23,2019,32640
35,0,30,65,53.85,0.0,46.15,2019,32683
1340,43,628,2011,66.63,2.14,31.23,2019,32686
2270,85,477,2832,80.16,3.0,16.84,2019,32618
7132,92,551,7775,91.73,1.18,7.09,2019,32804
6316,105,795,7216,87.53,1.46,11.02,2019,32931
13176,257,1424,14857,88.69,1.73,9.58,2019,32707
13506,301,1983,15790,85.54,1.91,12.56,2019,32712
9578,325,2590,12493,76.67,2.6,20.73,2019,32720
1658,18,81,1757,94.37,1.02,4.61,2019,32732
12651,298,1832,14781,85.59,2.02,12.39,2019,32738
17579,438,2433,20450,85.96,2.14,11.9,2019,32771
9691,339,1544,11574,83.73,2.93,13.34,2019,32773
3553,63,385,4001,88.8,1.57,9.62,2019,32776
14495,434,3615,18544,78.17,2.34,19.49,2019,32808
7319,155,1903,9377,78.05,1.65,20.29,2019,32809
9516,198,417,10131,93.93,1.95,4.12,2019,32819
27,0,0,27,100.0,0.0,0.0,2019,32831
16279,294,918,17491,93.07,1.68,5.25,2019,32835
6535,141,432,7108,91.94,1.98,6.08,2019,32836
7378,206,1848,9432,78.22,2.18,19.59,2019,32905
859,23,260,1142,75.22,2.01,22.77,2019,32322
1510,56,536,2102,71.84,2.66,25.5,2019,32440
13613,338,681,14632,93.04,2.31,4.65,2019,32566
442,51,136,629,70.27,8.11,21.62,2019,32625
16484,340,541,17365,94.93,1.96,3.12,2019,32746
3614,59,282,3955,91.38,1.49,7.13,2019,32908
9069,144,193,9406,96.42,1.53,2.05,2019,32832
3090,112,155,3357,92.05,3.34,4.62,2019,32833
14488,392,911,15791,91.75,2.48,5.77,2019,32837
14095,428,2241,16764,84.08,2.55,13.37,2019,32935
3647,84,1141,4872,74.86,1.72,23.42,2019,32976
541,0,197,738,73.31,0.0,26.69,2019,32694
3394,142,625,4161,81.57,3.41,15.02,2019,32754
6267,235,1022,7524,83.29,3.12,13.58,2019,32801
8918,128,554,9600,92.9,1.33,5.77,2019,32803
12568,394,1992,14954,84.04,2.63,13.32,2019,32811
12305,195,1509,14009,87.84,1.39,10.77,2019,32812
6768,65,398,7231,93.6,0.9,5.5,2019,32821
8164,135,1006,9305,87.74,1.45,10.81,2019,32043
1535,27,428,1990,77.14,1.36,21.51,2019,32130
979,62,197,1238,79.08,5.01,15.91,2019,32009
4636,200,538,5374,86.27,3.72,10.01,2019,32011
5649,235,1112,6996,80.75,3.36,15.89,2019,32024
3420,132,852,4404,77.66,3.0,19.35,2019,32063
11789,325,517,12631,93.33,2.57,4.09,2019,32082
223,52,186,461,48.37,11.28,40.35,2019,35651
5359,228,1037,6624,80.9,3.44,15.66,2019,35661
1583,9,383,1975,80.15,0.46,19.39,2019,35739
164,0,49,213,77.0,0.0,23.0,2019,35746
4142,97,261,4500,92.04,2.16,5.8,2019,35756
17264,692,610,18566,92.99,3.73,3.29,2019,35758
1494,84,253,1831,81.59,4.59,13.82,2019,35760
154,12,82,248,62.1,4.84,33.06,2019,35764
1179,21,678,1878,62.78,1.12,36.1,2019,35772
6501,359,3228,10088,64.44,3.56,32.0,2019,35020
780,30,387,1197,65.16,2.51,32.33,2019,35034
252,19,63,334,75.45,5.69,18.86,2019,35035
1646,50,634,2330,70.64,2.15,27.21,2019,35042
0,0,0,0,,,,2019,35082
4269,158,1587,6014,70.98,2.63,26.39,2019,35121
40,0,68,108,37.04,0.0,62.96,2019,35139
1990,17,191,2198,90.54,0.77,8.69,2019,35147
632,31,244,907,69.68,3.42,26.9,2019,35148
249,0,92,341,73.02,0.0,26.98,2019,35176
13522,278,1019,14819,91.25,1.88,6.88,2019,35216
1199,66,506,1771,67.7,3.73,28.57,2019,35221
3963,105,129,4197,94.42,2.5,3.07,2019,35223
1331,70,632,2033,65.47,3.44,31.09,2019,35224
762,134,25,921,82.74,14.55,2.71,2019,35233
7185,127,390,7702,93.29,1.65,5.06,2019,35243
225,26,141,392,57.4,6.63,35.97,2019,35441
541,7,173,721,75.03,0.97,23.99,2019,35446
922,18,249,1189,77.54,1.51,20.94,2019,35452
111,0,50,161,68.94,0.0,31.06,2019,35458
4802,109,646,5557,86.41,1.96,11.62,2019,35475
23,9,30,62,37.1,14.52,48.39,2019,35477
964,51,501,1516,63.59,3.36,33.05,2019,35549
340,0,115,455,74.73,0.0,25.27,2019,35554
940,36,391,1367,68.76,2.63,28.6,2019,35579
7618,236,1601,9455,80.57,2.5,16.93,2019,35640
2277,249,1085,3611,63.06,6.9,30.05,2019,35653
2556,175,1315,4046,63.17,4.33,32.5,2019,35660
383,27,257,667,57.42,4.05,38.53,2019,35677
7480,111,695,8286,90.27,1.34,8.39,2019,35749
2678,63,555,3296,81.25,1.91,16.84,2019,35179
5787,142,1374,7303,79.24,1.94,18.81,2019,35950
2126,72,545,2743,77.51,2.62,19.87,2019,35953
4594,110,1313,6017,76.35,1.83,21.82,2019,35967
384,0,206,590,65.08,0.0,34.92,2019,35979
663,64,185,912,72.7,7.02,20.29,2019,35987
626,15,148,789,79.34,1.9,18.76,2019,35988
1171,10,195,1376,85.1,0.73,14.17,2019,35049
2466,237,749,3452,71.44,6.87,21.7,2019,35051
80,0,52,132,60.61,0.0,39.39,2019,35060
4041,125,1293,5459,74.02,2.29,23.69,2019,35115
1469,32,188,1689,86.97,1.89,11.13,2019,35116
3937,162,725,4824,81.61,3.36,15.03,2019,35120
7138,234,2576,9948,71.75,2.35,25.89,2019,35160
782,30,430,1242,62.96,2.42,34.62,2019,35171
1646,95,262,2003,82.18,4.74,13.08,2019,35175
1267,65,323,1655,76.56,3.93,19.52,2019,35968
954,24,394,1372,69.53,1.75,28.72,2019,35989
782,61,430,1273,61.43,4.79,33.78,2019,35083
4556,305,785,5646,80.69,5.4,13.9,2019,35094
81,4,120,205,39.51,1.95,58.54,2019,38036
14,0,11,25,56.0,0.0,44.0,2019,38046
152,19,42,213,71.36,8.92,19.72,2019,38050
410,55,471,936,43.8,5.88,50.32,2019,38069
2942,430,3006,6378,46.13,6.74,47.13,2019,38108
9759,295,2855,12909,75.6,2.29,22.12,2019,38118
483,29,190,702,68.8,4.13,27.07,2019,38231
130,11,37,178,73.03,6.18,20.79,2019,38235
225,25,137,387,58.14,6.46,35.4,2019,38241
866,26,255,1147,75.5,2.27,22.23,2019,38251
116,17,12,145,80.0,11.72,8.28,2019,38347
716,22,277,1015,70.54,2.17,27.29,2019,38255
113,0,51,164,68.9,0.0,31.1,2019,38318
933,35,277,1245,74.94,2.81,22.25,2019,38329
281,5,106,392,71.68,1.28,27.04,2019,38371
2290,129,1049,3468,66.03,3.72,30.25,2019,38382
66,0,48,114,57.89,0.0,42.11,2019,38387
190,5,96,291,65.29,1.72,32.99,2019,38044
3059,148,507,3714,82.36,3.98,13.65,2019,38058
4864,163,1598,6625,73.42,2.46,24.12,2019,38063
2847,76,1228,4151,68.59,1.83,29.58,2019,38068
3731,316,2553,6600,56.53,4.79,38.68,2019,38107
1289,59,440,1788,72.09,3.3,24.61,2019,38330
586,21,219,826,70.94,2.54,26.51,2019,38334
404,12,151,567,71.25,2.12,26.63,2019,38342
2230,53,777,3060,72.88,1.73,25.39,2019,38344
397,87,190,674,58.9,12.91,28.19,2019,38345
544,6,162,712,76.4,0.84,22.75,2019,38366
410,32,350,792,51.77,4.04,44.19,2019,38368
53,0,0,53,100.0,0.0,0.0,2019,38376
320,16,296,632,50.63,2.53,46.84,2019,38381
277,48,99,424,65.33,11.32,23.35,2019,38391
344,6,153,503,68.39,1.19,30.42,2019,38460
111,0,23,134,82.84,0.0,17.16,2019,38471
12086,32,1019,13137,92.0,0.24,7.76,2019,38002
630,44,191,865,72.83,5.09,22.08,2019,38015
17761,311,939,19011,93.42,1.64,4.94,2019,38017
791,96,419,1306,60.57,7.35,32.08,2019,38079
9572,201,1308,11081,86.38,1.81,11.8,2019,38117
8029,864,5072,13965,57.49,6.19,36.32,2019,38127
0,0,0,0,,,,2019,38132
5164,184,128,5476,94.3,3.36,2.34,2019,38139
797,47,278,1122,71.03,4.19,24.78,2019,38233
154,0,18,172,89.53,0.0,10.47,2019,38236
5183,143,1285,6611,78.4,2.16,19.44,2019,38261
9212,661,3392,13265,69.45,4.98,25.57,2019,38301
16630,929,2524,20083,82.81,4.63,12.57,2019,38305
172,10,78,260,66.15,3.85,30.0,2019,38328
19,0,23,42,45.24,0.0,54.76,2019,38962
31,0,0,31,100.0,0.0,0.0,2019,38964
4023,301,2178,6502,61.87,4.63,33.5,2019,38112
8890,526,5324,14740,60.31,3.57,36.12,2019,38116
5620,105,619,6344,88.59,1.66,9.76,2019,38120
604,24,1470,2098,28.79,1.14,70.07,2019,38126
8899,330,670,9899,89.9,3.33,6.77,2019,38138
781,23,259,1063,73.47,2.16,24.37,2019,38316
53,0,28,81,65.43,0.0,34.57,2019,38333
751,43,206,1000,75.1,4.3,20.6,2019,38356
1466,11,573,2050,71.51,0.54,27.95,2019,38363
309,0,37,346,89.31,0.0,10.69,2019,40157
507,24,108,639,79.34,3.76,16.9,2019,40177
1941,245,517,2703,71.81,9.06,19.13,2019,40202
4512,510,802,5824,77.47,8.76,13.77,2019,40208
411,71,233,715,57.48,9.93,32.59,2019,40055
3714,268,1087,5069,73.27,5.29,21.44,2019,40033
1000,115,351,1466,68.21,7.84,23.94,2019,40045
1300,91,450,1841,70.61,4.94,24.44,2019,40051
27,0,5,32,84.38,0.0,15.62,2019,40058
242,9,0,251,96.41,3.59,0.0,2019,40070
692,18,192,902,76.72,2.0,21.29,2019,40076
11204,208,911,12323,90.92,1.69,7.39,2019,40502
10822,438,982,12242,88.4,3.58,8.02,2019,40503
8603,265,2048,10916,78.81,2.43,18.76,2019,40505
6864,991,1593,9448,72.65,10.49,16.86,2019,40508
10555,409,1545,12509,84.38,3.27,12.35,2019,40511
265,0,18,283,93.64,0.0,6.36,2019,40737
5490,246,1201,6937,79.14,3.55,17.31,2019,40213
12106,265,1934,14305,84.63,1.85,13.52,2019,40272
14497,237,1393,16127,89.89,1.47,8.64,2019,40299
78,13,43,134,58.21,9.7,32.09,2019,40310
343,22,77,442,77.6,4.98,17.42,2019,40358
825,1,241,1067,77.32,0.09,22.59,2019,40370
753,0,256,1009,74.63,0.0,25.37,2019,40385
7344,244,1626,9214,79.7,2.65,17.65,2019,40422
277,18,68,363,76.31,4.96,18.73,2019,40442
541,73,119,733,73.81,9.96,16.23,2019,40003
1855,45,57,1957,94.79,2.3,2.91,2019,40023
1012,69,334,1415,71.52,4.88,23.6,2019,40828
346,0,153,499,69.34,0.0,30.66,2019,40815
15,0,0,15,100.0,0.0,0.0,2019,40818
320,17,121,458,69.87,3.71,26.42,2019,40854
232,6,82,320,72.5,1.88,25.62,2019,40855
178,16,89,283,62.9,5.65,31.45,2019,40856
115,0,26,141,81.56,0.0,18.44,2019,40862
124,0,49,173,71.68,0.0,28.32,2019,40865
92,0,80,172,53.49,0.0,46.51,2019,40874
11,0,27,38,28.95,0.0,71.05,2019,40007
264,1,114,379,69.66,0.26,30.08,2019,40009
633,0,228,861,73.52,0.0,26.48,2019,40387
1996,68,351,2415,82.65,2.82,14.53,2019,40390
7411,170,1500,9081,81.61,1.87,16.52,2019,40403
345,7,99,451,76.5,1.55,21.95,2019,40460
334,0,148,482,69.29,0.0,30.71,2019,40771
808,0,289,1097,73.66,0.0,26.34,2019,40806
132,9,21,162,81.48,5.56,12.96,2019,40807
183,15,37,235,77.87,6.38,15.74,2019,40820
186,9,78,273,68.13,3.3,28.57,2019,40953
13096,488,3761,17345,75.5,2.81,21.68,2019,40216
5769,37,592,6398,90.17,0.58,9.25,2019,40228
962,26,350,1338,71.9,1.94,26.16,2019,40322
497,20,172,689,72.13,2.9,24.96,2019,40374
2350,76,885,3311,70.98,2.3,26.73,2019,40447
2705,115,1131,3951,68.46,2.91,28.63,2019,40456
515,18,146,679,75.85,2.65,21.5,2019,40468
9514,647,1395,11556,82.33,5.6,12.07,2019,40504
17312,1173,2925,21410,80.86,5.48,13.66,2019,40601
786,24,298,1108,70.94,2.17,26.9,2019,40740
6689,486,1831,9006,74.27,5.4,20.33,2019,40741
426,47,267,740,57.57,6.35,36.08,2019,29593
8322,224,2489,11035,75.41,2.03,22.56,2019,29617
13333,555,2270,16158,82.52,3.43,14.05,2019,29621
3804,194,971,4969,76.55,3.9,19.54,2019,29626
5547,232,388,6167,89.95,3.76,6.29,2019,29631
6514,139,1039,7692,84.69,1.81,13.51,2019,29644
125,38,26,189,66.14,20.11,13.76,2019,29658
5906,243,1704,7853,75.21,3.09,21.7,2019,29690
1225,86,553,1864,65.72,4.61,29.67,2019,29692
1595,83,309,1987,80.27,4.18,15.55,2019,29696
403,131,142,676,59.62,19.38,21.01,2019,29727
890,201,732,1823,48.82,11.03,40.15,2019,29810
23,0,92,115,20.0,0.0,80.0,2019,29840
206,45,64,315,65.4,14.29,20.32,2019,29848
128,8,31,167,76.65,4.79,18.56,2019,29939
37,0,39,76,48.68,0.0,51.32,2019,29046
764,77,239,1080,70.74,7.13,22.13,2019,29101
1086,121,241,1448,75.0,8.36,16.64,2019,29168
1145,142,168,1455,78.69,9.76,11.55,2019,29940
6218,286,2125,8629,72.06,3.31,24.63,2019,29020
1168,99,853,2120,55.09,4.67,40.24,2019,29044
542,22,228,792,68.43,2.78,28.79,2019,29126
0,0,0,0,,,,2019,29117
0,0,0,0,,,,2019,29147
0,0,0,0,,,,2019,29208
0,0,0,0,,,,2019,29225
68,0,46,114,59.65,0.0,40.35,2019,29324
76,9,8,93,81.72,9.68,8.6,2019,29329
38,0,0,38,100.0,0.0,0.0,2019,29331
168,0,56,224,75.0,0.0,25.0,2019,29333
119,7,5,131,90.84,5.34,3.82,2019,29346
55,0,0,55,100.0,0.0,0.0,2019,29368
22,0,18,40,55.0,0.0,45.0,2019,29378
10,0,0,10,100.0,0.0,0.0,2019,29409
7377,301,1213,8891,82.97,3.39,13.64,2019,29410
0,0,0,0,,,,2019,29424
15432,535,1531,17498,88.19,3.06,8.75,2019,29588
0,0,0,0,,,,2019,29613
79,12,0,91,86.81,13.19,0.0,2019,29614
14,0,12,26,53.85,0.0,46.15,2019,29634
11868,169,442,12479,95.1,1.35,3.54,2019,29707
0,0,0,0,,,,2019,29733
0,0,0,0,,,,2019,29899
0,0,0,0,,,,2019,29904
16,0,0,16,100.0,0.0,0.0,2019,29905
4407,188,473,5068,86.96,3.71,9.33,2019,29907
8269,389,498,9156,90.31,4.25,5.44,2019,29909
0,0,0,0,,,,2019,29912
196,0,5,201,97.51,0.0,2.49,2019,29915
1019,80,544,1643,62.02,4.87,33.11,2019,29817
3742,411,1384,5537,67.58,7.42,25.0,2019,29520
11119,204,1219,12542,88.65,1.63,9.72,2019,29642
71,3,34,108,65.74,2.78,31.48,2019,29667
1246,111,297,1654,75.33,6.71,17.96,2019,29689
576,54,450,1080,53.33,5.0,41.67,2019,29080
373,30,193,596,62.58,5.03,32.38,2019,29146
8358,189,1158,9705,86.12,1.95,11.93,2019,29045
5373,153,934,6460,83.17,2.37,14.46,2019,29118
1224,21,368,1613,75.88,1.3,22.81,2019,29372
366,0,174,540,67.78,0.0,32.22,2019,32083
1338,110,176,1624,82.39,6.77,10.84,2019,32087
3946,81,1618,5645,69.9,1.43,28.66,2019,32091
10910,716,851,12477,87.44,5.74,6.82,2019,32092
2371,53,693,3117,76.07,1.7,22.23,2019,32134
4021,223,2306,6550,61.39,3.4,35.21,2019,32206
18583,759,2857,22199,83.71,3.42,12.87,2019,32218
1161,20,313,1494,77.71,1.34,20.95,2019,32744
960,19,130,1109,86.56,1.71,11.72,2019,32767
11574,243,1637,13454,86.03,1.81,12.17,2019,32810
14059,422,2940,17421,80.7,2.42,16.88,2019,32818
2603,48,332,2983,87.26,1.61,11.13,2019,32820
3253,66,95,3414,95.28,1.93,2.78,2019,32827
4512,414,1367,6293,71.7,6.58,21.72,2019,32922
9105,65,862,10032,90.76,0.65,8.59,2019,32927
789,8,47,844,93.48,0.95,5.57,2019,32949
4251,98,411,4760,89.31,2.06,8.63,2019,32407
448,23,28,499,89.78,4.61,5.61,2019,32410
3400,184,1108,4692,72.46,3.92,23.61,2019,32425
248,41,175,464,53.45,8.84,37.72,2019,32427
1154,24,555,1733,66.59,1.38,32.03,2019,32431
320,13,168,501,63.87,2.59,33.53,2019,32445
2818,93,1413,4324,65.17,2.15,32.68,2019,32501
12898,400,1340,14638,88.11,2.73,9.15,2019,32526
9364,375,1016,10755,87.07,3.49,9.45,2019,32533
7958,531,1006,9495,83.81,5.59,10.6,2019,32539
3564,36,345,3945,90.34,0.91,8.75,2019,32222
9215,118,452,9785,94.17,1.21,4.62,2019,32223
386,0,27,413,93.46,0.0,6.54,2019,32227
19867,417,1159,21443,92.65,1.94,5.41,2019,32256
15146,1003,1486,17635,85.89,5.69,8.43,2019,32304
9341,290,690,10321,90.5,2.81,6.69,2019,32308
8369,464,1675,10508,79.64,4.42,15.94,2019,32901
7348,219,712,8279,88.75,2.65,8.6,2019,32926
15865,226,922,17013,93.25,1.33,5.42,2019,32940
1611,10,145,1766,91.22,0.57,8.21,2019,32950
4028,35,320,4383,91.9,0.8,7.3,2019,32968
13360,523,1343,15226,87.74,3.43,8.82,2019,32780
6480,109,680,7269,89.15,1.5,9.35,2019,32934
1401,186,216,1803,77.7,10.32,11.98,2019,32033
9713,171,544,10428,93.14,1.64,5.22,2019,32003
0,0,0,0,,,,2019,32026
1592,39,810,2441,65.22,1.6,33.18,2019,32064
8344,664,728,9736,85.7,6.82,7.48,2019,32080
4901,24,0,4925,99.51,0.49,0.0,2019,32081
7786,243,392,8421,92.46,2.89,4.66,2019,32128
7904,349,1576,9829,80.42,3.55,16.03,2019,32129
8,0,0,8,100.0,0.0,0.0,2019,32133
28221,397,1537,30155,93.59,1.32,5.1,2019,32162
0,0,0,0,,,,2019,32228
5717,206,1800,7723,74.03,2.67,23.31,2019,32305
11592,283,563,12438,93.2,2.28,4.53,2019,32309
4955,48,471,5474,90.52,0.88,8.6,2019,32317
2427,281,1047,3755,64.63,7.48,27.88,2019,32348
1602,37,741,2380,67.31,1.55,31.13,2019,32352
2379,78,514,2971,80.07,2.63,17.3,2019,32435
25,0,0,25,100.0,0.0,0.0,2019,32461
1271,43,221,1535,82.8,2.8,14.4,2019,32502
0,0,0,0,,,,2019,32509
2829,215,1051,4095,69.08,5.25,25.67,2019,35125
3464,224,606,4294,80.67,5.22,14.11,2019,35128
790,8,96,894,88.37,0.89,10.74,2019,35135
8315,310,695,9320,89.22,3.33,7.46,2019,35173
196,5,196,397,49.37,1.26,49.37,2019,35459
284,5,112,401,70.82,1.25,27.93,2019,35460
242,0,87,329,73.56,0.0,26.44,2019,35480
194,43,118,355,54.65,12.11,33.24,2019,35552
6,0,0,6,100.0,0.0,0.0,2019,35559
1281,122,493,1896,67.56,6.43,26.0,2019,35563
3131,132,1266,4529,69.13,2.91,27.95,2019,35570
191,2,131,324,58.95,0.62,40.43,2019,35571
841,38,455,1334,63.04,2.85,34.11,2019,35576
1938,73,674,2685,72.18,2.72,25.1,2019,35594
6959,273,705,7937,87.68,3.44,8.88,2019,35613
1866,191,554,2611,71.47,7.32,21.22,2019,35614
3324,171,1658,5153,64.51,3.32,32.18,2019,35650
524,156,192,872,60.09,17.89,22.02,2019,35671
1951,94,575,2620,74.47,3.59,21.95,2019,35673
987,74,358,1419,69.56,5.21,25.23,2019,35740
4316,157,793,5266,81.96,2.98,15.06,2019,35750
4930,248,1496,6674,73.87,3.72,22.42,2019,35903
1549,42,389,1980,78.23,2.12,19.65,2019,35754
8970,297,1680,10947,81.94,2.71,15.35,2019,35811
5694,165,1694,7553,75.39,2.18,22.43,2019,35901
3564,152,761,4477,79.61,3.4,17.0,2019,35954
1014,0,436,1450,69.93,0.0,30.07,2019,35958
1631,127,739,2497,65.32,5.09,29.6,2019,35961
1369,45,539,1953,70.1,2.3,27.6,2019,35971
81,5,0,86,94.19,5.81,0.0,2019,35751
1098,59,265,1422,77.22,4.15,18.64,2019,35771
10149,72,835,11056,91.8,0.65,7.55,2019,35806
343,0,8,351,97.72,0.0,2.28,2019,35808
211,0,169,380,55.53,0.0,44.47,2019,35775
10227,132,940,11299,90.51,1.17,8.32,2019,35803
2060,185,846,3091,66.65,5.99,27.37,2019,35044
5973,286,1579,7838,76.21,3.65,20.15,2019,35055
5362,151,815,6328,84.73,2.39,12.88,2019,35071
2199,81,775,3055,71.98,2.65,25.37,2019,35986
3719,156,749,4624,80.43,3.37,16.2,2019,35004
2020,58,619,2697,74.9,2.15,22.95,2019,35005
3993,259,1663,5915,67.51,4.38,28.11,2019,35045
0,0,23,23,0.0,0.0,100.0,2019,35052
1454,97,457,2008,72.41,4.83,22.76,2019,35186
5220,188,285,5693,91.69,3.3,5.01,2019,35213
14308,868,2997,18173,78.73,4.78,16.49,2019,35215
1484,50,473,2007,73.94,2.49,23.57,2019,35442
960,109,231,1300,73.85,8.38,17.77,2019,35456
954,21,217,1192,80.03,1.76,18.2,2019,35118
597,14,215,826,72.28,1.69,26.03,2019,35073
2341,125,725,3191,73.36,3.92,22.72,2019,35085
5022,106,637,5765,87.11,1.84,11.05,2019,35111
8669,189,724,9582,90.47,1.97,7.56,2019,35124
5187,226,1540,6953,74.6,3.25,22.15,2019,35150
951,232,505,1688,56.34,13.74,29.92,2019,35203
4775,259,1826,6860,69.61,3.78,26.62,2019,35206
10777,304,911,11992,89.87,2.54,7.6,2019,35209
1937,158,747,2842,68.16,5.56,26.28,2019,35218
12272,308,537,13117,93.56,2.35,4.09,2019,35226
275,16,105,396,69.44,4.04,26.52,2019,38390
2391,133,1456,3980,60.08,3.34,36.58,2019,38462
1682,120,650,2452,68.6,4.89,26.51,2019,38562
776,87,128,991,78.3,8.78,12.92,2019,38222
1063,19,551,1633,65.09,1.16,33.74,2019,38230
5955,442,1993,8390,70.98,5.27,23.75,2019,38242
388,84,181,653,59.42,12.86,27.72,2019,38258
1087,59,355,1501,72.42,3.93,23.65,2019,38260
568,56,301,925,61.41,6.05,32.54,2019,38321
866,4,363,1233,70.24,0.32,29.44,2019,38326
341,0,152,493,69.17,0.0,30.83,2019,38332
147,2,146,295,49.83,0.68,49.49,2019,38339
3508,29,960,4497,78.01,0.64,21.35,2019,38340
248,5,48,301,82.39,1.66,15.95,2019,38370
4840,230,1553,6623,73.08,3.47,23.45,2019,38372
355,5,159,519,68.4,0.96,30.64,2019,38379
457,65,209,731,62.52,8.89,28.59,2019,38425
840,21,232,1093,76.85,1.92,21.23,2019,38449
1019,0,154,1173,86.87,0.0,13.13,2019,38313
3063,167,1237,4467,68.57,3.74,27.69,2019,38320
514,58,329,901,57.05,6.44,36.51,2019,38341
277,0,123,400,69.25,0.0,30.75,2019,38348
1963,93,234,2290,85.72,4.06,10.22,2019,38355
3695,139,821,4655,79.38,2.99,17.64,2019,38358
545,12,257,814,66.95,1.47,31.57,2019,38374
19255,778,3292,23325,82.55,3.34,14.11,2019,38401
94,0,14,108,87.04,0.0,12.96,2019,38459
906,30,253,1189,76.2,2.52,21.28,2019,38472
1819,25,679,2523,72.1,0.99,26.91,2019,38485
9281,261,2152,11694,79.37,2.23,18.4,2019,38506
0,0,9,9,0.0,0.0,100.0,2019,38542
2492,153,1357,4002,62.27,3.82,33.91,2019,38570
292,15,175,482,60.58,3.11,36.31,2019,38575
359,80,83,522,68.77,15.33,15.9,2019,38625
200,0,153,353,56.66,0.0,43.34,2019,38627
132,8,144,284,46.48,2.82,50.7,2019,38647
544,0,186,730,74.52,0.0,25.48,2019,38658
421,67,254,742,56.74,9.03,34.23,2019,38661
1200,10,169,1379,87.02,0.73,12.26,2019,38664
1386,49,706,2141,64.74,2.29,32.98,2019,38676
584,23,265,872,66.97,2.64,30.39,2019,38730
351,2,170,523,67.11,0.38,32.5,2019,38753
341,19,218,578,59.0,3.29,37.72,2019,38754
402,49,288,739,54.4,6.63,38.97,2019,38761
347,3,200,550,63.09,0.55,36.36,2019,38778
4991,99,1576,6666,74.87,1.49,23.64,2019,38804
1945,76,747,2768,70.27,2.75,26.99,2019,38824
1688,111,475,2274,74.23,4.88,20.89,2019,38849
2574,213,503,3290,78.24,6.47,15.29,2019,38011
51,0,286,337,15.13,0.0,84.87,2019,38961
2250,92,581,2923,76.98,3.15,19.88,2019,38967
218,4,174,396,55.05,1.01,43.94,2019,38670
285,37,31,353,80.74,10.48,8.78,2019,38674
1776,74,295,2145,82.8,3.45,13.75,2019,38680
3022,199,1340,4561,66.26,4.36,29.38,2019,38703
164,1,111,276,59.42,0.36,40.22,2019,38725
133,5,57,195,68.21,2.56,29.23,2019,38726
4170,61,2029,6260,66.61,0.97,32.41,2019,38732
153,3,157,313,48.88,0.96,50.16,2019,38760
19,0,0,19,100.0,0.0,0.0,2019,40808
324,30,157,511,63.41,5.87,30.72,2019,40810
189,0,42,231,81.82,0.0,18.18,2019,40819
220,38,77,335,65.67,11.34,22.99,2019,40827
142,8,76,226,62.83,3.54,33.63,2019,40845
164,0,13,177,92.66,0.0,7.34,2019,40858
260,42,149,451,57.65,9.31,33.04,2019,40868
2393,423,1528,4344,55.09,9.74,35.17,2019,40906
80,0,55,135,59.26,0.0,40.74,2019,40913
147,0,18,165,89.09,0.0,10.91,2019,40914
3793,303,1998,6094,62.24,4.97,32.79,2019,40769
1064,23,174,1261,84.38,1.82,13.8,2019,40516
14232,567,1682,16481,86.35,3.44,10.21,2019,40517
78,24,110,212,36.79,11.32,51.89,2019,40763
254,28,31,313,81.15,8.95,9.9,2019,40915
22,21,35,78,28.21,26.92,44.87,2019,40921
259,0,48,307,84.36,0.0,15.64,2019,40949
2508,173,1368,4049,61.94,4.27,33.79,2019,40977
55,39,45,139,39.57,28.06,32.37,2019,40997
913,49,644,1606,56.85,3.05,40.1,2019,40419
6679,510,1377,8566,77.97,5.95,16.08,2019,40342
21,0,44,65,32.31,0.0,67.69,2019,40350
607,14,177,798,76.07,1.75,22.18,2019,40372
281,41,190,512,54.88,8.01,37.11,2019,40464
1495,92,407,1994,74.97,4.61,20.41,2019,41175
1523,39,441,2003,76.04,1.95,22.02,2019,41224
209,8,79,296,70.61,2.7,26.69,2019,41234
170,0,95,265,64.15,0.0,35.85,2019,41268
49,0,35,84,58.33,0.0,41.67,2019,41317
201,15,241,457,43.98,3.28,52.74,2019,41348
3231,71,1280,4582,70.52,1.55,27.94,2019,41465
294,0,31,325,90.46,0.0,9.54,2019,41527
206,17,128,351,58.69,4.84,36.47,2019,41528
421,39,158,618,68.12,6.31,25.57,2019,41603
193,0,25,218,88.53,0.0,11.47,2019,41615
53,0,0,53,100.0,0.0,0.0,2019,41621
393,27,192,612,64.22,4.41,31.37,2019,41630
688,15,358,1061,64.84,1.41,33.74,2019,41649
1128,88,368,1584,71.21,5.56,23.23,2019,41006
1380,67,174,1621,85.13,4.13,10.73,2019,41007
9287,118,1245,10650,87.2,1.11,11.69,2019,41018
975,13,171,1159,84.12,1.12,14.75,2019,41039
47,0,0,47,100.0,0.0,0.0,2019,41052
919,14,166,1099,83.62,1.27,15.1,2019,41059
344,11,89,444,77.48,2.48,20.05,2019,41425
166,0,59,225,73.78,0.0,26.22,2019,41513
50,0,15,65,76.92,0.0,23.08,2019,41524
226,9,99,334,67.66,2.69,29.64,2019,41558
70,0,10,80,87.5,0.0,12.5,2019,41559
103,0,8,111,92.79,0.0,7.21,2019,41560
29,0,22,51,56.86,0.0,43.14,2019,41567
1290,22,246,1558,82.8,1.41,15.79,2019,41572
335,0,119,454,73.79,0.0,26.21,2019,41606
24,0,22,46,52.17,0.0,47.83,2019,41612
41,8,43,92,44.57,8.7,46.74,2019,41619
321,0,153,474,67.72,0.0,32.28,2019,41631
209,8,173,390,53.59,2.05,44.36,2019,41636
99,23,22,144,68.75,15.97,15.28,2019,41650
213,0,7,220,96.82,0.0,3.18,2019,41667
4887,129,407,5423,90.12,2.38,7.51,2019,29492
18,0,0,18,100.0,0.0,0.0,2019,30451
0,0,0,0,,,,2019,30460
0,0,0,0,,,,2019,30475
3053,34,379,3466,88.08,0.98,10.93,2019,30536
23,0,1,24,95.83,0.0,4.17,2019,30573
0,0,0,0,,,,2019,30609
20,0,9,29,68.97,0.0,31.03,2019,30623
20,0,0,20,100.0,0.0,0.0,2019,30751
8,0,63,71,11.27,0.0,88.73,2019,30756
0,0,0,0,,,,2019,30812
302,0,0,302,100.0,0.0,0.0,2019,30903
0,0,0,0,,,,2019,30912
10410,134,669,11213,92.84,1.2,5.97,2019,30078
4149,85,885,5119,81.05,1.66,17.29,2019,30110
11259,1466,2072,14797,76.09,9.91,14.0,2019,30134
2871,95,535,3501,82.01,2.71,15.28,2019,30755
859,19,57,935,91.87,2.03,6.1,2019,30905
426,34,311,771,55.25,4.41,40.34,2019,30634
11365,310,2155,13830,82.18,2.24,15.58,2019,30060
1369,23,313,1705,80.29,1.35,18.36,2019,30565
424,23,86,533,79.55,4.32,16.14,2019,30619
2057,28,321,2406,85.49,1.16,13.34,2019,30710
344,2,133,479,71.82,0.42,27.77,2019,30823
11504,88,603,12195,94.33,0.72,4.94,2019,30068
22955,296,1022,24273,94.57,1.22,4.21,2019,30188
1038,79,411,1528,67.93,5.17,26.9,2019,30295
10763,591,1695,13049,82.48,4.53,12.99,2019,30341
22137,164,1260,23561,93.96,0.7,5.35,2019,30062
990,13,194,1197,82.71,1.09,16.21,2019,30124
942,25,145,1112,84.71,2.25,13.04,2019,30205
887,0,578,1465,60.55,0.0,39.45,2019,30833
13349,886,2067,16302,81.89,5.43,12.68,2019,30236
13925,380,627,14932,93.26,2.54,4.2,2019,30252
1367,4,379,1750,78.11,0.23,21.66,2019,30257
729,19,284,1032,70.64,1.84,27.52,2019,30258
156,46,66,268,58.21,17.16,24.63,2019,30285
10152,1051,1199,12402,81.86,8.47,9.67,2019,30312
4625,214,745,5584,82.83,3.83,13.34,2019,30317
1607,45,333,1985,80.96,2.27,16.78,2019,30559
393,59,142,594,66.16,9.93,23.91,2019,30568
245,31,173,449,54.57,6.9,38.53,2019,30572
354,21,181,556,63.67,3.78,32.55,2019,30575
706,38,171,915,77.16,4.15,18.69,2019,30576
5168,390,2081,7639,67.65,5.11,27.24,2019,30577
610,22,297,929,65.66,2.37,31.97,2019,30625
1289,108,423,1820,70.82,5.93,23.24,2019,30629
2023,41,713,2777,72.85,1.48,25.68,2019,30646
205,25,88,318,64.47,7.86,27.67,2019,30667
6073,94,616,6783,89.53,1.39,9.08,2019,30677
13717,196,1460,15373,89.23,1.27,9.5,2019,30506
6493,216,1248,7957,81.6,2.71,15.68,2019,30507
845,20,414,1279,66.07,1.56,32.37,2019,30511
899,51,244,1194,75.29,4.27,20.44,2019,30171
416,108,205,729,57.06,14.81,28.12,2019,30234
8260,325,2128,10713,77.1,3.03,19.86,2019,30240
11822,322,666,12810,92.29,2.51,5.2,2019,30265
4811,111,627,5549,86.7,2.0,11.3,2019,30276
8219,326,482,9027,91.05,3.61,5.34,2019,30307
0,0,0,0,,,,2019,32511
7,0,0,7,100.0,0.0,0.0,2019,32530
3129,286,213,3628,86.25,7.88,5.87,2019,32550
9341,241,626,10208,91.51,2.36,6.13,2019,32563
0,5,0,5,0.0,100.0,0.0,2019,32612
102,0,0,102,100.0,0.0,0.0,2019,32631
3485,34,23,3542,98.39,0.96,0.65,2019,32814
6,0,0,6,100.0,0.0,0.0,2019,32830
10765,271,1810,12846,83.8,2.11,14.09,2019,32405
1089,31,533,1653,65.88,1.88,32.24,2019,32131
18307,572,3444,22323,82.01,2.56,15.43,2019,32822
9413,177,1027,10617,88.66,1.67,9.67,2019,32909
313,7,58,378,82.8,1.85,15.34,2019,32616
8438,154,670,9262,91.1,1.66,7.23,2019,32750
20884,321,955,22160,94.24,1.45,4.31,2019,32828
3221,140,1388,4749,67.82,2.95,29.23,2019,32641
1361,104,392,1857,73.29,5.6,21.11,2019,32464
1356,25,430,1811,74.88,1.38,23.74,2019,32667
20173,390,1258,21821,92.45,1.79,5.77,2019,32765
11853,166,875,12894,91.93,1.29,6.79,2019,32824
7207,259,1555,9021,79.89,2.87,17.24,2019,32962
0,0,0,0,,,,2019,32356
2782,41,225,3048,91.27,1.35,7.38,2019,32266
12023,129,433,12585,95.53,1.03,3.44,2019,32065
1295,99,139,1533,84.47,6.46,9.07,2019,32580
1592,34,405,2031,78.39,1.67,19.94,2019,32668
14480,703,3076,18259,79.3,3.85,16.85,2019,32703
6359,252,1245,7856,80.94,3.21,15.85,2019,32060
682,21,255,958,71.19,2.19,26.62,2019,32094
294,24,112,430,68.37,5.58,26.05,2019,32139
1265,226,460,1951,64.84,11.58,23.58,2019,32145
3182,182,848,4212,75.55,4.32,20.13,2019,32148
4660,224,531,5415,86.06,4.14,9.81,2019,32169
1090,15,310,1415,77.03,1.06,21.91,2019,32180
532,0,192,724,73.48,0.0,26.52,2019,32187
254,7,161,422,60.19,1.66,38.15,2019,32190
7392,184,1095,8671,85.25,2.12,12.63,2019,32217
3182,445,708,4335,73.4,10.27,16.33,2019,32219
13288,636,1617,15541,85.5,4.09,10.4,2019,32257
12066,244,492,12802,94.25,1.91,3.84,2019,32258
16027,119,373,16519,97.02,0.72,2.26,2019,32259
4281,283,1057,5621,76.16,5.03,18.8,2019,32310
7922,97,382,8401,94.3,1.15,4.55,2019,32311
896,78,619,1593,56.25,4.9,38.86,2019,32331
333,33,96,462,72.08,7.14,20.78,2019,32336
87,0,37,124,70.16,0.0,29.84,2019,32355
623,9,9,641,97.19,1.4,1.4,2019,32403
1137,20,648,1805,62.99,1.11,35.9,2019,32113
14035,498,1174,15707,89.36,3.17,7.47,2019,32034
4519,178,1263,5960,75.82,2.99,21.19,2019,32055
107,0,15,122,87.7,0.0,12.3,2019,32061
1365,8,397,1770,77.12,0.45,22.43,2019,32066
1233,0,126,1359,90.73,0.0,9.27,2019,32071
207,6,20,233,88.84,2.58,8.58,2019,32079
1763,413,837,3013,58.51,13.71,27.78,2019,32110
7957,275,1809,10041,79.25,2.74,18.02,2019,32119
1638,38,105,1781,91.97,2.13,5.9,2019,32124
12719,622,1977,15318,83.03,4.06,12.91,2019,32159
8567,834,2933,12334,69.46,6.76,23.78,2019,32208
6940,216,983,8139,85.27,2.65,12.08,2019,35235
1105,37,286,1428,77.38,2.59,20.03,2019,35444
640,7,248,895,71.51,0.78,27.71,2019,35461
5524,160,536,6220,88.81,2.57,8.62,2019,35473
1051,62,159,1272,82.63,4.87,12.5,2019,35490
2884,118,778,3780,76.3,3.12,20.58,2019,35501
873,72,178,1123,77.74,6.41,15.85,2019,35540
1057,34,423,1514,69.82,2.25,27.94,2019,35541
307,6,104,417,73.62,1.44,24.94,2019,35542
153,0,99,252,60.71,0.0,39.29,2019,35544
536,41,317,894,59.96,4.59,35.46,2019,35564
8623,796,2871,12290,70.16,6.48,23.36,2019,35601
513,13,277,803,63.89,1.62,34.5,2019,35610
1238,59,550,1847,67.03,3.19,29.78,2019,35619
984,186,658,1828,53.83,10.18,36.0,2019,35646
1770,91,917,2778,63.71,3.28,33.01,2019,35654
1474,172,565,2211,66.67,7.78,25.55,2019,35672
302,30,405,737,40.98,4.07,54.95,2019,35744
4109,115,610,4834,85.0,2.38,12.62,2019,35761
6415,155,297,6867,93.42,2.26,4.33,2019,35763
1016,96,294,1406,72.26,6.83,20.91,2019,35765
3453,102,928,4483,77.02,2.28,20.7,2019,35768
3011,114,916,4041,74.51,2.82,22.67,2019,35769
1135,27,288,1450,78.28,1.86,19.86,2019,35776
1853,107,389,2349,78.88,4.56,16.56,2019,35905
2903,61,281,3245,89.46,1.88,8.66,2019,35907
2953,91,1232,4276,69.06,2.13,28.81,2019,35960
1123,7,373,1503,74.72,0.47,24.82,2019,35131
632,14,115,761,83.05,1.84,15.11,2019,35463
73,0,15,88,82.95,0.0,17.05,2019,35469
2732,88,679,3499,78.08,2.52,19.41,2019,35503
1040,90,594,1724,60.32,5.22,34.45,2019,35553
3300,250,1564,5114,64.53,4.89,30.58,2019,35565
435,15,231,681,63.88,2.2,33.92,2019,35574
1382,25,886,2293,60.27,1.09,38.64,2019,35578
68,14,55,137,49.64,10.22,40.15,2019,35584
410,91,351,852,48.12,10.68,41.2,2019,35618
261,0,107,368,70.92,0.0,29.08,2019,35647
29,0,1,30,96.67,0.0,3.33,2019,35649
2311,169,999,3479,66.43,4.86,28.72,2019,35652
1765,139,623,2527,69.85,5.5,24.65,2019,35670
1265,0,85,1350,93.7,0.0,6.3,2019,35741
706,20,293,1019,69.28,1.96,28.75,2019,35752
2822,14,253,3089,91.36,0.45,8.19,2019,35759
67,0,0,67,100.0,0.0,0.0,2019,35766
8834,245,941,10020,88.16,2.45,9.39,2019,35801
8793,373,2331,11497,76.48,3.24,20.27,2019,35810
4887,499,1236,6622,73.8,7.54,18.67,2019,35816
1900,61,915,2876,66.06,2.12,31.82,2019,35952
2241,64,778,3083,72.69,2.08,25.24,2019,35962
499,1,208,708,70.48,0.14,29.38,2019,35974
5481,158,1243,6882,79.64,2.3,18.06,2019,35976
10,7,6,23,43.48,30.43,26.09,2019,35990
2915,16,448,3379,86.27,0.47,13.26,2019,35068
4117,184,922,5223,78.82,3.52,17.65,2019,35645
52,6,23,81,64.2,7.41,28.4,2019,35745
55,0,12,67,82.09,0.0,17.91,2019,35774
558,40,158,756,73.81,5.29,20.9,2019,35984
1390,116,381,1887,73.66,6.15,20.19,2019,35978
66,0,74,140,47.14,0.0,52.86,2019,38764
0,0,21,21,0.0,0.0,100.0,2019,38772
678,49,623,1350,50.22,3.63,46.15,2019,38773
836,57,594,1487,56.22,3.83,39.95,2019,38828
266,0,220,486,54.73,0.0,45.27,2019,38838
674,24,201,899,74.97,2.67,22.36,2019,38846
1948,120,1068,3136,62.12,3.83,34.06,2019,38851
1325,93,814,2232,59.36,4.17,36.47,2019,38860
674,48,324,1046,64.44,4.59,30.98,2019,38862
120,0,54,174,68.97,0.0,31.03,2019,38913
1379,76,434,1889,73.0,4.02,22.98,2019,38006
3588,166,1794,5548,64.67,2.99,32.34,2019,38012
719,51,321,1091,65.9,4.67,29.42,2019,38034
376,29,185,590,63.73,4.92,31.36,2019,38037
1450,42,473,1965,73.79,2.14,24.07,2019,38040
15,0,11,26,57.69,0.0,42.31,2019,38047
1245,16,445,1706,72.98,0.94,26.08,2019,38052
852,56,222,1130,75.4,4.96,19.65,2019,38066
794,31,252,1077,73.72,2.88,23.4,2019,38080
5968,210,1457,7635,78.17,2.75,19.08,2019,38103
1438,343,1351,3132,45.91,10.95,43.14,2019,38105
21,0,16,37,56.76,0.0,43.24,2019,38569
502,5,124,631,79.56,0.79,19.65,2019,38582
4252,104,2261,6617,64.26,1.57,34.17,2019,38614
145,9,108,262,55.34,3.44,41.22,2019,38617
226,80,207,513,44.05,15.59,40.35,2019,38626
11780,356,1923,14059,83.79,2.53,13.68,2019,38671
1303,179,459,1941,67.13,9.22,23.65,2019,38683
61,0,37,98,62.24,0.0,37.76,2019,38740
133,31,232,396,33.59,7.83,58.59,2019,38685
247,19,151,417,59.23,4.56,36.21,2019,38721
96,0,60,156,61.54,0.0,38.46,2019,38736
2257,138,1408,3803,59.35,3.63,37.02,2019,38751
236,5,128,369,63.96,1.36,34.69,2019,38759
685,0,411,1096,62.5,0.0,37.5,2019,38771
3125,193,926,4244,73.63,4.55,21.82,2019,38843
2457,216,988,3661,67.11,5.9,26.99,2019,38852
4441,528,1993,6962,63.79,7.58,28.63,2019,38863
503,6,153,662,75.98,0.91,23.11,2019,38864
172,31,114,317,54.26,9.78,35.96,2019,38879
650,64,355,1069,60.8,5.99,33.21,2019,38917
973,58,529,1560,62.37,3.72,33.91,2019,38921
16,0,62,78,20.51,0.0,79.49,2019,38946
123,10,213,346,35.55,2.89,61.56,2019,38954
382,18,300,700,54.57,2.57,42.86,2019,38774
8560,603,2299,11462,74.68,5.26,20.06,2019,38801
8104,444,3036,11584,69.96,3.83,26.21,2019,38834
1274,53,374,1701,74.9,3.12,21.99,2019,38855
1229,45,371,1645,74.71,2.74,22.55,2019,38865
95,14,75,184,51.63,7.61,40.76,2019,38869
749,60,333,1142,65.59,5.25,29.16,2019,38878
1241,63,497,1801,68.91,3.5,27.6,2019,38001
3062,165,299,3526,86.84,4.68,8.48,2019,38004
2335,82,1174,3591,65.02,2.28,32.69,2019,38008
12675,243,755,13673,92.7,1.78,5.52,2019,38018
2246,39,293,2578,87.12,1.51,11.37,2019,38028
367,0,238,605,60.66,0.0,39.34,2019,38039
697,10,317,1024,68.07,0.98,30.96,2019,38041
7237,647,1877,9761,74.14,6.63,19.23,2019,38053
42,0,7,49,85.71,0.0,14.29,2019,41739
103,0,0,103,100.0,0.0,0.0,2019,41754
215,23,53,291,73.88,7.9,18.21,2019,41764
66,0,23,89,74.16,0.0,25.84,2019,41766
139,12,14,165,84.24,7.27,8.48,2019,41819
31,0,12,43,72.09,0.0,27.91,2019,41849
248,0,63,311,79.74,0.0,20.26,2019,41855
1565,44,365,1974,79.28,2.23,18.49,2019,41537
596,15,153,764,78.01,1.96,20.03,2019,41553
131,7,134,272,48.16,2.57,49.26,2019,41555
551,0,214,765,72.03,0.0,27.97,2019,41557
201,0,85,286,70.28,0.0,29.72,2019,41571
155,0,26,181,85.64,0.0,14.36,2019,41605
813,0,414,1227,66.26,0.0,33.74,2019,41635
287,40,140,467,61.46,8.57,29.98,2019,41640
38,0,33,71,53.52,0.0,46.48,2019,41735
823,90,231,1144,71.94,7.87,20.19,2019,41749
181,0,69,250,72.4,0.0,27.6,2019,41825
269,13,115,397,67.76,3.27,28.97,2019,41831
160,0,87,247,64.78,0.0,35.22,2019,41847
104,25,38,167,62.28,14.97,22.75,2019,41859
645,12,55,712,90.59,1.69,7.72,2019,41080
454,41,205,700,64.86,5.86,29.29,2019,41098
5915,193,1215,7323,80.77,2.64,16.59,2019,41101
462,64,124,650,71.08,9.85,19.08,2019,41121
5363,152,706,6221,86.21,2.44,11.35,2019,41001
1933,135,321,2389,80.91,5.65,13.44,2019,41016
18129,644,1905,20678,87.67,3.11,9.21,2019,41042
290,5,89,384,75.52,1.3,23.18,2019,41044
339,17,96,452,75.0,3.76,21.24,2019,41046
358,23,350,731,48.97,3.15,47.88,2019,41064
199,19,150,368,54.08,5.16,40.76,2019,41124
2860,103,758,3721,76.86,2.77,20.37,2019,41144
96,20,130,246,39.02,8.13,52.85,2019,41159
280,4,131,415,67.47,0.96,31.57,2019,41231
1485,31,992,2508,59.21,1.24,39.55,2019,41301
2895,161,1256,4312,67.14,3.73,29.13,2019,41339
108,0,63,171,63.16,0.0,36.84,2019,41385
0,0,12,12,0.0,0.0,100.0,2019,41390
121,0,90,211,57.35,0.0,42.65,2019,41421
167,25,63,255,65.49,9.8,24.71,2019,41464
194,0,85,279,69.53,0.0,30.47,2019,41503
338,37,143,518,65.25,7.14,27.61,2019,41519
75,10,27,112,66.96,8.93,24.11,2019,41534
94,0,0,94,100.0,0.0,0.0,2019,41543
704,73,356,1133,62.14,6.44,31.42,2019,41562
192,0,43,235,81.7,0.0,18.3,2019,41604
293,36,103,432,67.82,8.33,23.84,2019,41645
347,11,113,471,73.67,2.34,23.99,2019,41166
39,0,11,50,78.0,0.0,22.0,2019,41201
81,0,111,192,42.19,0.0,57.81,2019,41214
191,11,44,246,77.64,4.47,17.89,2019,41238
1969,50,411,2430,81.03,2.06,16.91,2019,41240
133,0,31,164,81.1,0.0,18.9,2019,41263
339,15,178,532,63.72,2.82,33.46,2019,41265
4,0,0,4,100.0,0.0,0.0,2019,41397
4904,121,1507,6532,75.08,1.85,23.07,2019,41701
90,11,56,157,57.32,7.01,35.67,2019,41714
115,0,0,115,100.0,0.0,0.0,2019,41751
7954,817,2585,11356,70.04,7.19,22.76,2019,30310
57,74,0,131,43.51,56.49,0.0,2019,30336
3806,508,1167,5481,69.44,9.27,21.29,2019,30337
12256,133,372,12761,96.04,1.04,2.92,2019,30339
3605,116,1408,5129,70.29,2.26,27.45,2019,30401
508,0,117,625,81.28,0.0,18.72,2019,30452
184,8,33,225,81.78,3.56,14.67,2019,30455
1344,52,773,2169,61.96,2.4,35.64,2019,30457
3160,112,1198,4470,70.69,2.51,26.8,2019,30467
7492,76,941,8509,88.05,0.89,11.06,2019,30504
1624,72,571,2267,71.64,3.18,25.19,2019,30510
552,2,320,874,63.16,0.23,36.61,2019,30516
2362,62,788,3212,73.54,1.93,24.53,2019,30525
500,25,73,598,83.61,4.18,12.21,2019,30541
765,109,277,1151,66.46,9.47,24.07,2019,30547
705,30,229,964,73.13,3.11,23.76,2019,30555
267,32,166,465,57.42,6.88,35.7,2019,30746
2132,47,534,2713,78.58,1.73,19.68,2019,30683
1329,62,166,1557,85.36,3.98,10.66,2019,30725
5641,216,1725,7582,74.4,2.85,22.75,2019,30728
3894,131,1720,5745,67.78,2.28,29.94,2019,30747
2582,148,787,3517,73.41,4.21,22.38,2019,30752
15397,911,3280,19588,78.6,4.65,16.74,2019,30906
10281,491,1392,12164,84.52,4.04,11.44,2019,30030
13955,522,2584,17061,81.79,3.06,15.15,2019,30034
13711,257,1015,14983,91.51,1.72,6.77,2019,30039
24024,420,2544,26988,89.02,1.56,9.43,2019,30044
15,0,14,29,51.72,0.0,48.28,2019,30412
2890,182,999,4071,70.99,4.47,24.54,2019,30417
436,18,145,599,72.79,3.01,24.21,2019,30425
6162,294,2313,8769,70.27,3.35,26.38,2019,30241
0,0,0,0,,,,2019,30250
989,81,121,1191,83.04,6.8,10.16,2019,30259
6310,406,1275,7991,78.96,5.08,15.96,2019,30260
7893,1043,3628,12564,62.82,8.3,28.88,2019,30315
4443,225,618,5286,84.05,4.26,11.69,2019,30360
2559,141,1303,4003,63.93,3.52,32.55,2019,30439
12056,972,2845,15873,75.95,6.12,17.92,2019,30458
19,0,9,28,67.86,0.0,32.14,2019,30464
4808,85,320,5213,92.23,1.63,6.14,2019,30517
7856,189,1589,9634,81.54,1.96,16.49,2019,30533
11645,115,689,12449,93.54,0.92,5.53,2019,30542
2558,68,700,3326,76.91,2.04,21.05,2019,30553
1544,93,363,2000,77.2,4.65,18.15,2019,30557
1278,26,161,1465,87.24,1.77,10.99,2019,30564
2328,23,304,2655,87.68,0.87,11.45,2019,30566
3145,53,459,3657,86.0,1.45,12.55,2019,30607
7168,277,2192,9637,74.38,2.87,22.75,2019,30601
14524,780,1345,16649,87.24,4.68,8.08,2019,30605
303,31,250,584,51.88,5.31,42.81,2019,30631
18393,403,759,19555,94.06,2.06,3.88,2019,30075
7596,118,1097,8811,86.21,1.34,12.45,2019,30116
7814,211,924,8949,87.32,2.36,10.33,2019,30143
18877,279,1412,20568,91.78,1.36,6.87,2019,30144
874,29,251,1154,75.74,2.51,21.75,2019,30170
7290,696,1791,9777,74.56,7.12,18.32,2019,30224
2336,41,1043,3420,68.3,1.2,30.5,2019,30230
21,0,0,21,100.0,0.0,0.0,2019,30275
7340,226,544,8110,90.51,2.79,6.71,2019,30277
8032,1282,3853,13167,61.0,9.74,29.26,2019,32209
5845,251,988,7084,82.51,3.54,13.95,2019,32176
7491,438,2460,10389,72.11,4.22,23.68,2019,32177
18889,574,4180,23643,79.89,2.43,17.68,2019,32210
11247,213,920,12380,90.85,1.72,7.43,2019,32250
10447,182,1455,12084,86.45,1.51,12.04,2019,32277
1220,62,237,1519,80.32,4.08,15.6,2019,32320
708,16,200,924,76.62,1.73,21.65,2019,32346
3258,232,2755,6245,52.17,3.71,44.12,2019,32351
6085,383,1288,7756,78.46,4.94,16.61,2019,32025
2727,56,627,3410,79.97,1.64,18.39,2019,32046
2422,118,964,3504,69.12,3.37,27.51,2019,32054
17985,377,1308,19670,91.43,1.92,6.65,2019,32068
2534,109,611,3254,77.87,3.35,18.78,2019,32179
701,64,232,997,70.31,6.42,23.27,2019,32181
11254,506,2839,14599,77.09,3.47,19.45,2019,32207
3920,145,638,4703,83.35,3.08,13.57,2019,32220
8405,313,937,9655,87.05,3.24,9.7,2019,32233
18203,419,1696,20318,89.59,2.06,8.35,2019,32246
11421,329,1063,12813,89.14,2.57,8.3,2019,32301
1063,64,503,1630,65.21,3.93,30.86,2019,32321
887,78,792,1757,50.48,4.44,45.08,2019,32324
1125,42,256,1423,79.06,2.95,17.99,2019,32328
90,3,136,229,39.3,1.31,59.39,2019,32330
224,12,237,473,47.36,2.54,50.11,2019,32332
598,33,198,829,72.14,3.98,23.88,2019,32334
4527,130,1215,5872,77.09,2.21,20.69,2019,32428
320,12,108,440,72.73,2.73,24.55,2019,32430
0,0,0,0,,,,2019,32432
3430,63,502,3995,85.86,1.58,12.57,2019,32439
956,5,525,1486,64.33,0.34,35.33,2019,32442
1004,8,217,1229,81.69,0.65,17.66,2019,32443
0,0,0,0,,,,2019,32447
1704,22,873,2599,65.56,0.85,33.59,2019,32465
7348,273,845,8466,86.79,3.22,9.98,2019,32536
7848,622,1173,9643,81.39,6.45,12.16,2019,32548
4310,232,331,4873,88.45,4.76,6.79,2019,32569
11890,185,469,12544,94.79,1.47,3.74,2019,32312
1382,76,304,1762,78.43,4.31,17.25,2019,32577
11219,415,750,12384,90.59,3.35,6.06,2019,32578
1407,272,53,1732,81.24,15.7,3.06,2019,32603
1338,57,584,1979,67.61,2.88,29.51,2019,32619
144,4,21,169,85.21,2.37,12.43,2019,32648
16,0,0,16,100.0,0.0,0.0,2019,32681
16024,267,1406,17697,90.55,1.51,7.94,2019,32708
12085,411,2215,14711,82.15,2.79,15.06,2019,32724
1866,43,197,2106,88.6,2.04,9.35,2019,32735
960,18,173,1151,83.41,1.56,15.03,2019,32764
7780,380,1401,9561,81.37,3.97,14.65,2019,32778
6820,95,361,7276,93.73,1.31,4.96,2019,32963
16,0,94,110,14.55,0.0,85.45,2019,32970
451,25,153,629,71.7,3.97,24.32,2019,32350
11972,359,1932,14263,83.94,2.52,13.55,2019,32404
621,18,257,896,69.31,2.01,28.68,2019,32420
1336,64,777,2177,61.37,2.94,35.69,2019,32424
1137,35,469,1641,69.29,2.13,28.58,2019,32455
5612,134,691,6437,87.18,2.08,10.73,2019,32534
1101,43,279,1423,77.37,3.02,19.61,2019,32462
1658,101,181,1940,85.46,5.21,9.33,2019,32466
3169,83,682,3934,80.55,2.11,17.34,2019,35634
3324,216,377,3917,84.86,5.51,9.62,2019,35906
1154,54,218,1426,80.93,3.79,15.29,2019,35983
0,0,17,17,0.0,0.0,100.0,2019,35013
11,0,4,15,73.33,0.0,26.67,2019,35032
3,0,0,3,100.0,0.0,0.0,2019,35187
0,0,0,0,,,,2019,35229
65,0,90,155,41.94,0.0,58.06,2019,35254
13,0,0,13,100.0,0.0,0.0,2019,35577
0,0,17,17,0.0,0.0,100.0,2019,35615
0,0,0,0,,,,2019,35896
898,32,200,1130,79.47,2.83,17.7,2019,35033
11639,143,479,12261,94.93,1.17,3.91,2019,35244
431,23,240,694,62.1,3.31,34.58,2019,35548
1701,29,346,2076,81.94,1.4,16.67,2019,35747
1378,147,403,1928,71.47,7.62,20.9,2019,35959
1087,120,434,1641,66.24,7.31,26.45,2019,35184
7410,697,1690,9797,75.64,7.11,17.25,2019,35205
3875,228,1336,5439,71.24,4.19,24.56,2019,35208
3069,227,1470,4766,64.39,4.76,30.84,2019,35212
3366,179,602,4147,81.17,4.32,14.52,2019,35222
987,103,815,1905,51.81,5.41,42.78,2019,35234
8206,247,839,9292,88.31,2.66,9.03,2019,35007
5089,267,1140,6496,78.34,4.11,17.55,2019,35016
689,21,308,1018,67.68,2.06,30.26,2019,35006
1180,129,346,1655,71.3,7.79,20.91,2019,35014
590,19,298,907,65.05,2.09,32.86,2019,35019
6788,149,1420,8357,81.23,1.78,16.99,2019,35023
5347,91,747,6185,86.45,1.47,12.08,2019,35040
1277,59,595,1931,66.13,3.06,30.81,2019,35054
3823,55,1099,4977,76.81,1.11,22.08,2019,35057
80,0,23,103,77.67,0.0,22.33,2019,35070
2402,78,578,3058,78.55,2.55,18.9,2019,35079
273,9,146,428,63.79,2.1,34.11,2019,35098
1030,30,139,1199,85.9,2.5,11.59,2019,35143
2843,147,350,3340,85.12,4.4,10.48,2019,35146
2423,223,1675,4321,56.07,5.16,38.76,2019,35204
1942,236,1366,3544,54.8,6.66,38.54,2019,35207
3224,221,1487,4932,65.37,4.48,30.15,2019,35217
5895,547,1315,7757,76.0,7.05,16.95,2019,35404
14041,525,2396,16962,82.78,3.1,14.13,2019,35405
6450,72,383,6905,93.41,1.04,5.55,2019,35406
274,0,260,534,51.31,0.0,48.69,2019,35443
181,12,113,306,59.15,3.92,36.93,2019,35464
1731,80,465,2276,76.05,3.51,20.43,2019,35474
15,0,35,50,30.0,0.0,70.0,2019,35545
1023,39,403,1465,69.83,2.66,27.51,2019,35546
317,0,191,508,62.4,0.0,37.6,2019,35572
313,5,113,431,72.62,1.16,26.22,2019,35575
878,51,414,1343,65.38,3.8,30.83,2019,35580
1033,58,615,1706,60.55,3.4,36.05,2019,35586
1303,35,572,1910,68.22,1.83,29.95,2019,35592
348,15,229,592,58.78,2.53,38.68,2019,35593
10652,583,2038,13273,80.25,4.39,15.35,2019,35603
1027,46,562,1635,62.81,2.81,34.37,2019,35616
10325,1204,3417,14946,69.08,8.06,22.86,2019,35630
5179,242,1884,7305,70.9,3.31,25.79,2019,35674
2211,111,416,2738,80.75,4.05,15.19,2019,35748
5631,119,271,6021,93.52,1.98,4.5,2019,35757
216,8,48,272,79.41,2.94,17.65,2019,38061
339,2,204,545,62.2,0.37,37.43,2019,38067
12945,139,792,13876,93.29,1.0,5.71,2019,38125
13093,351,2036,15480,84.58,2.27,13.15,2019,38134
9413,205,972,10590,88.89,1.94,9.18,2019,38135
479,30,254,763,62.78,3.93,33.29,2019,38220
843,56,487,1386,60.82,4.04,35.14,2019,38221
194,6,99,299,64.88,2.01,33.11,2019,38224
754,24,205,983,76.7,2.44,20.85,2019,38240
343,5,61,409,83.86,1.22,14.91,2019,38253
1134,6,382,1522,74.51,0.39,25.1,2019,38256
1399,47,444,1890,74.02,2.49,23.49,2019,38257
188,2,74,264,71.21,0.76,28.03,2019,38259
1022,28,295,1345,75.99,2.08,21.93,2019,38315
560,45,309,914,61.27,4.92,33.81,2019,38317
140,10,53,203,68.97,4.93,26.11,2019,38327
4584,184,1657,6425,71.35,2.86,25.79,2019,38343
272,27,92,391,69.57,6.91,23.53,2019,38361
464,3,188,655,70.84,0.46,28.7,2019,38369
2544,24,897,3465,73.42,0.69,25.89,2019,38375
151,19,67,237,63.71,8.02,28.27,2019,38380
11540,726,4976,17242,66.93,4.21,28.86,2019,38111
9014,176,997,10187,88.49,1.73,9.79,2019,38119
6020,351,2449,8820,68.25,3.98,27.77,2019,38122
2874,51,1127,4052,70.93,1.26,27.81,2019,38201
1547,50,701,2298,67.32,2.18,30.5,2019,38225
156,17,33,206,75.73,8.25,16.02,2019,38475
84,0,28,112,75.0,0.0,25.0,2019,38453
155,14,63,232,66.81,6.03,27.16,2019,38457
2187,198,684,3069,71.26,6.45,22.29,2019,38474
1475,177,276,1928,76.5,9.18,14.32,2019,38023
135,0,180,315,42.86,0.0,57.14,2019,38920
728,42,462,1232,59.09,3.41,37.5,2019,38925
242,1,183,426,56.81,0.23,42.96,2019,38951
107,27,106,240,44.58,11.25,44.17,2019,38953
3847,727,3696,8270,46.52,8.79,44.69,2019,38930
91,0,14,105,86.67,0.0,13.33,2019,38943
70,0,67,137,51.09,0.0,48.91,2019,38944
2264,59,1222,3545,63.86,1.66,34.47,2019,38965
167,0,147,314,53.18,0.0,46.82,2019,38966
532,32,349,913,58.27,3.5,38.23,2019,39425
1871,88,1432,3391,55.18,2.6,42.23,2019,39428
2451,291,1731,4473,54.8,6.51,38.7,2019,39437
2185,133,1112,3430,63.7,3.88,32.42,2019,39455
237,0,69,306,77.45,0.0,22.55,2019,39456
277,22,129,428,64.72,5.14,30.14,2019,39462
1191,111,939,2241,53.15,4.95,41.9,2019,39474
1094,5,1109,2208,49.55,0.23,50.23,2019,39479
2867,76,759,3702,77.44,2.05,20.5,2019,39482
16474,307,2956,19737,83.47,1.56,14.98,2019,39503
5759,128,1333,7220,79.76,1.77,18.46,2019,39507
12723,372,1847,14942,85.15,2.49,12.36,2019,39564
4221,57,674,4952,85.24,1.15,13.61,2019,39574
1336,30,844,2210,60.45,1.36,38.19,2019,39645
1826,66,502,2394,76.27,2.76,20.97,2019,39576
5520,639,2186,8345,66.15,7.66,26.2,2019,39601
216,23,80,319,67.71,7.21,25.08,2019,39647
2377,61,560,2998,79.29,2.03,18.68,2019,38059
1666,120,1124,2910,57.25,4.12,38.63,2019,39652
0,0,5,5,0.0,0.0,100.0,2019,41760
248,0,161,409,60.64,0.0,39.36,2019,41815
690,7,261,958,72.03,0.73,27.24,2019,41822
202,0,87,289,69.9,0.0,30.1,2019,41826
217,21,78,316,68.67,6.65,24.68,2019,41840
329,23,175,527,62.43,4.36,33.21,2019,41844
162,0,9,171,94.74,0.0,5.26,2019,41659
320,36,148,504,63.49,7.14,29.37,2019,41722
239,0,86,325,73.54,0.0,26.46,2019,41727
0,0,0,0,,,,2019,41729
358,0,47,405,88.4,0.0,11.6,2019,41740
115,0,44,159,72.33,0.0,27.67,2019,41745
78,0,23,101,77.23,0.0,22.77,2019,41759
0,0,0,0,,,,2019,41762
95,0,19,114,83.33,0.0,16.67,2019,41772
759,16,235,1010,75.15,1.58,23.27,2019,41774
0,22,0,22,0.0,100.0,0.0,2019,41775
90,0,54,144,62.5,0.0,37.5,2019,41834
251,64,118,433,57.97,14.78,27.25,2019,41837
2568,161,664,3393,75.69,4.75,19.57,2019,41858
103,7,138,248,41.53,2.82,55.65,2019,41721
45,0,0,45,100.0,0.0,0.0,2019,41725
322,10,117,449,71.71,2.23,26.06,2019,41731
105,10,100,215,48.84,4.65,46.51,2019,41746
334,8,250,592,56.42,1.35,42.23,2019,41773
246,40,75,361,68.14,11.08,20.78,2019,41835
140,0,106,246,56.91,0.0,43.09,2019,41838
214,44,144,402,53.23,10.95,35.82,2019,41862
2699,371,1125,4195,64.34,8.84,26.82,2019,41035
1897,78,799,2774,68.39,2.81,28.8,2019,41040
4574,32,304,4910,93.16,0.65,6.19,2019,41048
2154,81,283,2518,85.54,3.22,11.24,2019,41073
318,7,172,497,63.98,1.41,34.61,2019,41083
234,4,94,332,70.48,1.2,28.31,2019,41085
6519,106,267,6892,94.59,1.54,3.87,2019,41091
3216,296,1504,5016,64.11,5.9,29.98,2019,41143
79,0,72,151,52.32,0.0,47.68,2019,41146
688,56,190,934,73.66,6.0,20.34,2019,41168
1894,22,291,2207,85.82,1.0,13.19,2019,41169
606,9,180,795,76.23,1.13,22.64,2019,41189
91,13,65,169,53.85,7.69,38.46,2019,41365
2037,76,668,2781,73.25,2.73,24.02,2019,42129
5161,136,1483,6780,76.12,2.01,21.87,2019,42134
100,0,96,196,51.02,0.0,48.98,2019,42157
535,12,43,590,90.68,2.03,7.29,2019,42207
243,0,35,278,87.41,0.0,12.59,2019,42214
251,19,170,440,57.05,4.32,38.64,2019,42215
872,48,397,1317,66.21,3.64,30.14,2019,42217
170,10,101,281,60.5,3.56,35.94,2019,42275
29,0,7,36,80.56,0.0,19.44,2019,42463
1257,224,372,1853,67.84,12.09,20.08,2019,42724
6894,442,1719,9055,76.13,4.88,18.98,2019,43160
11094,420,1119,12633,87.82,3.32,8.86,2019,43201
10764,378,2685,13827,77.85,2.73,19.42,2019,43213
11038,220,513,11771,93.77,1.87,4.36,2019,43220
105,0,12,117,89.74,0.0,10.26,2019,43321
3045,73,629,3747,81.27,1.95,16.79,2019,43338
3337,157,762,4256,78.41,3.69,17.9,2019,43351
1355,26,216,1597,84.85,1.63,13.53,2019,43357
20111,1735,2687,24533,81.98,7.07,10.95,2019,30281
2730,39,284,3053,89.42,1.28,9.3,2019,30290
11169,311,954,12434,89.83,2.5,7.67,2019,30045
3359,96,630,4085,82.23,2.35,15.42,2019,30054
17335,660,2790,20785,83.4,3.18,13.42,2019,30058
16691,225,1362,18278,91.32,1.23,7.45,2019,30064
17919,262,1860,20041,89.41,1.31,9.28,2019,30067
22192,563,3070,25825,85.93,2.18,11.89,2019,30096
12967,108,1597,14672,88.38,0.74,10.88,2019,30102
2272,104,739,3115,72.94,3.34,23.72,2019,30108
18706,2131,1575,22412,83.46,9.51,7.03,2019,30135
472,9,13,494,95.55,1.82,2.63,2019,30177
9903,924,593,11420,86.72,8.09,5.19,2019,30213
849,15,703,1567,54.18,0.96,44.86,2019,30222
12245,440,1014,13699,89.39,3.21,7.4,2019,30269
6017,330,2322,8669,69.41,3.81,26.79,2019,30286
5933,839,1454,8226,72.12,10.2,17.68,2019,30291
11248,693,765,12706,88.53,5.45,6.02,2019,30305
10138,884,595,11617,87.27,7.61,5.12,2019,30308
13115,1141,688,14944,87.76,7.64,4.6,2019,30324
19329,936,4198,24463,79.01,3.83,17.16,2019,30331
14018,102,520,14640,95.75,0.7,3.55,2019,30338
11564,645,768,12977,89.11,4.97,5.92,2019,30342
11163,525,1701,13389,83.37,3.92,12.7,2019,30014
6675,362,1361,8398,79.48,4.31,16.21,2019,30035
616,18,166,800,77.0,2.25,20.75,2019,30056
15406,298,1111,16815,91.62,1.77,6.61,2019,30076
12234,391,1494,14119,86.65,2.77,10.58,2019,30084
8773,336,1209,10318,85.03,3.26,11.72,2019,30088
15600,229,540,16369,95.3,1.4,3.3,2019,30097
588,48,133,769,76.46,6.24,17.3,2019,30105
11917,833,1794,14544,81.94,5.73,12.33,2019,30120
1028,171,283,1482,69.37,11.54,19.1,2019,30139
622,22,150,794,78.34,2.77,18.89,2019,30816
205,17,19,241,85.06,7.05,7.88,2019,30818
3679,67,1157,4903,75.04,1.37,23.6,2019,30830
12895,424,3468,16787,76.82,2.53,20.66,2019,30909
13322,607,4272,18201,73.19,3.33,23.47,2019,30093
5428,502,1100,7030,77.21,7.14,15.65,2019,30021
99,13,72,184,53.8,7.07,39.13,2019,30070
333,3,41,377,88.33,0.8,10.88,2019,30072
14012,429,1103,15544,90.14,2.76,7.1,2019,30126
523,55,114,692,75.58,7.95,16.47,2019,30137
2155,84,633,2872,75.03,2.92,22.04,2019,30554
977,82,770,1829,53.42,4.48,42.1,2019,30558
1688,13,290,1991,84.78,0.65,14.57,2019,30560
15380,723,2286,18389,83.64,3.93,12.43,2019,30606
562,15,505,1082,51.94,1.39,46.67,2019,30624
1903,87,409,2399,79.32,3.63,17.05,2019,30628
2357,137,651,3145,74.94,4.36,20.7,2019,30633
3495,147,900,4542,76.95,3.24,19.82,2019,30650
4517,99,812,5428,83.22,1.82,14.96,2019,30656
2116,39,682,2837,74.59,1.37,24.04,2019,30176
10959,825,1223,13007,84.25,6.34,9.4,2019,30180
925,6,223,1154,80.16,0.52,19.32,2019,30206
9774,220,945,10939,89.35,2.01,8.64,2019,30214
3803,238,2013,6054,62.82,3.93,33.25,2019,30635
982,2,257,1241,79.13,0.16,20.71,2019,30567
502,15,436,953,52.68,1.57,45.75,2019,30630
14303,450,1817,16570,86.32,2.72,10.97,2019,32514
876,128,285,1289,67.96,9.93,22.11,2019,32567
9462,174,612,10248,92.33,1.7,5.97,2019,32605
10620,381,801,11802,89.98,3.23,6.79,2019,32607
365,5,52,422,86.49,1.18,12.32,2019,32622
72,0,26,98,73.47,0.0,26.53,2019,32658
3274,159,1187,4620,70.87,3.44,25.69,2019,32696
870,23,267,1160,75.0,1.98,23.02,2019,32702
7111,271,1107,8489,83.77,3.19,13.04,2019,32726
2269,60,310,2639,85.98,2.27,11.75,2019,32730
3320,76,253,3649,90.98,2.08,6.93,2019,32736
9499,541,1329,11369,83.55,4.76,11.69,2019,32757
963,62,193,1218,79.06,5.09,15.85,2019,32759
10277,161,524,10962,93.75,1.47,4.78,2019,32779
18811,358,1632,20801,90.43,1.72,7.85,2019,32792
5903,84,126,6113,96.56,1.37,2.06,2019,32829
5505,49,461,6015,91.52,0.81,7.66,2019,32903
10433,245,1260,11938,87.39,2.05,10.55,2019,32904
13548,231,1055,14834,91.33,1.56,7.11,2019,32907
6286,194,1475,7955,79.02,2.44,18.54,2019,32966
9889,333,1271,11493,86.04,2.9,11.06,2019,32958
6789,206,1662,8657,78.42,2.38,19.2,2019,32960
8816,313,1145,10274,85.81,3.05,11.14,2019,32221
18588,317,1305,20210,91.97,1.57,6.46,2019,32225
1739,71,443,2253,77.19,3.15,19.66,2019,32234
18988,833,1683,21504,88.3,3.87,7.83,2019,32244
3250,328,1185,4763,68.23,6.89,24.88,2019,32254
10188,203,697,11088,91.88,1.83,6.29,2019,32937
9272,293,2155,11720,79.11,2.5,18.39,2019,32807
4577,156,639,5372,85.2,2.9,11.9,2019,32920
441,19,0,460,95.87,4.13,0.0,2019,32925
4824,154,391,5369,89.85,2.87,7.28,2019,32951
18007,630,2043,20680,87.07,3.05,9.88,2019,32303
7747,553,1278,9578,80.88,5.77,13.34,2019,32327
1041,8,188,1237,84.16,0.65,15.2,2019,32343
14570,817,3080,18467,78.9,4.42,16.68,2019,33009
17156,461,6779,24396,70.32,1.89,27.79,2019,33012
13036,264,1337,14637,89.06,1.8,9.13,2019,33018
14924,574,2445,17943,83.17,3.2,13.63,2019,33312
7162,124,131,7417,96.56,1.67,1.77,2019,33331
17289,566,1182,19037,90.82,2.97,6.21,2019,33324
6258,63,180,6501,96.26,0.97,2.77,2019,33327
9437,214,500,10151,92.97,2.11,4.93,2019,33328
8207,149,762,9118,90.01,1.63,8.36,2019,33408
5248,46,96,5390,97.37,0.85,1.78,2019,33412
18654,264,831,19749,94.46,1.34,4.21,2019,33414
10733,586,3028,14347,74.81,4.08,21.11,2019,33417
16331,622,1345,18298,89.25,3.4,7.35,2019,33433
14647,543,2143,17333,84.5,3.13,12.36,2019,33436
7086,264,1355,8705,81.4,3.03,15.57,2019,33444
11953,663,1461,14077,84.91,4.71,10.38,2019,33445
9982,289,2139,12410,80.44,2.33,17.24,2019,33462
15779,358,2374,18511,85.24,1.93,12.82,2019,33463
5676,156,403,6235,91.03,2.5,6.46,2019,33483
8455,305,572,9332,90.6,3.27,6.13,2019,33487
222,27,234,483,45.96,5.59,48.45,2019,33493
137,4,77,218,62.84,1.83,35.32,2019,33521
5925,154,1124,7203,82.26,2.14,15.6,2019,33525
9124,265,193,9582,95.22,2.77,2.01,2019,33544
3752,29,47,3828,98.01,0.76,1.23,2019,35824
156,15,53,224,69.64,6.7,23.66,2019,35975
309,8,141,458,67.47,1.75,30.79,2019,36262
789,9,230,1028,76.75,0.88,22.37,2019,36279
626,26,253,905,69.17,2.87,27.96,2019,36319
835,52,479,1366,61.13,3.81,35.07,2019,36320
12349,234,1578,14161,87.2,1.65,11.14,2019,36330
1579,121,1219,2919,54.09,4.15,41.76,2019,36401
200,0,10,210,95.24,0.0,4.76,2019,36013
2880,121,1264,4265,67.53,2.84,29.64,2019,36037
46,13,28,87,52.87,14.94,32.18,2019,36039
3625,52,228,3905,92.83,1.33,5.84,2019,36093
4028,8,873,4909,82.05,0.16,17.78,2019,36111
5606,214,1160,6980,80.32,3.07,16.62,2019,36203
1691,0,143,1834,92.2,0.0,7.8,2019,36250
100,1,126,227,44.05,0.44,55.51,2019,36317
398,8,111,517,76.98,1.55,21.47,2019,36318
1125,42,449,1616,69.62,2.6,27.78,2019,36866
3957,70,824,4851,81.57,1.44,16.99,2019,36877
54,0,127,181,29.83,0.0,70.17,2019,36901
360,10,128,498,72.29,2.01,25.7,2019,36005
933,45,646,1624,57.45,2.77,39.78,2019,36010
4088,310,1713,6111,66.9,5.07,28.03,2019,36027
359,7,221,587,61.16,1.19,37.65,2019,36028
85,10,82,177,48.02,5.65,46.33,2019,36030
249,7,102,358,69.55,1.96,28.49,2019,36034
407,6,219,632,64.4,0.95,34.65,2019,36042
381,0,166,547,69.65,0.0,30.35,2019,36046
4983,101,780,5864,84.98,1.72,13.3,2019,36054
1569,214,879,2662,58.94,8.04,33.02,2019,36089
1816,232,884,2932,61.94,7.91,30.15,2019,36104
2205,221,1414,3840,57.42,5.76,36.82,2019,36105
14295,426,2328,17049,83.85,2.5,13.65,2019,36116
6575,210,1332,8117,81.0,2.59,16.41,2019,36207
979,97,528,1604,61.03,6.05,32.92,2019,36260
74,0,108,182,40.66,0.0,59.34,2019,36263
6113,414,1004,7531,81.17,5.5,13.33,2019,36265
0,0,7,7,0.0,0.0,100.0,2019,36267
5320,97,659,6076,87.56,1.6,10.85,2019,36305
1630,67,519,2216,73.56,3.02,23.42,2019,36268
351,25,137,513,68.42,4.87,26.71,2019,36269
1318,29,839,2186,60.29,1.33,38.38,2019,37096
4349,57,70,4476,97.16,1.27,1.56,2019,37135
667,13,425,1105,60.36,1.18,38.46,2019,37137
420,12,247,679,61.86,1.77,36.38,2019,37142
18630,832,1926,21388,87.1,3.89,9.01,2019,37167
226,0,45,271,83.39,0.0,16.61,2019,37171
339,158,29,526,64.45,30.04,5.51,2019,37201
22,0,0,22,100.0,0.0,0.0,2019,37213
1434,38,243,1715,83.62,2.22,14.17,2019,37302
6191,536,2546,9273,66.76,5.78,27.46,2019,37334
687,64,215,966,71.12,6.63,22.26,2019,37335
12246,617,2627,15490,79.06,3.98,16.96,2019,37601
4548,187,1449,6184,73.54,3.02,23.43,2019,37642
159,0,59,218,72.94,0.0,27.06,2019,37680
2647,214,359,3220,82.2,6.65,11.15,2019,37686
2410,60,633,3103,77.67,1.93,20.4,2019,37701
416,15,446,877,47.43,1.71,50.86,2019,37727
2940,43,694,3677,79.96,1.17,18.87,2019,37764
6377,420,1555,8352,76.35,5.03,18.62,2019,39702
66,2,30,98,67.35,2.04,30.61,2019,39736
134,28,146,308,43.51,9.09,47.4,2019,39745
333,23,131,487,68.38,4.72,26.9,2019,39633
742,90,598,1430,51.89,6.29,41.82,2019,39641
959,208,852,2019,47.5,10.3,42.2,2019,39654
462,7,333,802,57.61,0.87,41.52,2019,39657
236,64,277,577,40.9,11.09,48.01,2019,39665
156,0,170,326,47.85,0.0,52.15,2019,39668
612,51,370,1033,59.24,4.94,35.82,2019,39160
515,48,313,876,58.79,5.48,35.73,2019,39116
2727,13,550,3290,82.89,0.4,16.72,2019,39154
115,0,0,115,100.0,0.0,0.0,2019,39174
473,0,494,967,48.91,0.0,51.09,2019,39176
4112,248,1217,5577,73.73,4.45,21.82,2019,39183
2192,46,380,2618,83.73,1.76,14.51,2019,39218
99,25,50,174,56.9,14.37,28.74,2019,39326
224,0,261,485,46.19,0.0,53.81,2019,39336
1853,74,915,2842,65.2,2.6,32.2,2019,39365
11575,853,3962,16390,70.62,5.2,24.17,2019,39401
783,40,279,1102,71.05,3.63,25.32,2019,39423
5994,244,2800,9038,66.32,2.7,30.98,2019,39452
1133,30,578,1741,65.08,1.72,33.2,2019,39175
50,0,0,50,100.0,0.0,0.0,2019,39177
305,43,49,397,76.83,10.83,12.34,2019,39179
4968,187,2963,8118,61.2,2.3,36.5,2019,39443
6113,243,1786,8142,75.08,2.98,21.94,2019,39520
11634,445,1954,14033,82.9,3.17,13.92,2019,39532
2408,74,1083,3565,67.55,2.08,30.38,2019,39577
758,49,450,1257,60.3,3.9,35.8,2019,39638
622,23,266,911,68.28,2.52,29.2,2019,39653
93,51,84,228,40.79,22.37,36.84,2019,39656
740,34,287,1061,69.75,3.2,27.05,2019,39661
434,24,242,700,62.0,3.43,34.57,2019,39743
842,46,316,1204,69.93,3.82,26.25,2019,39746
380,14,350,744,51.08,1.88,47.04,2019,39747
21,0,0,21,100.0,0.0,0.0,2019,39762
933,0,246,1179,79.13,0.0,20.87,2019,39766
326,0,95,421,77.43,0.0,22.57,2019,39767
420,0,195,615,68.29,0.0,31.71,2019,39776
12903,1211,2469,16583,77.81,7.3,14.89,2019,39759
2425,32,1389,3846,63.05,0.83,36.12,2019,39666
3360,145,1635,5140,65.37,2.82,31.81,2019,39701
345,40,121,506,68.18,7.91,23.91,2019,39662
1100,193,1181,2474,44.46,7.8,47.74,2019,39095
210,7,123,340,61.76,2.06,36.18,2019,39755
1270,161,688,2119,59.93,7.6,32.47,2019,39038
3364,269,1910,5543,60.69,4.85,34.46,2019,39074
199,9,208,416,47.84,2.16,50.0,2019,39152
3416,240,1265,4921,69.42,4.88,25.71,2019,39090
2776,120,863,3759,73.85,3.19,22.96,2019,39170
278,0,30,308,90.26,0.0,9.74,2019,39352
3927,284,787,4998,78.57,5.68,15.75,2019,39475
2142,387,1301,3830,55.93,10.1,33.97,2019,39059
11545,292,2176,14013,82.39,2.08,15.53,2019,39042
113,29,63,205,55.12,14.15,30.73,2019,39062
1218,22,467,1707,71.35,1.29,27.36,2019,39069
1523,69,458,2050,74.29,3.37,22.34,2019,39071
932,31,475,1438,64.81,2.16,33.03,2019,39094
525,45,73,643,81.65,7.0,11.35,2019,43360
1263,49,179,1491,84.71,3.29,12.01,2019,43046
79,3,12,94,84.04,3.19,12.77,2019,43010
2687,23,329,3039,88.42,0.76,10.83,2019,43028
102,4,14,120,85.0,3.33,11.67,2019,43033
10025,65,318,10408,96.32,0.62,3.06,2019,43054
847,23,126,996,85.04,2.31,12.65,2019,43060
4205,58,498,4761,88.32,1.22,10.46,2019,43074
11409,91,448,11948,95.49,0.76,3.75,2019,43082
224,15,7,246,91.06,6.1,2.85,2019,43084
3547,61,360,3968,89.39,1.54,9.07,2019,43103
501,15,106,622,80.55,2.41,17.04,2019,43106
493,4,65,562,87.72,0.71,11.57,2019,43116
9277,190,648,10115,91.72,1.88,6.41,2019,43119
22599,595,1965,25159,89.82,2.36,7.81,2019,43123
6426,123,1059,7608,84.46,1.62,13.92,2019,43140
1767,52,331,2150,82.19,2.42,15.4,2019,43143
2650,51,481,3182,83.28,1.6,15.12,2019,43146
10110,229,1404,11743,86.09,1.95,11.96,2019,43209
929,127,355,1411,65.84,9.0,25.16,2019,43222
1741,73,361,2175,80.05,3.36,16.6,2019,43331
511,3,112,626,81.63,0.48,17.89,2019,43332
112,5,77,194,57.73,2.58,39.69,2019,43006
324,10,71,405,80.0,2.47,17.53,2019,43462
2076,10,390,2476,83.84,0.4,15.75,2019,43465
9583,233,399,10215,93.81,2.28,3.91,2019,43004
797,24,47,868,91.82,2.76,5.41,2019,43009
703,19,129,851,82.61,2.23,15.16,2019,43466
244,30,50,324,75.31,9.26,15.43,2019,43333
1759,44,495,2298,76.54,1.91,21.54,2019,43334
0,0,0,0,,,,2019,43336
336,6,45,387,86.82,1.55,11.63,2019,43341
568,17,83,668,85.03,2.54,12.43,2019,43406
3232,90,739,4061,79.59,2.22,18.2,2019,43410
9638,492,2010,12140,79.39,4.05,16.56,2019,43420
372,11,71,454,81.94,2.42,15.64,2019,43435
2029,143,348,2520,80.52,5.67,13.81,2019,43440
620,10,95,725,85.52,1.38,13.1,2019,43443
507,15,17,539,94.06,2.78,3.15,2019,43445
5137,354,846,6337,81.06,5.59,13.35,2019,43452
105,0,30,135,77.78,0.0,22.22,2019,43468
2692,68,418,3178,84.71,2.14,13.15,2019,43515
901,17,110,1028,87.65,1.65,10.7,2019,43518
357,6,37,400,89.25,1.5,9.25,2019,43525
1294,25,209,1528,84.69,1.64,13.68,2019,43532
150,0,12,162,92.59,0.0,7.41,2019,43565
4151,93,756,5000,83.02,1.86,15.12,2019,43567
1339,113,353,1805,74.18,6.26,19.56,2019,43610
301,29,159,489,61.55,5.93,32.52,2019,43727
6393,263,1757,8413,75.99,3.13,20.88,2019,43725
52,0,4,56,92.86,0.0,7.14,2019,43738
219,35,103,357,61.34,9.8,28.85,2019,43747
555,9,150,714,77.73,1.26,21.01,2019,43771
1362,110,380,1852,73.54,5.94,20.52,2019,43777
148,2,51,201,73.63,1.0,25.37,2019,43782
1663,35,263,1961,84.8,1.78,13.41,2019,43783
912,32,341,1285,70.97,2.49,26.54,2019,43787
232,0,96,328,70.73,0.0,29.27,2019,43802
413,16,528,957,43.16,1.67,55.17,2019,43804
3935,188,1105,5228,75.27,3.6,21.14,2019,30642
4158,222,1430,5810,71.57,3.82,24.61,2019,30643
837,75,372,1284,65.19,5.84,28.97,2019,30669
396,7,128,531,74.58,1.32,24.11,2019,30678
12173,311,2344,14828,82.09,2.1,15.81,2019,30680
9562,200,2319,12081,79.15,1.66,19.2,2019,30705
7576,117,1593,9286,81.59,1.26,17.15,2019,30720
13618,252,1627,15497,87.88,1.63,10.5,2019,30736
11226,507,1791,13524,83.01,3.75,13.24,2019,30813
11368,594,2201,14163,80.27,4.19,15.54,2019,30815
411,11,344,766,53.66,1.44,44.91,2019,30668
1435,196,1358,2989,48.01,6.56,45.43,2019,30673
4951,170,1202,6323,78.3,2.69,19.01,2019,30707
14107,237,3738,18082,78.02,1.31,20.67,2019,30721
0,0,0,0,,,,2019,30726
762,11,218,991,76.89,1.11,22.0,2019,30731
13820,343,2811,16974,81.42,2.02,16.56,2019,30518
1294,50,491,1835,70.52,2.72,26.76,2019,30520
517,13,87,617,83.79,2.11,14.1,2019,30537
5229,254,993,6476,80.74,3.92,15.33,2019,30153
13967,868,1608,16443,84.94,5.28,9.78,2019,30157
11968,369,2666,15003,79.77,2.46,17.77,2019,30165
7844,252,1086,9182,85.43,2.74,11.83,2019,30168
1756,50,244,2050,85.66,2.44,11.9,2019,30173
5375,136,770,6281,85.58,2.17,12.26,2019,30179
1279,42,188,1509,84.76,2.78,12.46,2019,30185
1420,70,406,1896,74.89,3.69,21.41,2019,30220
9656,541,1923,12120,79.67,4.46,15.87,2019,30238
1985,51,711,2747,72.26,1.86,25.88,2019,30453
158,0,98,256,61.72,0.0,38.28,2019,30454
4860,142,1288,6290,77.27,2.26,20.48,2019,30474
1150,145,486,1781,64.57,8.14,27.29,2019,30521
3731,160,1126,5017,74.37,3.19,22.44,2019,30523
500,26,175,701,71.33,3.71,24.96,2019,30730
1816,90,483,2389,76.02,3.77,20.22,2019,30735
1178,19,392,1589,74.13,1.2,24.67,2019,30738
2044,53,207,2304,88.72,2.3,8.98,2019,30739
2228,91,668,2987,74.59,3.05,22.36,2019,30742
707,11,173,891,79.35,1.23,19.42,2019,30757
1309,13,492,1814,72.16,0.72,27.12,2019,30802
12879,175,1632,14686,87.7,1.19,11.11,2019,30809
185,0,102,287,64.46,0.0,35.54,2019,30822
217,24,135,376,57.71,6.38,35.9,2019,30821
21817,588,600,23005,94.84,2.56,2.61,2019,30004
12747,654,4030,17431,73.13,3.75,23.12,2019,30032
10311,293,282,10886,94.72,2.69,2.59,2019,30306
10272,616,3597,14485,70.91,4.25,24.83,2019,30311
4870,567,2153,7590,64.16,7.47,28.37,2019,30314
0,0,0,0,,,,2019,30322
7455,532,1537,9524,78.28,5.59,16.14,2019,30340
2786,61,256,3103,89.78,1.97,8.25,2019,30346
22601,1123,3286,27010,83.68,4.16,12.17,2019,30349
15939,366,801,17106,93.18,2.14,4.68,2019,30350
551,14,149,714,77.17,1.96,20.87,2019,30410
309,1,165,475,65.05,0.21,34.74,2019,30420
1722,104,1182,3008,57.25,3.46,39.3,2019,30442
865,36,248,1149,75.28,3.13,21.58,2019,30445
516,7,324,847,60.92,0.83,38.25,2019,30450
1114,0,243,1357,82.09,0.0,17.91,2019,30543
554,11,152,717,77.27,1.53,21.2,2019,33514
4940,225,1447,6612,74.71,3.4,21.88,2019,33523
8767,123,497,9387,93.4,1.31,5.29,2019,33543
6476,179,714,7369,87.88,2.43,9.69,2019,33566
3148,163,669,3980,79.1,4.1,16.81,2019,33592
5132,143,1817,7092,72.36,2.02,25.62,2019,33605
12595,767,2878,16240,77.56,4.72,17.72,2019,33610
13132,416,1302,14850,88.43,2.8,8.77,2019,33611
9660,111,603,10374,93.12,1.07,5.81,2019,33625
6243,351,517,7111,87.79,4.94,7.27,2019,33635
7658,356,522,8536,89.71,4.17,6.12,2019,33706
10881,336,1782,12999,83.71,2.58,13.71,2019,33713
3285,200,205,3690,89.02,5.42,5.56,2019,33715
10608,560,2416,13584,78.09,4.12,17.79,2019,33756
10012,319,1456,11787,84.94,2.71,12.35,2019,33764
2640,58,180,2878,91.73,2.02,6.25,2019,33785
7268,847,3673,11788,61.66,7.19,31.16,2019,33801
9101,487,1559,11147,81.65,4.37,13.99,2019,33809
7051,193,1866,9110,77.4,2.12,20.48,2019,33825
1428,0,0,1428,100.0,0.0,0.0,2019,33194
5517,255,541,6313,87.39,4.04,8.57,2019,33305
816,21,116,953,85.62,2.2,12.17,2019,33827
2397,151,629,3177,75.45,4.75,19.8,2019,33850
5891,186,1134,7211,81.69,2.58,15.73,2019,33872
36,0,70,106,33.96,0.0,66.04,2019,33877
11286,192,2435,13913,81.12,1.38,17.5,2019,33133
10005,363,4255,14623,68.42,2.48,29.1,2019,33135
9374,268,2945,12587,74.47,2.13,23.4,2019,33138
7262,783,629,8674,83.72,9.03,7.25,2019,33140
16006,521,3170,19697,81.26,2.65,16.09,2019,33157
16057,556,1965,18578,86.43,2.99,10.58,2019,33020
21388,287,1930,23605,90.61,1.22,8.18,2019,33024
1348,36,145,1529,88.16,2.35,9.48,2019,33036
11429,885,1654,13968,81.82,6.34,11.84,2019,33040
94,0,0,94,100.0,0.0,0.0,2019,33122
1416,292,1505,3213,44.07,9.09,46.84,2019,33128
10799,483,1132,12414,86.99,3.89,9.12,2019,33143
9071,543,3479,13093,69.28,4.15,26.57,2019,33162
12834,633,2714,16181,79.32,3.91,16.77,2019,33179
19345,1094,1000,21439,90.23,5.1,4.66,2019,33186
12359,1316,829,14504,85.21,9.07,5.72,2019,33196
6403,471,915,7789,82.21,6.05,11.75,2019,34292
5477,66,1212,6755,81.08,0.98,17.94,2019,34420
4141,105,606,4852,85.35,2.16,12.49,2019,34452
6080,123,1518,7721,78.75,1.59,19.66,2019,34470
5583,40,1419,7042,79.28,0.57,20.15,2019,34474
5982,167,1183,7332,81.59,2.28,16.13,2019,34482
2296,94,345,2735,83.95,3.44,12.61,2019,34602
10192,268,1289,11749,86.75,2.28,10.97,2019,34606
4621,100,877,5598,82.55,1.79,15.67,2019,34102
7088,392,1066,8546,82.94,4.59,12.47,2019,34113
11983,296,824,13103,91.45,2.26,6.29,2019,34119
10201,664,1882,12747,80.03,5.21,14.76,2019,34208
7032,137,1615,8784,80.05,1.56,18.39,2019,34234
8315,243,1480,10038,82.84,2.42,14.74,2019,34471
2946,124,1376,4446,66.26,2.79,30.95,2019,34475
4424,29,615,5068,87.29,0.57,12.13,2019,34479
5375,275,1176,6826,78.74,4.03,17.23,2019,34480
14958,727,1429,17114,87.4,4.25,8.35,2019,34655
4431,136,568,5135,86.29,2.65,11.06,2019,37772
8263,159,2345,10767,76.74,1.48,21.78,2019,37801
7616,194,1561,9371,81.27,2.07,16.66,2019,37804
167,13,124,304,54.93,4.28,40.79,2019,37819
2763,45,589,3397,81.34,1.32,17.34,2019,37871
1307,72,593,1972,66.28,3.65,30.07,2019,37873
4280,166,1099,5545,77.19,2.99,19.82,2019,37874
9843,598,2291,12732,77.31,4.7,17.99,2019,37876
2739,230,1508,4477,61.18,5.14,33.68,2019,37879
1001,22,369,1392,71.91,1.58,26.51,2019,37880
518,67,266,851,60.87,7.87,31.26,2019,37881
4022,95,1002,5119,78.57,1.86,19.57,2019,37924
10251,205,765,11221,91.36,1.83,6.82,2019,37931
6695,139,593,7427,90.14,1.87,7.98,2019,37932
187,0,40,227,82.38,0.0,17.62,2019,37019
1681,75,297,2053,81.88,3.65,14.47,2019,37020
1485,29,466,1980,75.0,1.46,23.54,2019,37353
269,5,151,425,63.29,1.18,35.53,2019,37365
581,25,125,731,79.48,3.42,17.1,2019,37374
803,115,178,1096,73.27,10.49,16.24,2019,37375
2270,91,811,3172,71.56,2.87,25.57,2019,37385
53,0,26,79,67.09,0.0,32.91,2019,37396
4152,221,1722,6095,68.12,3.63,28.25,2019,37406
665,14,200,879,75.65,1.59,22.75,2019,37408
2301,158,330,2789,82.5,5.67,11.83,2019,37419
565,63,270,898,62.92,7.02,30.07,2019,37018
1750,37,322,2109,82.98,1.75,15.27,2019,37022
348,9,202,559,62.25,1.61,36.14,2019,37023
2103,78,672,2853,73.71,2.73,23.55,2019,37030
19554,429,1657,21640,90.36,1.98,7.66,2019,37064
10959,197,487,11643,94.13,1.69,4.18,2019,37067
12893,449,2979,16321,79.0,2.75,18.25,2019,37620
1048,28,393,1469,71.34,1.91,26.75,2019,37640
13000,520,3943,17463,74.44,2.98,22.58,2019,37660
9619,334,1701,11654,82.54,2.87,14.6,2019,37664
1317,50,342,1709,77.06,2.93,20.01,2019,37690
1143,58,528,1729,66.11,3.35,30.54,2019,37714
4701,87,637,5425,86.65,1.6,11.74,2019,37073
31679,1407,2511,35597,88.99,3.95,7.05,2019,37013
15780,299,1310,17389,90.75,1.72,7.53,2019,37076
9219,499,827,10545,87.43,4.73,7.84,2019,37086
556,27,285,868,64.06,3.11,32.83,2019,37097
1609,64,666,2339,68.79,2.74,28.47,2019,37101
9087,209,1847,11143,81.55,1.88,16.58,2019,37172
7465,324,937,8726,85.55,3.71,10.74,2019,37203
9582,374,822,10778,88.9,3.47,7.63,2019,37205
12114,317,1463,13894,87.19,2.28,10.53,2019,37214
384,4,222,610,62.95,0.66,36.39,2019,37313
1509,119,654,2282,66.13,5.21,28.66,2019,37324
681,24,236,941,72.37,2.55,25.08,2019,37012
706,13,136,855,82.57,1.52,15.91,2019,37026
151,14,123,288,52.43,4.86,42.71,2019,37028
1802,72,1072,2946,61.17,2.44,36.39,2019,37033
1314,71,751,2136,61.52,3.32,35.16,2019,37036
16604,462,1477,18543,89.54,2.49,7.97,2019,37043
1964,40,335,2339,83.97,1.71,14.32,2019,37048
969,22,468,1459,66.42,1.51,32.08,2019,37051
1567,13,493,2073,75.59,0.63,23.78,2019,37307
407,46,251,704,57.81,6.53,35.65,2019,37318
145,42,60,247,58.7,17.0,24.29,2019,39097
451,13,372,836,53.95,1.56,44.5,2019,39146
486,27,680,1193,40.74,2.26,57.0,2019,39153
4,0,18,22,18.18,0.0,81.82,2019,39162
0,0,0,0,,,,2019,39167
0,0,0,0,,,,2019,39193
0,0,0,0,,,,2019,39217
2843,177,165,3185,89.26,5.56,5.18,2019,39232
4104,311,507,4922,83.38,6.32,10.3,2019,39272
0,0,0,0,,,,2019,39309
462,24,97,583,79.25,4.12,16.64,2019,39342
0,0,0,0,,,,2019,39406
0,0,0,0,,,,2019,39534
2907,16,503,3426,84.85,0.47,14.68,2019,39540
52,0,47,99,52.53,0.0,47.47,2019,39737
12,0,0,12,100.0,0.0,0.0,2019,39760
439,50,298,787,55.78,6.35,37.87,2019,39813
310,14,340,664,46.69,2.11,51.2,2019,39815
2172,134,1535,3841,56.55,3.49,39.96,2019,39817
2372,292,1368,4032,58.83,7.24,33.93,2019,39819
1570,70,1323,2963,52.99,2.36,44.65,2019,39823
142,12,91,245,57.96,4.9,37.14,2019,39824
271,62,197,530,51.13,11.7,37.17,2019,39825
120,12,71,203,59.11,5.91,34.98,2019,39826
1129,33,327,1489,75.82,2.22,21.96,2019,39827
3673,47,1581,5301,69.29,0.89,29.82,2019,39828
458,20,394,872,52.52,2.29,45.18,2019,39834
74,0,14,88,84.09,0.0,15.91,2019,39836
1177,123,1291,2591,45.43,4.75,49.83,2019,39837
1377,109,432,1918,71.79,5.68,22.52,2019,39840
121,2,216,339,35.69,0.59,63.72,2019,39841
2159,100,692,2951,73.16,3.39,23.45,2019,39842
1934,66,1016,3016,64.12,2.19,33.69,2019,39845
480,24,286,790,60.76,3.04,36.2,2019,39846
600,42,228,870,68.97,4.83,26.21,2019,39851
474,48,347,869,54.55,5.52,39.93,2019,39854
263,29,122,414,63.53,7.0,29.47,2019,39859
220,25,269,514,42.8,4.86,52.33,2019,39861
288,9,199,496,58.06,1.81,40.12,2019,39862
85,11,42,138,61.59,7.97,30.43,2019,39866
162,6,14,182,89.01,3.3,7.69,2019,39867
852,95,528,1475,57.76,6.44,35.8,2019,38456
338,40,59,437,77.35,9.15,13.5,2019,38473
850,18,306,1174,72.4,1.53,26.06,2019,38477
294,8,113,415,70.84,1.93,27.23,2019,38481
1078,73,378,1529,70.5,4.77,24.72,2019,38549
1000,84,545,1629,61.39,5.16,33.46,2019,38551
6595,306,1541,8442,78.12,3.62,18.25,2019,38555
340,5,200,545,62.39,0.92,36.7,2019,38559
432,0,94,526,82.13,0.0,17.87,2019,38560
122,5,106,233,52.36,2.15,45.49,2019,38564
264,26,101,391,67.52,6.65,25.83,2019,38565
417,52,303,772,54.02,6.74,39.25,2019,38568
6460,515,2012,8987,71.88,5.73,22.39,2019,38583
182,14,114,310,58.71,4.52,36.77,2019,38588
55,0,29,84,65.48,0.0,34.52,2019,38589
449,56,241,746,60.19,7.51,32.31,2019,38601
846,42,403,1291,65.53,3.25,31.22,2019,38603
1097,142,745,1984,55.29,7.16,37.55,2019,38619
55,0,8,63,87.3,0.0,12.7,2019,43555
840,8,145,993,84.59,0.81,14.6,2019,43557
6378,312,1204,7894,80.8,3.95,15.25,2019,43611
2511,44,344,2899,86.62,1.52,11.87,2019,43619
6903,205,2513,9621,71.75,2.13,26.12,2019,43227
4182,154,1153,5489,76.19,2.81,21.01,2019,43326
440,16,233,689,63.86,2.32,33.82,2019,43340
14672,160,508,15340,95.65,1.04,3.31,2019,43016
3879,26,386,4291,90.4,0.61,9.0,2019,43023
1763,46,278,2087,84.48,2.2,13.32,2019,43025
99,15,25,139,71.22,10.79,17.99,2019,43029
18551,542,1913,21006,88.31,2.58,9.11,2019,43068
25,0,4,29,86.21,0.0,13.79,2019,43109
162,5,24,191,84.82,2.62,12.57,2019,43126
792,37,188,1017,77.88,3.64,18.49,2019,43128
35,5,17,57,61.4,8.77,29.82,2019,43142
693,78,165,936,74.04,8.33,17.63,2019,43149
271,0,66,337,80.42,0.0,19.58,2019,43153
2439,144,830,3413,71.46,4.22,24.32,2019,43203
5731,265,2381,8377,68.41,3.16,28.42,2019,43211
22146,293,1307,23746,93.26,1.23,5.5,2019,43230
996,27,210,1233,80.78,2.19,17.03,2019,43314
449,4,88,541,82.99,0.74,16.27,2019,43320
219,0,105,324,67.59,0.0,32.41,2019,43323
176,4,29,209,84.21,1.91,13.88,2019,43407
1123,44,93,1260,89.13,3.49,7.38,2019,43447
2849,127,497,3473,82.03,3.66,14.31,2019,43449
28,0,8,36,77.78,0.0,22.22,2019,43467
369,10,58,437,84.44,2.29,13.27,2019,43504
1310,46,191,1547,84.68,2.97,12.35,2019,43517
1276,0,66,1342,95.08,0.0,4.92,2019,43542
76,4,11,91,83.52,4.4,12.09,2019,43553
59,0,28,87,67.82,0.0,32.18,2019,43927
743,7,248,998,74.45,0.7,24.85,2019,43944
141,0,49,190,74.21,0.0,25.79,2019,43948
2840,82,844,3766,75.41,2.18,22.41,2019,43964
590,27,341,958,61.59,2.82,35.59,2019,43973
485,19,109,613,79.12,3.1,17.78,2019,43976
1597,34,140,1771,90.18,1.92,7.91,2019,43112
7408,192,1753,9353,79.2,2.05,18.74,2019,43113
578,30,292,900,64.22,3.33,32.44,2019,41003
1105,43,485,1633,67.67,2.63,29.7,2019,41004
2027,146,613,2786,72.76,5.24,22.0,2019,41014
6715,146,1146,8007,83.86,1.82,14.31,2019,41015
4237,177,1813,6227,68.04,2.84,29.12,2019,41031
484,0,112,596,81.21,0.0,18.79,2019,41033
26,0,0,26,100.0,0.0,0.0,2019,41142
112,43,42,197,56.85,21.83,21.32,2019,41274
1671,52,583,2306,72.46,2.25,25.28,2019,41522
48,0,11,59,81.36,0.0,18.64,2019,41622
14154,182,956,15292,92.56,1.19,6.25,2019,41017
341,0,124,465,73.33,0.0,26.67,2019,41548
328,37,39,404,81.19,9.16,9.65,2019,41602
171,0,95,266,64.29,0.0,35.71,2019,41642
141,0,95,236,59.75,0.0,40.25,2019,41763
103,0,74,177,58.19,0.0,41.81,2019,41833
669,17,165,851,78.61,2.0,19.39,2019,43903
991,24,332,1347,73.57,1.78,24.65,2019,41010
908,17,231,1156,78.55,1.47,19.98,2019,41063
2528,96,667,3291,76.82,2.92,20.27,2019,30546
24,0,9,33,72.73,0.0,27.27,2019,30581
4052,59,609,4720,85.85,1.25,12.9,2019,30622
672,30,110,812,82.76,3.69,13.55,2019,30641
645,44,462,1151,56.04,3.82,40.14,2019,30648
7160,310,1785,9255,77.36,3.35,19.29,2019,30655
4,0,11,15,26.67,0.0,73.33,2019,30664
1000,46,335,1381,72.41,3.33,24.26,2019,30711
229,0,69,298,76.85,0.0,23.15,2019,30803
560,23,390,973,57.55,2.36,40.08,2019,30627
2762,80,433,3275,84.34,2.44,13.22,2019,30740
8829,259,2457,11545,76.47,2.24,21.28,2019,30741
1144,24,100,1268,90.22,1.89,7.89,2019,30750
1848,52,596,2496,74.04,2.08,23.88,2019,30753
1826,138,728,2692,67.83,5.13,27.04,2019,30814
2416,75,326,2817,85.76,2.66,11.57,2019,30002
4374,59,510,4943,88.49,1.19,10.32,2019,30011
12028,263,837,13128,91.62,2.0,6.38,2019,30033
23265,220,1406,24891,93.47,0.88,5.65,2019,30040
26316,516,1693,28525,92.26,1.81,5.94,2019,30043
1273,25,206,1504,84.64,1.66,13.7,2019,30079
1208,70,374,1652,73.12,4.24,22.64,2019,30104
7370,186,623,8179,90.11,2.27,7.62,2019,30106
7056,260,1481,8797,80.21,2.96,16.84,2019,30121
7366,891,1082,9339,78.87,9.54,11.59,2019,30122
747,0,333,1080,69.17,0.0,30.83,2019,30182
1866,177,418,2461,75.82,7.19,16.98,2019,30184
2524,196,154,2874,87.82,6.82,5.36,2019,30187
13472,152,492,14116,95.44,1.08,3.49,2019,30189
1192,36,334,1562,76.31,2.3,21.38,2019,30527
7036,427,2135,9598,73.31,4.45,22.24,2019,30528
2854,132,1222,4208,67.82,3.14,29.04,2019,30529
2478,281,943,3702,66.94,7.59,25.47,2019,30531
9107,442,1128,10677,85.3,4.14,10.56,2019,30534
815,15,361,1191,68.43,1.26,30.31,2019,30538
5649,194,1789,7632,74.02,2.54,23.44,2019,30540
273,37,181,491,55.6,7.54,36.86,2019,30562
1523,54,372,1949,78.14,2.77,19.09,2019,30563
4229,109,429,4767,88.71,2.29,9.0,2019,30620
1623,48,145,1816,89.37,2.64,7.98,2019,30621
2011,37,78,2126,94.59,1.74,3.67,2019,30183
13,0,0,13,100.0,0.0,0.0,2019,31045
1263,85,571,1919,65.82,4.43,29.76,2019,31063
281,7,202,490,57.35,1.43,41.22,2019,31071
314,8,254,576,54.51,1.39,44.1,2019,31077
273,22,89,384,71.09,5.73,23.18,2019,31085
8445,369,2952,11766,71.77,3.14,25.09,2019,31204
3867,158,1917,5942,65.08,2.66,32.26,2019,31217
2218,35,566,2819,78.68,1.24,20.08,2019,31308
14267,247,1517,16031,89.0,1.54,9.46,2019,31313
0,0,0,0,,,,2019,31314
2055,43,548,2646,77.66,1.63,20.71,2019,31321
1387,8,64,1459,95.07,0.55,4.39,2019,31328
4548,201,403,5152,88.28,3.9,7.82,2019,31407
5274,456,1939,7669,68.77,5.95,25.28,2019,31503
3607,317,1895,5819,61.99,5.45,32.57,2019,31513
4104,233,1869,6206,66.13,3.75,30.12,2019,31533
3154,400,1554,5108,61.75,7.83,30.42,2019,31539
208,41,131,380,54.74,10.79,34.47,2019,31552
7872,260,597,8729,90.18,2.98,6.84,2019,34677
20521,411,951,21883,93.78,1.88,4.35,2019,34711
1064,16,128,1208,88.08,1.32,10.6,2019,34756
194,0,55,249,77.91,0.0,22.09,2019,34762
6721,144,1227,8092,83.06,1.78,15.16,2019,34769
916,74,33,1023,89.54,7.23,3.23,2019,34773
13489,265,1516,15270,88.34,1.74,9.93,2019,34785
3492,187,46,3725,93.74,5.02,1.23,2019,34987
4733,90,645,5468,86.56,1.65,11.8,2019,34996
10332,349,1555,12236,84.44,2.85,12.71,2019,34491
6719,61,594,7374,91.12,0.83,8.06,2019,34695
959,37,137,1133,84.64,3.27,12.09,2019,34737
3454,196,202,3852,89.67,5.09,5.24,2019,34242
5487,385,4100,9972,55.02,3.86,41.12,2019,34266
8789,540,1949,11278,77.93,4.79,17.28,2019,34287
2887,65,609,3561,81.07,1.83,17.1,2019,34431
2223,101,505,2829,78.58,3.57,17.85,2019,34433
2677,86,348,3111,86.05,2.76,11.19,2019,34434
6975,105,895,7975,87.46,1.32,11.22,2019,34446
6602,352,994,7948,83.06,4.43,12.51,2019,34465
8818,462,1193,10473,84.2,4.41,11.39,2019,34481
1114,68,322,1504,74.07,4.52,21.41,2019,34484
7682,698,2341,10721,71.65,6.51,21.84,2019,34652
4413,144,629,5186,85.09,2.78,12.13,2019,34669
334,0,0,334,100.0,0.0,0.0,2019,34681
10907,648,1403,12958,84.17,5.0,10.83,2019,34684
6086,646,1993,8725,69.75,7.4,22.84,2019,34691
6468,298,1116,7882,82.06,3.78,14.16,2019,34114
18,0,0,18,100.0,0.0,0.0,2019,34141
14460,849,2827,18136,79.73,4.68,15.59,2019,34698
1333,15,66,1414,94.27,1.06,4.67,2019,34734
5897,259,505,6661,88.53,3.89,7.58,2019,34235
3753,137,833,4723,79.46,2.9,17.64,2019,34448
8793,346,390,9529,92.28,3.63,4.09,2019,34202
4352,139,1051,5542,78.53,2.51,18.96,2019,34432
3922,157,980,5059,77.53,3.1,19.37,2019,34450
3746,174,549,4469,83.82,3.89,12.28,2019,34461
8824,325,1354,10503,84.01,3.09,12.89,2019,34472
8755,408,884,10047,87.14,4.06,8.8,2019,34476
13667,558,1659,15884,86.04,3.51,10.44,2019,34609
12288,636,2605,15529,79.13,4.1,16.78,2019,34667
22,0,11,33,66.67,0.0,33.33,2019,34679
8697,433,1684,10814,80.42,4.0,15.57,2019,34689
691,70,203,964,71.68,7.26,21.06,2019,34705
74,0,76,150,49.33,0.0,50.67,2019,34739
8755,380,1359,10494,83.43,3.62,12.95,2019,34104
9957,431,1477,11865,83.92,3.63,12.45,2019,34112
8221,442,977,9640,85.28,4.59,10.13,2019,34116
4260,326,2502,7088,60.1,4.6,35.3,2019,34142
6186,340,558,7084,87.32,4.8,7.88,2019,34210
271,0,0,271,100.0,0.0,0.0,2019,34215
323,6,55,384,84.11,1.56,14.32,2019,34216
7498,568,1143,9209,81.42,6.17,12.41,2019,34223
5921,156,792,6869,86.2,2.27,11.53,2019,34239
3739,63,144,3946,94.75,1.6,3.65,2019,34240
9693,703,1703,12099,80.11,5.81,14.08,2019,34743
244,0,55,299,81.61,0.0,18.39,2019,34760
13228,232,1185,14645,90.32,1.58,8.09,2019,34761
3955,138,1774,5867,67.41,2.35,30.24,2019,34950
9781,132,2181,12094,80.87,1.09,18.03,2019,37323
535,3,219,757,70.67,0.4,28.93,2019,37325
2247,116,644,3007,74.73,3.86,21.42,2019,37331
1216,91,486,1793,67.82,5.08,27.11,2019,37336
231,28,135,394,58.63,7.11,34.26,2019,37359
2739,165,1028,3932,69.66,4.2,26.14,2019,37367
6715,204,992,7911,84.88,2.58,12.54,2019,37405
2278,100,1181,3559,64.01,2.81,33.18,2019,37407
974,39,171,1184,82.26,3.29,14.44,2019,37409
0,0,0,0,,,,2019,37614
1736,70,290,2096,82.82,3.34,13.84,2019,37645
255,0,129,384,66.41,0.0,33.59,2019,37657
2891,325,1713,4929,58.65,6.59,34.75,2019,37683
170,0,63,233,72.96,0.0,27.04,2019,37691
1264,169,566,1999,63.23,8.45,28.31,2019,37711
185,8,113,306,60.46,2.61,36.93,2019,37715
525,11,269,805,65.22,1.37,33.42,2019,37726
44,0,55,99,44.44,0.0,55.56,2019,37732
5508,296,1539,7343,75.01,4.03,20.96,2019,37745
1744,10,762,2516,69.32,0.4,30.29,2019,37752
151,36,179,366,41.26,9.84,48.91,2019,37753
1435,61,421,1917,74.86,3.18,21.96,2019,37754
3641,253,863,4757,76.54,5.32,18.14,2019,37760
893,50,441,1384,64.52,3.61,31.86,2019,37779
1900,143,521,2564,74.1,5.58,20.32,2019,37863
6943,141,1340,8424,82.42,1.67,15.91,2019,37865
7886,333,2161,10380,75.97,3.21,20.82,2019,37912
2286,448,121,2855,80.07,15.69,4.24,2019,37916
8868,335,1574,10777,82.29,3.11,14.61,2019,37921
2358,52,385,2795,84.36,1.86,13.77,2019,37034
622,29,216,867,71.74,3.34,24.91,2019,37047
2344,66,602,3012,77.82,2.19,19.99,2019,37080
6401,302,1739,8442,75.82,3.58,20.6,2019,37091
9293,477,3378,13148,70.68,3.63,25.69,2019,37110
12242,585,3683,16510,74.15,3.54,22.31,2019,37115
5985,239,466,6690,89.46,3.57,6.97,2019,37127
375,15,41,431,87.01,3.48,9.51,2019,37141
663,14,163,840,78.93,1.67,19.4,2019,37145
1902,46,256,2204,86.3,2.09,11.62,2019,37153
4427,81,303,4811,92.02,1.68,6.3,2019,37179
885,47,235,1167,75.84,4.03,20.14,2019,37183
117,0,59,176,66.48,0.0,33.52,2019,36483
3639,32,2166,5837,62.34,0.55,37.11,2019,36502
1966,81,562,2609,75.35,3.1,21.54,2019,36522
2113,109,405,2627,80.43,4.15,15.42,2019,36530
171,47,44,262,65.27,17.94,16.79,2019,36539
984,16,485,1485,66.26,1.08,32.66,2019,36558
292,15,157,464,62.93,3.23,33.84,2019,36562
394,10,118,522,75.48,1.92,22.61,2019,36579
2823,5,424,3252,86.81,0.15,13.04,2019,36587
350,47,241,638,54.86,7.37,37.77,2019,36602
5165,300,2472,7937,65.07,3.78,31.15,2019,36606
8759,358,2194,11311,77.44,3.17,19.4,2019,36609
1669,119,2213,4001,41.71,2.97,55.31,2019,36610
1410,88,636,2134,66.07,4.12,29.8,2019,36611
17087,606,1288,18981,90.02,3.19,6.79,2019,36695
6474,166,1886,8526,75.93,1.95,22.12,2019,36701
944,104,659,1707,55.3,6.09,38.61,2019,36726
1101,20,745,1866,59.0,1.07,39.92,2019,36756
332,2,229,563,58.97,0.36,40.67,2019,38621
66,0,51,117,56.41,0.0,43.59,2019,38623
12,0,56,68,17.65,0.0,82.35,2019,38630
320,6,218,544,58.82,1.1,40.07,2019,38631
523,20,241,784,66.71,2.55,30.74,2019,38633
2564,53,280,2897,88.51,1.83,9.67,2019,38651
585,96,139,820,71.34,11.71,16.95,2019,38665
0,0,0,0,,,,2019,38677
5655,417,3011,9083,62.26,4.59,33.15,2019,38701
669,39,390,1098,60.93,3.55,35.52,2019,38737
0,0,59,59,0.0,0.0,100.0,2019,38745
102,1,95,198,51.52,0.51,47.98,2019,38746
172,0,50,222,77.48,0.0,22.52,2019,38392
363,12,160,535,67.85,2.24,29.91,2019,38876
163,14,77,254,64.17,5.51,30.31,2019,38914
52,13,155,220,23.64,5.91,70.45,2019,38924
12,0,125,137,8.76,0.0,91.24,2019,38928
419,31,135,585,71.62,5.3,23.08,2019,38940
528,115,717,1360,38.82,8.46,52.72,2019,38941
695,26,472,1193,58.26,2.18,39.56,2019,38646
8240,145,1148,9533,86.44,1.52,12.04,2019,38632
8378,190,1097,9665,86.68,1.97,11.35,2019,38637
601,50,179,830,72.41,6.02,21.57,2019,38642
731,118,519,1368,53.44,8.63,37.94,2019,38650
132,0,161,293,45.05,0.0,54.95,2019,38720
30,0,0,30,100.0,0.0,0.0,2019,38723
544,15,377,936,58.12,1.6,40.28,2019,38762
542,30,378,950,57.05,3.16,39.79,2019,38850
1834,158,593,2585,70.95,6.11,22.94,2019,38858
1553,71,563,2187,71.01,3.25,25.74,2019,38868
262,15,131,408,64.22,3.68,32.11,2019,38476
392,14,214,620,63.23,2.26,34.52,2019,38482
244,8,87,339,71.98,2.36,25.66,2019,38486
591,34,292,917,64.45,3.71,31.84,2019,38488
177,0,152,329,53.8,0.0,46.2,2019,38504
163,7,64,234,69.66,2.99,27.35,2019,38543
599,0,194,793,75.54,0.0,24.46,2019,38547
765,12,256,1033,74.06,1.16,24.78,2019,38553
3567,180,1375,5122,69.64,3.51,26.84,2019,38556
2243,135,908,3286,68.26,4.11,27.63,2019,38574
3014,193,1553,4760,63.32,4.05,32.63,2019,38618
3592,139,1755,5486,65.48,2.53,31.99,2019,38635
4220,387,1415,6022,70.08,6.43,23.5,2019,38652
16222,376,1588,18186,89.2,2.07,8.73,2019,38654
62,8,50,120,51.67,6.67,41.67,2019,38722
731,25,435,1191,61.38,2.1,36.52,2019,38748
1545,102,854,2501,61.78,4.08,34.15,2019,38756
3815,63,1192,5070,75.25,1.24,23.51,2019,38821
1441,106,317,1864,77.31,5.69,17.01,2019,38826
966,67,189,1222,79.05,5.48,15.47,2019,38827
628,88,298,1014,61.93,8.68,29.39,2019,38833
167,0,85,252,66.27,0.0,33.73,2019,38848
3486,182,596,4264,81.75,4.27,13.98,2019,38866
794,24,230,1048,75.76,2.29,21.95,2019,38870
252,24,211,487,51.75,4.93,43.33,2019,38963
8572,355,2280,11207,76.49,3.17,20.34,2019,38024
3403,99,564,4066,83.69,2.43,13.87,2019,38060
325,16,64,405,80.25,3.95,15.8,2019,38076
9012,497,3062,12571,71.69,3.95,24.36,2019,38104
216,0,90,306,70.59,0.0,29.41,2019,31568
280,0,118,398,70.35,0.0,29.65,2019,31625
1094,125,881,2100,52.1,5.95,41.95,2019,31634
226,19,219,464,48.71,4.09,47.2,2019,31638
711,109,502,1322,53.78,8.25,37.97,2019,31647
923,33,407,1363,67.72,2.42,29.86,2019,31650
4347,187,1565,6099,71.27,3.07,25.66,2019,31709
295,0,60,355,83.1,0.0,16.9,2019,31756
7065,86,1252,8403,84.08,1.02,14.9,2019,31763
5689,111,2043,7843,72.54,1.42,26.05,2019,31768
3398,135,567,4100,82.88,3.29,13.83,2019,31757
491,13,290,794,61.84,1.64,36.52,2019,31780
38,10,56,104,36.54,9.62,53.85,2019,31810
620,75,402,1097,56.52,6.84,36.65,2019,31637
2160,282,908,3350,64.48,8.42,27.1,2019,31643
7814,514,2103,10431,74.91,4.93,20.16,2019,31707
376,17,84,477,78.83,3.56,17.61,2019,31764
1394,156,465,2015,69.18,7.74,23.08,2019,31771
500,2,258,760,65.79,0.26,33.95,2019,31781
7621,236,1577,9434,80.78,2.5,16.72,2019,31792
268,16,30,314,85.35,5.1,9.55,2019,31829
640,2,138,780,82.05,0.26,17.69,2019,31830
2064,31,660,2755,74.92,1.13,23.96,2019,31833
270,42,162,474,56.96,8.86,34.18,2019,31836
781,221,1202,2204,35.44,10.03,54.54,2019,31055
2563,129,921,3613,70.94,3.57,25.49,2019,31064
317,8,113,438,72.37,1.83,25.8,2019,31070
265,48,201,514,51.56,9.34,39.11,2019,31072
148,31,197,376,39.36,8.24,52.39,2019,31090
1549,112,1025,2686,57.67,4.17,38.16,2019,31092
12311,328,1155,13794,89.25,2.38,8.37,2019,31210
2611,178,435,3224,80.99,5.52,13.49,2019,31302
411,16,160,587,70.02,2.73,27.26,2019,31323
6503,212,1055,7770,83.69,2.73,13.58,2019,31326
9505,246,1914,11665,81.48,2.11,16.41,2019,31404
4370,333,1579,6282,69.56,5.3,25.14,2019,31501
112,20,100,232,48.28,8.62,43.1,2019,31532
4203,310,1245,5758,72.99,5.38,21.62,2019,31545
188,4,552,744,25.27,0.54,74.19,2019,31549
488,23,389,900,54.22,2.56,43.22,2019,31001
1194,72,686,1952,61.17,3.69,35.14,2019,31006
5888,152,1079,7119,82.71,2.14,15.16,2019,31008
18275,606,2483,21364,85.54,2.84,11.62,2019,31088
5906,387,2958,9251,63.84,4.18,31.97,2019,31206
4723,241,1012,5976,79.03,4.03,16.93,2019,31216
1202,76,392,1670,71.98,4.55,23.47,2019,31301
549,88,255,892,61.55,9.87,28.59,2019,31303
1560,304,479,2343,66.58,12.97,20.44,2019,31305
8469,86,657,9212,91.93,0.93,7.13,2019,31324
6513,257,1108,7878,82.67,3.26,14.06,2019,31401
2549,100,455,3104,82.12,3.22,14.66,2019,31408
9352,204,486,10042,93.13,2.03,4.84,2019,31410
189,0,136,325,58.15,0.0,41.85,2019,31518
1093,194,347,1634,66.89,11.87,21.24,2019,31543
3778,385,462,4625,81.69,8.32,9.99,2019,31632
327,16,120,463,70.63,3.46,25.92,2019,31018
542,10,267,819,66.18,1.22,32.6,2019,31019
123,38,0,161,76.4,23.6,0.0,2019,32361
0,0,0,0,,,,2019,32399
12499,275,1134,13908,89.87,1.98,8.15,2019,34983
5972,375,1091,7438,80.29,5.04,14.67,2019,34994
5393,170,761,6324,85.28,2.69,12.03,2019,34736
7162,331,435,7928,90.34,4.18,5.49,2019,34108
4349,47,373,4769,91.19,0.99,7.82,2019,34117
106,0,49,155,68.39,0.0,31.61,2019,34138
95,3,17,115,82.61,2.61,14.78,2019,34139
2482,112,149,2743,90.48,4.08,5.43,2019,34217
7613,628,376,8617,88.35,7.29,4.36,2019,34219
3445,215,178,3838,89.76,5.6,4.64,2019,34228
11934,433,1400,13767,86.69,3.15,10.17,2019,34232
11882,340,1070,13292,89.39,2.56,8.05,2019,34243
7559,592,1749,9900,76.35,5.98,17.67,2019,34285
15987,503,1606,18096,88.35,2.78,8.87,2019,34293
2699,143,730,3572,75.56,4.0,20.44,2019,34436
3018,75,1069,4162,72.51,1.8,25.68,2019,34488
214,15,43,272,78.68,5.51,15.81,2019,34498
4214,68,735,5017,83.99,1.36,14.65,2019,34610
6116,410,499,7025,87.06,5.84,7.1,2019,34685
5549,197,706,6452,86.0,3.05,10.94,2019,34731
404,0,14,418,96.65,0.0,3.35,2019,34797
14337,526,2163,17026,84.21,3.09,12.7,2019,34952
1173,97,484,1754,66.88,5.53,27.59,2019,34981
10376,529,933,11838,87.65,4.47,7.88,2019,34986
1539,136,353,2028,75.89,6.71,17.41,2019,34251
8063,295,981,9339,86.34,3.16,10.5,2019,34275
3323,122,892,4337,76.62,2.81,20.57,2019,34453
11606,355,1518,13479,86.1,2.63,11.26,2019,34608
9342,480,1242,11064,84.44,4.34,11.23,2019,34109
20172,485,1182,21839,92.37,2.22,5.41,2019,34953
4102,333,801,5236,78.34,6.36,15.3,2019,34222
6198,144,1099,7441,83.3,1.94,14.77,2019,34224
3001,56,320,3377,88.87,1.66,9.48,2019,34229
12328,492,1685,14505,84.99,3.39,11.62,2019,34231
9002,186,903,10091,89.21,1.84,8.95,2019,34238
0,0,88,88,0.0,0.0,100.0,2019,34268
6137,37,320,6494,94.5,0.57,4.93,2019,34286
3395,84,514,3993,85.02,2.1,12.87,2019,34428
5992,138,701,6831,87.72,2.02,10.26,2019,34442
5905,83,741,6729,87.75,1.23,11.01,2019,34473
16115,670,2924,19709,81.76,3.4,14.84,2019,34668
3422,143,119,3684,92.89,3.88,3.23,2019,33957
3415,145,507,4067,83.97,3.57,12.47,2019,33982
5361,51,726,6138,87.34,0.83,11.83,2019,33598
5157,221,323,5701,90.46,3.88,5.67,2019,33480
1887,80,165,2132,88.51,3.75,7.74,2019,33576
14287,696,3883,18866,75.73,3.69,20.58,2019,33612
16340,239,1818,18397,88.82,1.3,9.88,2019,33614
15157,357,1941,17455,86.83,2.05,11.12,2019,33615
0,0,11,11,0.0,0.0,100.0,2019,33620
8613,308,1694,10615,81.14,2.9,15.96,2019,33709
6264,164,1511,7939,78.9,2.07,19.03,2019,33714
9015,403,2203,11621,77.58,3.47,18.96,2019,33770
8287,296,1265,9848,84.15,3.01,12.85,2019,33772
7571,256,306,8133,93.09,3.15,3.76,2019,33028
3825,166,717,4708,81.24,3.53,15.23,2019,33037
5917,414,3238,9569,61.84,4.33,33.84,2019,33054
9955,351,2989,13295,74.88,2.64,22.48,2019,33060
10263,489,1406,12158,84.41,4.02,11.56,2019,33062
87,0,3,90,96.67,0.0,3.33,2019,36793
2472,82,760,3314,74.59,2.47,22.93,2019,36853
3354,114,1431,4899,68.46,2.33,29.21,2019,36863
5598,372,2192,8162,68.59,4.56,26.86,2019,36869
631,60,148,839,75.21,7.15,17.64,2019,36908
554,31,375,960,57.71,3.23,39.06,2019,36009
1129,5,184,1318,85.66,0.38,13.96,2019,36025
263,20,164,447,58.84,4.47,36.69,2019,36047
3582,237,1093,4912,72.92,4.82,22.25,2019,36078
2467,164,728,3359,73.44,4.88,21.67,2019,36079
659,22,174,855,77.08,2.57,20.35,2019,36080
253,3,7,263,96.2,1.14,2.66,2019,36113
4197,298,2609,7104,59.08,4.19,36.73,2019,36201
3265,121,1047,4433,73.65,2.73,23.62,2019,36206
1137,132,549,1818,62.54,7.26,30.2,2019,36251
3262,125,974,4361,74.8,2.87,22.33,2019,36274
142,1,54,197,72.08,0.51,27.41,2019,36314
337,14,194,545,61.83,2.57,35.6,2019,36346
1048,37,381,1466,71.49,2.52,25.99,2019,36351
724,33,200,957,75.65,3.45,20.9,2019,36523
11470,209,1250,12929,88.72,1.62,9.67,2019,36532
109,11,126,246,44.31,4.47,51.22,2019,36540
5473,343,895,6711,81.55,5.11,13.34,2019,36542
107,0,0,107,100.0,0.0,0.0,2019,36559
42,19,0,61,68.85,31.15,0.0,2019,36564
3810,134,1032,4976,76.57,2.69,20.74,2019,36567
4383,100,1075,5558,78.86,1.8,19.34,2019,36571
1335,60,931,2326,57.39,2.58,40.03,2019,36862
1014,110,388,1512,67.06,7.28,25.66,2019,36904
830,36,380,1246,66.61,2.89,30.5,2019,36925
673,193,629,1495,45.02,12.91,42.07,2019,36016
1700,43,432,2175,78.16,1.98,19.86,2019,36024
40,0,52,92,43.48,0.0,56.52,2019,36031
889,44,385,1318,67.45,3.34,29.21,2019,36043
20071,583,1898,22552,89.0,2.59,8.42,2019,36117
298,0,84,382,78.01,0.0,21.99,2019,36255
2119,82,1045,3246,65.28,2.53,32.19,2019,36264
1021,19,584,1624,62.87,1.17,35.96,2019,36280
10140,291,3713,14144,71.69,2.06,26.25,2019,36301
68,0,49,117,58.12,0.0,41.88,2019,36455
1644,265,1867,3776,43.54,7.02,49.44,2019,36460
117,0,83,200,58.5,0.0,41.5,2019,36511
228,11,249,488,46.72,2.25,51.02,2019,36524
481,25,122,628,76.59,3.98,19.43,2019,36525
51,0,26,77,66.23,0.0,33.77,2019,36529
225,35,37,297,75.76,11.78,12.46,2019,36583
256,28,115,399,64.16,7.02,28.82,2019,36749
2576,169,2196,4941,52.14,3.42,44.44,2019,36617
43,0,84,127,33.86,0.0,66.14,2019,36723
656,3,334,993,66.06,0.3,33.64,2019,36748
441,0,135,576,76.56,0.0,23.44,2019,36776
518,18,412,948,54.64,1.9,43.46,2019,36782
527,23,151,701,75.18,3.28,21.54,2019,36353
210,2,108,320,65.62,0.62,33.75,2019,36371
662,27,252,941,70.35,2.87,26.78,2019,36453
2799,61,1135,3995,70.06,1.53,28.41,2019,36467
38,0,21,59,64.41,0.0,35.59,2019,36790
8385,974,875,10234,81.93,9.52,8.55,2019,36832
93,0,59,152,61.18,0.0,38.82,2019,36858
8468,721,7196,16385,51.68,4.4,43.92,2019,38109
4382,416,4981,9779,44.81,4.25,50.94,2019,38114
10778,865,4162,15805,68.19,5.47,26.33,2019,38128
6900,105,645,7650,90.2,1.37,8.43,2019,38141
573,28,213,814,70.39,3.44,26.17,2019,38232
1600,39,717,2356,67.91,1.66,30.43,2019,38310
1090,15,458,1563,69.74,0.96,29.3,2019,38915
297,0,277,574,51.74,0.0,48.26,2019,38929
76,2,96,174,43.68,1.15,55.17,2019,38952
154,5,106,265,58.11,1.89,40.0,2019,38957
12911,735,3344,16990,75.99,4.33,19.68,2019,38501
471,18,239,728,64.7,2.47,32.83,2019,38541
4236,288,1308,5832,72.63,4.94,22.43,2019,38611
295,18,34,347,85.01,5.19,9.8,2019,38673
386,10,324,720,53.61,1.39,45.0,2019,38769
482,0,377,859,56.11,0.0,43.89,2019,38643
535,0,145,680,78.68,0.0,21.32,2019,38545
62,0,8,70,88.57,0.0,11.43,2019,38552
339,21,71,431,78.65,4.87,16.47,2019,38554
4154,138,351,4643,89.47,2.97,7.56,2019,38558
202,8,51,261,77.39,3.07,19.54,2019,38567
1063,21,426,1510,70.4,1.39,28.21,2019,38581
4853,237,1730,6820,71.16,3.48,25.37,2019,38829
249,8,240,497,50.1,1.61,48.29,2019,38927
1106,81,302,1489,74.28,5.44,20.28,2019,38857
752,30,458,1240,60.65,2.42,36.94,2019,38075
98,0,32,130,75.38,0.0,24.62,2019,38226
412,7,161,580,71.03,1.21,27.76,2019,38337
953,2,485,1440,66.18,0.14,33.68,2019,38585
14,7,24,45,31.11,15.56,53.33,2019,38738
331,15,69,415,79.76,3.61,16.63,2019,38311
375,13,94,482,77.8,2.7,19.5,2019,38362
908,9,418,1335,68.01,0.67,31.31,2019,38057
720,56,363,1139,63.21,4.92,31.87,2019,38450
4658,206,1310,6174,75.45,3.34,21.22,2019,38237
296,18,120,434,68.2,4.15,27.65,2019,38923
596,3,453,1052,56.65,0.29,43.06,2019,38948
50,0,32,82,60.98,0.0,39.02,2019,38844
132,0,11,143,92.31,0.0,7.69,2019,38949
29,7,0,36,80.56,19.44,0.0,2019,38007
17191,449,1037,18677,92.04,2.4,5.55,2019,38016
12,0,0,12,100.0,0.0,0.0,2019,38029
33,0,0,33,100.0,0.0,0.0,2019,38054
56,0,9,65,86.15,0.0,13.85,2019,38070
23,0,16,39,58.97,0.0,41.03,2019,38077
0,0,0,0,,,,2019,38152
22,0,3,25,88.0,0.0,12.0,2019,38254
0,0,0,0,,,,2019,38365
58,0,9,67,86.57,0.0,13.43,2019,38455
0,0,0,0,,,,2019,38505
4342,108,1336,5786,75.04,1.87,23.09,2019,38571
3861,68,886,4815,80.19,1.41,18.4,2019,38572
55,0,6,61,90.16,0.0,9.84,2019,38578
13,0,0,13,100.0,0.0,0.0,2019,38702
2,0,0,2,100.0,0.0,0.0,2019,38704
8,0,46,54,14.81,0.0,85.19,2019,38731
5,0,29,34,14.71,0.0,85.29,2019,38749
22,0,85,107,20.56,0.0,79.44,2019,38781
12,0,0,12,100.0,0.0,0.0,2019,38945
