"GEOID","IntSub","IntNoSub","noInt","total","IntSubPct","IntNoSubPct","NoIntPct","year"
"5425245",174,9,111,294,59.18,3.06,37.76,2019
"5425268",279,10,65,354,78.81,2.82,18.36,2019
"5425286",452,10,151,613,73.74,1.63,24.63,2019
"5425303",2649,44,277,2970,89.19,1.48,9.33,2019
"5425311",3857,94,1137,5088,75.81,1.85,22.35,2019
"5425419",3599,61,528,4188,85.94,1.46,12.61,2019
"5425434",703,58,191,952,73.84,6.09,20.06,2019
"5425446",487,0,20,507,96.06,0,3.94,2019
"5425106",235,1,41,277,84.84,0.36,14.8,2019
"5425501",322,0,167,489,65.85,0,34.15,2019
"5425507",244,12,66,322,75.78,3.73,20.5,2019
"5425515",638,29,196,863,73.93,3.36,22.71,2019
"5425520",186,73,255,514,36.19,14.2,49.61,2019
"5425535",647,43,157,847,76.39,5.08,18.54,2019
"5425564",345,36,55,436,79.13,8.26,12.61,2019
"5425601",1901,20,419,2340,81.24,0.85,17.91,2019
"5425606",542,0,0,542,100,0,0,2019
"5425608",349,8,126,483,72.26,1.66,26.09,2019
"5425617",218,24,69,311,70.1,7.72,22.19,2019
"5425621",486,35,224,745,65.23,4.7,30.07,2019
"5425628",99,15,0,114,86.84,13.16,0,2019
"5425632",138,0,81,219,63.01,0,36.99,2019
"5425644",97,0,16,113,85.84,0,14.16,2019
"5425671",392,24,129,545,71.93,4.4,23.67,2019
"5425817",180,40,44,264,68.18,15.15,16.67,2019
"5425818",226,12,0,238,94.96,5.04,0,2019
"5425836",133,0,0,133,100,0,0,2019
"5425843",323,21,85,429,75.29,4.9,19.81,2019
"5425666",139,0,84,223,62.33,0,37.67,2019
"5425650",82,0,29,111,73.87,0,26.13,2019
"5426541",849,0,147,996,85.24,0,14.76,2019
"5426576",270,0,0,270,100,0,0,2019
"5426627",114,0,37,151,75.5,0,24.5,2019
"5426629",48,0,98,146,32.88,0,67.12,2019
"5426676",107,0,31,138,77.54,0,22.46,2019
"5426680",106,0,0,106,100,0,0,2019
"5426714",70,0,106,176,39.77,0,60.23,2019
"5426726",4017,176,880,5073,79.18,3.47,17.35,2019
"5426731",117,0,57,174,67.24,0,32.76,2019
"5426753",1951,26,449,2426,80.42,1.07,18.51,2019
"5426757",1817,74,868,2759,65.86,2.68,31.46,2019
"5426804",140,62,63,265,52.83,23.4,23.77,2019
"5426823",76,0,51,127,59.84,0,40.16,2019
"5426855",173,0,116,289,59.86,0,40.14,2019
"5426003",12330,843,3783,16956,72.72,4.97,22.31,2019
"5426031",445,18,215,678,65.63,2.65,31.71,2019
"5426150",2142,42,275,2459,87.11,1.71,11.18,2019
"5426152",36,0,0,36,100,0,0,2019
"5426159",971,31,221,1223,79.39,2.53,18.07,2019
"5426180",678,0,279,957,70.85,0,29.15,2019
"5426184",790,0,139,929,85.04,0,14.96,2019
"5426217",65,0,71,136,47.79,0,52.21,2019
"5426224",81,26,14,121,66.94,21.49,11.57,2019
"5426259",0,0,13,13,0,0,100,2019
"5426269",299,0,89,388,77.06,0,22.94,2019
"5426278",147,10,105,262,56.11,3.82,40.08,2019
"5426294",233,53,154,440,52.95,12.05,35,2019
"5426327",17,0,0,17,100,0,0,2019
"3728119",740,20,334,1094,67.64,1.83,30.53,2019
"5426034",1633,38,447,2118,77.1,1.79,21.1,2019
"5426037",2168,165,500,2833,76.53,5.82,17.65,2019
"5426062",7055,207,1586,8848,79.74,2.34,17.92,2019
"5426143",1288,70,514,1872,68.8,3.74,27.46,2019
"5426149",560,30,175,765,73.2,3.92,22.88,2019
"5426201",5881,283,1610,7774,75.65,3.64,20.71,2019
"5426266",22,0,21,43,51.16,0,48.84,2019
"5426267",80,0,11,91,87.91,0,12.09,2019
"5426292",174,18,79,271,64.21,6.64,29.15,2019
"5426320",135,0,146,281,48.04,0,51.96,2019
"5426347",678,3,139,820,82.68,0.37,16.95,2019
"5426385",1143,95,271,1509,75.75,6.3,17.96,2019
"5426411",168,38,70,276,60.87,13.77,25.36,2019
"5426419",300,0,118,418,71.77,0,28.23,2019
"5426430",80,2,55,137,58.39,1.46,40.15,2019
"5426440",419,0,105,524,79.96,0,20.04,2019
"5426447",311,6,219,536,58.02,1.12,40.86,2019
"5426519",550,19,204,773,71.15,2.46,26.39,2019
"5426554",14135,359,2534,17028,83.01,2.11,14.88,2019
"5426570",929,71,297,1297,71.63,5.47,22.9,2019
"5426587",132,0,26,158,83.54,0,16.46,2019
"5426611",59,0,43,102,57.84,0,42.16,2019
"5426623",284,10,176,470,60.43,2.13,37.45,2019
"5426624",943,52,242,1237,76.23,4.2,19.56,2019
"5426443",56,0,54,110,50.91,0,49.09,2019
"5426562",160,8,10,178,89.89,4.49,5.62,2019
"5426621",228,0,95,323,70.59,0,29.41,2019
"5426833",535,0,211,746,71.72,0,28.28,2019
"5426169",184,8,52,244,75.41,3.28,21.31,2019
"5426291",55,0,0,55,100,0,0,2019
"5426408",993,0,142,1135,87.49,0,12.51,2019
"5426705",178,0,45,223,79.82,0,20.18,2019
"5426707",88,0,19,107,82.24,0,17.76,2019
"5426719",1020,0,245,1265,80.63,0,19.37,2019
"5426801",230,0,136,366,62.84,0,37.16,2019
"5426808",229,0,150,379,60.42,0,39.58,2019
"5426814",120,0,47,167,71.86,0,28.14,2019
"5426836",2367,93,541,3001,78.87,3.1,18.03,2019
"5426852",205,16,89,310,66.13,5.16,28.71,2019
"5426374",391,19,99,509,76.82,3.73,19.45,2019
"5426537",1645,22,521,2188,75.18,1.01,23.81,2019
"5426710",685,0,127,812,84.36,0,15.64,2019
"5426716",217,0,64,281,77.22,0,22.78,2019
"5426717",226,5,88,319,70.85,1.57,27.59,2019
"5426743",459,0,143,602,76.25,0,23.75,2019
"5426750",243,8,79,330,73.64,2.42,23.94,2019
"5426560",49,0,17,66,74.24,0,25.76,2019
"5426335",502,6,142,650,77.23,0.92,21.85,2019
"5426254",43,34,28,105,40.95,32.38,26.67,2019
"5426563",193,0,9,202,95.54,0,4.46,2019
"5426591",486,0,66,552,88.04,0,11.96,2019
"5426178",77,0,28,105,73.33,0,26.67,2019
"5426425",253,0,199,452,55.97,0,44.03,2019
"5426559",444,6,52,502,88.45,1.2,10.36,2019
"5426631",23,0,85,108,21.3,0,78.7,2019
"5426030",161,26,38,225,71.56,11.56,16.89,2019
"5426170",1755,83,461,2299,76.34,3.61,20.05,2019
"5426268",7,0,10,17,41.18,0,58.82,2019
"4217953",128,5,61,194,65.98,2.58,31.44,2019
"5426321",103,9,48,160,64.38,5.62,30,2019
"5426412",86,0,84,170,50.59,0,49.41,2019
"3727890",548,61,433,1042,52.59,5.85,41.55,2019
"3727958",3700,140,395,4235,87.37,3.31,9.33,2019
"3727101",5901,458,2272,8631,68.37,5.31,26.32,2019
"3727283",956,69,180,1205,79.34,5.73,14.94,2019
"3727834",18022,1257,3993,23272,77.44,5.4,17.16,2019
"3727873",122,1,38,161,75.78,0.62,23.6,2019
"3727925",983,37,498,1518,64.76,2.44,32.81,2019
"3727973",461,35,121,617,74.72,5.67,19.61,2019
"3727110",0,0,0,0,NA,NA,NA,2019
"3727201",11,0,19,30,36.67,0,63.33,2019
"3727205",9977,415,2734,13126,76.01,3.16,20.83,2019
"3727332",8630,598,1435,10663,80.93,5.61,13.46,2019
"3727340",37,0,0,37,100,0,0,2019
"3727517",10627,663,366,11656,91.17,5.69,3.14,2019
"3727518",7958,133,176,8267,96.26,1.61,2.13,2019
"3727519",18878,391,438,19707,95.79,1.98,2.22,2019
"3727523",4132,113,181,4426,93.36,2.55,4.09,2019
"3727527",7768,65,454,8287,93.74,0.78,5.48,2019
"3727531",0,0,0,0,NA,NA,NA,2019
"3727537",6595,168,1980,8743,75.43,1.92,22.65,2019
"3727539",7578,68,504,8150,92.98,0.83,6.18,2019
"3727556",43,1,70,114,37.72,0.88,61.4,2019
"3727574",4419,99,1259,5777,76.49,1.71,21.79,2019
"3727617",8625,376,311,9312,92.62,4.04,3.34,2019
"3727709",403,0,19,422,95.5,0,4.5,2019
"3727825",12,3,13,28,42.86,10.71,46.43,2019
"3727861",9,0,8,17,52.94,0,47.06,2019
"3727879",88,2,38,128,68.75,1.56,29.69,2019
"3727881",26,0,8,34,76.47,0,23.53,2019
"3727978",42,0,39,81,51.85,0,48.15,2019
"3727577",6952,255,2388,9595,72.45,2.66,24.89,2019
"3727016",416,12,131,559,74.42,2.15,23.43,2019
"3727326",942,32,375,1349,69.83,2.37,27.8,2019
"3727356",834,27,182,1043,79.96,2.59,17.45,2019
"3727408",6840,484,790,8114,84.3,5.96,9.74,2019
"3727504",3870,310,1252,5432,71.24,5.71,23.05,2019
"3727513",17356,170,585,18111,95.83,0.94,3.23,2019
"3727520",12416,653,1968,15037,82.57,4.34,13.09,2019
"3727525",4414,128,1328,5870,75.2,2.18,22.62,2019
"3727530",12443,326,2953,15722,79.14,2.07,18.78,2019
"3727534",11305,292,1690,13287,85.08,2.2,12.72,2019
"3727536",4115,208,1985,6308,65.23,3.3,31.47,2019
"3727540",12122,161,563,12846,94.36,1.25,4.38,2019
"3727560",13094,215,470,13779,95.03,1.56,3.41,2019
"3727587",22641,401,1180,24222,93.47,1.66,4.87,2019
"3727866",203,19,108,330,61.52,5.76,32.73,2019
"3727892",3955,390,1429,5774,68.5,6.75,24.75,2019
"3727924",798,42,688,1528,52.23,2.75,45.03,2019
"3727928",478,19,302,799,59.82,2.38,37.8,2019
"3727935",580,0,132,712,81.46,0,18.54,2019
"3727937",1270,89,316,1675,75.82,5.31,18.87,2019
"3727962",2123,79,919,3121,68.02,2.53,29.45,2019
"5426234",455,0,254,709,64.17,0,35.83,2019
"3727850",2099,235,968,3302,63.57,7.12,29.32,2019
"3727871",1136,105,523,1764,64.4,5.95,29.65,2019
"3727874",796,134,814,1744,45.64,7.68,46.67,2019
"4217025",6255,70,966,7291,85.79,0.96,13.25,2019
"3728144",6924,359,1993,9276,74.64,3.87,21.49,2019
"3728150",6659,788,3117,10564,63.03,7.46,29.51,2019
"3728168",3026,120,808,3954,76.53,3.03,20.44,2019
"3728173",17413,243,583,18239,95.47,1.33,3.2,2019
"3728205",16639,448,3007,20094,82.81,2.23,14.96,2019
"3728214",12553,232,1474,14259,88.04,1.63,10.34,2019
"3728307",4509,74,116,4699,95.96,1.57,2.47,2019
"3728315",4029,49,880,4958,81.26,0.99,17.75,2019
"3728318",1341,22,337,1700,78.88,1.29,19.82,2019
"3728320",2709,144,1007,3860,70.18,3.73,26.09,2019
"3728333",3016,61,929,4006,75.29,1.52,23.19,2019
"3728730",3043,50,480,3573,85.17,1.4,13.43,2019
"3728480",1070,39,67,1176,90.99,3.32,5.7,2019
"3728715",8226,480,1632,10338,79.57,4.64,15.79,2019
"3728716",5112,440,1779,7331,69.73,6,24.27,2019
"3728729",1209,62,182,1453,83.21,4.27,12.53,2019
"3728732",6349,142,975,7466,85.04,1.9,13.06,2019
"3728733",15,0,0,15,100,0,0,2019
"3728001",8382,230,1781,10393,80.65,2.21,17.14,2019
"3728007",205,3,53,261,78.54,1.15,20.31,2019
"3728018",1272,124,726,2122,59.94,5.84,34.21,2019
"3728020",541,45,206,792,68.31,5.68,26.01,2019
"3728025",17355,349,2242,19946,87.01,1.75,11.24,2019
"3728072",496,6,52,554,89.53,1.08,9.39,2019
"3728432",339,12,229,580,58.45,2.07,39.48,2019
"3728394",1934,18,207,2159,89.58,0.83,9.59,2019
"3728395",607,3,168,778,78.02,0.39,21.59,2019
"3728411",13690,343,941,14974,91.43,2.29,6.28,2019
"3728436",424,0,312,736,57.61,0,42.39,2019
"3728441",840,20,245,1105,76.02,1.81,22.17,2019
"3728443",7571,109,778,8458,89.51,1.29,9.2,2019
"3728452",153,0,171,324,47.22,0,52.78,2019
"3728458",1428,142,861,2431,58.74,5.84,35.42,2019
"3728463",1914,105,1016,3035,63.06,3.46,33.48,2019
"3728479",2185,0,478,2663,82.05,0,17.95,2019
"3728510",526,30,179,735,71.56,4.08,24.35,2019
"3728512",1372,53,188,1613,85.06,3.29,11.66,2019
"3728515",607,4,318,929,65.34,0.43,34.23,2019
"3728421",354,7,121,482,73.44,1.45,25.1,2019
"3728422",2567,174,444,3185,80.6,5.46,13.94,2019
"3728423",653,45,221,919,71.06,4.9,24.05,2019
"3728430",534,12,263,809,66.01,1.48,32.51,2019
"3728445",2587,83,261,2931,88.26,2.83,8.9,2019
"3728448",406,0,57,463,87.69,0,12.31,2019
"3728449",736,20,39,795,92.58,2.52,4.91,2019
"3728468",2141,47,331,2519,84.99,1.87,13.14,2019
"3728745",187,31,0,218,85.78,14.22,0,2019
"3728751",1369,124,264,1757,77.92,7.06,15.03,2019
"3728752",9183,313,2594,12090,75.96,2.59,21.46,2019
"3728768",2534,74,516,3124,81.11,2.37,16.52,2019
"3728805",7599,167,1505,9271,81.97,1.8,16.23,2019
"3728906",6796,313,1811,8920,76.19,3.51,20.3,2019
"3728077",132,5,78,215,61.4,2.33,36.28,2019
"3728097",2132,33,297,2462,86.6,1.34,12.06,2019
"3728103",3420,36,496,3952,86.54,0.91,12.55,2019
"3728105",16157,339,1031,17527,92.18,1.93,5.88,2019
"3728110",15970,371,1866,18207,87.71,2.04,10.25,2019
"3728124",1939,51,259,2249,86.22,2.27,11.52,2019
"4219140",11057,1166,6588,18811,58.78,6.2,35.02,2019
"4217009",706,16,139,861,82,1.86,16.14,2019
"4217010",77,0,0,77,100,0,0,2019
"4217033",5603,326,563,6492,86.31,5.02,8.67,2019
"4217044",6724,227,2151,9102,73.87,2.49,23.63,2019
"4217829",59,3,17,79,74.68,3.8,21.52,2019
"4217832",251,5,62,318,78.93,1.57,19.5,2019
"4217835",101,0,19,120,84.17,0,15.83,2019
"4217845",480,21,184,685,70.07,3.07,26.86,2019
"4217861",46,0,18,64,71.88,0,28.12,2019
"4217866",2333,72,1019,3424,68.14,2.1,29.76,2019
"4217929",530,6,102,638,83.07,0.94,15.99,2019
"4217002",92,10,139,241,38.17,4.15,57.68,2019
"4217005",108,0,27,135,80,0,20,2019
"4217006",240,4,114,358,67.04,1.12,31.84,2019
"4217020",2928,68,614,3610,81.11,1.88,17.01,2019
"4217035",278,4,95,377,73.74,1.06,25.2,2019
"4217047",632,36,242,910,69.45,3.96,26.59,2019
"4217061",2269,95,657,3021,75.11,3.14,21.75,2019
"4217065",1360,57,237,1654,82.22,3.45,14.33,2019
"4217087",744,19,183,946,78.65,2.01,19.34,2019
"4217104",5718,417,1476,7611,75.13,5.48,19.39,2019
"4217213",175,5,61,241,72.61,2.07,25.31,2019
"4217214",241,0,150,391,61.64,0,38.36,2019
"4217215",71,0,16,87,81.61,0,18.39,2019
"4217222",3921,97,854,4872,80.48,1.99,17.53,2019
"4217225",6352,142,939,7433,85.46,1.91,12.63,2019
"4217302",718,46,259,1023,70.19,4.5,25.32,2019
"4217340",3598,62,616,4276,84.14,1.45,14.41,2019
"4217355",118,1,6,125,94.4,0.8,4.8,2019
"4217403",11712,638,2541,14891,78.65,4.28,17.06,2019
"4217516",1538,43,304,1885,81.59,2.28,16.13,2019
"4217538",2062,111,295,2468,83.55,4.5,11.95,2019
"4217554",2440,266,330,3036,80.37,8.76,10.87,2019
"4217557",3881,299,1048,5228,74.23,5.72,20.05,2019
"4217565",761,32,133,926,82.18,3.46,14.36,2019
"4217569",1480,128,344,1952,75.82,6.56,17.62,2019
"4217601",17771,1206,2021,20998,84.63,5.74,9.62,2019
"4217602",15270,953,2786,19009,80.33,5.01,14.66,2019
"4217721",526,23,121,670,78.51,3.43,18.06,2019
"4217739",15,0,2,17,88.24,0,11.76,2019
"4217758",322,31,71,424,75.94,7.31,16.75,2019
"4217810",517,21,187,725,71.31,2.9,25.79,2019
"4217823",379,17,91,487,77.82,3.49,18.69,2019
"4217887",75,0,64,139,53.96,0,46.04,2019
"4217921",2183,18,490,2691,81.12,0.67,18.21,2019
"4217923",132,0,47,179,73.74,0,26.26,2019
"4217933",46,0,0,46,100,0,0,2019
"4217935",544,3,146,693,78.5,0.43,21.07,2019
"4217959",400,11,186,597,67,1.84,31.16,2019
"4217960",1471,5,235,1711,85.97,0.29,13.73,2019
"4217972",3792,126,816,4734,80.1,2.66,17.24,2019
"4217965",698,31,166,895,77.99,3.46,18.55,2019
"4217978",89,2,24,115,77.39,1.74,20.87,2019
"4217820",1796,56,444,2296,78.22,2.44,19.34,2019
"4217776",101,3,37,141,71.63,2.13,26.24,2019
"4217812",398,13,98,509,78.19,2.55,19.25,2019
"4217311",52,0,51,103,50.49,0,49.51,2019
"4217314",1657,93,313,2063,80.32,4.51,15.17,2019
"1120012",5284,130,856,6270,84.27,2.07,13.65,2019
"4217090",2059,28,321,2408,85.51,1.16,13.33,2019
"4217265",230,3,37,270,85.19,1.11,13.7,2019
"4217028",1297,4,249,1550,83.68,0.26,16.06,2019
"4217067",4510,179,1093,5782,78,3.1,18.9,2019
"4217228",330,15,77,422,78.2,3.55,18.25,2019
"4217886",266,0,313,579,45.94,0,54.06,2019
"4217964",220,8,88,316,69.62,2.53,27.85,2019
"4217083",24,0,0,24,100,0,0,2019
"4217221",132,41,69,242,54.55,16.94,28.51,2019
"4217327",2350,69,413,2832,82.98,2.44,14.58,2019
"4217509",826,50,428,1304,63.34,3.83,32.82,2019
"4217762",154,0,22,176,87.5,0,12.5,2019
"4217860",820,5,170,995,82.41,0.5,17.09,2019
"4217764",695,44,191,930,74.73,4.73,20.54,2019
"4217814",1531,13,376,1920,79.74,0.68,19.58,2019
"4217830",589,8,197,794,74.18,1.01,24.81,2019
"4217938",734,2,187,923,79.52,0.22,20.26,2019
"4217985",415,30,100,545,76.15,5.5,18.35,2019
"4217744",931,31,276,1238,75.2,2.5,22.29,2019
"4217868",474,0,63,537,88.27,0,11.73,2019
"4217980",1029,19,223,1271,80.96,1.49,17.55,2019
"4217015",7196,131,952,8279,86.92,1.58,11.5,2019
"4217030",199,5,106,310,64.19,1.61,34.19,2019
"4217039",9,29,0,38,23.68,76.32,0,2019
"4217050",13774,505,1082,15361,89.67,3.29,7.04,2019
"4217056",13,0,10,23,56.52,0,43.48,2019
"4217071",40,0,12,52,76.92,0,23.08,2019
"4217120",0,0,0,0,NA,NA,NA,2019
"4217202",9385,280,1369,11034,85.06,2.54,12.41,2019
"4217210",85,0,0,85,100,0,0,2019
"4217217",69,0,15,84,82.14,0,17.86,2019
"4217246",39,0,55,94,41.49,0,58.51,2019
"4217247",101,0,132,233,43.35,0,56.65,2019
"4217250",0,0,34,34,0,0,100,2019
"4217251",40,0,2,42,95.24,0,4.76,2019
"4217256",49,0,0,49,100,0,0,2019
"4217261",0,0,0,0,NA,NA,NA,2019
"4217263",213,0,0,213,100,0,0,2019
"4217272",178,0,35,213,83.57,0,16.43,2019
"4217371",54,5,30,89,60.67,5.62,33.71,2019
"4217408",7662,307,1670,9639,79.49,3.18,17.33,2019
"4217507",51,0,14,65,78.46,0,21.54,2019
"4217550",163,0,144,307,53.09,0,46.91,2019
"4217606",31,110,80,221,14.03,49.77,36.2,2019
"4217723",17,0,6,23,73.91,0,26.09,2019
"4217727",38,0,5,43,88.37,0,11.63,2019
"4217779",97,0,14,111,87.39,0,12.61,2019
"4217822",0,0,0,0,NA,NA,NA,2019
"4217876",621,20,204,845,73.49,2.37,24.14,2019
"4217880",38,0,7,45,84.44,0,15.56,2019
"4217268",10039,222,1678,11939,84.09,1.86,14.05,2019
"4217271",85,0,14,99,85.86,0,14.14,2019
"4217094",718,33,283,1034,69.44,3.19,27.37,2019
"4217102",3107,292,675,4074,76.26,7.17,16.57,2019
"4217223",83,0,35,118,70.34,0,29.66,2019
"4217224",474,51,103,628,75.48,8.12,16.4,2019
"4217236",2590,100,567,3257,79.52,3.07,17.41,2019
"4217240",919,27,315,1261,72.88,2.14,24.98,2019
"1120427",0,0,0,0,NA,NA,NA,2019
"4219333",2485,113,233,2831,87.78,3.99,8.23,2019
"4219341",6551,96,356,7003,93.55,1.37,5.08,2019
"4219344",3094,190,1003,4287,72.17,4.43,23.4,2019
"4219350",3953,19,149,4121,95.92,0.46,3.62,2019
"4219403",16288,206,1496,17990,90.54,1.15,8.32,2019
"4219435",47,0,0,47,100,0,0,2019
"4219457",22,23,0,45,48.89,51.11,0,2019
"4219137",2544,98,449,3091,82.3,3.17,14.53,2019
"4219046",6410,201,663,7274,88.12,2.76,9.11,2019
"4219047",11456,286,1084,12826,89.32,2.23,8.45,2019
"4219063",13332,176,1509,15017,88.78,1.17,10.05,2019
"4219075",2556,16,206,2778,92.01,0.58,7.42,2019
"4219076",2245,9,434,2688,83.52,0.33,16.15,2019
"4219015",5698,52,746,6496,87.72,0.8,11.48,2019
"4219030",3908,98,673,4679,83.52,2.09,14.38,2019
"4219038",10335,201,711,11247,91.89,1.79,6.32,2019
"1019730",283,0,18,301,94.02,0,5.98,2019
"1019732",26,0,0,26,100,0,0,2019
"1019806",4572,146,474,5192,88.06,2.81,9.13,2019
"1019954",494,2,54,550,89.82,0.36,9.82,2019
"1019960",1856,58,602,2516,73.77,2.31,23.93,2019
"1019966",10134,94,2083,12311,82.32,0.76,16.92,2019
"4219136",9825,275,2232,12332,79.67,2.23,18.1,2019
"4219081",3110,104,162,3376,92.12,3.08,4.8,2019
"4219086",3984,44,192,4220,94.41,1.04,4.55,2019
"4219106",6535,43,158,6736,97.02,0.64,2.35,2019
"4219141",8549,659,3315,12523,68.27,5.26,26.47,2019
"4219145",13596,638,4145,18379,73.98,3.47,22.55,2019
"4219367",17,0,0,17,100,0,0,2019
"4219374",296,0,84,380,77.89,0,22.11,2019
"4219437",376,14,0,390,96.41,3.59,0,2019
"4219444",3940,66,307,4313,91.35,1.53,7.12,2019
"4219446",19673,606,1933,22212,88.57,2.73,8.7,2019
"4219453",787,0,29,816,96.45,0,3.55,2019
"4219465",5915,83,625,6623,89.31,1.25,9.44,2019
"4219519",67,0,0,67,100,0,0,2019
"4219610",5414,72,846,6332,85.5,1.14,13.36,2019
"1019702",18182,343,1055,19580,92.86,1.75,5.39,2019
"1019703",4915,239,893,6047,81.28,3.95,14.77,2019
"4219609",3512,76,428,4016,87.45,1.89,10.66,2019
"4219454",10279,357,786,11422,89.99,3.13,6.88,2019
"4219462",5483,167,426,6076,90.24,2.75,7.01,2019
"4219464",14977,402,2819,18198,82.3,2.21,15.49,2019
"1019711",17968,689,1026,19683,91.29,3.5,5.21,2019
"1019720",17933,992,2522,21447,83.62,4.63,11.76,2019
"4219002",11136,201,845,12182,91.41,1.65,6.94,2019
"4219510",2977,0,298,3275,90.9,0,9.1,2019
"4219506",2296,44,431,2771,82.86,1.59,15.55,2019
"4219507",912,4,176,1092,83.52,0.37,16.12,2019
"4219522",4578,152,613,5343,85.68,2.84,11.47,2019
"4219526",3612,102,891,4605,78.44,2.21,19.35,2019
"4219551",1567,34,262,1863,84.11,1.83,14.06,2019
"4219554",136,0,36,172,79.07,0,20.93,2019
"4219604",6467,144,1627,8238,78.5,1.75,19.75,2019
"4219147",15331,451,1608,17390,88.16,2.59,9.25,2019
"1019701",13049,305,1056,14410,90.56,2.12,7.33,2019
"1019710",0,0,0,0,NA,NA,NA,2019
"1019713",10216,402,1011,11629,87.85,3.46,8.69,2019
"5124292",109,6,86,201,54.23,2.99,42.79,2019
"1120015",5785,53,545,6383,90.63,0.83,8.54,2019
"5120110",12888,263,1286,14437,89.27,1.82,8.91,2019
"5120121",9119,70,372,9561,95.38,0.73,3.89,2019
"5120124",4805,26,65,4896,98.14,0.53,1.33,2019
"5120181",2572,6,195,2773,92.75,0.22,7.03,2019
"5120184",218,0,98,316,68.99,0,31.01,2019
"2420602",8946,71,1149,10166,88,0.7,11.3,2019
"2420603",10586,207,467,11260,94.01,1.84,4.15,2019
"2420606",96,7,34,137,70.07,5.11,24.82,2019
"2420607",3690,61,131,3882,95.05,1.57,3.37,2019
"2420608",156,25,98,279,55.91,8.96,35.13,2019
"2420621",265,0,115,380,69.74,0,30.26,2019
"2420623",844,43,8,895,94.3,4.8,0.89,2019
"2420624",469,0,50,519,90.37,0,9.63,2019
"2420653",8054,463,1174,9691,83.11,4.78,12.11,2019
"2420659",6735,119,1077,7931,84.92,1.5,13.58,2019
"2420684",268,11,137,416,64.42,2.64,32.93,2019
"2420687",174,0,45,219,79.45,0,20.55,2019
"2420689",557,21,66,644,86.49,3.26,10.25,2019
"5120144",395,20,47,462,85.5,4.33,10.17,2019
"2420832",8406,146,251,8803,95.49,1.66,2.85,2019
"5120135",1058,45,148,1251,84.57,3.6,11.83,2019
"5120164",11122,255,942,12319,90.28,2.07,7.65,2019
"5120180",2346,36,151,2533,92.62,1.42,5.96,2019
"2420609",258,43,126,427,60.42,10.07,29.51,2019
"2420617",254,7,35,296,85.81,2.36,11.82,2019
"2420618",147,10,34,191,76.96,5.24,17.8,2019
"2420636",3270,189,337,3796,86.14,4.98,8.88,2019
"2420637",1783,0,111,1894,94.14,0,5.86,2019
"2420645",248,0,52,300,82.67,0,17.33,2019
"2420674",257,12,39,308,83.44,3.9,12.66,2019
"2420754",2203,65,203,2471,89.15,2.63,8.22,2019
"2420758",173,0,0,173,100,0,0,2019
"2420625",173,10,57,240,72.08,4.17,23.75,2019
"2420755",2648,191,36,2875,92.1,6.64,1.25,2019
"2420860",809,0,79,888,91.1,0,8.9,2019
"2420676",1174,33,64,1271,92.37,2.6,5.04,2019
"2420777",1132,0,40,1172,96.59,0,3.41,2019
"2420833",2193,3,159,2355,93.12,0.13,6.75,2019
"2420912",8012,311,1038,9361,85.59,3.32,11.09,2019
"1120045",0,0,0,0,NA,NA,NA,2019
"1120052",0,0,0,0,NA,NA,NA,2019
"1120053",0,0,0,0,NA,NA,NA,2019
"1120057",0,0,0,0,NA,NA,NA,2019
"1120064",0,0,0,0,NA,NA,NA,2019
"1120202",0,0,0,0,NA,NA,NA,2019
"1120204",0,0,0,0,NA,NA,NA,2019
"1120228",0,0,0,0,NA,NA,NA,2019
"1120230",0,0,0,0,NA,NA,NA,2019
"1120240",0,0,0,0,NA,NA,NA,2019
"1120245",0,0,0,0,NA,NA,NA,2019
"1120260",0,0,0,0,NA,NA,NA,2019
"1120307",0,0,0,0,NA,NA,NA,2019
"1120317",25,7,294,326,7.67,2.15,90.18,2019
"1120373",0,0,0,0,NA,NA,NA,2019
"1120390",0,0,0,0,NA,NA,NA,2019
"1120405",0,0,0,0,NA,NA,NA,2019
"1120418",0,0,0,0,NA,NA,NA,2019
"5124501",7134,413,2639,10186,70.04,4.05,25.91,2019
"1120506",0,0,0,0,NA,NA,NA,2019
"1120510",0,0,0,0,NA,NA,NA,2019
"1120520",0,0,0,0,NA,NA,NA,2019
"1120535",0,0,0,0,NA,NA,NA,2019
"1120540",0,0,0,0,NA,NA,NA,2019
"1120551",0,0,0,0,NA,NA,NA,2019
"1120553",0,0,0,0,NA,NA,NA,2019
"1120560",0,0,0,0,NA,NA,NA,2019
"1120565",0,0,0,0,NA,NA,NA,2019
"1120566",0,0,0,0,NA,NA,NA,2019
"1120593",0,0,0,0,NA,NA,NA,2019
"2420660",0,0,0,0,NA,NA,NA,2019
"2420686",40,69,0,109,36.7,63.3,0,2019
"2420742",0,0,0,0,NA,NA,NA,2019
"2420899",118,0,72,190,62.11,0,37.89,2019
"2420612",76,0,62,138,55.07,0,44.93,2019
"2420707",11074,168,959,12201,90.76,1.38,7.86,2019
"2420902",15075,397,1258,16730,90.11,2.37,7.52,2019
"2420711",1994,65,380,2439,81.75,2.67,15.58,2019
"2420770",8898,194,725,9817,90.64,1.98,7.39,2019
"2420872",3882,175,167,4224,91.9,4.14,3.95,2019
"2420670",342,3,0,345,99.13,0.87,0,2019
"2420720",7316,91,150,7557,96.81,1.2,1.98,2019
"2420905",5593,56,252,5901,94.78,0.95,4.27,2019
"2421009",10789,138,736,11663,92.51,1.18,6.31,2019
"2421017",2665,50,62,2777,95.97,1.8,2.23,2019
"2421028",894,25,130,1049,85.22,2.38,12.39,2019
"2421032",2876,0,190,3066,93.8,0,6.2,2019
"2421036",654,0,55,709,92.24,0,7.76,2019
"2421044",16481,525,951,17957,91.78,2.92,5.3,2019
"2421048",3231,52,399,3682,87.75,1.41,10.84,2019
"2421130",52,0,0,52,100,0,0,2019
"2421146",8925,53,480,9458,94.36,0.56,5.08,2019
"2421154",1871,51,191,2113,88.55,2.41,9.04,2019
"2421160",682,55,223,960,71.04,5.73,23.23,2019
"2421209",10152,390,962,11504,88.25,3.39,8.36,2019
"2421212",10825,303,1265,12393,87.35,2.44,10.21,2019
"2421216",5760,1403,3446,10609,54.29,13.22,32.48,2019
"2421520",782,23,118,923,84.72,2.49,12.78,2019
"2421545",512,28,234,774,66.15,3.62,30.23,2019
"2421555",421,20,178,619,68.01,3.23,28.76,2019
"2421001",8185,220,1357,9762,83.85,2.25,13.9,2019
"2421013",1529,9,144,1682,90.9,0.54,8.56,2019
"2421029",3274,36,102,3412,95.96,1.06,2.99,2019
"2421045",14213,190,723,15126,93.96,1.26,4.78,2019
"2421057",1312,104,200,1616,81.19,6.44,12.38,2019
"2421060",11709,261,1468,13438,87.13,1.94,10.92,2019
"2421531",624,4,259,887,70.35,0.45,29.2,2019
"2421012",7342,141,241,7724,95.05,1.83,3.12,2019
"2421030",9132,96,813,10041,90.95,0.96,8.1,2019
"2421046",5905,96,209,6210,95.09,1.55,3.37,2019
"2421056",89,0,0,89,100,0,0,2019
"2421105",0,0,0,0,NA,NA,NA,2019
"2421111",1770,0,64,1834,96.51,0,3.49,2019
"2421122",20045,366,1554,21965,91.26,1.67,7.07,2019
"2421161",1842,10,69,1921,95.89,0.52,3.59,2019
"2421163",2240,85,201,2526,88.68,3.37,7.96,2019
"2421206",16317,372,2772,19461,83.84,1.91,14.24,2019
"5124432",117,0,9,126,92.86,0,7.14,2019
"5124473",290,0,80,370,78.38,0,21.62,2019
"5124237",213,28,147,388,54.9,7.22,37.89,2019
"5124483",217,0,54,271,80.07,0,19.93,2019
"5124485",140,0,21,161,86.96,0,13.04,2019
"5124503",6887,160,661,7708,89.35,2.08,8.58,2019
"5124555",576,9,281,866,66.51,1.04,32.45,2019
"5124563",1718,56,673,2447,70.21,2.29,27.5,2019
"5124565",217,5,180,402,53.98,1.24,44.78,2019
"5124569",289,0,81,370,78.11,0,21.89,2019
"5124586",1768,70,450,2288,77.27,3.06,19.67,2019
"5124465",504,13,88,605,83.31,2.15,14.55,2019
"5124014",6138,174,1116,7428,82.63,2.34,15.02,2019
"5124064",1524,9,340,1873,81.37,0.48,18.15,2019
"5124065",2181,73,501,2755,79.17,2.65,18.19,2019
"5124085",656,17,325,998,65.73,1.7,32.57,2019
"5124086",27,0,61,88,30.68,0,69.32,2019
"5124105",142,0,72,214,66.36,0,33.64,2019
"5124018",13964,243,2080,16287,85.74,1.49,12.77,2019
"5124059",325,25,43,393,82.7,6.36,10.94,2019
"5124072",319,17,77,413,77.24,4.12,18.64,2019
"5124073",10955,372,1440,12767,85.81,2.91,11.28,2019
"5124088",1115,60,544,1719,64.86,3.49,31.65,2019
"5124102",370,7,216,593,62.39,1.18,36.42,2019
"5124121",3492,210,901,4603,75.86,4.56,19.57,2019
"5124124",1295,14,493,1802,71.86,0.78,27.36,2019
"5124131",7,0,0,7,100,0,0,2019
"5124138",517,0,132,649,79.66,0,20.34,2019
"5124139",137,0,62,199,68.84,0,31.16,2019
"5124142",0,0,0,0,NA,NA,NA,2019
"5124162",780,52,214,1046,74.57,4.97,20.46,2019
"5124179",5940,222,1584,7746,76.68,2.87,20.45,2019
"5124230",2042,276,858,3176,64.29,8.69,27.02,2019
"5124053",747,39,448,1234,60.53,3.16,36.3,2019
"5124077",314,0,40,354,88.7,0,11.3,2019
"5124090",1530,35,304,1869,81.86,1.87,16.27,2019
"5124091",2500,88,751,3339,74.87,2.64,22.49,2019
"5124523",5729,255,2009,7993,71.68,3.19,25.13,2019
"5124531",2557,33,820,3410,74.99,0.97,24.05,2019
"5124550",2228,164,608,3000,74.27,5.47,20.27,2019
"5124557",2344,79,1103,3526,66.48,2.24,31.28,2019
"5124577",927,40,1065,2032,45.62,1.97,52.41,2019
"5124590",2292,37,775,3104,73.84,1.19,24.97,2019
"5124598",291,32,324,647,44.98,4.95,50.08,2019
"5124602",195,12,99,306,63.73,3.92,32.35,2019
"5124603",255,0,120,375,68,0,32,2019
"5124622",154,2,211,367,41.96,0.54,57.49,2019
"5424712",435,34,159,628,69.27,5.41,25.32,2019
"5424733",244,0,36,280,87.14,0,12.86,2019
"5424818",290,25,138,453,64.02,5.52,30.46,2019
"5424822",294,0,21,315,93.33,0,6.67,2019
"5424844",339,49,203,591,57.36,8.29,34.35,2019
"5424851",209,37,15,261,80.08,14.18,5.75,2019
"5124504",2766,151,946,3863,71.6,3.91,24.49,2019
"5124517",1534,77,485,2096,73.19,3.67,23.14,2019
"5124522",2637,168,1027,3832,68.82,4.38,26.8,2019
"5124529",346,10,410,766,45.17,1.31,53.52,2019
"5124549",1186,65,305,1556,76.22,4.18,19.6,2019
"5124553",380,7,265,652,58.28,1.07,40.64,2019
"5426330",5189,58,615,5862,88.52,0.99,10.49,2019
"5124521",2723,119,1129,3971,68.57,3,28.43,2019
"5124526",294,18,254,566,51.94,3.18,44.88,2019
"5124530",345,0,81,426,80.99,0,19.01,2019
"5124534",277,32,206,515,53.79,6.21,40,2019
"5124536",70,0,18,88,79.55,0,20.45,2019
"5124539",24,0,37,61,39.34,0,60.66,2019
"5124566",340,0,234,574,59.23,0,40.77,2019
"5124571",647,12,283,942,68.68,1.27,30.04,2019
"5124363",365,7,224,596,61.24,1.17,37.58,2019
"5124283",620,111,256,987,62.82,11.25,25.94,2019
"5124319",2081,158,616,2855,72.89,5.53,21.58,2019
"5124324",558,13,168,739,75.51,1.76,22.73,2019
"5124370",1932,42,739,2713,71.21,1.55,27.24,2019
"5124597",384,17,100,501,76.65,3.39,19.96,2019
"5424981",104,18,39,161,64.6,11.18,24.22,2019
"5424962",40,0,0,40,100,0,0,2019
"5424963",1290,48,322,1660,77.71,2.89,19.4,2019
"5424976",380,14,153,547,69.47,2.56,27.97,2019
"5424888",27,0,0,27,100,0,0,2019
"5424977",158,39,15,212,74.53,18.4,7.08,2019
"5124313",206,0,105,311,66.24,0,33.76,2019
"5124314",476,6,141,623,76.4,0.96,22.63,2019
"5124316",0,0,0,0,NA,NA,NA,2019
"5124317",1123,112,377,1612,69.67,6.95,23.39,2019
"5124318",149,0,112,261,57.09,0,42.91,2019
"5124352",206,0,208,414,49.76,0,50.24,2019
"5124366",137,0,82,219,62.56,0,37.44,2019
"5124019",9884,180,1193,11257,87.8,1.6,10.6,2019
"5124054",1693,57,767,2517,67.26,2.26,30.47,2019
"5124055",3565,205,1300,5070,70.32,4.04,25.64,2019
"5124069",524,92,190,806,65.01,11.41,23.57,2019
"5124070",603,8,78,689,87.52,1.16,11.32,2019
"5124087",1055,132,127,1314,80.29,10.05,9.67,2019
"5124089",681,10,429,1120,60.8,0.89,38.3,2019
"5124128",711,51,127,889,79.98,5.74,14.29,2019
"5124151",5884,250,2165,8299,70.9,3.01,26.09,2019
"5124167",54,0,48,102,52.94,0,47.06,2019
"5124171",2409,197,967,3573,67.42,5.51,27.06,2019
"5124211",3479,172,641,4292,81.06,4.01,14.93,2019
"5124217",58,0,78,136,42.65,0,57.35,2019
"5124219",3061,404,650,4115,74.39,9.82,15.8,2019
"5124250",345,57,186,588,58.67,9.69,31.63,2019
"5124260",1116,37,1077,2230,50.04,1.66,48.3,2019
"5124263",1085,483,875,2443,44.41,19.77,35.82,2019
"5124269",83,0,28,111,74.77,0,25.23,2019
"5124127",1330,101,375,1806,73.64,5.59,20.76,2019
"5124133",697,79,250,1026,67.93,7.7,24.37,2019
"5124011",361,18,12,391,92.33,4.6,3.07,2019
"5124013",1985,65,942,2992,66.34,2.17,31.48,2019
"5124556",951,44,236,1231,77.25,3.57,19.17,2019
"5124520",555,76,454,1085,51.15,7,41.84,2019
"5124528",731,85,492,1308,55.89,6.5,37.61,2019
"5124551",8748,207,559,9514,91.95,2.18,5.88,2019
"5124592",3262,352,1630,5244,62.2,6.71,31.08,2019
"5124609",2147,200,634,2981,72.02,6.71,21.27,2019
"5124380",757,32,287,1076,70.35,2.97,26.67,2019
"5124416",2509,116,810,3435,73.04,3.38,23.58,2019
"5124426",4430,231,1105,5766,76.83,4.01,19.16,2019
"5426161",193,9,40,242,79.75,3.72,16.53,2019
"5124441",2003,88,586,2677,74.82,3.29,21.89,2019
"5124459",165,0,116,281,58.72,0,41.28,2019
"5124467",724,30,98,852,84.98,3.52,11.5,2019
"5123696",1221,70,98,1389,87.9,5.04,7.06,2019
"5123707",4558,208,1128,5894,77.33,3.53,19.14,2019
"5123821",476,26,219,721,66.02,3.61,30.37,2019
"5123827",397,2,137,536,74.07,0.37,25.56,2019
"5123830",441,9,142,592,74.49,1.52,23.99,2019
"5123833",629,6,242,877,71.72,0.68,27.59,2019
"5123850",277,0,141,418,66.27,0,33.73,2019
"5123851",4080,213,1304,5597,72.9,3.81,23.3,2019
"5123890",1135,68,397,1600,70.94,4.25,24.81,2019
"5123302",64,0,17,81,79.01,0,20.99,2019
"5123307",142,23,94,259,54.83,8.88,36.29,2019
"5123336",1236,31,272,1539,80.31,2.01,17.67,2019
"5123150",4164,97,851,5112,81.46,1.9,16.65,2019
"5123220",10068,1180,1814,13062,77.08,9.03,13.89,2019
"5123222",6966,405,2792,10163,68.54,3.99,27.47,2019
"5123230",2552,140,543,3235,78.89,4.33,16.79,2019
"5123294",6843,69,783,7695,88.93,0.9,10.18,2019
"5123301",383,2,145,530,72.26,0.38,27.36,2019
"5123321",11516,173,1145,12834,89.73,1.35,8.92,2019
"5123347",255,0,60,315,80.95,0,19.05,2019
"5123409",30,6,20,56,53.57,10.71,35.71,2019
"5123417",1322,171,256,1749,75.59,9.78,14.64,2019
"5123960",408,0,229,637,64.05,0,35.95,2019
"5123962",248,0,46,294,84.35,0,15.65,2019
"5123963",24,0,40,64,37.5,0,62.5,2019
"5123079",108,0,43,151,71.52,0,28.48,2019
"5123084",559,0,144,703,79.52,0,20.48,2019
"5123092",140,19,117,276,50.72,6.88,42.39,2019
"5123108",46,0,0,46,100,0,0,2019
"5123115",21,0,0,21,100,0,0,2019
"5123038",411,7,127,545,75.41,1.28,23.3,2019
"5123146",1022,98,86,1206,84.74,8.13,7.13,2019
"5123022",244,0,170,414,58.94,0,41.06,2019
"5123024",2726,48,590,3364,81.03,1.43,17.54,2019
"5123091",73,0,48,121,60.33,0,39.67,2019
"5123103",2001,79,101,2181,91.75,3.62,4.63,2019
"5123109",728,0,215,943,77.2,0,22.8,2019
"5123110",88,0,101,189,46.56,0,53.44,2019
"5123113",8884,119,588,9591,92.63,1.24,6.13,2019
"5123129",164,65,14,243,67.49,26.75,5.76,2019
"5123188",15254,983,1293,17530,87.02,5.61,7.38,2019
"5123192",2240,26,404,2670,83.9,0.97,15.13,2019
"5123233",11925,110,598,12633,94.4,0.87,4.73,2019
"5123234",12432,456,2784,15672,79.33,2.91,17.76,2019
"5123237",7373,176,1071,8620,85.53,2.04,12.42,2019
"5123303",220,0,64,284,77.46,0,22.54,2019
"5123011",229,23,142,394,58.12,5.84,36.04,2019
"5123032",131,8,40,179,73.18,4.47,22.35,2019
"5123337",183,19,82,284,64.44,6.69,28.87,2019
"5123310",1435,111,334,1880,76.33,5.9,17.77,2019
"5123356",346,44,98,488,70.9,9.02,20.08,2019
"5123357",278,16,36,330,84.24,4.85,10.91,2019
"5123358",50,0,0,50,100,0,0,2019
"5123413",185,1,67,253,73.12,0.4,26.48,2019
"5123434",14346,536,3636,18518,77.47,2.89,19.63,2019
"3727020",1722,58,754,2534,67.96,2.29,29.76,2019
"5426348",41,0,17,58,70.69,0,29.31,2019
"5426349",28,0,0,28,100,0,0,2019
"5426354",3287,31,860,4178,78.67,0.74,20.58,2019
"5426384",175,0,111,286,61.19,0,38.81,2019
"5426405",282,0,135,417,67.63,0,32.37,2019
"5426438",30,11,24,65,46.15,16.92,36.92,2019
"5426448",417,0,121,538,77.51,0,22.49,2019
"5426585",136,6,41,183,74.32,3.28,22.4,2019
"5426662",380,0,63,443,85.78,0,14.22,2019
"5426678",281,18,49,348,80.75,5.17,14.08,2019
"5426036",87,0,0,87,100,0,0,2019
"5426101",9155,331,2678,12164,75.26,2.72,22.02,2019
"5426138",35,0,23,58,60.34,0,39.66,2019
"5426148",83,0,31,114,72.81,0,27.19,2019
"5426164",2156,66,793,3015,71.51,2.19,26.3,2019
"5426181",2191,72,218,2481,88.31,2.9,8.79,2019
"5426205",1103,52,112,1267,87.06,4.1,8.84,2019
"5426208",240,5,126,371,64.69,1.35,33.96,2019
"5426209",68,32,0,100,68,32,0,2019
"5426228",15,0,0,15,100,0,0,2019
"5426261",833,11,277,1121,74.31,0.98,24.71,2019
"5426337",326,23,128,477,68.34,4.82,26.83,2019
"5426339",85,0,0,85,100,0,0,2019
"5426342",53,0,55,108,49.07,0,50.93,2019
"5426376",103,0,117,220,46.82,0,53.18,2019
"5426377",110,0,94,204,53.92,0,46.08,2019
"5426404",99,0,104,203,48.77,0,51.23,2019
"5426075",142,9,18,169,84.02,5.33,10.65,2019
"5426104",5581,182,1300,7063,79.02,2.58,18.41,2019
"5426105",4297,194,605,5096,84.32,3.81,11.87,2019
"5426146",245,7,83,335,73.13,2.09,24.78,2019
"5426039",184,0,30,214,85.98,0,14.02,2019
"5426033",600,18,326,944,63.56,1.91,34.53,2019
"5426035",544,0,208,752,72.34,0,27.66,2019
"5426038",1097,28,124,1249,87.83,2.24,9.93,2019
"5426047",1912,137,545,2594,73.71,5.28,21.01,2019
"5426050",601,35,144,780,77.05,4.49,18.46,2019
"5426059",777,92,170,1039,74.78,8.85,16.36,2019
"5426134",309,1,66,376,82.18,0.27,17.55,2019
"5426151",179,0,77,256,69.92,0,30.08,2019
"5426160",303,6,104,413,73.37,1.45,25.18,2019
"5426187",2262,104,319,2685,84.25,3.87,11.88,2019
"5426222",181,0,23,204,88.73,0,11.27,2019
"5426236",18,0,0,18,100,0,0,2019
"5426237",88,0,120,208,42.31,0,57.69,2019
"5426238",242,0,62,304,79.61,0,20.39,2019
"5426241",4158,169,1300,5627,73.89,3,23.1,2019
"5426273",249,3,72,324,76.85,0.93,22.22,2019
"5426283",446,14,266,726,61.43,1.93,36.64,2019
"5426288",993,71,421,1485,66.87,4.78,28.35,2019
"5426298",37,0,17,54,68.52,0,31.48,2019
"5426361",61,0,25,86,70.93,0,29.07,2019
"5426362",1034,79,291,1404,73.65,5.63,20.73,2019
"5426372",304,7,50,361,84.21,1.94,13.85,2019
"5426415",870,48,282,1200,72.5,4,23.5,2019
"5426574",210,2,60,272,77.21,0.74,22.06,2019
"5426581",178,0,134,312,57.05,0,42.95,2019
"5426586",77,0,17,94,81.91,0,18.09,2019
"4217862",94,0,77,171,54.97,0,45.03,2019
"3727027",1155,113,596,1864,61.96,6.06,31.97,2019
"3727030",9894,1631,3654,15179,65.18,10.75,24.07,2019
"3727048",2358,122,714,3194,73.83,3.82,22.35,2019
"3727053",1094,114,222,1430,76.5,7.97,15.52,2019
"3727104",11314,300,1165,12779,88.54,2.35,9.12,2019
"3727106",16830,361,2554,19745,85.24,1.83,12.93,2019
"3727814",520,10,256,786,66.16,1.27,32.57,2019
"3727818",319,32,256,607,52.55,5.27,42.17,2019
"3727822",2447,21,746,3214,76.14,0.65,23.21,2019
"3727011",1855,146,388,2389,77.65,6.11,16.24,2019
"3727012",9850,96,846,10792,91.27,0.89,7.84,2019
"3727014",277,9,48,334,82.93,2.69,14.37,2019
"3727017",2189,469,770,3428,63.86,13.68,22.46,2019
"3727870",7340,647,2652,10639,68.99,6.08,24.93,2019
"3727885",274,22,116,412,66.5,5.34,28.16,2019
"3727926",501,0,145,646,77.55,0,22.45,2019
"3727947",329,30,108,467,70.45,6.42,23.13,2019
"3727959",1228,40,44,1312,93.6,3.05,3.35,2019
"3727965",115,77,0,192,59.9,40.1,0,2019
"3727974",420,0,65,485,86.6,0,13.4,2019
"3727985",122,18,40,180,67.78,10,22.22,2019
"3727922",105,13,185,303,34.65,4.29,61.06,2019
"3727936",346,19,61,426,81.22,4.46,14.32,2019
"3727939",1018,35,90,1143,89.06,3.06,7.87,2019
"3727950",660,4,201,865,76.3,0.46,23.24,2019
"3727954",2759,123,216,3098,89.06,3.97,6.97,2019
"3727970",527,73,479,1079,48.84,6.77,44.39,2019
"3727878",522,16,349,887,58.85,1.8,39.35,2019
"3727883",793,48,316,1157,68.54,4.15,27.31,2019
"3727909",11615,370,2731,14716,78.93,2.51,18.56,2019
"3727932",3621,273,1307,5201,69.62,5.25,25.13,2019
"3727941",120,61,11,192,62.5,31.77,5.73,2019
"3727960",232,0,85,317,73.19,0,26.81,2019
"3727967",30,18,45,93,32.26,19.35,48.39,2019
"3727972",43,0,0,43,100,0,0,2019
"3727976",1397,11,87,1495,93.44,0.74,5.82,2019
"3727045",2929,65,787,3781,77.47,1.72,20.81,2019
"3727009",895,8,127,1030,86.89,0.78,12.33,2019
"3727028",8140,179,1844,10163,80.09,1.76,18.14,2019
"3727054",841,39,115,995,84.52,3.92,11.56,2019
"3727127",13184,321,1958,15463,85.26,2.08,12.66,2019
"3727208",460,0,181,641,71.76,0,28.24,2019
"3727215",14656,792,2961,18409,79.61,4.3,16.08,2019
"3727217",9409,499,3796,13704,68.66,3.64,27.7,2019
"3727235",1523,105,186,1814,83.96,5.79,10.25,2019
"3727214",3032,261,708,4001,75.78,6.52,17.7,2019
"3727244",4243,117,711,5071,83.67,2.31,14.02,2019
"3727263",6766,326,1625,8717,77.62,3.74,18.64,2019
"3727278",9194,136,1166,10496,87.6,1.3,11.11,2019
"3727288",7030,454,2457,9941,70.72,4.57,24.72,2019
"3727291",462,0,130,592,78.04,0,21.96,2019
"3727301",2675,309,350,3334,80.23,9.27,10.5,2019
"3727302",9980,441,1464,11885,83.97,3.71,12.32,2019
"3727313",2237,48,359,2644,84.61,1.82,13.58,2019
"3727343",523,0,118,641,81.59,0,18.41,2019
"3727350",2048,71,457,2576,79.5,2.76,17.74,2019
"3727370",4501,207,969,5677,79.28,3.65,17.07,2019
"3727379",1233,54,829,2116,58.27,2.55,39.18,2019
"4217244",644,22,163,829,77.68,2.65,19.66,2019
"4217870",4513,97,978,5588,80.76,1.74,17.5,2019
"4217920",116,0,42,158,73.42,0,26.58,2019
"4217925",99,3,33,135,73.33,2.22,24.44,2019
"4217551",3578,376,370,4324,82.75,8.7,8.56,2019
"4217552",7284,241,842,8367,87.06,2.88,10.06,2019
"4217570",37,0,13,50,74,0,26,2019
"4217576",68,0,0,68,100,0,0,2019
"4217730",50,0,54,104,48.08,0,51.92,2019
"4217749",106,1,10,117,90.6,0.85,8.55,2019
"4217750",53,15,0,68,77.94,22.06,0,2019
"4217754",4135,95,637,4867,84.96,1.95,13.09,2019
"4217756",3331,193,773,4297,77.52,4.49,17.99,2019
"4217768",104,0,45,149,69.8,0,30.2,2019
"4217774",406,37,91,534,76.03,6.93,17.04,2019
"4217815",9228,348,1658,11234,82.14,3.1,14.76,2019
"4217827",201,13,51,265,75.85,4.91,19.25,2019
"4217837",5070,219,1303,6592,76.91,3.32,19.77,2019
"4217846",1243,31,272,1546,80.4,2.01,17.59,2019
"4217847",3696,84,932,4712,78.44,1.78,19.78,2019
"4217853",803,11,367,1181,67.99,0.93,31.08,2019
"4217878",420,19,87,526,79.85,3.61,16.54,2019
"4217884",66,0,21,87,75.86,0,24.14,2019
"4217888",90,6,33,129,69.77,4.65,25.58,2019
"4217945",74,2,15,91,81.32,2.2,16.48,2019
"4217339",2539,24,308,2871,88.44,0.84,10.73,2019
"4217406",7824,175,1171,9170,85.32,1.91,12.77,2019
"4217502",892,10,135,1037,86.02,0.96,13.02,2019
"4217532",934,10,173,1117,83.62,0.9,15.49,2019
"4217540",2543,227,838,3608,70.48,6.29,23.23,2019
"4217543",14776,665,2177,17618,83.87,3.77,12.36,2019
"4217584",3372,174,424,3970,84.94,4.38,10.68,2019
"4217701",13693,925,3077,17695,77.38,5.23,17.39,2019
"4217702",3495,191,682,4368,80.01,4.37,15.61,2019
"4217724",1404,62,440,1906,73.66,3.25,23.08,2019
"4217728",1639,50,380,2069,79.22,2.42,18.37,2019
"4217729",22,0,10,32,68.75,0,31.25,2019
"4217771",1006,34,244,1284,78.35,2.65,19,2019
"4217813",609,13,145,767,79.4,1.69,18.9,2019
"4217842",2522,46,737,3305,76.31,1.39,22.3,2019
"4217850",177,22,98,297,59.6,7.41,33,2019
"4217856",1033,52,93,1178,87.69,4.41,7.89,2019
"4217857",2357,86,639,3082,76.48,2.79,20.73,2019
"4217864",451,3,253,707,63.79,0.42,35.79,2019
"4217867",38,0,22,60,63.33,0,36.67,2019
"4217901",7164,320,2345,9829,72.89,3.26,23.86,2019
"4217930",132,2,46,180,73.33,1.11,25.56,2019
"4217949",67,0,18,85,78.82,0,21.18,2019
"4217954",1596,0,407,2003,79.68,0,20.32,2019
"4217970",1016,36,349,1401,72.52,2.57,24.91,2019
"4217936",224,4,76,304,73.68,1.32,25,2019
"4217944",43,0,4,47,91.49,0,8.51,2019
"4217952",80,0,50,130,61.54,0,38.46,2019
"4217982",165,3,54,222,74.32,1.35,24.32,2019
"4217983",554,0,90,644,86.02,0,13.98,2019
"4217946",26,0,31,57,45.61,0,54.39,2019
"4217957",80,0,52,132,60.61,0,39.39,2019
"4217968",61,0,30,91,67.03,0,32.97,2019
"4217003",3542,100,613,4255,83.24,2.35,14.41,2019
"1019807",2939,39,174,3152,93.24,1.24,5.52,2019
"4217254",0,0,39,39,0,0,100,2019
"4217255",345,12,90,447,77.18,2.68,20.13,2019
"4217257",8537,614,1939,11090,76.98,5.54,17.48,2019
"4217262",365,0,137,502,72.71,0,27.29,2019
"4217304",867,7,190,1064,81.48,0.66,17.86,2019
"4217307",1736,101,365,2202,78.84,4.59,16.58,2019
"4217317",178,3,50,231,77.06,1.3,21.65,2019
"4217325",8675,242,1771,10688,81.17,2.26,16.57,2019
"4217344",1087,65,400,1552,70.04,4.19,25.77,2019
"4217345",2676,110,688,3474,77.03,3.17,19.8,2019
"4217352",414,0,93,507,81.66,0,18.34,2019
"4217004",900,67,748,1715,52.48,3.91,43.62,2019
"4217080",88,3,27,118,74.58,2.54,22.88,2019
"4217084",1421,23,374,1818,78.16,1.27,20.57,2019
"4217360",2205,57,334,2596,84.94,2.2,12.87,2019
"4217361",2158,32,403,2593,83.22,1.23,15.54,2019
"4217366",1745,31,334,2110,82.7,1.47,15.83,2019
"4217370",1820,143,253,2216,82.13,6.45,11.42,2019
"4217545",6521,265,1377,8163,79.88,3.25,16.87,2019
"4217562",880,50,469,1399,62.9,3.57,33.52,2019
"4217566",3062,70,995,4127,74.19,1.7,24.11,2019
"4217603",20368,1488,3398,25254,80.65,5.89,13.46,2019
"4217737",2084,129,398,2611,79.82,4.94,15.24,2019
"4217016",310,0,45,355,87.32,0,12.68,2019
"4217019",5916,163,902,6981,84.74,2.33,12.92,2019
"4217024",565,32,108,705,80.14,4.54,15.32,2019
"4217027",113,0,0,113,100,0,0,2019
"4217034",810,48,246,1104,73.37,4.35,22.28,2019
"4217041",120,0,0,120,100,0,0,2019
"4217086",670,12,172,854,78.45,1.41,20.14,2019
"4217088",252,58,40,350,72,16.57,11.43,2019
"4217109",8417,217,2037,10671,78.88,2.03,19.09,2019
"4217201",8581,268,2131,10980,78.15,2.44,19.41,2019
"4217021",265,0,121,386,68.65,0,31.35,2019
"4217038",2520,83,518,3121,80.74,2.66,16.6,2019
"4217049",862,0,227,1089,79.16,0,20.84,2019
"4217057",7734,297,1694,9725,79.53,3.05,17.42,2019
"4217058",525,0,154,679,77.32,0,22.68,2019
"4217060",365,4,91,460,79.35,0.87,19.78,2019
"4217076",13,0,0,13,100,0,0,2019
"4217081",213,0,30,243,87.65,0,12.35,2019
"4218415",466,10,105,581,80.21,1.72,18.07,2019
"4218417",342,17,38,397,86.15,4.28,9.57,2019
"4218424",1710,49,230,1989,85.97,2.46,11.56,2019
"4218434",1016,17,598,1631,62.29,1.04,36.66,2019
"4218436",3952,40,895,4887,80.87,0.82,18.31,2019
"4218438",501,26,76,603,83.08,4.31,12.6,2019
"4218453",320,12,78,410,78.05,2.93,19.02,2019
"4218350",560,19,107,686,81.63,2.77,15.6,2019
"4218643",4228,94,907,5229,80.86,1.8,17.35,2019
"4218701",533,52,385,970,54.95,5.36,39.69,2019
"4218810",1959,38,498,2495,78.52,1.52,19.96,2019
"4218818",450,22,88,560,80.36,3.93,15.71,2019
"4218915",284,0,0,284,100,0,0,2019
"4218920",113,0,10,123,91.87,0,8.13,2019
"4218929",3102,15,95,3212,96.58,0.47,2.96,2019
"4218960",4052,111,532,4695,86.3,2.36,11.33,2019
"4218966",13114,130,1151,14395,91.1,0.9,8,2019
"2421218",13993,924,3442,18359,76.22,5.03,18.75,2019
"1019809",5191,365,474,6030,86.09,6.05,7.86,2019
"1019810",8713,418,649,9780,89.09,4.27,6.64,2019
"1019938",2652,55,416,3123,84.92,1.76,13.32,2019
"1019940",1660,30,516,2206,75.25,1.36,23.39,2019
"2420880",225,8,5,238,94.54,3.36,2.1,2019
"2420903",6370,304,837,7511,84.81,4.05,11.14,2019
"5120197",733,15,0,748,97.99,2.01,0,2019
"1120008",14411,376,1022,15809,91.16,2.38,6.46,2019
"1120009",25014,530,2164,27708,90.28,1.91,7.81,2019
"2420611",380,17,154,551,68.97,3.09,27.95,2019
"2420616",1945,13,387,2345,82.94,0.55,16.5,2019
"2420619",5073,90,323,5486,92.47,1.64,5.89,2019
"2420620",372,82,94,548,67.88,14.96,17.15,2019
"2420629",127,0,12,139,91.37,0,8.63,2019
"2420640",3084,73,531,3688,83.62,1.98,14.4,2019
"2420678",3694,69,518,4281,86.29,1.61,12.1,2019
"2420688",732,25,81,838,87.35,2.98,9.67,2019
"2420705",7996,346,924,9266,86.29,3.73,9.97,2019
"2420714",1745,79,159,1983,88,3.98,8.02,2019
"2420733",901,0,134,1035,87.05,0,12.95,2019
"2420736",2766,103,130,2999,92.23,3.43,4.33,2019
"2420744",16756,340,1254,18350,91.31,1.85,6.83,2019
"2420747",12253,603,2211,15067,81.32,4,14.67,2019
"2420772",14946,260,1042,16248,91.99,1.6,6.41,2019
"1120003",12611,172,756,13539,93.15,1.27,5.58,2019
"1120004",1157,41,66,1264,91.53,3.24,5.22,2019
"1120005",6481,233,873,7587,85.42,3.07,11.51,2019
"1120016",12388,164,468,13020,95.15,1.26,3.59,2019
"5120111",9366,246,592,10204,91.79,2.41,5.8,2019
"5120115",2258,76,172,2506,90.1,3.03,6.86,2019
"5120169",7749,86,77,7912,97.94,1.09,0.97,2019
"5120176",16310,452,609,17371,93.89,2.6,3.51,2019
"1120319",0,0,0,0,NA,NA,NA,2019
"2420622",1427,65,305,1797,79.41,3.62,16.97,2019
"2420634",2139,118,191,2448,87.38,4.82,7.8,2019
"2420658",216,15,66,297,72.73,5.05,22.22,2019
"2420685",2315,14,55,2384,97.11,0.59,2.31,2019
"2420701",62,0,0,62,100,0,0,2019
"2420724",6260,61,427,6748,92.77,0.9,6.33,2019
"2420740",8174,667,791,9632,84.86,6.92,8.21,2019
"2420748",12527,540,1681,14748,84.94,3.66,11.4,2019
"2420817",12648,175,417,13240,95.53,1.32,3.15,2019
"2420854",16159,163,333,16655,97.02,0.98,2,2019
"2420868",211,0,0,211,100,0,0,2019
"2420901",11372,104,890,12366,91.96,0.84,7.2,2019
"2420910",18757,399,1360,20516,91.43,1.94,6.63,2019
"1120019",15069,1901,7148,24118,62.48,7.88,29.64,2019
"1120017",6122,240,1348,7710,79.4,3.11,17.48,2019
"5120109",12116,302,1045,13463,89.99,2.24,7.76,2019
"5120137",496,5,21,522,95.02,0.96,4.02,2019
"5120139",83,17,0,100,83,17,0,2019
"5120141",2185,58,143,2386,91.58,2.43,5.99,2019
"5120147",21339,428,506,22273,95.81,1.92,2.27,2019
"5120158",1378,24,54,1456,94.64,1.65,3.71,2019
"5120187",5765,46,215,6026,95.67,0.76,3.57,2019
"1120007",11239,291,274,11804,95.21,2.47,2.32,2019
"1120018",6459,121,1492,8072,80.02,1.5,18.48,2019
"1120037",5663,240,241,6144,92.17,3.91,3.92,2019
"5124579",328,0,135,463,70.84,0,29.16,2019
"2421403",11638,377,1214,13229,87.97,2.85,9.18,2019
"2421405",151,0,9,160,94.38,0,5.62,2019
"2421162",1205,20,109,1334,90.33,1.5,8.17,2019
"2421128",4634,92,446,5172,89.6,1.78,8.62,2019
"2421155",839,22,103,964,87.03,2.28,10.68,2019
"2421157",11647,350,2002,13999,83.2,2.5,14.3,2019
"2421214",6956,183,718,7857,88.53,2.33,9.14,2019
"2421223",5644,263,2305,8212,68.73,3.2,28.07,2019
"2421224",15550,625,2872,19047,81.64,3.28,15.08,2019
"2421226",1881,50,386,2317,81.18,2.16,16.66,2019
"2421230",12839,243,1725,14807,86.71,1.64,11.65,2019
"2421237",9774,301,1351,11426,85.54,2.63,11.82,2019
"2421402",271,0,19,290,93.45,0,6.55,2019
"2421524",205,0,77,282,72.7,0,27.3,2019
"2421530",482,13,272,767,62.84,1.69,35.46,2019
"2421536",1192,57,360,1609,74.08,3.54,22.37,2019
"2421539",761,3,208,972,78.29,0.31,21.4,2019
"2421541",629,34,81,744,84.54,4.57,10.89,2019
"2421612",152,0,17,169,89.94,0,10.06,2019
"2421619",2333,20,229,2582,90.36,0.77,8.87,2019
"2421620",3900,177,1009,5086,76.68,3.48,19.84,2019
"2421634",85,0,33,118,72.03,0,27.97,2019
"2421635",687,22,144,853,80.54,2.58,16.88,2019
"2421648",57,0,24,81,70.37,0,29.63,2019
"2421650",79,0,9,88,89.77,0,10.23,2019
"2421651",935,16,220,1171,79.85,1.37,18.79,2019
"2421653",60,0,6,66,90.91,0,9.09,2019
"2421659",422,1,89,512,82.42,0.2,17.38,2019
"2421664",165,4,21,190,86.84,2.11,11.05,2019
"2421665",83,0,0,83,100,0,0,2019
"2421673",1160,35,217,1412,82.15,2.48,15.37,2019
"2421676",169,0,13,182,92.86,0,7.14,2019
"2421710",1565,34,267,1866,83.87,1.82,14.31,2019
"2421737",637,4,35,676,94.23,0.59,5.18,2019
"2421742",10834,326,1972,13132,82.5,2.48,15.02,2019
"2421005",707,7,36,750,94.27,0.93,4.8,2019
"2421015",9570,133,666,10369,92.29,1.28,6.42,2019
"2421043",15909,108,864,16881,94.24,0.64,5.12,2019
"2421053",994,16,98,1108,89.71,1.44,8.84,2019
"2421076",6595,173,171,6939,95.04,2.49,2.46,2019
"2421084",2435,28,183,2646,92.03,1.06,6.92,2019
"2421113",13100,150,594,13844,94.63,1.08,4.29,2019
"2421136",11717,171,1032,12920,90.69,1.32,7.99,2019
"2421144",10788,239,791,11818,91.28,2.02,6.69,2019
"2421152",2118,49,75,2242,94.47,2.19,3.35,2019
"2421210",4719,174,261,5154,91.56,3.38,5.06,2019
"2421239",9732,284,1949,11965,81.34,2.37,16.29,2019
"2421523",71,0,21,92,77.17,0,22.83,2019
"2421529",132,25,49,206,64.08,12.14,23.79,2019
"2421532",4373,99,768,5240,83.45,1.89,14.66,2019
"2421601",9118,137,1366,10621,85.85,1.29,12.86,2019
"2421613",5525,183,1491,7199,76.75,2.54,20.71,2019
"2421701",13472,507,1453,15432,87.3,3.29,9.42,2019
"2421702",14341,505,1195,16041,89.4,3.15,7.45,2019
"2421704",4874,52,395,5321,91.6,0.98,7.42,2019
"2421716",1651,59,154,1864,88.57,3.17,8.26,2019
"2421722",1490,37,525,2052,72.61,1.8,25.58,2019
"2421727",1500,22,370,1892,79.28,1.16,19.56,2019
"5123435",10067,385,931,11383,88.44,3.38,8.18,2019
"5124595",58,0,0,58,100,0,0,2019
"5124599",124,0,253,377,32.89,0,67.11,2019
"5424724",27,2,2,31,87.1,6.45,6.45,2019
"5424731",24,27,29,80,30,33.75,36.25,2019
"5424736",182,14,78,274,66.42,5.11,28.47,2019
"5424813",28,0,36,64,43.75,0,56.25,2019
"5424862",212,22,73,307,69.06,7.17,23.78,2019
"5424898",27,0,0,27,100,0,0,2019
"5424946",384,1,88,473,81.18,0.21,18.6,2019
"5424957",39,0,34,73,53.42,0,46.58,2019
"5124606",38,8,34,80,47.5,10,42.5,2019
"5124607",69,8,35,112,61.61,7.14,31.25,2019
"5124614",2095,133,646,2874,72.89,4.63,22.48,2019
"5124628",68,0,28,96,70.83,0,29.17,2019
"5124656",693,13,453,1159,59.79,1.12,39.09,2019
"5424715",111,6,59,176,63.07,3.41,33.52,2019
"5424726",171,0,107,278,61.51,0,38.49,2019
"5424846",15,0,0,15,100,0,0,2019
"5424849",60,0,32,92,65.22,0,34.78,2019
"5424850",134,12,144,290,46.21,4.14,49.66,2019
"5424854",23,0,64,87,26.44,0,73.56,2019
"5424882",85,0,43,128,66.41,0,33.59,2019
"5424887",10,0,0,10,100,0,0,2019
"5424924",133,0,47,180,73.89,0,26.11,2019
"5424935",122,0,101,223,54.71,0,45.29,2019
"5424941",260,14,74,348,74.71,4.02,21.26,2019
"5424951",531,0,82,613,86.62,0,13.38,2019
"5424974",66,0,93,159,41.51,0,58.49,2019
"5424983",535,40,465,1040,51.44,3.85,44.71,2019
"5124165",350,5,202,557,62.84,0.9,36.27,2019
"5124225",252,12,417,681,37,1.76,61.23,2019
"5124236",893,7,339,1239,72.07,0.56,27.36,2019
"5124245",228,23,98,349,65.33,6.59,28.08,2019
"5124266",2521,75,1006,3602,69.99,2.08,27.93,2019
"5124272",163,0,109,272,59.93,0,40.07,2019
"5124277",1195,257,908,2360,50.64,10.89,38.47,2019
"5124311",545,56,161,762,71.52,7.35,21.13,2019
"5124343",2793,35,959,3787,73.75,0.92,25.32,2019
"5124401",11696,786,2988,15470,75.6,5.08,19.31,2019
"5124448",74,8,27,109,67.89,7.34,24.77,2019
"5124471",642,0,101,743,86.41,0,13.59,2019
"5124168",98,0,48,146,67.12,0,32.88,2019
"5124174",621,41,525,1187,52.32,3.45,44.23,2019
"5124210",5268,292,1553,7113,74.06,4.11,21.83,2019
"5124221",134,0,105,239,56.07,0,43.93,2019
"5124226",341,52,197,590,57.8,8.81,33.39,2019
"5124243",525,64,114,703,74.68,9.1,16.22,2019
"5124244",1259,58,717,2034,61.9,2.85,35.25,2019
"5124251",2352,130,850,3332,70.59,3.9,25.51,2019
"5124415",0,0,0,0,NA,NA,NA,2019
"5124422",1745,67,780,2592,67.32,2.58,30.09,2019
"5124093",40,0,2,42,95.24,0,4.76,2019
"5124137",892,43,246,1181,75.53,3.64,20.83,2019
"5124148",2528,96,778,3402,74.31,2.82,22.87,2019
"5124202",3802,20,1088,4910,77.43,0.41,22.16,2019
"5424934",108,3,65,176,61.36,1.7,36.93,2019
"5424945",107,0,77,184,58.15,0,41.85,2019
"5424966",354,61,197,612,57.84,9.97,32.19,2019
"5426590",177,0,85,262,67.56,0,32.44,2019
"5123480",168,0,43,211,79.62,0,20.38,2019
"5123661",4277,235,772,5284,80.94,4.45,14.61,2019
"5123662",3979,108,494,4581,86.86,2.36,10.78,2019
"5123664",3626,44,348,4018,90.24,1.1,8.66,2019
"5123665",1357,15,35,1407,96.45,1.07,2.49,2019
"5123691",35,0,0,35,100,0,0,2019
"5123503",12009,414,1199,13622,88.16,3.04,8.8,2019
"5123507",3110,33,187,3330,93.39,0.99,5.62,2019
"5123508",5493,220,476,6189,88.75,3.55,7.69,2019
"5123518",10257,434,1305,11996,85.5,3.62,10.88,2019
"5123603",945,222,108,1275,74.12,17.41,8.47,2019
"5123604",707,114,13,834,84.77,13.67,1.56,2019
"5123605",3950,756,1370,6076,65.01,12.44,22.55,2019
"5123663",4090,230,770,5090,80.35,4.52,15.13,2019
"5123701",7229,219,1647,9095,79.48,2.41,18.11,2019
"5123805",5884,197,1421,7502,78.43,2.63,18.94,2019
"5123828",92,0,35,127,72.44,0,27.56,2019
"5123837",1327,62,387,1776,74.72,3.49,21.79,2019
"5123842",1852,46,499,2397,77.26,1.92,20.82,2019
"5123857",220,0,124,344,63.95,0,36.05,2019
"5123881",553,56,236,845,65.44,6.63,27.93,2019
"5123924",1212,91,951,2254,53.77,4.04,42.19,2019
"5123938",77,0,41,118,65.25,0,34.75,2019
"5123005",5198,157,1023,6378,81.5,2.46,16.04,2019
"5123025",39,0,47,86,45.35,0,54.65,2019
"5123027",267,0,293,560,47.68,0,52.32,2019
"5123039",350,6,64,420,83.33,1.43,15.24,2019
"5123061",6911,316,996,8223,84.04,3.84,12.11,2019
"5123075",2626,48,972,3646,72.02,1.32,26.66,2019
"5123867",591,112,263,966,61.18,11.59,27.23,2019
"5123878",351,0,134,485,72.37,0,27.63,2019
"5123879",124,0,95,219,56.62,0,43.38,2019
"5123885",687,9,184,880,78.07,1.02,20.91,2019
"5123887",100,0,15,115,86.96,0,13.04,2019
"5123915",169,0,85,254,66.54,0,33.46,2019
"5123942",443,20,114,577,76.78,3.47,19.76,2019
"5123959",324,17,149,490,66.12,3.47,30.41,2019
"5123964",314,47,199,560,56.07,8.39,35.54,2019
"5123967",229,9,215,453,50.55,1.99,47.46,2019
"5123462",22970,560,2386,25916,88.63,2.16,9.21,2019
"5123464",24676,692,2155,27523,89.66,2.51,7.83,2019
"5123116",9649,192,799,10640,90.69,1.8,7.51,2019
"5123123",460,88,265,813,56.58,10.82,32.6,2019
"5123141",2204,163,316,2683,82.15,6.08,11.78,2019
"5123169",318,30,81,429,74.13,6.99,18.88,2019
"5123176",148,26,9,183,80.87,14.21,4.92,2019
"5123177",181,0,90,271,66.79,0,33.21,2019
"5123185",15277,870,1537,17684,86.39,4.92,8.69,2019
"5123224",10254,666,3014,13934,73.59,4.78,21.63,2019
"5123227",8903,340,2534,11777,75.6,2.89,21.52,2019
"5123231",10968,349,2611,13928,78.75,2.51,18.75,2019
"5123235",12090,230,837,13157,91.89,1.75,6.36,2019
"5123304",18,0,0,18,100,0,0,2019
"5123306",282,19,57,358,78.77,5.31,15.92,2019
"5123316",116,7,77,200,58,3.5,38.5,2019
"5123320",20811,396,1813,23020,90.4,1.72,7.88,2019
"5123324",6760,200,1408,8368,80.78,2.39,16.83,2019
"5123354",63,0,27,90,70,0,30,2019
"5426656",80,0,37,117,68.38,0,31.62,2019
"5426711",949,48,144,1141,83.17,4.21,12.62,2019
"5426767",235,0,31,266,88.35,0,11.65,2019
"5426810",112,0,38,150,74.67,0,25.33,2019
"5426040",551,25,199,775,71.1,3.23,25.68,2019
"5426041",4350,274,1783,6407,67.89,4.28,27.83,2019
"5426060",525,95,102,722,72.71,13.16,14.13,2019
"5426070",2753,160,929,3842,71.66,4.16,24.18,2019
"5426074",152,27,34,213,71.36,12.68,15.96,2019
"5426422",154,17,58,229,67.25,7.42,25.33,2019
"5426431",1801,53,486,2340,76.97,2.26,20.77,2019
"5426436",50,0,13,63,79.37,0,20.63,2019
"5426501",7386,148,1068,8602,85.86,1.72,12.42,2019
"5426505",13420,645,1119,15184,88.38,4.25,7.37,2019
"5426534",675,26,119,820,82.32,3.17,14.51,2019
"5426547",912,7,136,1055,86.45,0.66,12.89,2019
"5426575",150,0,155,305,49.18,0,50.82,2019
"5426582",1195,21,499,1715,69.68,1.22,29.1,2019
"5426610",337,0,60,397,84.89,0,15.11,2019
"5426615",11,0,12,23,47.83,0,52.17,2019
"5426617",15,0,0,15,100,0,0,2019
"5426691",69,26,37,132,52.27,19.7,28.03,2019
"5426763",393,0,203,596,65.94,0,34.06,2019
"5426812",551,0,116,667,82.61,0,17.39,2019
"5426815",149,6,169,324,45.99,1.85,52.16,2019
"5426845",289,0,46,335,86.27,0,13.73,2019
"5426301",9078,347,2326,11751,77.25,2.95,19.79,2019
"5426369",266,0,12,278,95.68,0,4.32,2019
"5426386",695,21,260,976,71.21,2.15,26.64,2019
"5426410",339,9,46,394,86.04,2.28,11.68,2019
"5426421",34,1,18,53,64.15,1.89,33.96,2019
"5426444",1017,30,360,1407,72.28,2.13,25.59,2019
"5426451",241,6,25,272,88.6,2.21,9.19,2019
"5426456",952,91,379,1422,66.95,6.4,26.65,2019
"5426508",10625,461,1183,12269,86.6,3.76,9.64,2019
"5426542",803,17,178,998,80.46,1.7,17.84,2019
"5426543",85,23,0,108,78.7,21.3,0,2019
"5426568",197,0,92,289,68.17,0,31.83,2019
"5426571",695,0,148,843,82.44,0,17.56,2019
"5426572",59,13,0,72,81.94,18.06,0,2019
"5426761",123,0,54,177,69.49,0,30.51,2019
"5426764",1276,48,376,1700,75.06,2.82,22.12,2019
"5426817",86,0,62,148,58.11,0,41.89,2019
"5426865",78,0,26,104,75,0,25,2019
"5426636",164,0,27,191,85.86,0,14.14,2019
"5426638",12,0,39,51,23.53,0,76.47,2019
"5426660",137,0,24,161,85.09,0,14.91,2019
"5426720",30,0,6,36,83.33,0,16.67,2019
"5426755",256,10,95,361,70.91,2.77,26.32,2019
"5426802",251,30,191,472,53.18,6.36,40.47,2019
"5426847",1927,27,699,2653,72.63,1.02,26.35,2019
"5426055",296,27,125,448,66.07,6.03,27.9,2019
"5426133",463,3,92,558,82.97,0.54,16.49,2019
"5426137",197,0,76,273,72.16,0,27.84,2019
"5426142",898,14,80,992,90.52,1.41,8.06,2019
"5426147",591,27,215,833,70.95,3.24,25.81,2019
"5426175",939,43,310,1292,72.68,3.33,23.99,2019
"5426202",150,0,92,242,61.98,0,38.02,2019
"4217007",2147,99,134,2380,90.21,4.16,5.63,2019
"4217013",11768,237,1995,14000,84.06,1.69,14.25,2019
"4217018",1524,5,205,1734,87.89,0.29,11.82,2019
"4217023",1110,27,201,1338,82.96,2.02,15.02,2019
"4217026",1225,80,238,1543,79.39,5.18,15.42,2019
"4217037",214,10,126,350,61.14,2.86,36,2019
"4217045",973,24,268,1265,76.92,1.9,21.19,2019
"4217066",1747,88,500,2335,74.82,3.77,21.41,2019
"4217070",5989,211,787,6987,85.72,3.02,11.26,2019
"4217077",37,0,0,37,100,0,0,2019
"4217229",363,27,154,544,66.73,4.96,28.31,2019
"4217235",238,0,68,306,77.78,0,22.22,2019
"4217241",3615,116,955,4686,77.14,2.48,20.38,2019
"4217264",742,19,214,975,76.1,1.95,21.95,2019
"4217270",43,0,0,43,100,0,0,2019
"4217306",86,0,12,98,87.76,0,12.24,2019
"4217331",17098,518,3243,20859,81.97,2.48,15.55,2019
"4217350",4024,225,837,5086,79.12,4.42,16.46,2019
"4217362",4270,98,702,5070,84.22,1.93,13.85,2019
"4217363",3190,81,368,3639,87.66,2.23,10.11,2019
"4217368",2493,169,381,3043,81.93,5.55,12.52,2019
"4217402",11742,275,1754,13771,85.27,2,12.74,2019
"4217407",728,18,69,815,89.33,2.21,8.47,2019
"4217508",149,14,35,198,75.25,7.07,17.68,2019
"4217527",1235,83,527,1845,66.94,4.5,28.56,2019
"4217529",784,45,595,1424,55.06,3.16,41.78,2019
"4217560",1410,0,446,1856,75.97,0,24.03,2019
"4217578",2089,63,566,2718,76.86,2.32,20.82,2019
"4217581",214,26,25,265,80.75,9.81,9.43,2019
"4217731",103,4,14,121,85.12,3.31,11.57,2019
"4217747",701,45,334,1080,64.91,4.17,30.93,2019
"4217767",35,0,25,60,58.33,0,41.67,2019
"4217777",2319,30,615,2964,78.24,1.01,20.75,2019
"4217778",53,0,0,53,100,0,0,2019
"4217824",1248,68,434,1750,71.31,3.89,24.8,2019
"4217881",462,34,125,621,74.4,5.48,20.13,2019
"4217931",1553,35,503,2091,74.27,1.67,24.06,2019
"4217951",83,0,21,104,79.81,0,20.19,2019
"4217963",2946,53,629,3628,81.2,1.46,17.34,2019
"4217979",92,0,17,109,84.4,0,15.6,2019
"4217356",6998,125,1116,8239,84.94,1.52,13.55,2019
"4217364",1159,8,188,1355,85.54,0.59,13.87,2019
"4217372",1248,36,206,1490,83.76,2.42,13.83,2019
"4217401",4296,319,1669,6284,68.36,5.08,26.56,2019
"4217404",11429,402,2165,13996,81.66,2.87,15.47,2019
"4217536",527,23,316,866,60.85,2.66,36.49,2019
"4217547",2362,103,288,2753,85.8,3.74,10.46,2019
"4217097",284,3,50,337,84.27,0.89,14.84,2019
"4217099",390,55,66,511,76.32,10.76,12.92,2019
"4217112",12560,274,1425,14259,88.08,1.92,9.99,2019
"4217219",72,5,54,131,54.96,3.82,41.22,2019
"4217238",440,26,175,641,68.64,4.06,27.3,2019
"4217243",393,3,151,547,71.85,0.55,27.61,2019
"4217266",136,0,49,185,73.51,0,26.49,2019
"4217267",834,19,281,1134,73.54,1.68,24.78,2019
"4217316",2718,81,273,3072,88.48,2.64,8.89,2019
"4217318",170,18,0,188,90.43,9.57,0,2019
"4217320",2729,31,301,3061,89.15,1.01,9.83,2019
"4217322",1719,90,385,2194,78.35,4.1,17.55,2019
"5120118",0,0,1,1,0,0,100,2019
"5120119",1097,27,280,1404,78.13,1.92,19.94,2019
"5120130",106,7,25,138,76.81,5.07,18.12,2019
"5120132",5149,67,429,5645,91.21,1.19,7.6,2019
"5120152",10589,183,117,10889,97.24,1.68,1.07,2019
"5120155",10960,270,350,11580,94.65,2.33,3.02,2019
"2420615",198,0,0,198,100,0,0,2019
"2420646",6536,98,907,7541,86.67,1.3,12.03,2019
"2420657",6300,69,590,6959,90.53,0.99,8.48,2019
"2420664",887,0,353,1240,71.53,0,28.47,2019
"2420690",220,17,122,359,61.28,4.74,33.98,2019
"2420722",1501,50,253,1804,83.2,2.77,14.02,2019
"2420745",8701,318,1657,10676,81.5,2.98,15.52,2019
"2420751",782,0,68,850,92,0,8,2019
"2420763",632,29,82,743,85.06,3.9,11.04,2019
"2420776",1125,14,72,1211,92.9,1.16,5.95,2019
"2420778",700,9,42,751,93.21,1.2,5.59,2019
"2420812",97,0,4,101,96.04,0,3.96,2019
"2420816",5818,70,164,6052,96.13,1.16,2.71,2019
"2420852",19336,401,884,20621,93.77,1.94,4.29,2019
"2420861",491,0,47,538,91.26,0,8.74,2019
"2420871",5470,133,152,5755,95.05,2.31,2.64,2019
"1120001",17333,460,2354,20147,86.03,2.28,11.68,2019
"1120020",15017,1058,5405,21480,69.91,4.93,25.16,2019
"5120105",7180,61,272,7513,95.57,0.81,3.62,2019
"5120166",4198,63,48,4309,97.42,1.46,1.11,2019
"5120175",11336,186,512,12034,94.2,1.55,4.25,2019
"5120186",4997,94,460,5551,90.02,1.69,8.29,2019
"5120191",11047,176,384,11607,95.18,1.52,3.31,2019
"5120194",5334,52,60,5446,97.94,0.95,1.1,2019
"2420601",8118,173,633,8924,90.97,1.94,7.09,2019
"2420626",154,0,30,184,83.7,0,16.3,2019
"2420650",4366,132,835,5333,81.87,2.48,15.66,2019
"2420662",652,13,409,1074,60.71,1.21,38.08,2019
"2420667",151,0,70,221,68.33,0,31.67,2019
"2420680",271,20,32,323,83.9,6.19,9.91,2019
"2420692",281,0,41,322,87.27,0,12.73,2019
"2420715",8741,39,300,9080,96.27,0.43,3.3,2019
"2420716",8122,243,418,8783,92.47,2.77,4.76,2019
"2420721",9100,261,222,9583,94.96,2.72,2.32,2019
"2420732",3366,12,315,3693,91.15,0.32,8.53,2019
"2420735",11195,337,741,12273,91.22,2.75,6.04,2019
"2420743",11401,554,2494,14449,78.91,3.83,17.26,2019
"2420815",12118,216,610,12944,93.62,1.67,4.71,2019
"2420842",604,17,57,678,89.09,2.51,8.41,2019
"2420850",19406,425,805,20636,94.04,2.06,3.9,2019
"2420862",106,12,0,118,89.83,10.17,0,2019
"2420866",4571,104,190,4865,93.96,2.14,3.91,2019
"2420874",20417,324,928,21669,94.22,1.5,4.28,2019
"2420876",8978,187,408,9573,93.78,1.95,4.26,2019
"2420878",21408,251,745,22404,95.55,1.12,3.33,2019
"2420882",4258,64,200,4522,94.16,1.42,4.42,2019
"1120032",10683,594,3874,15151,70.51,3.92,25.57,2019
"1120036",3632,144,166,3942,92.14,3.65,4.21,2019
"5120117",878,60,125,1063,82.6,5.64,11.76,2019
"2420794",3974,13,324,4311,92.18,0.3,7.52,2019
"2420814",12645,270,478,13393,94.41,2.02,3.57,2019
"2420838",88,0,9,97,90.72,0,9.28,2019
"2420877",10704,446,1650,12800,83.62,3.48,12.89,2019
"5424991",174,0,101,275,63.27,0,36.73,2019
"5122476",35,12,72,119,29.41,10.08,60.5,2019
"5122529",16,0,73,89,17.98,0,82.02,2019
"5122542",444,123,180,747,59.44,16.47,24.1,2019
"5122620",809,69,153,1031,78.47,6.69,14.84,2019
"5122625",1277,0,55,1332,95.87,0,4.13,2019
"5122637",659,16,191,866,76.1,1.85,22.06,2019
"5122650",224,0,55,279,80.29,0,19.71,2019
"5122655",6752,384,669,7805,86.51,4.92,8.57,2019
"5122548",103,0,0,103,100,0,0,2019
"5122514",582,9,301,892,65.25,1.01,33.74,2019
"5122534",797,26,202,1025,77.76,2.54,19.71,2019
"5122535",131,8,75,214,61.21,3.74,35.05,2019
"5122640",132,0,67,199,66.33,0,33.67,2019
"5122642",1734,60,50,1844,94.03,3.25,2.71,2019
"5122652",503,40,92,635,79.21,6.3,14.49,2019
"5122660",490,41,193,724,67.68,5.66,26.66,2019
"5122728",842,30,162,1034,81.43,2.9,15.67,2019
"5122733",297,0,44,341,87.1,0,12.9,2019
"5122737",880,12,139,1031,85.35,1.16,13.48,2019
"5122811",194,9,76,279,69.53,3.23,27.24,2019
"5122824",1994,14,496,2504,79.63,0.56,19.81,2019
"5122831",309,0,75,384,80.47,0,19.53,2019
"5122840",1691,27,136,1854,91.21,1.46,7.34,2019
"5122842",1619,12,451,2082,77.76,0.58,21.66,2019
"5122845",0,0,9,9,0,0,100,2019
"5122853",1121,71,475,1667,67.25,4.26,28.49,2019
"5122902",9076,244,1330,10650,85.22,2.29,12.49,2019
"5122911",6444,184,663,7291,88.38,2.52,9.09,2019
"5122923",1983,72,312,2367,83.78,3.04,13.18,2019
"5122947",1527,44,219,1790,85.31,2.46,12.23,2019
"5122959",547,0,81,628,87.1,0,12.9,2019
"5122980",10202,428,2789,13419,76.03,3.19,20.78,2019
"5122039",5802,49,29,5880,98.67,0.83,0.49,2019
"5122060",2402,62,106,2570,93.46,2.41,4.12,2019
"5122124",6316,182,154,6652,94.95,2.74,2.32,2019
"5122134",1160,93,41,1294,89.64,7.19,3.17,2019
"5122304",19630,316,1494,21440,91.56,1.47,6.97,2019
"5122310",10838,63,515,11416,94.94,0.55,4.51,2019
"5122315",10279,95,352,10726,95.83,0.89,3.28,2019
"5122432",53,0,53,106,50,0,50,2019
"5122480",277,32,37,346,80.06,9.25,10.69,2019
"5122520",1759,12,737,2508,70.14,0.48,29.39,2019
"5122576",802,0,166,968,82.85,0,17.15,2019
"5122602",8851,387,1573,10811,81.87,3.58,14.55,2019
"5124502",13653,451,2289,16393,83.29,2.75,13.96,2019
"5124558",1559,112,974,2645,58.94,4.23,36.82,2019
"5124562",117,15,53,185,63.24,8.11,28.65,2019
"5124572",4615,215,1682,6512,70.87,3.3,25.83,2019
"5124580",168,21,47,236,71.19,8.9,19.92,2019
"5124581",0,0,27,27,0,0,100,2019
"5124589",655,27,392,1074,60.99,2.51,36.5,2019
"5124601",0,0,0,0,NA,NA,NA,2019
"5124604",78,0,36,114,68.42,0,31.58,2019
"5124605",2581,53,651,3285,78.57,1.61,19.82,2019
"5124612",45,0,32,77,58.44,0,41.56,2019
"5124631",528,0,270,798,66.17,0,33.83,2019
"5124634",145,0,70,215,67.44,0,32.56,2019
"5124641",1633,34,671,2338,69.85,1.45,28.7,2019
"5425514",905,39,445,1389,65.15,2.81,32.04,2019
"5124639",764,73,422,1259,60.68,5.8,33.52,2019
"5124657",96,0,75,171,56.14,0,43.86,2019
"5424737",36,0,17,53,67.92,0,32.08,2019
"5424811",259,32,0,291,89,11,0,2019
"5424817",212,3,125,340,62.35,0.88,36.76,2019
"5424823",150,0,52,202,74.26,0,25.74,2019
"5424839",529,0,146,675,78.37,0,21.63,2019
"5424867",136,0,30,166,81.93,0,18.07,2019
"5424871",54,4,9,67,80.6,5.97,13.43,2019
"5424872",230,0,121,351,65.53,0,34.47,2019
"5424881",133,0,29,162,82.1,0,17.9,2019
"5424884",36,0,76,112,32.14,0,67.86,2019
"5424892",375,77,176,628,59.71,12.26,28.03,2019
"5424894",19,0,41,60,31.67,0,68.33,2019
"5124224",1338,7,1083,2428,55.11,0.29,44.6,2019
"5124228",1639,107,749,2495,65.69,4.29,30.02,2019
"5124239",40,0,53,93,43.01,0,56.99,2019
"5124256",827,92,473,1392,59.41,6.61,33.98,2019
"5124273",1639,282,573,2494,65.72,11.31,22.98,2019
"5124301",3910,479,1636,6025,64.9,7.95,27.15,2019
"5124323",220,16,95,331,66.47,4.83,28.7,2019
"5124326",316,8,176,500,63.2,1.6,35.2,2019
"5124330",764,36,420,1220,62.62,2.95,34.43,2019
"5124347",503,20,191,714,70.45,2.8,26.75,2019
"5124348",1298,27,450,1775,73.13,1.52,25.35,2019
"5124361",1453,18,498,1969,73.79,0.91,25.29,2019
"5124368",1642,72,416,2130,77.09,3.38,19.53,2019
"5124377",107,0,50,157,68.15,0,31.85,2019
"5424944",135,12,42,189,71.43,6.35,22.22,2019
"5124312",443,48,270,761,58.21,6.31,35.48,2019
"5124412",13,0,0,13,100,0,0,2019
"5124258",443,72,188,703,63.02,10.24,26.74,2019
"5124325",277,0,157,434,63.82,0,36.18,2019
"5124130",8,0,0,8,100,0,0,2019
"5124246",10,176,56,242,4.13,72.73,23.14,2019
"5124411",0,0,27,27,0,0,100,2019
"5124476",97,0,13,110,88.18,0,11.82,2019
"5124570",0,0,0,0,NA,NA,NA,2019
"5424729",52,0,52,104,50,0,50,2019
"5424738",67,0,46,113,59.29,0,40.71,2019
"5424826",34,0,7,41,82.93,0,17.07,2019
"5424834",200,0,24,224,89.29,0,10.71,2019
"5424847",67,0,48,115,58.26,0,41.74,2019
"5424878",113,0,107,220,51.36,0,48.64,2019
"5124613",177,0,91,268,66.04,0,33.96,2019
"5124635",119,5,113,237,50.21,2.11,47.68,2019
"5124649",657,23,392,1072,61.29,2.15,36.57,2019
"5424714",49,0,51,100,49,0,51,2019
"5424716",145,0,23,168,86.31,0,13.69,2019
"5424747",686,27,317,1030,66.6,2.62,30.78,2019
"5424808",163,0,56,219,74.43,0,25.57,2019
"5424816",65,0,0,65,100,0,0,2019
"5424853",103,14,54,171,60.23,8.19,31.58,2019
"5424879",190,20,40,250,76,8,16,2019
"5424861",20,12,18,50,40,24,36,2019
"5424870",764,44,358,1166,65.52,3.77,30.7,2019
"5424873",133,0,93,226,58.85,0,41.15,2019
"5424701",5917,193,2413,8523,69.42,2.26,28.31,2019
"5426218",800,4,295,1099,72.79,0.36,26.84,2019
"5425979",274,0,119,393,69.72,0,30.28,2019
"5425009",282,9,116,407,69.29,2.21,28.5,2019
"5425028",82,0,78,160,51.25,0,48.75,2019
"5425035",329,0,40,369,89.16,0,10.84,2019
"5425036",65,0,15,80,81.25,0,18.75,2019
"5425162",110,0,32,142,77.46,0,22.54,2019
"5425414",6023,223,705,6951,86.65,3.21,10.14,2019
"5425565",251,0,22,273,91.94,0,8.06,2019
"5425840",2324,0,787,3111,74.7,0,25.3,2019
"5425989",10,25,0,35,28.57,71.43,0,2019
"5425082",610,51,84,745,81.88,6.85,11.28,2019
"5425061",227,0,49,276,82.25,0,17.75,2019
"5425062",29,4,52,85,34.12,4.71,61.18,2019
"5425093",40,9,60,109,36.7,8.26,55.05,2019
"5425112",0,0,0,0,NA,NA,NA,2019
"5425142",134,0,80,214,62.62,0,37.38,2019
"5425156",55,0,52,107,51.4,0,48.6,2019
"5425180",20,0,18,38,52.63,0,47.37,2019
"5425185",0,0,0,0,NA,NA,NA,2019
"5425201",18,0,0,18,100,0,0,2019
"5425203",8,0,0,8,100,0,0,2019
"5425305",0,0,0,0,NA,NA,NA,2019
"5425403",4578,162,440,5180,88.38,3.13,8.49,2019
"5425404",7375,194,813,8382,87.99,2.31,9.7,2019
"5425405",4178,166,482,4826,86.57,3.44,9.99,2019
"5425432",47,0,17,64,73.44,0,26.56,2019
"5425690",101,0,0,101,100,0,0,2019
"5425810",48,0,0,48,100,0,0,2019
"5425811",15,0,0,15,100,0,0,2019
"5425264",80,0,35,115,69.57,0,30.43,2019
"5425309",4573,165,871,5609,81.53,2.94,15.53,2019
"5425044",70,0,32,102,68.63,0,31.37,2019
"5425873",215,0,44,259,83.01,0,16.99,2019
"5425876",37,0,0,37,100,0,0,2019
"5425906",139,0,31,170,81.76,0,18.24,2019
"5425911",12,0,10,22,54.55,0,45.45,2019
"5425115",14,0,38,52,26.92,0,73.08,2019
"5425430",2632,59,418,3109,84.66,1.9,13.44,2019
"5425854",285,10,197,492,57.93,2.03,40.04,2019
"5425969",385,22,50,457,84.25,4.81,10.94,2019
"5425868",126,0,46,172,73.26,0,26.74,2019
"5425871",260,5,100,365,71.23,1.37,27.4,2019
"5425913",67,0,46,113,59.29,0,40.71,2019
"5425917",568,6,281,855,66.43,0.7,32.87,2019
"5425922",37,15,50,102,36.27,14.71,49.02,2019
"5425857",32,0,15,47,68.09,0,31.91,2019
"5425862",80,0,13,93,86.02,0,13.98,2019
"5425005",60,0,16,76,78.95,0,21.05,2019
"5425844",360,23,217,600,60,3.83,36.17,2019
"5425823",661,0,293,954,69.29,0,30.71,2019
"5425827",720,0,156,876,82.19,0,17.81,2019
"5425831",539,0,175,714,75.49,0,24.51,2019
"5425915",41,0,29,70,58.57,0,41.43,2019
"5425918",1394,74,460,1928,72.3,3.84,23.86,2019
"5425938",382,32,127,541,70.61,5.91,23.48,2019
"5425978",94,0,144,238,39.5,0,60.5,2019
"5425202",397,38,78,513,77.39,7.41,15.2,2019
"5425213",2102,85,192,2379,88.36,3.57,8.07,2019
"3728717",739,6,138,883,83.69,0.68,15.63,2019
"5426263",71,0,52,123,57.72,0,42.28,2019
"5426264",169,0,65,234,72.22,0,27.78,2019
"5426280",409,18,214,641,63.81,2.81,33.39,2019
"5426282",10,25,0,35,28.57,71.43,0,2019
"5426287",1073,40,286,1399,76.7,2.86,20.44,2019
"5426521",74,3,25,102,72.55,2.94,24.51,2019
"5426588",895,27,175,1097,81.59,2.46,15.95,2019
"5426155",2197,35,688,2920,75.24,1.2,23.56,2019
"5426167",247,15,93,355,69.58,4.23,26.2,2019
"5426253",1138,18,327,1483,76.74,1.21,22.05,2019
"5426260",569,26,127,722,78.81,3.6,17.59,2019
"5426271",133,0,37,170,78.24,0,21.76,2019
"5426275",151,25,56,232,65.09,10.78,24.14,2019
"5426276",76,0,54,130,58.46,0,41.54,2019
"5426323",141,4,13,158,89.24,2.53,8.23,2019
"5426884",199,31,119,349,57.02,8.88,34.1,2019
"5426343",56,7,49,112,50,6.25,43.75,2019
"5426351",1101,64,182,1347,81.74,4.75,13.51,2019
"5426366",15,0,0,15,100,0,0,2019
"5426424",32,0,66,98,32.65,0,67.35,2019
"5426437",140,0,19,159,88.05,0,11.95,2019
"5426851",555,17,65,637,87.13,2.67,10.2,2019
"5426296",54,0,0,54,100,0,0,2019
"5426203",57,0,12,69,82.61,0,17.39,2019
"5426206",964,3,434,1401,68.81,0.21,30.98,2019
"5426215",14,0,0,14,100,0,0,2019
"5426230",30,0,36,66,45.45,0,54.55,2019
"5426250",1343,23,499,1865,72.01,1.23,26.76,2019
"5426257",345,6,135,486,70.99,1.23,27.78,2019
"5426270",141,0,88,229,61.57,0,38.43,2019
"5426285",81,0,88,169,47.93,0,52.07,2019
"5426293",196,0,50,246,79.67,0,20.33,2019
"5426325",63,0,94,157,40.13,0,59.87,2019
"5426338",193,0,117,310,62.26,0,37.74,2019
"5426346",267,32,48,347,76.95,9.22,13.83,2019
"5426378",1254,46,317,1617,77.55,2.84,19.6,2019
"5426416",2111,181,900,3192,66.13,5.67,28.2,2019
"5426426",1794,125,645,2564,69.97,4.88,25.16,2019
"5426435",39,0,25,64,60.94,0,39.06,2019
"5426452",2594,116,953,3663,70.82,3.17,26.02,2019
"5426520",324,0,20,344,94.19,0,5.81,2019
"5426525",1580,66,379,2025,78.02,3.26,18.72,2019
"5426866",145,3,150,298,48.66,1.01,50.34,2019
"5426032",117,10,70,197,59.39,5.08,35.53,2019
"5426056",37,12,0,49,75.51,24.49,0,2019
"5426136",188,0,61,249,75.5,0,24.5,2019
"5426141",68,0,61,129,52.71,0,47.29,2019
"5426601",1263,72,414,1749,72.21,4.12,23.67,2019
"5426619",36,0,92,128,28.12,0,71.88,2019
"5426651",3117,94,808,4019,77.56,2.34,20.1,2019
"5426679",646,28,105,779,82.93,3.59,13.48,2019
"5426681",308,0,97,405,76.05,0,23.95,2019
"5426684",70,0,0,70,100,0,0,2019
"5426690",162,0,87,249,65.06,0,34.94,2019
"5426704",1658,37,385,2080,79.71,1.78,18.51,2019
"5426722",186,0,73,259,71.81,0,28.19,2019
"5426739",265,0,115,380,69.74,0,30.26,2019
"5426807",875,63,332,1270,68.9,4.96,26.14,2019
"4217349",2374,68,234,2676,88.71,2.54,8.74,2019
"3728742",1029,14,170,1213,84.83,1.15,14.01,2019
"3728747",842,16,79,937,89.86,1.71,8.43,2019
"3728748",3489,135,1314,4938,70.66,2.73,26.61,2019
"3728754",2731,131,809,3671,74.39,3.57,22.04,2019
"3728781",220,7,195,422,52.13,1.66,46.21,2019
"3728786",6988,331,2366,9685,72.15,3.42,24.43,2019
"3728904",3151,79,892,4122,76.44,1.92,21.64,2019
"3728905",902,124,248,1274,70.8,9.73,19.47,2019
"3728273",13156,211,1425,14792,88.94,1.43,9.63,2019
"3728328",6165,459,3315,9939,62.03,4.62,33.35,2019
"3728340",1730,79,1939,3748,46.16,2.11,51.73,2019
"3728345",3537,23,1485,5045,70.11,0.46,29.44,2019
"3728349",675,64,380,1119,60.32,5.72,33.96,2019
"3728350",56,0,19,75,74.67,0,25.33,2019
"3728365",4174,162,1622,5958,70.06,2.72,27.22,2019
"3728367",39,0,16,55,70.91,0,29.09,2019
"3728382",1840,143,944,2927,62.86,4.89,32.25,2019
"3728384",2583,41,1311,3935,65.64,1.04,33.32,2019
"3728501",5461,185,2085,7731,70.64,2.39,26.97,2019
"3728508",757,17,192,966,78.36,1.76,19.88,2019
"3728523",675,0,231,906,74.5,0,25.5,2019
"3728582",768,32,31,831,92.42,3.85,3.73,2019
"3728594",1609,40,119,1768,91.01,2.26,6.73,2019
"3728613",7399,183,1313,8895,83.18,2.06,14.76,2019
"3728622",736,35,290,1061,69.37,3.3,27.33,2019
"3728532",7701,138,694,8533,90.25,1.62,8.13,2019
"3728618",861,19,215,1095,78.63,1.74,19.63,2019
"3728646",126,3,12,141,89.36,2.13,8.51,2019
"3728683",402,77,102,581,69.19,13.25,17.56,2019
"3728901",1475,100,524,2099,70.27,4.76,24.96,2019
"3728584",4676,55,442,5173,90.39,1.06,8.54,2019
"3728586",2263,48,741,3052,74.15,1.57,24.28,2019
"3728601",17291,370,3203,20864,82.87,1.77,15.35,2019
"3728604",2552,33,455,3040,83.95,1.09,14.97,2019
"3728627",430,0,91,521,82.53,0,17.47,2019
"3728640",1341,69,680,2090,64.16,3.3,32.54,2019
"3728649",338,0,15,353,95.75,0,4.25,2019
"3728654",1379,20,258,1657,83.22,1.21,15.57,2019
"3728666",0,0,73,73,0,0,100,2019
"3728670",948,11,267,1226,77.32,0.9,21.78,2019
"3728682",530,0,59,589,89.98,0,10.02,2019
"3728694",2530,84,838,3452,73.29,2.43,24.28,2019
"3728711",4611,162,951,5724,80.56,2.83,16.61,2019
"3728714",5132,150,1834,7116,72.12,2.11,25.77,2019
"3728739",8424,183,1148,9755,86.36,1.88,11.77,2019
"3728763",942,13,139,1094,86.11,1.19,12.71,2019
"3728356",1535,37,279,1851,82.93,2,15.07,2019
"3728269",27494,488,2100,30082,91.4,1.62,6.98,2019
"3728403",14409,907,2613,17929,80.37,5.06,14.57,2019
"3728516",4039,123,940,5102,79.17,2.41,18.42,2019
"3728607",10950,624,1494,13068,83.79,4.78,11.43,2019
"3728678",1617,10,501,2128,75.99,0.47,23.54,2019
"3728114",1911,31,773,2715,70.39,1.14,28.47,2019
"3728746",955,33,135,1123,85.04,2.94,12.02,2019
"3728806",14540,480,2938,17958,80.97,2.67,16.36,2019
"3728134",3449,100,725,4274,80.7,2.34,16.96,2019
"3728504",6887,501,1509,8897,77.41,5.63,16.96,2019
"3728792",11215,447,3101,14763,75.97,3.03,21.01,2019
"1019945",2276,69,494,2839,80.17,2.43,17.4,2019
"4217353",1159,31,178,1368,84.72,2.27,13.01,2019
"4217501",1511,39,247,1797,84.08,2.17,13.75,2019
"4217517",4915,163,704,5782,85.01,2.82,12.18,2019
"4217022",9571,406,1496,11473,83.42,3.54,13.04,2019
"4217029",44,0,15,59,74.58,0,25.42,2019
"4217042",12323,323,2382,15028,82,2.15,15.85,2019
"4217048",1066,24,469,1559,68.38,1.54,30.08,2019
"4217059",2278,54,811,3143,72.48,1.72,25.8,2019
"4217072",52,0,99,151,34.44,0,65.56,2019
"4217082",997,12,230,1239,80.47,0.97,18.56,2019
"4217098",736,25,219,980,75.1,2.55,22.35,2019
"4217103",3544,302,896,4742,74.74,6.37,18.89,2019
"4217110",8412,192,1542,10146,82.91,1.89,15.2,2019
"4217111",10885,270,1701,12856,84.67,2.1,13.23,2019
"4217113",3167,49,686,3902,81.16,1.26,17.58,2019
"4217252",1298,15,387,1700,76.35,0.88,22.76,2019
"4217253",93,0,19,112,83.04,0,16.96,2019
"4217301",1435,22,211,1668,86.03,1.32,12.65,2019
"4217309",534,0,305,839,63.65,0,36.35,2019
"4217321",713,65,99,877,81.3,7.41,11.29,2019
"4217329",794,32,97,923,86.02,3.47,10.51,2019
"4217064",347,16,0,363,95.59,4.41,0,2019
"4217068",1240,25,291,1556,79.69,1.61,18.7,2019
"4217075",38,0,8,46,82.61,0,17.39,2019
"4217519",1471,60,586,2117,69.49,2.83,27.68,2019
"4217535",395,90,255,740,53.38,12.16,34.46,2019
"4217555",1397,17,739,2153,64.89,0.79,34.32,2019
"4217563",759,32,413,1204,63.04,2.66,34.3,2019
"4217572",712,117,628,1457,48.87,8.03,43.1,2019
"4217579",1791,76,322,2189,81.82,3.47,14.71,2019
"4217582",678,47,104,829,81.79,5.67,12.55,2019
"4217751",1980,77,520,2577,76.83,2.99,20.18,2019
"4217772",680,10,215,905,75.14,1.1,23.76,2019
"4217233",1588,60,589,2237,70.99,2.68,26.33,2019
"4217239",57,3,26,86,66.28,3.49,30.23,2019
"4217249",129,2,26,157,82.17,1.27,16.56,2019
"4217101",963,126,361,1450,66.41,8.69,24.9,2019
"4217212",190,16,55,261,72.8,6.13,21.07,2019
"4217220",93,8,89,190,48.95,4.21,46.84,2019
"4217237",558,19,86,663,84.16,2.87,12.97,2019
"4217260",330,2,94,426,77.46,0.47,22.07,2019
"4217313",3782,95,633,4510,83.86,2.11,14.04,2019
"4217315",8581,340,1755,10676,80.38,3.18,16.44,2019
"4217319",3913,44,456,4413,88.67,1,10.33,2019
"4217324",1299,19,452,1770,73.39,1.07,25.54,2019
"4217740",3854,202,879,4935,78.1,4.09,17.81,2019
"4217742",12,0,6,18,66.67,0,33.33,2019
"4217745",5723,219,1146,7088,80.74,3.09,16.17,2019
"4217748",70,5,29,104,67.31,4.81,27.88,2019
"4217760",190,2,64,256,74.22,0.78,25,2019
"4217801",5027,117,1773,6917,72.68,1.69,25.63,2019
"4217834",1164,22,351,1537,75.73,1.43,22.84,2019
"4217844",2675,34,1100,3809,70.23,0.89,28.88,2019
"4217865",30,2,5,37,81.08,5.41,13.51,2019
"4217889",709,26,183,918,77.23,2.83,19.93,2019
"4217922",1681,73,122,1876,89.61,3.89,6.5,2019
"4217943",57,0,15,72,79.17,0,20.83,2019
"4217948",1452,21,428,1901,76.38,1.1,22.51,2019
"2420895",6507,87,296,6890,94.44,1.26,4.3,2019
"1019967",512,8,11,531,96.42,1.51,2.07,2019
"1019971",6067,173,769,7009,86.56,2.47,10.97,2019
"1019979",258,8,33,299,86.29,2.68,11.04,2019
"4219534",702,11,93,806,87.1,1.36,11.54,2019
"4219540",3841,42,576,4459,86.14,0.94,12.92,2019
"4219606",11827,281,1272,13380,88.39,2.1,9.51,2019
"1019731",61,0,10,71,85.92,0,14.08,2019
"1019802",7716,764,1919,10399,74.2,7.35,18.45,2019
"1019930",1145,12,93,1250,91.6,0.96,7.44,2019
"1019931",105,3,17,125,84,2.4,13.6,2019
"1019934",4678,81,290,5049,92.65,1.6,5.74,2019
"1019950",1883,90,625,2598,72.48,3.46,24.06,2019
"1019958",10827,143,1158,12128,89.27,1.18,9.55,2019
"1019962",3839,81,252,4172,92.02,1.94,6.04,2019
"4219118",4069,91,343,4503,90.36,2.02,7.62,2019
"4219121",8015,943,3450,12408,64.6,7.6,27.8,2019
"4219128",14544,275,1517,16336,89.03,1.68,9.29,2019
"4219131",12461,802,4261,17524,71.11,4.58,24.32,2019
"4219135",9991,292,1787,12070,82.78,2.42,14.81,2019
"4219316",94,0,27,121,77.69,0,22.31,2019
"4219319",95,0,0,95,100,0,0,2019
"4219352",2657,14,207,2878,92.32,0.49,7.19,2019
"4219363",4367,44,1344,5755,75.88,0.76,23.35,2019
"4219401",12522,592,3295,16409,76.31,3.61,20.08,2019
"4219472",5,0,0,5,100,0,0,2019
"4219505",1224,0,245,1469,83.32,0,16.68,2019
"4219003",5124,64,435,5623,91.13,1.14,7.74,2019
"4219010",6739,106,504,7349,91.7,1.44,6.86,2019
"4219012",2066,44,169,2279,90.65,1.93,7.42,2019
"4219014",6744,175,788,7707,87.5,2.27,10.22,2019
"4219033",2777,56,323,3156,87.99,1.77,10.23,2019
"4219034",1825,90,105,2020,90.35,4.46,5.2,2019
"4219026",10567,159,1135,11861,89.09,1.34,9.57,2019
"4219035",1345,46,48,1439,93.47,3.2,3.34,2019
"4219040",6907,114,765,7786,88.71,1.46,9.83,2019
"4219053",8860,174,892,9926,89.26,1.75,8.99,2019
"4219064",7898,149,448,8495,92.97,1.75,5.27,2019
"4219095",2592,53,332,2977,87.07,1.78,11.15,2019
"4219102",2908,66,81,3055,95.19,2.16,2.65,2019
"4219113",35,4,11,50,70,8,22,2019
"4219122",4713,309,1641,6663,70.73,4.64,24.63,2019
"4219129",3683,132,856,4671,78.85,2.83,18.33,2019
"4219133",5482,316,3159,8957,61.2,3.53,35.27,2019
"4219144",13694,747,4089,18530,73.9,4.03,22.07,2019
"4219301",2310,67,214,2591,89.15,2.59,8.26,2019
"4219468",9256,104,757,10117,91.49,1.03,7.48,2019
"4219473",5422,102,377,5901,91.88,1.73,6.39,2019
"4219474",261,0,42,303,86.14,0,13.86,2019
"4219503",518,17,70,605,85.62,2.81,11.57,2019
"4219530",3860,179,842,4881,79.08,3.67,17.25,2019
"4219536",166,7,29,202,82.18,3.47,14.36,2019
"4219539",1568,14,234,1816,86.34,0.77,12.89,2019
"4219562",705,45,263,1013,69.6,4.44,25.96,2019
"4219605",6276,159,992,7427,84.5,2.14,13.36,2019
"4219607",8141,141,1372,9654,84.33,1.46,14.21,2019
"1019709",13763,304,483,14550,94.59,2.09,3.32,2019
"1019733",72,0,0,72,100,0,0,2019
"4219130",12620,181,875,13676,92.28,1.32,6.4,2019
"5124651",1600,94,423,2117,75.58,4.44,19.98,2019
"2420896",286,4,2,292,97.95,1.37,0.68,2019
"2420906",21676,770,2692,25138,86.23,3.06,10.71,2019
"1120011",18838,792,4299,23929,78.72,3.31,17.97,2019
"1120006",542,0,26,568,95.42,0,4.58,2019
"1120010",10696,363,1533,12592,84.94,2.88,12.17,2019
"1120024",7029,269,976,8274,84.95,3.25,11.8,2019
"5120106",1664,33,291,1988,83.7,1.66,14.64,2019
"5120112",7990,83,136,8209,97.33,1.01,1.66,2019
"5120120",13005,148,341,13494,96.38,1.1,2.53,2019
"5120129",179,0,0,179,100,0,0,2019
"5120136",8178,137,92,8407,97.28,1.63,1.09,2019
"5120143",270,9,8,287,94.08,3.14,2.79,2019
"5120148",15581,171,100,15852,98.29,1.08,0.63,2019
"5120151",6591,63,168,6822,96.61,0.92,2.46,2019
"5120165",10645,125,398,11168,95.32,1.12,3.56,2019
"5120170",12606,260,532,13398,94.09,1.94,3.97,2019
"5120171",16803,196,411,17410,96.51,1.13,2.36,2019
"5120190",8540,213,429,9182,93.01,2.32,4.67,2019
"5120198",698,10,167,875,79.77,1.14,19.09,2019
"2420613",3998,189,470,4657,85.85,4.06,10.09,2019
"2420628",99,0,89,188,52.66,0,47.34,2019
"2420630",72,0,45,117,61.54,0,38.46,2019
"2420632",90,0,19,109,82.57,0,17.43,2019
"2420639",4414,90,361,4865,90.73,1.85,7.42,2019
"2420675",703,0,57,760,92.5,0,7.5,2019
"2420677",651,16,124,791,82.3,2.02,15.68,2019
"2420693",306,11,0,317,96.53,3.47,0,2019
"2420708",8740,217,915,9872,88.53,2.2,9.27,2019
"2420710",3037,88,703,3828,79.34,2.3,18.36,2019
"2420746",8661,452,2235,11348,76.32,3.98,19.7,2019
"2420783",9965,204,1747,11916,83.63,1.71,14.66,2019
"2420839",23,0,0,23,100,0,0,2019
"2420841",3054,16,24,3094,98.71,0.52,0.78,2019
"2420879",7520,262,430,8212,91.57,3.19,5.24,2019
"2420904",17401,1068,1305,19774,88,5.4,6.6,2019
"2420759",1666,12,11,1689,98.64,0.71,0.65,2019
"2420762",765,21,43,829,92.28,2.53,5.19,2019
"2420765",161,0,0,161,100,0,0,2019
"2420774",16962,234,1154,18350,92.44,1.28,6.29,2019
"2420779",341,0,91,432,78.94,0,21.06,2019
"2420781",3357,86,439,3882,86.48,2.22,11.31,2019
"2420785",12107,255,1538,13900,87.1,1.83,11.06,2019
"2420837",1850,22,79,1951,94.82,1.13,4.05,2019
"2420853",8830,224,579,9633,91.66,2.33,6.01,2019
"2420886",10569,303,971,11843,89.24,2.56,8.2,2019
"2420695",2591,10,305,2906,89.16,0.34,10.5,2019
"2420706",11813,197,1169,13179,89.64,1.49,8.87,2019
"2420712",3162,79,736,3977,79.51,1.99,18.51,2019
"2420723",11091,110,432,11633,95.34,0.95,3.71,2019
"2420737",4694,206,1148,6048,77.61,3.41,18.98,2019
"2420764",1384,12,53,1449,95.51,0.83,3.66,2019
"2420769",1904,21,16,1941,98.09,1.08,0.82,2019
"2420782",9752,202,1238,11192,87.13,1.8,11.06,2019
"2420784",7712,383,1387,9482,81.33,4.04,14.63,2019
"2420818",768,0,29,797,96.36,0,3.64,2019
"2420851",4405,50,534,4989,88.29,1,10.7,2019
"2420855",4953,61,230,5244,94.45,1.16,4.39,2019
"1120002",24056,680,3813,28549,84.26,2.38,13.36,2019
"5424719",15,0,0,15,100,0,0,2019
"5424866",101,6,8,115,87.83,5.22,6.96,2019
"5424869",102,27,55,184,55.43,14.67,29.89,2019
"5424901",3643,98,746,4487,81.19,2.18,16.63,2019
"5424986",1579,63,572,2214,71.32,2.85,25.84,2019
"5124095",1391,20,440,1851,75.15,1.08,23.77,2019
"5124439",351,0,209,560,62.68,0,37.32,2019
"5124538",1545,127,467,2139,72.23,5.94,21.83,2019
"5124540",9909,463,3394,13766,71.98,3.36,24.65,2019
"5124541",9100,415,2614,12129,75.03,3.42,21.55,2019
"5124554",973,70,575,1618,60.14,4.33,35.54,2019
"5124574",1030,51,353,1434,71.83,3.56,24.62,2019
"5124588",2869,298,733,3900,73.56,7.64,18.79,2019
"5124593",519,0,196,715,72.59,0,27.41,2019
"5124594",327,51,294,672,48.66,7.59,43.75,2019
"5124620",814,0,296,1110,73.33,0,26.67,2019
"5124630",2019,28,636,2683,75.25,1.04,23.7,2019
"5124464",29,0,50,79,36.71,0,63.29,2019
"5124477",3352,133,969,4454,75.26,2.99,21.76,2019
"5124479",449,84,148,681,65.93,12.33,21.73,2019
"5124482",1441,41,449,1931,74.62,2.12,23.25,2019
"5124487",102,0,56,158,64.56,0,35.44,2019
"5424918",525,0,268,793,66.2,0,33.8,2019
"5124016",2760,257,1150,4167,66.23,6.17,27.6,2019
"5124017",6167,373,2764,9304,66.28,4.01,29.71,2019
"5124060",16793,420,1062,18275,91.89,2.3,5.81,2019
"5124078",2330,64,678,3072,75.85,2.08,22.07,2019
"5124104",1143,21,345,1509,75.75,1.39,22.86,2019
"5124136",1087,59,262,1408,77.2,4.19,18.61,2019
"5124149",1017,71,240,1328,76.58,5.35,18.07,2019
"5124153",11491,421,2678,14590,78.76,2.89,18.36,2019
"5124184",1562,69,203,1834,85.17,3.76,11.07,2019
"5124201",5453,280,1311,7044,77.41,3.98,18.61,2019
"5124220",204,21,104,329,62.01,6.38,31.61,2019
"5124271",522,98,386,1006,51.89,9.74,38.37,2019
"5124282",103,42,162,307,33.55,13.68,52.77,2019
"5424925",218,0,51,269,81.04,0,18.96,2019
"5424931",488,0,89,577,84.58,0,15.42,2019
"5124315",833,0,314,1147,72.62,0,27.38,2019
"5124281",423,215,335,973,43.47,22.1,34.43,2019
"5124322",43,0,6,49,87.76,0,12.24,2019
"5124340",1697,59,479,2235,75.93,2.64,21.43,2019
"5124350",239,0,227,466,51.29,0,48.71,2019
"5124351",126,40,89,255,49.41,15.69,34.9,2019
"5124360",1495,94,687,2276,65.69,4.13,30.18,2019
"5124440",847,58,192,1097,77.21,5.29,17.5,2019
"5424910",1474,32,480,1986,74.22,1.61,24.17,2019
"5424915",243,0,33,276,88.04,0,11.96,2019
"5124293",2491,521,832,3844,64.8,13.55,21.64,2019
"5124333",5146,362,1687,7195,71.52,5.03,23.45,2019
"5124354",4018,258,1562,5838,68.82,4.42,26.76,2019
"5124378",242,8,261,511,47.36,1.57,51.08,2019
"5124435",663,0,178,841,78.83,0,21.17,2019
"5124458",137,10,100,247,55.47,4.05,40.49,2019
"5124431",772,42,225,1039,74.3,4.04,21.66,2019
"5424927",74,0,30,104,71.15,0,28.85,2019
"5124381",1224,35,325,1584,77.27,2.21,20.52,2019
"5124421",1320,30,374,1724,76.57,1.74,21.69,2019
"5124442",34,0,20,54,62.96,0,37.04,2019
"5425235",372,0,88,460,80.87,0,19.13,2019
"5424815",169,0,153,322,52.48,0,47.52,2019
"5424827",461,15,21,497,92.76,3.02,4.23,2019
"5424828",241,16,69,326,73.93,4.91,21.17,2019
"5424830",34,2,38,74,45.95,2.7,51.35,2019
"5424836",162,35,57,254,63.78,13.78,22.44,2019
"5424848",48,8,22,78,61.54,10.26,28.21,2019
"5424874",908,55,296,1259,72.12,4.37,23.51,2019
"5424880",123,0,22,145,84.83,0,15.17,2019
"5424938",498,12,109,619,80.45,1.94,17.61,2019
"5424970",1490,58,421,1969,75.67,2.95,21.38,2019
"5424984",66,0,54,120,55,0,45,2019
"5124012",9374,369,2253,11996,78.14,3.08,18.78,2019
"5424831",74,0,6,80,92.5,0,7.5,2019
"5124646",135,0,138,273,49.45,0,50.55,2019
"5424740",9623,482,2858,12963,74.23,3.72,22.05,2019
"5424801",915,101,257,1273,71.88,7.93,20.19,2019
"5424845",123,0,11,134,91.79,0,8.21,2019
"5424857",250,0,48,298,83.89,0,16.11,2019
"5424860",56,0,57,113,49.56,0,50.44,2019
"5424868",333,14,134,481,69.23,2.91,27.86,2019
"5424920",65,0,65,130,50,0,50,2019
"5424954",1046,44,523,1613,64.85,2.73,32.42,2019
"5124015",5537,146,886,6569,84.29,2.22,13.49,2019
"5124020",32,0,0,32,100,0,0,2019
"5124092",682,0,475,1157,58.95,0,41.05,2019
"5124101",2099,100,373,2572,81.61,3.89,14.5,2019
"5124134",1568,73,451,2092,74.95,3.49,21.56,2019
"5124141",7369,442,1246,9057,81.36,4.88,13.76,2019
"5124161",154,0,38,192,80.21,0,19.79,2019
"5124279",1226,135,463,1824,67.21,7.4,25.38,2019
"5124079",583,26,188,797,73.15,3.26,23.59,2019
"5124066",1575,65,547,2187,72.02,2.97,25.01,2019
"5124067",590,33,311,934,63.17,3.53,33.3,2019
"5124076",383,17,133,533,71.86,3.19,24.95,2019
"5124082",199,0,36,235,84.68,0,15.32,2019
"5124120",456,12,189,657,69.41,1.83,28.77,2019
"5124122",454,35,182,671,67.66,5.22,27.12,2019
"5124132",46,0,105,151,30.46,0,69.54,2019
"5124147",437,8,67,512,85.35,1.56,13.09,2019
"5124150",246,0,131,377,65.25,0,34.75,2019
"5124176",530,0,57,587,90.29,0,9.71,2019
"5124216",581,175,353,1109,52.39,15.78,31.83,2019
"5124248",486,100,468,1054,46.11,9.49,44.4,2019
"5124265",142,31,111,284,50,10.92,39.08,2019
"5124270",217,0,80,297,73.06,0,26.94,2019
"5124290",444,42,282,768,57.81,5.47,36.72,2019
"5124328",482,59,313,854,56.44,6.91,36.65,2019
"5124374",237,0,108,345,68.7,0,31.3,2019
"5124375",567,21,133,721,78.64,2.91,18.45,2019
"5124430",365,3,216,584,62.5,0.51,36.99,2019
"5124433",20,0,7,27,74.07,0,25.93,2019
"5124437",270,11,54,335,80.6,3.28,16.12,2019
"5124445",787,6,372,1165,67.55,0.52,31.93,2019
"5124450",4838,134,1215,6187,78.2,2.17,19.64,2019
"5124457",16,0,112,128,12.5,0,87.5,2019
"5124486",993,54,185,1232,80.6,4.38,15.02,2019
"5124472",498,29,273,800,62.25,3.62,34.12,2019
"5124484",204,0,46,250,81.6,0,18.4,2019
"5426818",316,0,56,372,84.95,0,15.05,2019
"2142087",593,56,259,908,65.31,6.17,28.52,2019
"2142120",625,42,248,915,68.31,4.59,27.1,2019
"3944720",14374,328,1498,16200,88.73,2.02,9.25,2019
"3944064",547,34,100,681,80.32,4.99,14.68,2019
"3944077",19150,379,2774,22303,85.86,1.7,12.44,2019
"3944093",298,5,120,423,70.45,1.18,28.37,2019
"3944099",326,72,328,726,44.9,9.92,45.18,2019
"3944113",7659,357,1744,9760,78.47,3.66,17.87,2019
"3944114",2674,309,855,3838,69.67,8.05,22.28,2019
"3944132",5002,172,1176,6350,78.77,2.71,18.52,2019
"3944135",9297,336,2260,11893,78.17,2.83,19,2019
"3944136",9116,157,1126,10399,87.66,1.51,10.83,2019
"3944215",698,31,162,891,78.34,3.48,18.18,2019
"3944140",5667,75,279,6021,94.12,1.25,4.63,2019
"3944141",5074,97,446,5617,90.33,1.73,7.94,2019
"3944212",15082,708,1463,17253,87.42,4.1,8.48,2019
"3944223",6513,209,904,7626,85.41,2.74,11.85,2019
"3944233",2657,214,137,3008,88.33,7.11,4.55,2019
"3944243",0,0,0,0,NA,NA,NA,2019
"3944256",21947,655,1883,24485,89.63,2.68,7.69,2019
"3944302",1754,155,473,2382,73.64,6.51,19.86,2019
"3944310",7042,511,2734,10287,68.46,4.97,26.58,2019
"3944403",1397,48,318,1763,79.24,2.72,18.04,2019
"3944429",1073,25,126,1224,87.66,2.04,10.29,2019
"3944445",1217,89,190,1496,81.35,5.95,12.7,2019
"3944721",5021,88,475,5584,89.92,1.58,8.51,2019
"3944809",95,0,41,136,69.85,0,30.15,2019
"3944824",1425,19,145,1589,89.68,1.2,9.13,2019
"3944847",1205,40,187,1432,84.15,2.79,13.06,2019
"3944849",806,0,152,958,84.13,0,15.87,2019
"3944854",583,23,78,684,85.23,3.36,11.4,2019
"3944880",735,29,238,1002,73.35,2.89,23.75,2019
"3944889",2340,83,395,2818,83.04,2.95,14.02,2019
"3944903",7425,250,1822,9497,78.18,2.63,19.19,2019
"3944906",5399,351,1588,7338,73.58,4.78,21.64,2019
"3944241",5655,247,617,6519,86.75,3.79,9.46,2019
"3944288",960,118,289,1367,70.23,8.63,21.14,2019
"3944304",1109,109,168,1386,80.01,7.86,12.12,2019
"3944320",6276,437,2041,8754,71.69,4.99,23.32,2019
"3944321",5453,170,508,6131,88.94,2.77,8.29,2019
"3944406",7855,97,710,8662,90.68,1.12,8.2,2019
"3944432",3348,143,831,4322,77.46,3.31,19.23,2019
"3944441",540,29,89,658,82.07,4.41,13.53,2019
"3944443",484,119,41,644,75.16,18.48,6.37,2019
"3944444",3363,88,821,4272,78.72,2.06,19.22,2019
"3944483",8360,380,2081,10821,77.26,3.51,19.23,2019
"3944503",98,80,270,448,21.88,17.86,60.27,2019
"3944510",673,18,247,938,71.75,1.92,26.33,2019
"3944614",4740,0,311,5051,93.84,0,6.16,2019
"3944641",6914,189,961,8064,85.74,2.34,11.92,2019
"3944653",179,8,56,243,73.66,3.29,23.05,2019
"3944662",2868,72,657,3597,79.73,2,18.27,2019
"3944670",61,0,0,61,100,0,0,2019
"3944671",79,0,0,79,100,0,0,2019
"3944676",1392,31,334,1757,79.23,1.76,19.01,2019
"3944707",2837,103,867,3807,74.52,2.71,22.77,2019
"3944804",338,3,56,397,85.14,0.76,14.11,2019
"3944807",726,31,129,886,81.94,3.5,14.56,2019
"3944811",4169,210,649,5028,82.92,4.18,12.91,2019
"2142642",3021,165,1517,4703,64.24,3.51,32.26,2019
"2142717",1704,25,848,2577,66.12,0.97,32.91,2019
"2142721",965,72,286,1323,72.94,5.44,21.62,2019
"2142722",155,0,57,212,73.11,0,26.89,2019
"2142729",399,0,231,630,63.33,0,36.67,2019
"2142731",23,0,38,61,37.7,0,62.3,2019
"2142027",526,24,84,634,82.97,3.79,13.25,2019
"2142028",142,0,98,240,59.17,0,40.83,2019
"2142041",1313,64,529,1906,68.89,3.36,27.75,2019
"2142048",601,10,163,774,77.65,1.29,21.06,2019
"2142050",632,32,368,1032,61.24,3.1,35.66,2019
"2142079",448,18,123,589,76.06,3.06,20.88,2019
"2142086",1403,113,241,1757,79.85,6.43,13.72,2019
"2142164",4347,155,1699,6201,70.1,2.5,27.4,2019
"2142071",10175,481,1672,12328,82.54,3.9,13.56,2019
"2142122",1571,90,240,1901,82.64,4.73,12.62,2019
"2142159",471,1,128,600,78.5,0.17,21.33,2019
"2142160",489,6,129,624,78.37,0.96,20.67,2019
"2142166",757,15,177,949,79.77,1.58,18.65,2019
"2142206",1368,115,596,2079,65.8,5.53,28.67,2019
"2142220",1486,118,943,2547,58.34,4.63,37.02,2019
"2142259",298,10,105,413,72.15,2.42,25.42,2019
"2142261",2897,51,1213,4161,69.62,1.23,29.15,2019
"2142274",706,0,185,891,79.24,0,20.76,2019
"2142338",14,0,0,14,100,0,0,2019
"2142347",1810,36,532,2378,76.11,1.51,22.37,2019
"2142366",1622,35,375,2032,79.82,1.72,18.45,2019
"2142410",386,34,122,542,71.22,6.27,22.51,2019
"2142431",8109,378,2156,10643,76.19,3.55,20.26,2019
"2142141",9875,248,2151,12274,80.45,2.02,17.52,2019
"2142202",563,23,344,930,60.54,2.47,36.99,2019
"2142236",170,0,93,263,64.64,0,35.36,2019
"2142256",1337,18,510,1865,71.69,0.97,27.35,2019
"2142262",3042,115,110,3267,93.11,3.52,3.37,2019
"2142266",530,10,235,775,68.39,1.29,30.32,2019
"2142333",321,19,115,455,70.55,4.18,25.27,2019
"2142337",594,13,180,787,75.48,1.65,22.87,2019
"2142343",421,18,194,633,66.51,2.84,30.65,2019
"2142348",1406,41,362,1809,77.72,2.27,20.01,2019
"2142408",1845,91,915,2851,64.71,3.19,32.09,2019
"2142440",217,3,159,379,57.26,0.79,41.95,2019
"2142456",452,49,159,660,68.48,7.42,24.09,2019
"2142459",1276,134,355,1765,72.29,7.59,20.11,2019
"2142462",348,17,69,434,80.18,3.92,15.9,2019
"2142539",2658,90,958,3706,71.72,2.43,25.85,2019
"2142567",1581,153,659,2393,66.07,6.39,27.54,2019
"2142602",2329,69,1585,3983,58.47,1.73,39.79,2019
"2142603",9,0,4,13,69.23,0,30.77,2019
"2142629",1597,39,571,2207,72.36,1.77,25.87,2019
"2142635",798,30,487,1315,60.68,2.28,37.03,2019
"2142647",695,73,614,1382,50.29,5.28,44.43,2019
"2142649",513,87,259,859,59.72,10.13,30.15,2019
"2142718",7563,184,2115,9862,76.69,1.87,21.45,2019
"2142733",400,12,100,512,78.12,2.34,19.53,2019
"2142754",4040,591,1420,6051,66.77,9.77,23.47,2019
"2142354",56,0,12,68,82.35,0,17.65,2019
"2142355",652,32,128,812,80.3,3.94,15.76,2019
"2142368",333,0,125,458,72.71,0,27.29,2019
"2142370",6,0,0,6,100,0,0,2019
"2142049",489,4,89,582,84.02,0.69,15.29,2019
"2142032",56,5,16,77,72.73,6.49,20.78,2019
"2142038",1284,43,555,1882,68.23,2.28,29.49,2019
"2142045",695,16,220,931,74.65,1.72,23.63,2019
"2142055",1044,5,274,1323,78.91,0.38,20.71,2019
"2142058",865,0,75,940,92.02,0,7.98,2019
"2142061",16,0,39,55,29.09,0,70.91,2019
"2142064",2166,104,930,3200,67.69,3.25,29.06,2019
"2142069",166,0,51,217,76.5,0,23.5,2019
"2142101",17899,479,3029,21407,83.61,2.24,14.15,2019
"2142140",270,7,142,419,64.44,1.67,33.89,2019
"2142151",26,0,25,51,50.98,0,49.02,2019
"2142170",405,30,159,594,68.18,5.05,26.77,2019
"2142171",2235,69,385,2689,83.12,2.57,14.32,2019
"2142210",1360,28,451,1839,73.95,1.52,24.52,2019
"2142223",4153,147,220,4520,91.88,3.25,4.87,2019
"2142320",2212,112,1056,3380,65.44,3.31,31.24,2019
"2142327",1183,26,314,1523,77.68,1.71,20.62,2019
"2142328",380,4,146,530,71.7,0.75,27.55,2019
"2142352",683,18,163,864,79.05,2.08,18.87,2019
"2142376",1834,66,354,2254,81.37,2.93,15.71,2019
"2142378",926,23,258,1207,76.72,1.91,21.38,2019
"2142436",327,35,77,439,74.49,7.97,17.54,2019
"2142528",453,5,144,602,75.25,0.83,23.92,2019
"2142541",157,0,85,242,64.88,0,35.12,2019
"2142553",1456,137,583,2176,66.91,6.3,26.79,2019
"2142638",25,0,0,25,100,0,0,2019
"2142715",68,0,48,116,58.62,0,41.38,2019
"2142716",471,74,116,661,71.26,11.2,17.55,2019
"2142746",587,19,122,728,80.63,2.61,16.76,2019
"2142154",178,5,25,208,85.58,2.4,12.02,2019
"2142234",531,18,481,1030,51.55,1.75,46.7,2019
"2142240",12212,785,3584,16581,73.65,4.73,21.62,2019
"2142273",143,4,41,188,76.06,2.13,21.81,2019
"2142276",3775,95,1836,5706,66.16,1.66,32.18,2019
"2142285",116,0,30,146,79.45,0,20.55,2019
"2142321",7,0,40,47,14.89,0,85.11,2019
"2142323",183,0,91,274,66.79,0,33.21,2019
"2142330",2459,106,655,3220,76.37,3.29,20.34,2019
"2142372",449,42,219,710,63.24,5.92,30.85,2019
"2142409",577,54,281,912,63.27,5.92,30.81,2019
"2142420",11642,570,3224,15436,75.42,3.69,20.89,2019
"2142441",468,6,167,641,73.01,0.94,26.05,2019
"2142458",430,0,96,526,81.75,0,18.25,2019
"2142501",4859,423,1658,6940,70.01,6.1,23.89,2019
"2142519",834,82,420,1336,62.43,6.14,31.44,2019
"2142566",90,26,48,164,54.88,15.85,29.27,2019
"2142631",76,0,0,76,100,0,0,2019
"2142653",998,98,720,1816,54.96,5.4,39.65,2019
"2142726",1138,208,483,1829,62.22,11.37,26.41,2019
"2142728",4213,95,1692,6000,70.22,1.58,28.2,2019
"2142741",157,14,26,197,79.7,7.11,13.2,2019
"2142753",224,8,84,316,70.89,2.53,26.58,2019
"2142023",699,23,179,901,77.58,2.55,19.87,2019
"2142056",502,0,115,617,81.36,0,18.64,2019
"2142021",495,25,138,658,75.23,3.8,20.97,2019
"2142081",523,40,294,857,61.03,4.67,34.31,2019
"2142371",92,0,62,154,59.74,0,40.26,2019
"2142301",15205,371,2854,18430,82.5,2.01,15.49,2019
"2142303",13630,206,2173,16009,85.14,1.29,13.57,2019
"2142351",1374,31,242,1647,83.42,1.88,14.69,2019
"2142442",863,47,341,1251,68.98,3.76,27.26,2019
"2142445",3276,85,996,4357,75.19,1.95,22.86,2019
"2142451",213,0,142,355,60,0,40,2019
"2142565",167,0,109,276,60.51,0,39.49,2019
"2142633",4942,130,2740,7812,63.26,1.66,35.07,2019
"2142701",16116,1227,3081,20424,78.91,6.01,15.09,2019
"2142712",370,9,198,577,64.12,1.56,34.32,2019
"2142765",1421,53,778,2252,63.1,2.35,34.55,2019
"2142204",127,0,88,215,59.07,0,40.93,2019
"2142254",50,0,16,66,75.76,0,24.24,2019
"2142324",315,46,117,478,65.9,9.62,24.48,2019
"2142326",133,8,0,141,94.33,5.67,0,2019
"2142001",10593,268,2013,12874,82.28,2.08,15.64,2019
"2142133",459,30,139,628,73.09,4.78,22.13,2019
"2142784",640,48,261,949,67.44,5.06,27.5,2019
"2142788",112,0,22,134,83.58,0,16.42,2019
"2142265",180,7,143,330,54.55,2.12,43.33,2019
"2142044",1371,32,231,1634,83.9,1.96,14.14,2019
"2142103",7741,300,752,8793,88.04,3.41,8.55,2019
"2142088",659,20,279,958,68.79,2.09,29.12,2019
"2142211",3849,222,1406,5477,70.28,4.05,25.67,2019
"2142374",83,0,48,131,63.36,0,36.64,2019
"2142037",17,0,13,30,56.67,0,43.33,2019
"2142102",84,0,22,106,79.25,0,20.75,2019
"2142124",14,0,0,14,100,0,0,2019
"2142130",103,0,0,103,100,0,0,2019
"2142156",114,0,30,144,79.17,0,20.83,2019
"2142163",49,0,0,49,100,0,0,2019
"2142322",0,0,36,36,0,0,100,2019
"2142356",0,0,0,0,NA,NA,NA,2019
"2142367",208,2,80,290,71.72,0.69,27.59,2019
"2142758",22,0,12,34,64.71,0,35.29,2019
"2142764",183,6,123,312,58.65,1.92,39.42,2019
"2142078",523,52,201,776,67.4,6.7,25.9,2019
"2142083",71,0,31,102,69.61,0,30.39,2019
"2142084",19,0,4,23,82.61,0,17.39,2019
"2142085",321,3,46,370,86.76,0.81,12.43,2019
"2142332",18,0,85,103,17.48,0,82.52,2019
"2142344",243,0,29,272,89.34,0,10.66,2019
"2142349",327,13,123,463,70.63,2.81,26.57,2019
"2142350",469,26,114,609,77.01,4.27,18.72,2019
"2142361",83,7,101,191,43.46,3.66,52.88,2019
"2142404",698,15,202,915,76.28,1.64,22.08,2019
"2142406",1024,27,309,1360,75.29,1.99,22.72,2019
"2142413",985,16,202,1203,81.88,1.33,16.79,2019
"2142450",1059,72,434,1565,67.67,4.6,27.73,2019
"2142452",706,26,141,873,80.87,2.98,16.15,2019
"2142461",339,34,127,500,67.8,6.8,25.4,2019
"2142518",775,37,310,1122,69.07,3.3,27.63,2019
"2142533",200,12,95,307,65.15,3.91,30.94,2019
"2142743",2535,81,901,3517,72.08,2.3,25.62,2019
"2142748",2459,362,631,3452,71.23,10.49,18.28,2019
"2142749",1589,134,502,2225,71.42,6.02,22.56,2019
"2142762",30,0,14,44,68.18,0,31.82,2019
"2142003",9313,272,2330,11915,78.16,2.28,19.56,2019
"2142029",2057,60,452,2569,80.07,2.34,17.59,2019
"2142031",750,46,295,1091,68.74,4.22,27.04,2019
"2142036",393,12,62,467,84.15,2.57,13.28,2019
"2142040",280,12,75,367,76.29,3.27,20.44,2019
"2142051",835,0,385,1220,68.44,0,31.56,2019
"2142076",416,9,98,523,79.54,1.72,18.74,2019
"2142082",464,27,141,632,73.42,4.27,22.31,2019
"2142104",12149,652,1125,13926,87.24,4.68,8.08,2019
"2142732",553,75,61,689,80.26,10.89,8.85,2019
"2142740",693,42,88,823,84.2,5.1,10.69,2019
"2142757",862,26,270,1158,74.44,2.25,23.32,2019
"2142776",714,42,133,889,80.31,4.72,14.96,2019
"2142782",262,20,135,417,62.83,4.8,32.37,2019
"2142035",326,0,50,376,86.7,0,13.3,2019
"2142123",259,0,20,279,92.83,0,7.17,2019
"2142153",133,7,11,151,88.08,4.64,7.28,2019
"2142167",2600,112,776,3488,74.54,3.21,22.25,2019
"2142232",287,13,47,347,82.71,3.75,13.54,2019
"2142280",98,0,43,141,69.5,0,30.5,2019
"2142286",256,8,179,443,57.79,1.81,40.41,2019
"2142325",608,12,232,852,71.36,1.41,27.23,2019
"2142339",258,0,63,321,80.37,0,19.63,2019
"2142345",3154,85,962,4201,75.08,2.02,22.9,2019
"2142369",71,6,25,102,69.61,5.88,24.51,2019
"2142411",447,33,189,669,66.82,4.93,28.25,2019
"2142437",2081,75,652,2808,74.11,2.67,23.22,2019
"2142453",191,1,40,232,82.33,0.43,17.24,2019
"2142455",801,66,299,1166,68.7,5.66,25.64,2019
"2142464",519,10,156,685,75.77,1.46,22.77,2019
"2142503",7235,328,1735,9298,77.81,3.53,18.66,2019
"2142516",130,0,71,201,64.68,0,35.32,2019
"2142544",1649,177,550,2376,69.4,7.45,23.15,2019
"2142713",569,22,208,799,71.21,2.75,26.03,2019
"2142054",255,0,68,323,78.95,0,21.05,2019
"2142060",0,0,0,0,NA,NA,NA,2019
"2142066",6728,331,2086,9145,73.57,3.62,22.81,2019
"2142127",1910,123,501,2534,75.37,4.85,19.77,2019
"2142025",6363,220,1463,8046,79.08,2.73,18.18,2019
"2142039",522,78,97,697,74.89,11.19,13.92,2019
"2142053",1647,47,369,2063,79.84,2.28,17.89,2019
"2142634",338,27,164,529,63.89,5.1,31,2019
"1847982",55,4,13,72,76.39,5.56,18.06,2019
"1847987",1367,40,315,1722,79.38,2.32,18.29,2019
"1847990",592,34,102,728,81.32,4.67,14.01,2019
"1847997",36,3,13,52,69.23,5.77,25,2019
"1847368",864,69,247,1180,73.22,5.85,20.93,2019
"1847381",48,1,9,58,82.76,1.72,15.52,2019
"1847451",346,6,121,473,73.15,1.27,25.58,2019
"1847460",3491,92,1165,4748,73.53,1.94,24.54,2019
"1847462",1525,0,241,1766,86.35,0,13.65,2019
"1847516",319,4,109,432,73.84,0.93,25.23,2019
"1847610",1836,71,283,2190,83.84,3.24,12.92,2019
"1847612",225,2,82,309,72.82,0.65,26.54,2019
"1847619",522,33,170,725,72,4.55,23.45,2019
"1847970",621,29,93,743,83.58,3.9,12.52,2019
"1847981",337,9,29,375,89.87,2.4,7.73,2019
"1847983",89,27,0,116,76.72,23.28,0,2019
"1847243",1522,87,340,1949,78.09,4.46,17.44,2019
"1847280",214,21,36,271,78.97,7.75,13.28,2019
"1847337",41,1,15,57,71.93,1.75,26.32,2019
"1847846",168,0,39,207,81.16,0,18.84,2019
"1847853",44,3,6,53,83.02,5.66,11.32,2019
"1847854",177,25,52,254,69.69,9.84,20.47,2019
"1847868",922,33,338,1293,71.31,2.55,26.14,2019
"1847901",1569,173,388,2130,73.66,8.12,18.22,2019
"1847906",20794,2308,1203,24305,85.55,9.5,4.95,2019
"1847921",301,9,69,379,79.42,2.37,18.21,2019
"1847932",1812,78,290,2180,83.12,3.58,13.3,2019
"1847940",575,15,65,655,87.79,2.29,9.92,2019
"1847546",7432,174,1232,8838,84.09,1.97,13.94,2019
"1847025",7381,112,1059,8552,86.31,1.31,12.38,2019
"1847141",426,0,108,534,79.78,0,20.22,2019
"1847232",970,56,157,1183,81.99,4.73,13.27,2019
"1847429",3239,84,246,3569,90.75,2.35,6.89,2019
"1847611",412,12,109,533,77.3,2.25,20.45,2019
"1847992",521,0,7,528,98.67,0,1.33,2019
"1847040",1648,113,514,2275,72.44,4.97,22.59,2019
"1847161",891,0,304,1195,74.56,0,25.44,2019
"1847150",14338,420,4139,18897,75.87,2.22,21.9,2019
"1847250",6889,477,1783,9149,75.3,5.21,19.49,2019
"1847711",10921,315,1854,13090,83.43,2.41,14.16,2019
"1847725",6020,136,365,6521,92.32,2.09,5.6,2019
"1847802",11211,364,1885,13460,83.29,2.7,14,2019
"1847837",281,20,162,463,60.69,4.32,34.99,2019
"1847858",162,0,90,252,64.29,0,35.71,2019
"1847865",18,0,0,18,100,0,0,2019
"1847917",136,2,24,162,83.95,1.23,14.81,2019
"1847925",53,0,8,61,86.89,0,13.11,2019
"1847963",704,21,114,839,83.91,2.5,13.59,2019
"1847967",228,8,48,284,80.28,2.82,16.9,2019
"1847974",395,9,116,520,75.96,1.73,22.31,2019
"1847978",3442,77,724,4243,81.12,1.81,17.06,2019
"1847283",886,29,312,1227,72.21,2.36,25.43,2019
"1847362",8408,546,2175,11129,75.55,4.91,19.54,2019
"1847106",1456,30,326,1812,80.35,1.66,17.99,2019
"1847670",4027,84,810,4921,81.83,1.71,16.46,2019
"1847930",415,7,72,494,84.01,1.42,14.57,2019
"1847665",1204,6,193,1403,85.82,0.43,13.76,2019
"1847872",1880,49,970,2899,64.85,1.69,33.46,2019
"1847123",25,0,17,42,59.52,0,40.48,2019
"3168407",195,0,59,254,76.77,0,23.23,2019
"3168437",91,8,13,112,81.25,7.14,11.61,2019
"3168447",146,1,98,245,59.59,0.41,40,2019
"3168460",251,11,27,289,86.85,3.81,9.34,2019
"3168465",660,3,207,870,75.86,0.34,23.79,2019
"3168502",9496,299,1355,11150,85.17,2.68,12.15,2019
"3168523",490,0,7,497,98.59,0,1.41,2019
"3168532",224,0,0,224,100,0,0,2019
"3168621",119,15,69,203,58.62,7.39,33.99,2019
"3858353",32,0,26,58,55.17,0,44.83,2019
"3858361",79,9,25,113,69.91,7.96,22.12,2019
"3858372",34,4,5,43,79.07,9.3,11.63,2019
"3858386",44,5,8,57,77.19,8.77,14.04,2019
"3858401",6018,251,1360,7629,78.88,3.29,17.83,2019
"3858431",47,2,6,55,85.45,3.64,10.91,2019
"3858433",335,18,129,482,69.5,3.73,26.76,2019
"3858454",93,11,34,138,67.39,7.97,24.64,2019
"3858532",95,0,19,114,83.33,0,16.67,2019
"3858542",68,4,43,115,59.13,3.48,37.39,2019
"3858568",154,0,66,220,70,0,30,2019
"3858576",296,22,83,401,73.82,5.49,20.7,2019
"3858581",103,7,12,122,84.43,5.74,9.84,2019
"3858634",83,0,3,86,96.51,0,3.49,2019
"3858636",313,21,29,363,86.23,5.79,7.99,2019
"3858638",411,26,87,524,78.44,4.96,16.6,2019
"3858651",194,2,58,254,76.38,0.79,22.83,2019
"3858716",37,1,25,63,58.73,1.59,39.68,2019
"3858756",92,0,5,97,94.85,0,5.15,2019
"3858759",222,50,62,334,66.47,14.97,18.56,2019
"3858761",337,4,33,374,90.11,1.07,8.82,2019
"3858768",99,0,16,115,86.09,0,13.91,2019
"3858778",32,4,9,45,71.11,8.89,20,2019
"3858785",431,18,77,526,81.94,3.42,14.64,2019
"3858795",41,21,18,80,51.25,26.25,22.5,2019
"3858844",29,0,6,35,82.86,0,17.14,2019
"3858571",186,16,40,242,76.86,6.61,16.53,2019
"3858573",191,5,75,271,70.48,1.85,27.68,2019
"3858620",52,0,6,58,89.66,0,10.34,2019
"3858655",193,6,28,227,85.02,2.64,12.33,2019
"3858621",455,38,161,654,69.57,5.81,24.62,2019
"3858626",127,5,32,164,77.44,3.05,19.51,2019
"3858653",289,8,24,321,90.03,2.49,7.48,2019
"3858704",1445,35,14,1494,96.72,2.34,0.94,2019
"3858744",40,6,10,56,71.43,10.71,17.86,2019
"3858752",116,6,3,125,92.8,4.8,2.4,2019
"3858776",55,0,37,92,59.78,0,40.22,2019
"3858790",596,19,116,731,81.53,2.6,15.87,2019
"3858030",209,5,45,259,80.69,1.93,17.37,2019
"3858038",124,0,17,141,87.94,0,12.06,2019
"3858041",473,8,152,633,74.72,1.26,24.01,2019
"3858064",152,10,34,196,77.55,5.1,17.35,2019
"3858079",147,0,16,163,90.18,0,9.82,2019
"3858081",284,9,50,343,82.8,2.62,14.58,2019
"3858214",116,4,27,147,78.91,2.72,18.37,2019
"3858230",227,7,38,272,83.46,2.57,13.97,2019
"3858243",213,5,82,300,71,1.67,27.33,2019
"3858730",335,94,194,623,53.77,15.09,31.14,2019
"3858733",117,7,5,129,90.7,5.43,3.88,2019
"3858736",196,6,42,244,80.33,2.46,17.21,2019
"3944081",2305,50,258,2613,88.21,1.91,9.87,2019
"3944087",7619,127,920,8666,87.92,1.47,10.62,2019
"3944092",6611,189,1030,7830,84.43,2.41,13.15,2019
"3944104",4710,527,3740,8977,52.47,5.87,41.66,2019
"3944108",5469,455,3392,9316,58.71,4.88,36.41,2019
"3944120",11577,486,4033,16096,71.92,3.02,25.06,2019
"3944121",11341,289,2193,13823,82.04,2.09,15.86,2019
"3944126",6315,104,680,7099,88.96,1.46,9.58,2019
"3944133",11223,236,1400,12859,87.28,1.84,10.89,2019
"3944145",12432,198,1179,13809,90.03,1.43,8.54,2019
"3944147",7146,45,484,7675,93.11,0.59,6.31,2019
"3944202",6888,126,706,7720,89.22,1.63,9.15,2019
"3944254",1695,76,366,2137,79.32,3.56,17.13,2019
"3944255",2188,218,703,3109,70.38,7.01,22.61,2019
"3944280",1549,45,134,1728,89.64,2.6,7.75,2019
"3944286",2093,29,187,2309,90.65,1.26,8.1,2019
"3944833",5515,224,1208,6947,79.39,3.22,17.39,2019
"3944805",10123,255,2283,12661,79.95,2.01,18.03,2019
"3944814",864,34,96,994,86.92,3.42,9.66,2019
"3944820",5995,257,1254,7506,79.87,3.42,16.71,2019
"3944828",34,0,0,34,100,0,0,2019
"3944837",1019,123,474,1616,63.06,7.61,29.33,2019
"3944838",78,0,19,97,80.41,0,19.59,2019
"3944865",798,50,214,1062,75.14,4.71,20.15,2019
"3944878",684,8,311,1003,68.2,0.8,31.01,2019
"3944887",219,31,86,336,65.18,9.23,25.6,2019
"3944904",4704,109,921,5734,82.04,1.9,16.06,2019
"3944022",6353,114,273,6740,94.26,1.69,4.05,2019
"3944026",3781,69,529,4379,86.34,1.58,12.08,2019
"3944080",44,0,57,101,43.56,0,56.44,2019
"3944836",655,5,233,893,73.35,0.56,26.09,2019
"3944851",1484,58,325,1867,79.49,3.11,17.41,2019
"3944856",62,0,63,125,49.6,0,50.4,2019
"3944866",587,63,155,805,72.92,7.83,19.25,2019
"3944902",1223,85,644,1952,62.65,4.35,32.99,2019
"3944023",6026,160,518,6704,89.89,2.39,7.73,2019
"3944074",3207,222,414,3843,83.45,5.78,10.77,2019
"3944084",967,30,148,1145,84.45,2.62,12.93,2019
"3944105",9984,424,5019,15427,64.72,2.75,32.53,2019
"3944106",7818,783,2553,11154,70.09,7.02,22.89,2019
"3944107",21217,647,2917,24781,85.62,2.61,11.77,2019
"3944109",12521,804,3954,17279,72.46,4.65,22.88,2019
"3944115",2368,331,1352,4051,58.45,8.17,33.37,2019
"3944117",2976,305,1742,5023,59.25,6.07,34.68,2019
"3944666",881,58,64,1003,87.84,5.78,6.38,2019
"3944710",3174,94,598,3866,82.1,2.43,15.47,2019
"3944138",8157,201,909,9267,88.02,2.17,9.81,2019
"3944217",1147,11,204,1362,84.21,0.81,14.98,2019
"3944124",14771,446,2072,17289,85.44,2.58,11.98,2019
"3944143",9030,279,1445,10754,83.97,2.59,13.44,2019
"1847227",622,71,184,877,70.92,8.1,20.98,2019
"1847467",29,0,17,46,63.04,0,36.96,2019
"1847525",87,13,54,154,56.49,8.44,35.06,2019
"1847637",383,2,141,526,72.81,0.38,26.81,2019
"1847918",1916,24,597,2537,75.52,0.95,23.53,2019
"1847433",1288,19,315,1622,79.41,1.17,19.42,2019
"1847535",208,0,32,240,86.67,0,13.33,2019
"1847635",1601,66,506,2173,73.68,3.04,23.29,2019
"1847989",312,3,161,476,65.55,0.63,33.82,2019
"1847369",440,29,134,603,72.97,4.81,22.22,2019
"1847952",898,22,229,1149,78.15,1.91,19.93,2019
"1847104",0,0,0,0,NA,NA,NA,2019
"1847110",102,0,13,115,88.7,0,11.3,2019
"1847306",0,0,4,4,0,0,100,2019
"1847324",42,13,11,66,63.64,19.7,16.67,2019
"1847335",225,27,71,323,69.66,8.36,21.98,2019
"1847367",33,0,11,44,75,0,25,2019
"1847388",94,10,21,125,75.2,8,16.8,2019
"1847405",0,0,0,0,NA,NA,NA,2019
"1847434",0,0,0,0,NA,NA,NA,2019
"1847437",59,0,28,87,67.82,0,32.18,2019
"1847457",60,0,0,60,100,0,0,2019
"1847458",19,0,0,19,100,0,0,2019
"1847809",0,0,0,0,NA,NA,NA,2019
"1847857",104,0,31,135,77.04,0,22.96,2019
"1847869",77,0,0,77,100,0,0,2019
"1847871",97,3,25,125,77.6,2.4,20,2019
"1847880",20,0,20,40,50,0,50,2019
"1847907",0,0,0,0,NA,NA,NA,2019
"1847382",70,6,22,98,71.43,6.12,22.45,2019
"1847522",75,0,29,104,72.12,0,27.88,2019
"1847574",75,0,0,75,100,0,0,2019
"1847630",12560,129,1347,14036,89.48,0.92,9.6,2019
"1847805",4352,159,629,5140,84.67,3.09,12.24,2019
"1847536",0,0,0,0,NA,NA,NA,2019
"1847537",262,14,74,350,74.86,4,21.14,2019
"1847568",175,2,112,289,60.55,0.69,38.75,2019
"1847576",117,0,22,139,84.17,0,15.83,2019
"1847588",204,4,59,267,76.4,1.5,22.1,2019
"1847590",187,0,77,264,70.83,0,29.17,2019
"1847596",28,0,7,35,80,0,20,2019
"1847616",77,0,9,86,89.53,0,10.47,2019
"1847648",1368,46,285,1699,80.52,2.71,16.77,2019
"1847683",85,2,2,89,95.51,2.25,2.25,2019
"1847708",156,6,26,188,82.98,3.19,13.83,2019
"1847443",266,13,143,422,63.03,3.08,33.89,2019
"1847396",2303,81,408,2792,82.49,2.9,14.61,2019
"1847403",11932,646,1544,14122,84.49,4.57,10.93,2019
"1847432",1407,22,507,1936,72.68,1.14,26.19,2019
"1847452",1392,53,548,1993,69.84,2.66,27.5,2019
"1847464",66,5,16,87,75.86,5.75,18.39,2019
"1847470",419,18,234,671,62.44,2.68,34.87,2019
"1847036",185,37,90,312,59.29,11.86,28.85,2019
"1847060",2020,76,219,2315,87.26,3.28,9.46,2019
"1847120",167,0,117,284,58.8,0,41.2,2019
"1847136",1140,18,428,1586,71.88,1.13,26.99,2019
"1847959",856,5,204,1065,80.38,0.47,19.15,2019
"1847964",34,0,12,46,73.91,0,26.09,2019
"1847968",363,11,30,404,89.85,2.72,7.43,2019
"3858063",123,5,17,145,84.83,3.45,11.72,2019
"3858102",10687,1122,1557,13366,79.96,8.39,11.65,2019
"3858204",656,26,36,718,91.36,3.62,5.01,2019
"3858212",148,34,82,264,56.06,12.88,31.06,2019
"3858220",657,8,257,922,71.26,0.87,27.87,2019
"3858229",27,2,9,38,71.05,5.26,23.68,2019
"3858250",68,0,38,106,64.15,0,35.85,2019
"3858267",412,5,151,568,72.54,0.88,26.58,2019
"3858271",191,0,87,278,68.71,0,31.29,2019
"4657475",50,0,8,58,86.21,0,13.79,2019
"4657476",170,0,17,187,90.91,0,9.09,2019
"4657534",82,6,19,107,76.64,5.61,17.76,2019
"4657547",41,0,23,64,64.06,0,35.94,2019
"4657551",525,57,207,789,66.54,7.22,26.24,2019
"4657564",312,9,86,407,76.66,2.21,21.13,2019
"4657567",367,37,183,587,62.52,6.3,31.18,2019
"4657574",40,0,0,40,100,0,0,2019
"4657319",289,3,82,374,77.27,0.8,21.93,2019
"4657339",193,24,199,416,46.39,5.77,47.84,2019
"4657340",84,1,33,118,71.19,0.85,27.97,2019
"4657345",410,11,91,512,80.08,2.15,17.77,2019
"4657337",37,3,9,49,75.51,6.12,18.37,2019
"4657341",44,0,12,56,78.57,0,21.43,2019
"4657350",4536,242,1567,6345,71.49,3.81,24.7,2019
"4657365",215,11,33,259,83.01,4.25,12.74,2019
"4657366",670,44,217,931,71.97,4.73,23.31,2019
"4657369",666,55,287,1008,66.07,5.46,28.47,2019
"4657371",53,0,18,71,74.65,0,25.35,2019
"4657373",192,0,54,246,78.05,0,21.95,2019
"4657434",180,1,15,196,91.84,0.51,7.65,2019
"4657438",368,14,126,508,72.44,2.76,24.8,2019
"4657440",118,2,55,175,67.43,1.14,31.43,2019
"4657450",171,6,40,217,78.8,2.76,18.43,2019
"4657454",220,9,36,265,83.02,3.4,13.58,2019
"4657461",150,1,13,164,91.46,0.61,7.93,2019
"4657473",37,16,33,86,43.02,18.6,38.37,2019
"4657474",58,0,7,65,89.23,0,10.77,2019
"4657477",47,0,3,50,94,0,6,2019
"4657521",13,9,42,64,20.31,14.06,65.62,2019
"4657529",116,2,21,139,83.45,1.44,15.11,2019
"4657572",195,10,285,490,39.8,2.04,58.16,2019
"4657585",44,2,19,65,67.69,3.08,29.23,2019
"4657625",632,9,528,1169,54.06,0.77,45.17,2019
"4657636",16,0,31,47,34.04,0,65.96,2019
"4657747",2197,75,355,2627,83.63,2.85,13.51,2019
"4657430",727,34,207,968,75.1,3.51,21.38,2019
"4657433",170,9,19,198,85.86,4.55,9.6,2019
"4657471",162,22,43,227,71.37,9.69,18.94,2019
"4657479",214,3,15,232,92.24,1.29,6.47,2019
"4657531",48,0,2,50,96,0,4,2019
"4657536",99,4,33,136,72.79,2.94,24.26,2019
"4657540",24,0,0,24,100,0,0,2019
"4657548",227,15,157,399,56.89,3.76,39.35,2019
"4657553",52,0,0,52,100,0,0,2019
"4657555",562,77,584,1223,45.95,6.3,47.75,2019
"4657562",25,0,0,25,100,0,0,2019
"4657571",5,0,0,5,100,0,0,2019
"4657620",170,2,35,207,82.13,0.97,16.91,2019
"4657621",36,3,32,71,50.7,4.23,45.07,2019
"3944144",7389,335,1872,9596,77,3.49,19.51,2019
"3944221",11247,170,1909,13326,84.4,1.28,14.33,2019
"3944230",3070,67,381,3518,87.27,1.9,10.83,2019
"3944235",420,40,138,598,70.23,6.69,23.08,2019
"3944236",8339,311,517,9167,90.97,3.39,5.64,2019
"3944240",13244,1420,1670,16334,81.08,8.69,10.22,2019
"3944262",1697,106,248,2051,82.74,5.17,12.09,2019
"3944270",2877,137,479,3493,82.36,3.92,13.71,2019
"3944303",3137,54,413,3604,87.04,1.5,11.46,2019
"3944622",5602,299,1287,7188,77.94,4.16,17.9,2019
"3944627",490,34,1113,1637,29.93,2.08,67.99,2019
"3944628",204,12,127,343,59.48,3.5,37.03,2019
"3944629",767,23,182,972,78.91,2.37,18.72,2019
"3944632",3181,75,391,3647,87.22,2.06,10.72,2019
"3944646",16646,371,2369,19386,85.87,1.91,12.22,2019
"3944657",3349,62,556,3967,84.42,1.56,14.02,2019
"3944672",1470,69,407,1946,75.54,3.55,20.91,2019
"3944695",430,48,147,625,68.8,7.68,23.52,2019
"3944802",339,17,49,405,83.7,4.2,12.1,2019
"3944815",199,14,72,285,69.82,4.91,25.26,2019
"3944818",743,11,164,918,80.94,1.2,17.86,2019
"3944839",4308,290,641,5239,82.23,5.54,12.24,2019
"3944840",810,38,103,951,85.17,4,10.83,2019
"3944853",462,17,80,559,82.65,3.04,14.31,2019
"3944857",7883,224,1369,9476,83.19,2.36,14.45,2019
"3944875",4506,303,1078,5887,76.54,5.15,18.31,2019
"3944011",7597,199,312,8108,93.7,2.45,3.85,2019
"3944021",1596,0,700,2296,69.51,0,30.49,2019
"3944028",2861,110,333,3304,86.59,3.33,10.08,2019
"3944053",6207,451,1504,8162,76.05,5.53,18.43,2019
"3944056",4107,94,409,4610,89.09,2.04,8.87,2019
"3944057",6380,104,1027,7511,84.94,1.38,13.67,2019
"3944062",1835,19,1999,3853,47.63,0.49,51.88,2019
"3944405",2430,109,766,3305,73.52,3.3,23.18,2019
"3944410",6393,200,972,7565,84.51,2.64,12.85,2019
"3944413",2309,142,424,2875,80.31,4.94,14.75,2019
"3944420",5039,540,1103,6682,75.41,8.08,16.51,2019
"3944437",1318,125,346,1789,73.67,6.99,19.34,2019
"3944473",1182,53,216,1451,81.46,3.65,14.89,2019
"3944502",2684,176,919,3779,71.02,4.66,24.32,2019
"3944611",511,34,184,729,70.1,4.66,25.24,2019
"3944613",635,24,139,798,79.57,3.01,17.42,2019
"3944621",1453,29,279,1761,82.51,1.65,15.84,2019
"3944626",940,35,133,1108,84.84,3.16,12,2019
"3944656",879,41,210,1130,77.79,3.63,18.58,2019
"3944663",8157,303,2218,10678,76.39,2.84,20.77,2019
"3944680",1431,27,297,1755,81.54,1.54,16.92,2019
"3944681",1587,112,866,2565,61.87,4.37,33.76,2019
"3944706",5643,232,1201,7076,79.75,3.28,16.97,2019
"3944709",7009,253,1139,8401,83.43,3.01,13.56,2019
"1847993",1183,28,249,1460,81.03,1.92,17.05,2019
"1847143",914,7,113,1034,88.39,0.68,10.93,2019
"1847164",1097,30,646,1773,61.87,1.69,36.44,2019
"1847167",4082,194,1736,6012,67.9,3.23,28.88,2019
"1847223",307,0,142,449,68.37,0,31.63,2019
"1847229",917,7,261,1185,77.38,0.59,22.03,2019
"1847234",468,9,103,580,80.69,1.55,17.76,2019
"1847246",1138,45,450,1633,69.69,2.76,27.56,2019
"1847264",345,0,172,517,66.73,0,33.27,2019
"2648726",1690,73,519,2282,74.06,3.2,22.74,2019
"2648734",2806,58,456,3320,84.52,1.75,13.73,2019
"2648741",632,10,155,797,79.3,1.25,19.45,2019
"2648744",1149,137,479,1765,65.1,7.76,27.14,2019
"2648754",213,31,117,361,59,8.59,32.41,2019
"2648757",1217,95,247,1559,78.06,6.09,15.84,2019
"2648801",3795,267,1030,5092,74.53,5.24,20.23,2019
"2648806",441,31,174,646,68.27,4.8,26.93,2019
"2648815",752,38,113,903,83.28,4.21,12.51,2019
"2648818",764,39,219,1022,74.76,3.82,21.43,2019
"2648832",487,5,97,589,82.68,0.85,16.47,2019
"2648850",1155,45,496,1696,68.1,2.65,29.25,2019
"2648856",194,30,159,383,50.65,7.83,41.51,2019
"2648861",505,10,57,572,88.29,1.75,9.97,2019
"2648866",1478,65,302,1845,80.11,3.52,16.37,2019
"2648895",3912,164,435,4511,86.72,3.64,9.64,2019
"2648896",54,0,28,82,65.85,0,34.15,2019
"2648933",1110,3,348,1461,75.98,0.21,23.82,2019
"2648706",13995,318,2396,16709,83.76,1.9,14.34,2019
"2648653",3959,138,592,4689,84.43,2.94,12.63,2019
"2648662",423,67,160,650,65.08,10.31,24.62,2019
"2648703",1115,53,317,1485,75.08,3.57,21.35,2019
"2648872",2224,98,330,2652,83.86,3.7,12.44,2019
"2648837",7034,242,928,8204,85.74,2.95,11.31,2019
"2648840",5194,173,473,5840,88.94,2.96,8.1,2019
"2648847",1705,67,520,2292,74.39,2.92,22.69,2019
"2648875",3384,133,391,3908,86.59,3.4,10.01,2019
"2648880",1810,79,634,2523,71.74,3.13,25.13,2019
"2648881",1771,20,352,2143,82.64,0.93,16.43,2019
"2648235",11983,852,5364,18199,65.84,4.68,29.47,2019
"2648236",10121,268,897,11286,89.68,2.37,7.95,2019
"2648301",5106,92,303,5501,92.82,1.67,5.51,2019
"2648302",5821,106,285,6212,93.71,1.71,4.59,2019
"2648313",11797,246,1241,13284,88.81,1.85,9.34,2019
"2648314",7164,212,920,8296,86.35,2.56,11.09,2019
"2648326",8486,250,913,9649,87.95,2.59,9.46,2019
"2648328",9632,363,1266,11261,85.53,3.22,11.24,2019
"2648342",4678,166,1717,6561,71.3,2.53,26.17,2019
"2648353",2216,73,259,2548,86.97,2.86,10.16,2019
"2648416",1358,74,457,1889,71.89,3.92,24.19,2019
"2648433",8532,168,1346,10046,84.93,1.67,13.4,2019
"2648454",390,22,87,499,78.16,4.41,17.43,2019
"2648455",2652,103,322,3077,86.19,3.35,10.46,2019
"2648458",5692,438,1725,7855,72.46,5.58,21.96,2019
"2648466",447,33,147,627,71.29,5.26,23.44,2019
"2648468",393,17,133,543,72.38,3.13,24.49,2019
"2648509",3172,42,571,3785,83.8,1.11,15.09,2019
"2648519",2303,27,609,2939,78.36,0.92,20.72,2019
"2648602",9437,268,2587,12292,76.77,2.18,21.05,2019
"2648607",409,13,300,722,56.65,1.8,41.55,2019
"4657645",51,0,11,62,82.26,0,17.74,2019
"4657657",58,0,18,76,76.32,0,23.68,2019
"4657725",96,0,22,118,81.36,0,18.64,2019
"4657735",393,28,156,577,68.11,4.85,27.04,2019
"4657748",66,0,33,99,66.67,0,33.33,2019
"4657788",105,29,36,170,61.76,17.06,21.18,2019
"4657799",0,0,0,0,NA,NA,NA,2019
"4657790",317,40,64,421,75.3,9.5,15.2,2019
"4657766",45,0,6,51,88.24,0,11.76,2019
"2066968",480,47,132,659,72.84,7.13,20.03,2019
"2066770",307,23,73,403,76.18,5.71,18.11,2019
"2066870",32,3,23,58,55.17,5.17,39.66,2019
"2066956",339,23,149,511,66.34,4.5,29.16,2019
"2066085",2946,57,61,3064,96.15,1.86,1.99,2019
"2066216",8446,223,552,9221,91.6,2.42,5.99,2019
"2066010",200,0,139,339,59,0,41,2019
"2066031",0,0,0,0,NA,NA,NA,2019
"2066045",0,0,0,0,NA,NA,NA,2019
"2066621",0,0,0,0,NA,NA,NA,2019
"2066622",0,0,0,0,NA,NA,NA,2019
"2066728",17,0,8,25,68,0,32,2019
"2066873",80,7,28,115,69.57,6.09,24.35,2019
"2965580",216,19,42,277,77.98,6.86,15.16,2019
"2965618",58,0,21,79,73.42,0,26.58,2019
"2965647",493,99,261,853,57.8,11.61,30.6,2019
"2965745",470,107,550,1127,41.7,9.49,48.8,2019
"2965789",455,14,202,671,67.81,2.09,30.1,2019
"2965321",129,3,40,172,75,1.74,23.26,2019
"2965612",441,11,63,515,85.63,2.14,12.23,2019
"2965664",41,0,10,51,80.39,0,19.61,2019
"2965755",125,0,109,234,53.42,0,46.58,2019
"2965634",152,0,81,233,65.24,0,34.76,2019
"2965704",1053,14,320,1387,75.92,1.01,23.07,2019
"2965215",0,0,0,0,NA,NA,NA,2019
"2965584",3455,212,336,4003,86.31,5.3,8.39,2019
"2965586",0,0,45,45,0,0,100,2019
"2965654",56,2,32,90,62.22,2.22,35.56,2019
"2066043",2638,171,210,3019,87.38,5.66,6.96,2019
"2066047",7407,343,708,8458,87.57,4.06,8.37,2019
"2066048",10629,495,2063,13187,80.6,3.75,15.64,2019
"2066053",2271,159,312,2742,82.82,5.8,11.38,2019
"2066054",847,12,120,979,86.52,1.23,12.26,2019
"2066060",370,10,117,497,74.45,2.01,23.54,2019
"2066103",4732,419,914,6065,78.02,6.91,15.07,2019
"2066112",4187,219,755,5161,81.13,4.24,14.63,2019
"2066208",8579,134,421,9134,93.92,1.47,4.61,2019
"2066224",4600,47,44,4691,98.06,1,0.94,2019
"2066411",414,4,105,523,79.16,0.76,20.08,2019
"2066412",44,0,40,84,52.38,0,47.62,2019
"2066432",74,13,47,134,55.22,9.7,35.07,2019
"2066438",50,5,0,55,90.91,9.09,0,2019
"2066451",537,16,103,656,81.86,2.44,15.7,2019
"2066522",48,0,1,49,97.96,0,2.04,2019
"2066540",146,18,46,210,69.52,8.57,21.9,2019
"2066546",278,66,75,419,66.35,15.75,17.9,2019
"2066604",7008,1174,1681,9863,71.05,11.9,17.04,2019
"2066614",10531,1474,1922,13927,75.62,10.58,13.8,2019
"2066712",545,22,199,766,71.15,2.87,25.98,2019
"2066753",368,21,79,468,78.63,4.49,16.88,2019
"3944714",3169,226,689,4084,77.6,5.53,16.87,2019
"3945711",279,21,129,429,65.03,4.9,30.07,2019
"3945744",744,41,330,1115,66.73,3.68,29.6,2019
"3945766",332,15,147,494,67.21,3.04,29.76,2019
"3945786",965,15,299,1279,75.45,1.17,23.38,2019
"3945788",250,0,192,442,56.56,0,43.44,2019
"3945819",109,0,17,126,86.51,0,13.49,2019
"3945832",911,39,217,1167,78.06,3.34,18.59,2019
"3945840",20621,586,2585,23792,86.67,2.46,10.86,2019
"3945845",963,4,148,1115,86.37,0.36,13.27,2019
"3945863",441,9,66,516,85.47,1.74,12.79,2019
"3945729",494,14,93,601,82.2,2.33,15.47,2019
"3945347",1380,25,340,1745,79.08,1.43,19.48,2019
"3945381",1633,56,402,2091,78.1,2.68,19.23,2019
"3945414",7344,203,1432,8979,81.79,2.26,15.95,2019
"3945417",7786,446,3796,12028,64.73,3.71,31.56,2019
"3945426",5252,206,1347,6805,77.18,3.03,19.79,2019
"3945504",5574,135,911,6620,84.2,2.04,13.76,2019
"3945309",4305,142,748,5195,82.87,2.73,14.4,2019
"3945369",1076,66,230,1372,78.43,4.81,16.76,2019
"3945620",200,8,117,325,61.54,2.46,36,2019
"3945653",1219,6,315,1540,79.16,0.39,20.45,2019
"3945693",2166,107,1180,3453,62.73,3.1,34.17,2019
"3945770",182,5,92,279,65.23,1.79,32.97,2019
"3945873",585,38,122,745,78.52,5.1,16.38,2019
"3945619",2199,148,720,3067,71.7,4.83,23.48,2019
"3945732",1082,82,554,1718,62.98,4.77,32.25,2019
"3945817",2206,67,278,2551,86.48,2.63,10.9,2019
"3945870",72,0,0,72,100,0,0,2019
"3945836",416,18,113,547,76.05,3.29,20.66,2019
"3945384",111,0,0,111,100,0,0,2019
"3945011",21610,435,2530,24575,87.93,1.77,10.3,2019
"3945032",113,4,20,137,82.48,2.92,14.6,2019
"3945070",59,2,19,80,73.75,2.5,23.75,2019
"3945101",717,7,297,1021,70.23,0.69,29.09,2019
"3945123",2389,102,948,3439,69.47,2.97,27.57,2019
"3945130",1229,35,294,1558,78.88,2.25,18.87,2019
"3945140",19054,457,1173,20684,92.12,2.21,5.67,2019
"3945162",891,18,78,987,90.27,1.82,7.9,2019
"3945177",7406,274,1322,9002,82.27,3.04,14.69,2019
"3945205",5920,254,1176,7350,80.54,3.46,16,2019
"3945206",4161,200,1577,5938,70.07,3.37,26.56,2019
"3945212",8198,291,1654,10143,80.82,2.87,16.31,2019
"3945216",2675,195,993,3863,69.25,5.05,25.71,2019
"3945219",5462,358,649,6469,84.43,5.53,10.03,2019
"3945225",3070,164,750,3984,77.06,4.12,18.83,2019
"3945241",9224,142,704,10070,91.6,1.41,6.99,2019
"3945248",9084,131,759,9974,91.08,1.31,7.61,2019
"3945051",0,0,0,0,NA,NA,NA,2019
"3945145",10,0,0,10,100,0,0,2019
"2648609",4346,260,607,5213,83.37,4.99,11.64,2019
"2648631",1426,3,285,1714,83.2,0.18,16.63,2019
"2648632",1506,53,582,2141,70.34,2.48,27.18,2019
"2648637",949,40,264,1253,75.74,3.19,21.07,2019
"2648724",124,0,106,230,53.91,0,46.09,2019
"2648738",424,31,106,561,75.58,5.53,18.89,2019
"2648739",1457,50,457,1964,74.19,2.55,23.27,2019
"2648748",629,21,162,812,77.46,2.59,19.95,2019
"2648749",325,9,127,461,70.5,1.95,27.55,2019
"1847359",884,100,330,1314,67.28,7.61,25.11,2019
"1847371",3375,426,995,4796,70.37,8.88,20.75,2019
"1847247",61,0,13,74,82.43,0,17.57,2019
"1847263",71,4,31,106,66.98,3.77,29.25,2019
"1847303",8369,486,1633,10488,79.8,4.63,15.57,2019
"1847305",1203,82,440,1725,69.74,4.75,25.51,2019
"1847334",1107,35,169,1311,84.44,2.67,12.89,2019
"1847345",382,16,113,511,74.76,3.13,22.11,2019
"1847352",220,30,53,303,72.61,9.9,17.49,2019
"1847885",2652,50,894,3596,73.75,1.39,24.86,2019
"1847933",9209,281,1801,11291,81.56,2.49,15.95,2019
"1847951",735,21,180,936,78.53,2.24,19.23,2019
"1847960",5255,107,1058,6420,81.85,1.67,16.48,2019
"1847965",208,3,26,237,87.76,1.27,10.97,2019
"1847966",141,0,23,164,85.98,0,14.02,2019
"1847971",517,58,163,738,70.05,7.86,22.09,2019
"1847118",846,8,395,1249,67.73,0.64,31.63,2019
"1847122",3212,60,529,3801,84.5,1.58,13.92,2019
"1847135",294,1,32,327,89.91,0.31,9.79,2019
"1847170",3906,303,1466,5675,68.83,5.34,25.83,2019
"1847172",4977,109,1064,6150,80.93,1.77,17.3,2019
"1847177",351,9,128,488,71.93,1.84,26.23,2019
"1847203",8838,177,1327,10342,85.46,1.71,12.83,2019
"1847336",888,113,317,1318,67.37,8.57,24.05,2019
"1847339",96,13,94,203,47.29,6.4,46.31,2019
"1847356",1775,39,405,2219,79.99,1.76,18.25,2019
"1847373",727,89,223,1039,69.97,8.57,21.46,2019
"1847384",499,54,172,725,68.83,7.45,23.72,2019
"1847387",214,4,56,274,78.1,1.46,20.44,2019
"1847401",15869,778,1099,17746,89.42,4.38,6.19,2019
"1847404",8179,741,1147,10067,81.25,7.36,11.39,2019
"1847420",73,0,80,153,47.71,0,52.29,2019
"1847438",1135,55,539,1729,65.64,3.18,31.17,2019
"1847465",144,3,56,203,70.94,1.48,27.59,2019
"1847469",554,4,166,724,76.52,0.55,22.93,2019
"1847501",5124,112,1584,6820,75.13,1.64,23.23,2019
"1847527",588,15,168,771,76.26,1.95,21.79,2019
"1847552",80,0,14,94,85.11,0,14.89,2019
"1847561",434,3,261,698,62.18,0.43,37.39,2019
"1847562",1096,47,458,1601,68.46,2.94,28.61,2019
"1847580",62,0,73,135,45.93,0,54.07,2019
"1847581",1036,13,531,1580,65.57,0.82,33.61,2019
"1847586",3653,112,993,4758,76.78,2.35,20.87,2019
"1847916",8,0,4,12,66.67,0,33.33,2019
"1847920",781,21,46,848,92.1,2.48,5.42,2019
"1847929",234,25,22,281,83.27,8.9,7.83,2019
"1847944",1209,35,248,1492,81.03,2.35,16.62,2019
"1847137",321,9,251,581,55.25,1.55,43.2,2019
"1847112",4307,171,1412,5890,73.12,2.9,23.97,2019
"1847126",1305,9,346,1660,78.61,0.54,20.84,2019
"2066760",0,0,0,0,NA,NA,NA,2019
"2066761",77,0,21,98,78.57,0,21.43,2019
"2066762",7637,367,1862,9866,77.41,3.72,18.87,2019
"2066771",249,21,72,342,72.81,6.14,21.05,2019
"2066781",257,43,187,487,52.77,8.83,38.4,2019
"2066783",718,21,238,977,73.49,2.15,24.36,2019
"2066830",77,0,8,85,90.59,0,9.41,2019
"2066845",329,9,91,429,76.69,2.1,21.21,2019
"2066868",291,15,25,331,87.92,4.53,7.55,2019
"3168624",284,20,72,376,75.53,5.32,19.15,2019
"3168647",220,2,50,272,80.88,0.74,18.38,2019
"3168648",98,9,16,123,79.67,7.32,13.01,2019
"3168649",640,42,115,797,80.3,5.27,14.43,2019
"3168651",484,5,67,556,87.05,0.9,12.05,2019
"3168661",1749,11,494,2254,77.6,0.49,21.92,2019
"3168664",107,9,19,135,79.26,6.67,14.07,2019
"3168669",184,4,32,220,83.64,1.82,14.55,2019
"3168714",394,44,108,546,72.16,8.06,19.78,2019
"3168326",53,1,4,58,91.38,1.72,6.9,2019
"3168464",200,1,58,259,77.22,0.39,22.39,2019
"3168636",452,23,130,605,74.71,3.8,21.49,2019
"3168850",3423,126,789,4338,78.91,2.9,18.19,2019
"3168001",18,5,1,24,75,20.83,4.17,2019
"3168003",1501,154,201,1856,80.87,8.3,10.83,2019
"3168005",7910,293,1089,9292,85.13,3.15,11.72,2019
"3168017",586,12,163,761,77,1.58,21.42,2019
"3168023",846,36,123,1005,84.18,3.58,12.24,2019
"3168028",4455,161,286,4902,90.88,3.28,5.83,2019
"3168033",115,3,20,138,83.33,2.17,14.49,2019
"3168041",385,10,33,428,89.95,2.34,7.71,2019
"3168920",596,15,115,726,82.09,2.07,15.84,2019
"3168975",35,7,1,43,81.4,16.28,2.33,2019
"3168943",72,15,18,105,68.57,14.29,17.14,2019
"3168945",103,0,6,109,94.5,0,5.5,2019
"3168950",132,2,17,151,87.42,1.32,11.26,2019
"3168955",704,7,59,770,91.43,0.91,7.66,2019
"3168966",232,16,61,309,75.08,5.18,19.74,2019
"3168967",337,10,109,456,73.9,2.19,23.9,2019
"3168976",131,13,10,154,85.06,8.44,6.49,2019
"3168981",127,28,10,165,76.97,16.97,6.06,2019
"3168937",696,10,102,808,86.14,1.24,12.62,2019
"3168956",437,17,94,548,79.74,3.1,17.15,2019
"3168958",257,6,17,280,91.79,2.14,6.07,2019
"3168959",1259,25,280,1564,80.5,1.6,17.9,2019
"3168972",59,0,22,81,72.84,0,27.16,2019
"3168978",757,17,264,1038,72.93,1.64,25.43,2019
"3168979",614,14,118,746,82.31,1.88,15.82,2019
"3168982",187,12,35,234,79.91,5.13,14.96,2019
"3168834",60,0,17,77,77.92,0,22.08,2019
"3168840",931,23,213,1167,79.78,1.97,18.25,2019
"3168866",340,1,70,411,82.73,0.24,17.03,2019
"3168874",274,30,82,386,70.98,7.77,21.24,2019
"3168883",761,17,137,915,83.17,1.86,14.97,2019
"3168948",111,7,29,147,75.51,4.76,19.73,2019
"3168952",32,0,9,41,78.05,0,21.95,2019
"3168957",200,8,44,252,79.37,3.17,17.46,2019
"3168964",25,1,6,32,78.12,3.12,18.75,2019
"3168971",115,15,61,191,60.21,7.85,31.94,2019
"3168977",84,0,28,112,75,0,25,2019
"3945147",83,0,0,83,100,0,0,2019
"3945158",105,5,27,137,76.64,3.65,19.71,2019
"3945166",26,0,20,46,56.52,0,43.48,2019
"3945319",111,2,17,130,85.38,1.54,13.08,2019
"3945350",22,0,1,23,95.65,0,4.35,2019
"3945361",101,4,6,111,90.99,3.6,5.41,2019
"3945372",121,0,20,141,85.82,0,14.18,2019
"3945428",0,0,0,0,NA,NA,NA,2019
"3945868",209,2,19,230,90.87,0.87,8.26,2019
"3945617",106,0,0,106,100,0,0,2019
"3945618",3,2,0,5,60,40,0,2019
"3945630",45,0,0,45,100,0,0,2019
"3945636",50,0,0,50,100,0,0,2019
"3945721",20,0,0,20,100,0,0,2019
"3945787",12,0,20,32,37.5,0,62.5,2019
"3945826",127,14,26,167,76.05,8.38,15.57,2019
"3945854",135,1,30,166,81.33,0.6,18.07,2019
"3945864",68,0,6,74,91.89,0,8.11,2019
"3945884",22,0,0,22,100,0,0,2019
"3945215",10208,333,2045,12586,81.11,2.65,16.25,2019
"3945877",767,8,91,866,88.57,0.92,10.51,2019
"3945887",1335,38,227,1600,83.44,2.38,14.19,2019
"3945891",4833,230,1195,6258,77.23,3.68,19.1,2019
"3945897",0,0,0,0,NA,NA,NA,2019
"3945044",16720,515,2688,19923,83.92,2.58,13.49,2019
"3945050",3016,17,278,3311,91.09,0.51,8.4,2019
"3945062",194,11,49,254,76.38,4.33,19.29,2019
"3945064",885,16,241,1142,77.5,1.4,21.1,2019
"3945067",4660,101,425,5186,89.86,1.95,8.2,2019
"3945121",2530,118,1000,3648,69.35,3.23,27.41,2019
"3945135",1447,66,342,1855,78.01,3.56,18.44,2019
"3945144",1075,53,590,1718,62.57,3.08,34.34,2019
"3945239",10341,327,1271,11939,86.62,2.74,10.65,2019
"3945246",4898,309,979,6186,79.18,5,15.83,2019
"3945305",4293,31,142,4466,96.13,0.69,3.18,2019
"3945310",92,6,6,104,88.46,5.77,5.77,2019
"3945324",14371,771,1847,16989,84.59,4.54,10.87,2019
"3945326",303,11,41,355,85.35,3.1,11.55,2019
"3945332",128,3,136,267,47.94,1.12,50.94,2019
"3945333",265,16,139,420,63.1,3.81,33.1,2019
"3945339",357,26,114,497,71.83,5.23,22.94,2019
"3945340",194,4,55,253,76.68,1.58,21.74,2019
"3945345",2290,41,199,2530,90.51,1.62,7.87,2019
"3945346",688,22,126,836,82.3,2.63,15.07,2019
"3945352",75,0,23,98,76.53,0,23.47,2019
"3945362",284,29,88,401,70.82,7.23,21.95,2019
"3945371",6867,200,936,8003,85.81,2.5,11.7,2019
"3945385",12963,613,2104,15680,82.67,3.91,13.42,2019
"3945874",613,25,264,902,67.96,2.77,29.27,2019
"3945895",6580,113,882,7575,86.86,1.49,11.64,2019
"1847138",1058,32,602,1692,62.53,1.89,35.58,2019
"1847142",242,4,176,422,57.35,0.95,41.71,2019
"1847145",488,11,156,655,74.5,1.68,23.82,2019
"1847147",186,18,187,391,47.57,4.6,47.83,2019
"1847166",494,45,69,608,81.25,7.4,11.35,2019
"1847224",151,0,56,207,72.95,0,27.05,2019
"1847244",186,9,71,266,69.92,3.38,26.69,2019
"1847274",9302,364,2439,12105,76.84,3.01,20.15,2019
"1847020",375,0,123,498,75.3,0,24.7,2019
"1847034",46,5,4,55,83.64,9.09,7.27,2019
"1847994",95,2,46,143,66.43,1.4,32.17,2019
"1847713",2876,121,1293,4290,67.04,2.82,30.14,2019
"1847840",575,4,84,663,86.73,0.6,12.67,2019
"1847855",131,2,82,215,60.93,0.93,38.14,2019
"1847862",442,0,137,579,76.34,0,23.66,2019
"1847874",966,9,241,1216,79.44,0.74,19.82,2019
"1847926",373,17,151,541,68.95,3.14,27.91,2019
"1847394",2530,141,667,3338,75.79,4.22,19.98,2019
"1847380",441,35,159,635,69.45,5.51,25.04,2019
"1847385",382,19,179,580,65.86,3.28,30.86,2019
"1847615",479,17,306,802,59.73,2.12,38.15,2019
"1847471",647,46,384,1077,60.07,4.27,35.65,2019
"1847520",919,72,277,1268,72.48,5.68,21.85,2019
"1847553",2255,20,818,3093,72.91,0.65,26.45,2019
"1847528",138,1,71,210,65.71,0.48,33.81,2019
"1847542",3114,93,618,3825,81.41,2.43,16.16,2019
"1847550",169,9,61,239,70.71,3.77,25.52,2019
"1847578",214,15,79,308,69.48,4.87,25.65,2019
"1847584",41,0,35,76,53.95,0,46.05,2019
"1847598",884,29,272,1185,74.6,2.45,22.95,2019
"1847601",4633,171,940,5744,80.66,2.98,16.36,2019
"1847638",1069,50,244,1363,78.43,3.67,17.9,2019
"1847712",8434,405,1500,10339,81.57,3.92,14.51,2019
"1847836",0,0,0,0,NA,NA,NA,2019
"1847841",660,40,288,988,66.8,4.05,29.15,2019
"1847847",340,24,84,448,75.89,5.36,18.75,2019
"1847848",466,13,122,601,77.54,2.16,20.3,2019
"1847849",166,0,30,196,84.69,0,15.31,2019
"1847860",108,0,66,174,62.07,0,37.93,2019
"1847861",157,20,57,234,67.09,8.55,24.36,2019
"1847866",135,0,98,233,57.94,0,42.06,2019
"1847881",105,6,26,137,76.64,4.38,18.98,2019
"1847904",5262,340,1446,7048,74.66,4.82,20.52,2019
"1847905",14177,645,2188,17010,83.35,3.79,12.86,2019
"2648003",1988,107,199,2294,86.66,4.66,8.67,2019
"2648015",2869,0,593,3462,82.87,0,17.13,2019
"2648022",800,1,160,961,83.25,0.1,16.65,2019
"2648025",5445,78,290,5813,93.67,1.34,4.99,2019
"2648026",5133,160,725,6018,85.29,2.66,12.05,2019
"2648030",5535,321,1232,7088,78.09,4.53,17.38,2019
"2648034",5997,220,1136,7353,81.56,2.99,15.45,2019
"2648038",17659,509,2066,20234,87.27,2.52,10.21,2019
"2648039",2613,49,586,3248,80.45,1.51,18.04,2019
"2648041",1446,40,270,1756,82.35,2.28,15.38,2019
"2648065",3717,64,511,4292,86.6,1.49,11.91,2019
"2648071",11284,330,1572,13186,85.58,2.5,11.92,2019
"2648890",649,18,150,817,79.44,2.2,18.36,2019
"2648911",13156,464,2612,16232,81.05,2.86,16.09,2019
"2648915",2910,112,795,3817,76.24,2.93,20.83,2019
"3168030",229,2,109,340,67.35,0.59,32.06,2019
"3168069",951,45,156,1152,82.55,3.91,13.54,2019
"3168343",296,11,54,361,81.99,3.05,14.96,2019
"3168354",304,21,98,423,71.87,4.96,23.17,2019
"3168402",421,2,50,473,89.01,0.42,10.57,2019
"3168436",165,2,49,216,76.39,0.93,22.69,2019
"3168016",166,6,19,191,86.91,3.14,9.95,2019
"3168844",65,0,38,103,63.11,0,36.89,2019
"3168869",694,28,160,882,78.68,3.17,18.14,2019
"3858321",25,1,3,29,86.21,3.45,10.34,2019
"3858323",13,0,0,13,100,0,0,2019
"3858335",147,66,184,397,37.03,16.62,46.35,2019
"3858341",976,57,192,1225,79.67,4.65,15.67,2019
"3858345",38,9,10,57,66.67,15.79,17.54,2019
"3858382",81,0,4,85,95.29,0,4.71,2019
"3858413",377,12,114,503,74.95,2.39,22.66,2019
"3858421",964,38,232,1234,78.12,3.08,18.8,2019
"3858423",10,0,18,28,35.71,0,64.29,2019
"3858428",45,31,21,97,46.39,31.96,21.65,2019
"3858429",167,0,33,200,83.5,0,16.5,2019
"3858440",26,11,15,52,50,21.15,28.85,2019
"3858443",62,1,12,75,82.67,1.33,16,2019
"3858474",969,42,156,1167,83.03,3.6,13.37,2019
"3858492",193,0,19,212,91.04,0,8.96,2019
"3858496",72,0,11,83,86.75,0,13.25,2019
"3858552",514,30,284,828,62.08,3.62,34.3,2019
"3858554",9545,381,1421,11347,84.12,3.36,12.52,2019
"3858559",61,24,18,103,59.22,23.3,17.48,2019
"3858231",142,10,17,169,84.02,5.92,10.06,2019
"3858239",4,3,0,7,57.14,42.86,0,2019
"3858258",87,2,34,123,70.73,1.63,27.64,2019
"3858278",680,14,81,775,87.74,1.81,10.45,2019
"3858355",10,0,16,26,38.46,0,61.54,2019
"3858845",120,5,18,143,83.92,3.5,12.59,2019
"3858853",56,35,29,120,46.67,29.17,24.17,2019
"3858004",95,19,21,135,70.37,14.07,15.56,2019
"3858257",710,29,138,877,80.96,3.31,15.74,2019
"3858240",449,14,79,542,82.84,2.58,14.58,2019
"3858244",39,0,5,44,88.64,0,11.36,2019
"3858256",234,8,64,306,76.47,2.61,20.92,2019
"3858260",71,0,18,89,79.78,0,20.22,2019
"3858261",324,2,150,476,68.07,0.42,31.51,2019
"3858311",23,0,15,38,60.53,0,39.47,2019
"3858324",393,18,235,646,60.84,2.79,36.38,2019
"3858351",140,10,34,184,76.09,5.43,18.48,2019
"3858363",44,0,0,44,100,0,0,2019
"3858033",157,2,18,177,88.7,1.13,10.17,2019
"3858040",456,16,67,539,84.6,2.97,12.43,2019
"3858042",454,14,26,494,91.9,2.83,5.26,2019
"3858057",39,0,3,42,92.86,0,7.14,2019
"3858078",12858,245,926,14029,91.65,1.75,6.6,2019
"3858227",192,0,54,246,78.05,0,21.95,2019
"3858228",312,12,82,406,76.85,2.96,20.2,2019
"3858011",144,2,24,170,84.71,1.18,14.12,2019
"3858013",63,0,26,89,70.79,0,29.21,2019
"3858029",23,1,5,29,79.31,3.45,17.24,2019
"3858031",156,5,26,187,83.42,2.67,13.9,2019
"3858035",92,5,28,125,73.6,4,22.4,2019
"3858043",56,0,12,68,82.35,0,17.65,2019
"3945899",44,3,9,56,78.57,5.36,16.07,2019
"3945831",1003,23,301,1327,75.58,1.73,22.68,2019
"3945387",2195,107,253,2555,85.91,4.19,9.9,2019
"3945388",274,0,13,287,95.47,0,4.53,2019
"3945389",136,9,35,180,75.56,5,19.44,2019
"3945429",10128,241,1139,11508,88.01,2.09,9.9,2019
"3945432",5645,166,677,6488,87.01,2.56,10.43,2019
"3945458",11853,122,929,12904,91.86,0.95,7.2,2019
"3945505",6259,175,1483,7917,79.06,2.21,18.73,2019
"3945634",505,14,215,734,68.8,1.91,29.29,2019
"3945642",0,0,0,0,NA,NA,NA,2019
"3945646",131,0,60,191,68.59,0,31.41,2019
"3945662",8954,435,2941,12330,72.62,3.53,23.85,2019
"3945684",616,0,202,818,75.31,0,24.69,2019
"3945685",330,10,129,469,70.36,2.13,27.51,2019
"3945719",317,9,122,448,70.76,2.01,27.23,2019
"3945727",52,49,82,183,28.42,26.78,44.81,2019
"3945741",75,10,122,207,36.23,4.83,58.94,2019
"3945810",2157,118,296,2571,83.9,4.59,11.51,2019
"3944408",3453,114,609,4176,82.69,2.73,14.58,2019
"3944411",581,43,83,707,82.18,6.08,11.74,2019
"3944436",1199,31,264,1494,80.25,2.07,17.67,2019
"3944450",474,10,165,649,73.04,1.54,25.42,2019
"3944451",1062,35,115,1212,87.62,2.89,9.49,2019
"3944471",3535,118,735,4388,80.56,2.69,16.75,2019
"3944484",7413,428,1447,9288,79.81,4.61,15.58,2019
"3944485",4706,241,2014,6961,67.61,3.46,28.93,2019
"3944490",298,20,55,373,79.89,5.36,14.75,2019
"3944610",62,0,0,62,100,0,0,2019
"3944001",7000,334,1094,8428,83.06,3.96,12.98,2019
"3944030",4524,250,1215,5989,75.54,4.17,20.29,2019
"3944032",319,0,142,461,69.2,0,30.8,2019
"3944040",1060,9,78,1147,92.41,0.78,6.8,2019
"3944041",4712,228,1054,5994,78.61,3.8,17.58,2019
"3944050",2061,81,205,2347,87.81,3.45,8.73,2019
"3944076",1186,105,424,1715,69.15,6.12,24.72,2019
"3944102",14627,608,4198,19433,75.27,3.13,21.6,2019
"3944110",5619,284,3102,9005,62.4,3.15,34.45,2019
"3944111",14143,557,3114,17814,79.39,3.13,17.48,2019
"3944125",9061,326,2102,11489,78.87,2.84,18.3,2019
"3944137",7514,217,1680,9411,79.84,2.31,17.85,2019
"3944142",6332,136,1106,7574,83.6,1.8,14.6,2019
"3944201",2106,29,332,2467,85.37,1.18,13.46,2019
"3944214",723,2,128,853,84.76,0.23,15.01,2019
"3944231",2519,231,636,3386,74.39,6.82,18.78,2019
"3944260",4165,74,726,4965,83.89,1.49,14.62,2019
"3944266",10954,756,1888,13598,80.56,5.56,13.88,2019
"3944272",1700,115,195,2010,84.58,5.72,9.7,2019
"3944273",2589,57,306,2952,87.7,1.93,10.37,2019
"3944276",559,17,73,649,86.13,2.62,11.25,2019
"2648808",2155,25,291,2471,87.21,1.01,11.78,2019
"2648831",1040,35,275,1350,77.04,2.59,20.37,2019
"2648848",2584,36,270,2890,89.41,1.25,9.34,2019
"2648865",502,30,221,753,66.67,3.98,29.35,2019
"2648442",7016,315,921,8252,85.02,3.82,11.16,2019
"2648444",2666,184,749,3599,74.08,5.11,20.81,2019
"2648445",397,13,91,501,79.24,2.59,18.16,2019
"2648451",4862,83,510,5455,89.13,1.52,9.35,2019
"2648465",210,32,28,270,77.78,11.85,10.37,2019
"2648476",169,0,23,192,88.02,0,11.98,2019
"2648502",118,0,9,127,92.91,0,7.09,2019
"2648504",7094,934,3088,11116,63.82,8.4,27.78,2019
"2648630",20,0,0,20,100,0,0,2019
"2648661",3338,277,856,4471,74.66,6.2,19.15,2019
"2648701",401,26,141,568,70.6,4.58,24.82,2019
"2648731",470,41,160,671,70.04,6.11,23.85,2019
"2648761",319,8,101,428,74.53,1.87,23.6,2019
"2648762",395,26,87,508,77.76,5.12,17.13,2019
"2648765",188,12,111,311,60.45,3.86,35.69,2019
"2648811",833,62,342,1237,67.34,5.01,27.65,2019
"2648817",1899,51,451,2401,79.09,2.12,18.78,2019
"2648827",5149,162,980,6291,81.85,2.58,15.58,2019
"2648834",665,44,132,841,79.07,5.23,15.7,2019
"2648843",14698,914,1550,17162,85.64,5.33,9.03,2019
"2648846",5316,178,1088,6582,80.77,2.7,16.53,2019
"2648852",56,2,17,75,74.67,2.67,22.67,2019
"2648853",166,7,52,225,73.78,3.11,23.11,2019
"2648178",11957,102,926,12985,92.08,0.79,7.13,2019
"2648161",8420,472,1830,10722,78.53,4.4,17.07,2019
"2648167",8297,150,560,9007,92.12,1.67,6.22,2019
"2648170",15106,335,1584,17025,88.73,1.97,9.3,2019
"2648179",1325,14,142,1481,89.47,0.95,9.59,2019
"2648184",5324,197,1112,6633,80.27,2.97,16.76,2019
"2648187",16974,257,1162,18393,92.29,1.4,6.32,2019
"2648209",5794,1140,2879,9813,59.04,11.62,29.34,2019
"2648221",11792,933,3008,15733,74.95,5.93,19.12,2019
"2648229",2227,282,1194,3703,60.14,7.62,32.24,2019
"2648234",6987,719,5246,12952,53.95,5.55,40.5,2019
"2648240",5524,267,985,6776,81.52,3.94,14.54,2019
"2648304",5952,104,316,6372,93.41,1.63,4.96,2019
"2648317",10489,270,843,11602,90.41,2.33,7.27,2019
"2648320",2143,13,144,2300,93.17,0.57,6.26,2019
"2648322",11342,104,888,12334,91.96,0.84,7.2,2019
"2648329",8867,164,898,9929,89.3,1.65,9.04,2019
"2648336",9217,166,1404,10787,85.45,1.54,13.02,2019
"2648367",1475,0,228,1703,86.61,0,13.39,2019
"2648375",8047,145,338,8530,94.34,1.7,3.96,2019
"2648428",1744,70,170,1984,87.9,3.53,8.57,2019
"2648441",1283,66,395,1744,73.57,3.78,22.65,2019
"2648449",805,40,251,1096,73.45,3.65,22.9,2019
"2648461",2615,54,507,3176,82.34,1.7,15.96,2019
"2648471",1524,133,674,2331,65.38,5.71,28.91,2019
"2648604",3472,133,510,4115,84.37,3.23,12.39,2019
"2648616",2389,111,520,3020,79.11,3.68,17.22,2019
"2648625",3847,138,1352,5337,72.08,2.59,25.33,2019
"2648629",2705,90,694,3489,77.53,2.58,19.89,2019
"2648634",1615,26,276,1917,84.25,1.36,14.4,2019
"2648636",247,62,107,416,59.38,14.9,25.72,2019
"2648642",11858,449,1277,13584,87.29,3.31,9.4,2019
"3858052",222,6,36,264,84.09,2.27,13.64,2019
"3858056",36,5,22,63,57.14,7.94,34.92,2019
"3858059",463,5,67,535,86.54,0.93,12.52,2019
"3858425",465,26,83,574,81.01,4.53,14.46,2019
"3858426",63,4,10,77,81.82,5.19,12.99,2019
"3858442",162,5,30,197,82.23,2.54,15.23,2019
"3858445",63,0,13,76,82.89,0,17.11,2019
"3858451",53,1,8,62,85.48,1.61,12.9,2019
"3858456",183,7,64,254,72.05,2.76,25.2,2019
"4657780",17,0,3,20,85,0,15,2019
"4657785",3146,172,741,4059,77.51,4.24,18.26,2019
"4657792",43,0,11,54,79.63,0,20.37,2019
"4657584",29,0,13,42,69.05,0,30.95,2019
"4657622",17,0,72,89,19.1,0,80.9,2019
"4657626",265,3,84,352,75.28,0.85,23.86,2019
"4657642",332,11,230,573,57.94,1.92,40.14,2019
"4657644",108,3,20,131,82.44,2.29,15.27,2019
"4657652",61,6,46,113,53.98,5.31,40.71,2019
"4657719",2577,33,472,3082,83.61,1.07,15.31,2019
"4657730",2076,92,422,2590,80.15,3.55,16.29,2019
"4657738",47,1,23,71,66.2,1.41,32.39,2019
"4657751",337,7,55,399,84.46,1.75,13.78,2019
"4657756",31,17,75,123,25.2,13.82,60.98,2019
"4657761",408,15,47,470,86.81,3.19,10,2019
"4657783",6013,174,623,6810,88.3,2.56,9.15,2019
"4657212",793,38,118,949,83.56,4,12.43,2019
"4657214",21,0,4,25,84,0,16,2019
"4657225",639,33,204,876,72.95,3.77,23.29,2019
"4657239",92,11,9,112,82.14,9.82,8.04,2019
"4657249",289,11,98,398,72.61,2.76,24.62,2019
"4657252",1780,45,244,2069,86.03,2.17,11.79,2019
"4657255",113,0,59,172,65.7,0,34.3,2019
"4657258",37,5,10,52,71.15,9.62,19.23,2019
"4657259",151,4,39,194,77.84,2.06,20.1,2019
"4657265",55,0,21,76,72.37,0,27.63,2019
"4657362",802,6,181,989,81.09,0.61,18.3,2019
"4657368",355,5,106,466,76.18,1.07,22.75,2019
"4657379",32,0,4,36,88.89,0,11.11,2019
"4657380",745,71,294,1110,67.12,6.4,26.49,2019
"4657384",305,9,107,421,72.45,2.14,25.42,2019
"4657386",64,4,21,89,71.91,4.49,23.6,2019
"4657420",19,9,20,48,39.58,18.75,41.67,2019
"4657442",613,35,128,776,78.99,4.51,16.49,2019
"3059057",299,10,7,316,94.62,3.16,2.22,2019
"3059062",5,0,4,9,55.56,0,44.44,2019
"3059085",42,0,10,52,80.77,0,19.23,2019
"3059106",6453,265,585,7303,88.36,3.63,8.01,2019
"3059215",338,6,122,466,72.53,1.29,26.18,2019
"3059231",151,0,81,232,65.09,0,34.91,2019
"3059254",819,25,137,981,83.49,2.55,13.97,2019
"3059258",42,0,12,54,77.78,0,22.22,2019
"3059311",71,4,14,89,79.78,4.49,15.73,2019
"3059332",62,3,14,79,78.48,3.8,17.72,2019
"3059427",1319,64,306,1689,78.09,3.79,18.12,2019
"3059432",35,3,16,54,64.81,5.56,29.63,2019
"3059443",153,0,33,186,82.26,0,17.74,2019
"3059530",26,0,11,37,70.27,0,29.73,2019
"3059730",756,18,127,901,83.91,2,14.1,2019
"3059632",397,22,170,589,67.4,3.74,28.86,2019
"3944287",2501,20,452,2973,84.12,0.67,15.2,2019
"3944146",10665,350,2965,13980,76.29,2.5,21.21,2019
"3944250",384,0,105,489,78.53,0,21.47,2019
"3944253",913,57,114,1084,84.23,5.26,10.52,2019
"3944308",183,0,91,274,66.79,0,33.21,2019
"3944311",1946,268,656,2870,67.8,9.34,22.86,2019
"3944402",1105,18,202,1325,83.4,1.36,15.25,2019
"3944427",358,40,86,484,73.97,8.26,17.77,2019
"3944003",1058,54,434,1546,68.43,3.49,28.07,2019
"3944012",8478,472,589,9539,88.88,4.95,6.17,2019
"3944035",20767,1346,4885,26998,76.92,4.99,18.09,2019
"3944048",708,118,77,903,78.41,13.07,8.53,2019
"3944060",22714,315,2196,25225,90.05,1.25,8.71,2019
"3944067",7103,185,891,8179,86.84,2.26,10.89,2019
"3944070",11352,395,1334,13081,86.78,3.02,10.2,2019
"3944082",467,0,190,657,71.08,0,28.92,2019
"3944085",924,20,319,1263,73.16,1.58,25.26,2019
"3944086",795,10,127,932,85.3,1.07,13.63,2019
"3944094",14019,399,1793,16211,86.48,2.46,11.06,2019
"3944122",11583,264,1761,13608,85.12,1.94,12.94,2019
"3944127",1066,61,684,1811,58.86,3.37,37.77,2019
"3944128",9206,429,3230,12865,71.56,3.33,25.11,2019
"3944130",18590,524,3138,22252,83.54,2.35,14.1,2019
"3944131",7261,147,901,8309,87.39,1.77,10.84,2019
"3944134",12848,344,2422,15614,82.29,2.2,15.51,2019
"3944634",680,50,91,821,82.83,6.09,11.08,2019
"3944638",339,15,130,484,70.04,3.1,26.86,2019
"3944647",6338,263,1047,7648,82.87,3.44,13.69,2019
"3944661",45,1,14,60,75,1.67,23.33,2019
"3944683",2379,84,692,3155,75.4,2.66,21.93,2019
"3944685",9424,148,820,10392,90.69,1.42,7.89,2019
"3944689",166,0,81,247,67.21,0,32.79,2019
"3944697",66,1,20,87,75.86,1.15,22.99,2019
"3944703",2741,130,947,3818,71.79,3.4,24.8,2019
"3944705",5727,177,1434,7338,78.05,2.41,19.54,2019
"3944708",9289,458,1253,11000,84.45,4.16,11.39,2019
"3944827",2285,72,584,2941,77.69,2.45,19.86,2019
"3944842",1538,77,427,2042,75.32,3.77,20.91,2019
"3944861",24,0,12,36,66.67,0,33.33,2019
"3944867",746,12,152,910,81.98,1.32,16.7,2019
"3944870",12961,867,2909,16737,77.44,5.18,17.38,2019
"3944882",988,15,174,1177,83.94,1.27,14.78,2019
"3944905",3747,191,842,4780,78.39,4,17.62,2019
"3944412",745,34,221,1000,74.5,3.4,22.1,2019
"3944417",580,0,119,699,82.98,0,17.02,2019
"3944123",6182,233,1506,7921,78.05,2.94,19.01,2019
"3944129",10039,250,1606,11895,84.4,2.1,13.5,2019
"3944826",520,24,93,637,81.63,3.77,14.6,2019
"3944678",123,0,19,142,86.62,0,13.38,2019
"3944691",15023,440,2836,18299,82.1,2.4,15.5,2019
"2648655",1878,75,441,2394,78.45,3.13,18.42,2019
"2648728",105,0,39,144,72.92,0,27.08,2019
"2648735",323,12,123,458,70.52,2.62,26.86,2019
"2648742",544,17,198,759,71.67,2.24,26.09,2019
"2648745",402,0,164,566,71.02,0,28.98,2019
"2648807",237,26,80,343,69.1,7.58,23.32,2019
"2648809",3376,156,542,4074,82.87,3.83,13.3,2019
"2648823",16767,1694,1485,19946,84.06,8.49,7.45,2019
"2648854",6566,291,701,7558,86.87,3.85,9.27,2019
"2648857",897,8,161,1066,84.15,0.75,15.1,2019
"2648871",571,13,199,783,72.92,1.66,25.42,2019
"2648874",47,0,7,54,87.04,0,12.96,2019
"2648001",4600,108,631,5339,86.16,2.02,11.82,2019
"2648048",2410,25,284,2719,88.64,0.92,10.45,2019
"2648050",433,25,48,506,85.57,4.94,9.49,2019
"2648051",5724,98,649,6471,88.46,1.51,10.03,2019
"2648082",6357,94,796,7247,87.72,1.3,10.98,2019
"2648083",8320,176,741,9237,90.07,1.91,8.02,2019
"2648093",8618,203,1423,10244,84.13,1.98,13.89,2019
"2648095",1932,16,166,2114,91.39,0.76,7.85,2019
"2648917",12343,444,1949,14736,83.76,3.01,13.23,2019
"2648014",1328,39,227,1594,83.31,2.45,14.24,2019
"2648032",660,22,83,765,86.27,2.88,10.85,2019
"2648054",2536,45,385,2966,85.5,1.52,12.98,2019
"2648066",16431,732,3013,20176,81.44,3.63,14.93,2019
"2648070",2275,16,60,2351,96.77,0.68,2.55,2019
"2648072",6090,147,446,6683,91.13,2.2,6.67,2019
"2648073",14816,307,1345,16468,89.97,1.86,8.17,2019
"2648096",1228,64,350,1642,74.79,3.9,21.32,2019
"2648105",13130,894,644,14668,89.51,6.09,4.39,2019
"2648114",7067,162,584,7813,90.45,2.07,7.47,2019
"2648138",3663,72,411,4146,88.35,1.74,9.91,2019
"2648140",1081,11,183,1275,84.78,0.86,14.35,2019
"2648160",4024,78,548,4650,86.54,1.68,11.78,2019
"2648165",2609,42,201,2852,91.48,1.47,7.05,2019
"2648182",7421,314,1121,8856,83.8,3.55,12.66,2019
"2648202",4991,396,2226,7613,65.56,5.2,29.24,2019
"2648215",3374,484,1168,5026,67.13,9.63,23.24,2019
"2648217",1575,385,940,2900,54.31,13.28,32.41,2019
"2648220",10027,242,1028,11297,88.76,2.14,9.1,2019
"2648227",8962,1293,5558,15813,56.67,8.18,35.15,2019
"2648242",0,0,0,0,NA,NA,NA,2019
"2648310",13315,201,1329,14845,89.69,1.35,8.95,2019
"2648312",11869,208,1580,13657,86.91,1.52,11.57,2019
"2648770",547,24,190,761,71.88,3.15,24.97,2019
"2648851",601,18,233,852,70.54,2.11,27.35,2019
"2648174",9055,863,1915,11833,76.52,7.29,16.18,2019
"2648237",10126,277,1704,12107,83.64,2.29,14.07,2019
"2648421",2016,82,329,2427,83.07,3.38,13.56,2019
"2648457",2526,156,326,3008,83.98,5.19,10.84,2019
"2648889",358,11,190,559,64.04,1.97,33.99,2019
"2648891",870,42,250,1162,74.87,3.61,21.51,2019
"2648894",512,14,128,654,78.29,2.14,19.57,2019
"2648436",1205,30,209,1444,83.45,2.08,14.47,2019
"2648456",251,21,50,322,77.95,6.52,15.53,2019
"2648473",7938,138,907,8983,88.37,1.54,10.1,2019
"2648506",8425,605,2623,11653,72.3,5.19,22.51,2019
"2648006",1182,30,247,1459,81.01,2.06,16.93,2019
"2648036",7739,138,1296,9173,84.37,1.5,14.13,2019
"2066415",236,32,48,316,74.68,10.13,15.19,2019
"2066416",183,7,40,230,79.57,3.04,17.39,2019
"2066428",123,2,20,145,84.83,1.38,13.79,2019
"2066431",202,0,32,234,86.32,0,13.68,2019
"2066503",6121,141,212,6474,94.55,2.18,3.27,2019
"2066506",0,12,0,12,0,100,0,2019
"2066508",1547,51,314,1912,80.91,2.67,16.42,2019
"2066509",802,11,278,1091,73.51,1.01,25.48,2019
"2066512",942,11,171,1124,83.81,0.98,15.21,2019
"3168627",228,9,56,293,77.82,3.07,19.11,2019
"3168358",561,13,20,594,94.44,2.19,3.37,2019
"3168418",364,2,48,414,87.92,0.48,11.59,2019
"3168445",68,0,0,68,100,0,0,2019
"3168524",1935,75,100,2110,91.71,3.55,4.74,2019
"3168727",252,10,66,328,76.83,3.05,20.12,2019
"3168947",208,5,38,251,82.87,1.99,15.14,2019
"3168974",66,2,7,75,88,2.67,9.33,2019
"3168301",458,34,50,542,84.5,6.27,9.23,2019
"3168652",198,12,87,297,66.67,4.04,29.29,2019
"3168769",631,36,85,752,83.91,4.79,11.3,2019
"3168837",50,1,8,59,84.75,1.69,13.56,2019
"3168954",6,0,12,18,33.33,0,66.67,2019
"3168752",234,8,58,300,78,2.67,19.33,2019
"3168835",199,23,53,275,72.36,8.36,19.27,2019
"3168927",436,37,81,554,78.7,6.68,14.62,2019
"3168055",69,11,34,114,60.53,9.65,29.82,2019
"3168137",9259,234,888,10381,89.19,2.25,8.55,2019
"3168072",23,6,1,30,76.67,20,3.33,2019
"3168178",0,0,0,0,NA,NA,NA,2019
"3168379",26,0,7,33,78.79,0,21.21,2019
"3168382",7,0,2,9,77.78,0,22.22,2019
"3168438",38,1,7,46,82.61,2.17,15.22,2019
"3168514",26,0,0,26,100,0,0,2019
"3168531",231,0,16,247,93.52,0,6.48,2019
"3168749",19,0,9,28,67.86,0,32.14,2019
"3168751",24,0,2,26,92.31,0,7.69,2019
"3168849",0,0,0,0,NA,NA,NA,2019
"3168969",8,0,1,9,88.89,0,11.11,2019
"3168743",182,9,20,211,86.26,4.27,9.48,2019
"3169034",296,5,94,395,74.94,1.27,23.8,2019
"3169132",46,0,5,51,90.2,0,9.8,2019
"3169156",222,13,57,292,76.03,4.45,19.52,2019
"3169157",40,0,3,43,93.02,0,6.98,2019
"3169217",130,2,70,202,64.36,0.99,34.65,2019
"3169337",2312,76,315,2703,85.53,2.81,11.65,2019
"3169355",72,0,4,76,94.74,0,5.26,2019
"3169360",364,26,162,552,65.94,4.71,29.35,2019
"3169366",78,5,6,89,87.64,5.62,6.74,2019
"3169339",487,19,135,641,75.98,2.96,21.06,2019
"3169345",156,2,17,175,89.14,1.14,9.71,2019
"3169350",127,5,43,175,72.57,2.86,24.57,2019
"3169351",86,24,2,112,76.79,21.43,1.79,2019
"3169001",3023,48,718,3789,79.78,1.27,18.95,2019
"3169020",164,0,30,194,84.54,0,15.46,2019
"3169043",171,2,42,215,79.53,0.93,19.53,2019
"3169123",309,6,43,358,86.31,1.68,12.01,2019
"3169127",330,0,47,377,87.53,0,12.47,2019
"3169138",1275,55,266,1596,79.89,3.45,16.67,2019
"3169140",633,7,127,767,82.53,0.91,16.56,2019
"3944816",0,0,24,24,0,0,100,2019
"3944841",218,36,40,294,74.15,12.24,13.61,2019
"3944846",1029,31,67,1127,91.3,2.75,5.94,2019
"3944850",26,0,0,26,100,0,0,2019
"3944855",365,3,97,465,78.49,0.65,20.86,2019
"3944859",508,14,76,598,84.95,2.34,12.71,2019
"3944890",3260,150,844,4254,76.63,3.53,19.84,2019
"3944425",5059,191,948,6198,81.62,3.08,15.3,2019
"3944430",1216,36,220,1472,82.61,2.45,14.95,2019
"3944442",1374,32,255,1661,82.72,1.93,15.35,2019
"3944506",723,86,248,1057,68.4,8.14,23.46,2019
"3944612",1770,32,320,2122,83.41,1.51,15.08,2019
"3944615",2959,112,802,3873,76.4,2.89,20.71,2019
"3944438",1497,39,407,1943,77.05,2.01,20.95,2019
"3944507",1323,83,641,2047,64.63,4.05,31.31,2019
"3944514",8346,98,1203,9647,86.51,1.02,12.47,2019
"3944625",475,29,91,595,79.83,4.87,15.29,2019
"3944667",4210,56,830,5096,82.61,1.1,16.29,2019
"3944669",421,47,85,553,76.13,8.5,15.37,2019
"3944688",873,54,382,1309,66.69,4.13,29.18,2019
"3944690",33,0,16,49,67.35,0,32.65,2019
"3944693",10,6,4,20,50,30,20,2019
"3944704",1001,80,467,1548,64.66,5.17,30.17,2019
"3944718",4842,87,495,5424,89.27,1.6,9.13,2019
"3944730",1855,59,384,2298,80.72,2.57,16.71,2019
"3944813",2585,44,634,3263,79.22,1.35,19.43,2019
"3944817",485,12,51,548,88.5,2.19,9.31,2019
"3944072",1593,12,268,1873,85.05,0.64,14.31,2019
"3944118",13222,300,2123,15645,84.51,1.92,13.57,2019
"3944203",12508,638,3458,16604,75.33,3.84,20.83,2019
"3944264",1022,57,87,1166,87.65,4.89,7.46,2019
"3944431",1545,53,243,1841,83.92,2.88,13.2,2019
"3944440",1671,29,254,1954,85.52,1.48,13,2019
"3944512",12429,402,1827,14658,84.79,2.74,12.46,2019
"3944139",8035,142,657,8834,90.96,1.61,7.44,2019
"3944216",3096,115,282,3493,88.63,3.29,8.07,2019
"3944278",6405,84,734,7223,88.68,1.16,10.16,2019
"3944313",10833,257,1298,12388,87.45,2.07,10.48,2019
"3944314",6222,379,1661,8262,75.31,4.59,20.1,2019
"3944418",390,12,56,458,85.15,2.62,12.23,2019
"3944428",972,134,239,1345,72.27,9.96,17.77,2019
"3944446",6669,374,2031,9074,73.5,4.12,22.38,2019
"3944449",481,26,53,560,85.89,4.64,9.46,2019
"3944452",1123,74,114,1311,85.66,5.64,8.7,2019
"3944454",387,0,25,412,93.93,0,6.07,2019
"3944455",591,85,61,737,80.19,11.53,8.28,2019
"3944481",3114,167,658,3939,79.06,4.24,16.7,2019
"3944491",626,33,355,1014,61.74,3.25,35.01,2019
"3944504",1484,149,415,2048,72.46,7.28,20.26,2019
"3944505",4966,350,2168,7484,66.35,4.68,28.97,2019
"2648043",5406,179,1285,6870,78.69,2.61,18.7,2019
"2648045",10102,161,1368,11631,86.85,1.38,11.76,2019
"2648047",14351,390,1209,15950,89.97,2.45,7.58,2019
"2648063",1416,23,118,1557,90.94,1.48,7.58,2019
"2648069",1026,9,36,1071,95.8,0.84,3.36,2019
"2648074",2985,27,482,3494,85.43,0.77,13.8,2019
"2648076",8729,63,899,9691,90.07,0.65,9.28,2019
"2648081",7767,186,1051,9004,86.26,2.07,11.67,2019
"2648601",9755,435,4111,14301,68.21,3.04,28.75,2019
"2648603",10046,340,1440,11826,84.95,2.88,12.18,2019
"2648617",2510,76,827,3413,73.54,2.23,24.23,2019
"2648089",9538,331,2421,12290,77.61,2.69,19.7,2019
"2648135",8944,209,1596,10749,83.21,1.94,14.85,2019
"2648626",1928,59,386,2373,81.25,2.49,16.27,2019
"2648627",47,0,0,47,100,0,0,2019
"2648650",2294,49,703,3046,75.31,1.61,23.08,2019
"2648652",528,18,113,659,80.12,2.73,17.15,2019
"2648659",755,66,230,1051,71.84,6.28,21.88,2019
"2648705",173,12,88,273,63.37,4.4,32.23,2019
"2648708",8546,207,2324,11077,77.15,1.87,20.98,2019
"2648720",326,18,122,466,69.96,3.86,26.18,2019
"2648732",4316,103,591,5010,86.15,2.06,11.8,2019
"2648733",549,19,126,694,79.11,2.74,18.16,2019
"2648740",777,29,296,1102,70.51,2.63,26.86,2019
"2648747",430,7,108,545,78.9,1.28,19.82,2019
"2648755",1019,107,276,1402,72.68,7.63,19.69,2019
"2648768",2981,122,840,3943,75.6,3.09,21.3,2019
"2648820",6008,117,601,6726,89.33,1.74,8.94,2019
"2648821",2069,55,359,2483,83.33,2.22,14.46,2019
"2648829",993,38,295,1326,74.89,2.87,22.25,2019
"2648841",217,10,60,287,75.61,3.48,20.91,2019
"2648888",1899,64,489,2452,77.45,2.61,19.94,2019
"2648897",564,18,104,686,82.22,2.62,15.16,2019
"2648327",8209,246,1076,9531,86.13,2.58,11.29,2019
"2648092",8477,208,1557,10242,82.77,2.03,15.2,2019
"2648186",11291,350,1806,13447,83.97,2.6,13.43,2019
"2648002",988,58,190,1236,79.94,4.69,15.37,2019
"2648028",438,6,108,552,79.35,1.09,19.57,2019
"2648059",4864,189,996,6049,80.41,3.12,16.47,2019
"2648453",1434,146,503,2083,68.84,7.01,24.15,2019
"2648640",11266,307,1619,13192,85.4,2.33,12.27,2019
"2648370",565,0,42,607,93.08,0,6.92,2019
"2648460",768,19,146,933,82.32,2.04,15.65,2019
"2648532",6718,344,1320,8382,80.15,4.1,15.75,2019
"2648635",545,29,146,720,75.69,4.03,20.28,2019
"2648033",6086,258,1260,7604,80.04,3.39,16.57,2019
"2648085",8434,39,355,8828,95.54,0.44,4.02,2019
"2648088",7863,111,1118,9092,86.48,1.22,12.3,2019
"2648168",8005,44,290,8339,95.99,0.53,3.48,2019
"2648177",36,31,9,76,47.37,40.79,11.84,2019
"2648193",5004,321,913,6238,80.22,5.15,14.64,2019
"2648233",0,0,0,0,NA,NA,NA,2019
"2648243",0,0,0,0,NA,NA,NA,2019
"2648397",0,0,0,0,NA,NA,NA,2019
"2648411",33,0,0,33,100,0,0,2019
"2648551",0,0,0,0,NA,NA,NA,2019
"2648553",0,0,0,0,NA,NA,NA,2019
"2648554",0,0,0,0,NA,NA,NA,2019
"2648638",4531,133,1027,5691,79.62,2.34,18.05,2019
"3858577",708,86,52,846,83.69,10.17,6.15,2019
"3858579",393,15,134,542,72.51,2.77,24.72,2019
"3858656",122,33,26,181,67.4,18.23,14.36,2019
"3858710",168,6,56,230,73.04,2.61,24.35,2019
"3858713",8,0,2,10,80,0,20,2019
"3858718",339,30,56,425,79.76,7.06,13.18,2019
"3858721",168,12,40,220,76.36,5.45,18.18,2019
"3858737",48,5,9,62,77.42,8.06,14.52,2019
"3858740",247,19,19,285,86.67,6.67,6.67,2019
"3059028",189,1,35,225,84,0.44,15.56,2019
"3059047",4829,266,809,5904,81.79,4.51,13.7,2019
"3059058",12,0,0,12,100,0,0,2019
"3059537",19,0,4,23,82.61,0,17.39,2019
"3059645",402,49,173,624,64.42,7.85,27.72,2019
"3059715",12715,743,976,14434,88.09,5.15,6.76,2019
"3059718",14537,384,787,15708,92.55,2.44,5.01,2019
"3059061",108,8,9,125,86.4,6.4,7.2,2019
"3059068",1423,6,225,1654,86.03,0.36,13.6,2019
"3059069",170,8,57,235,72.34,3.4,24.26,2019
"3059078",69,0,11,80,86.25,0,13.75,2019
"3059447",106,7,36,149,71.14,4.7,24.16,2019
"3059450",174,14,40,228,76.32,6.14,17.54,2019
"3059453",104,2,20,126,82.54,1.59,15.87,2019
"3059466",41,6,0,47,87.23,12.77,0,2019
"3059472",170,0,85,255,66.67,0,33.33,2019
"3059486",306,14,110,430,71.16,3.26,25.58,2019
"3059217",63,0,0,63,100,0,0,2019
"3059219",78,18,5,101,77.23,17.82,4.95,2019
"3059221",528,30,114,672,78.57,4.46,16.96,2019
"3059230",1683,70,251,2004,83.98,3.49,12.52,2019
"3059241",134,20,34,188,71.28,10.64,18.09,2019
"3059244",7,0,2,9,77.78,0,22.22,2019
"3059853",318,3,77,398,79.9,0.75,19.35,2019
"3059930",105,69,71,245,42.86,28.16,28.98,2019
"3059828",1797,68,336,2201,81.64,3.09,15.27,2019
"3059754",292,40,75,407,71.74,9.83,18.43,2019
"3059759",1216,41,323,1580,76.96,2.59,20.44,2019
"3059761",113,11,11,135,83.7,8.15,8.15,2019
"3059820",520,25,159,704,73.86,3.55,22.59,2019
"3059841",166,3,19,188,88.3,1.6,10.11,2019
"3059006",463,0,55,518,89.38,0,10.62,2019
"3059015",166,11,25,202,82.18,5.45,12.38,2019
"3059020",38,0,3,41,92.68,0,7.32,2019
"3059030",475,48,161,684,69.44,7.02,23.54,2019
"3059039",9,2,7,18,50,11.11,38.89,2019
"3059043",464,4,246,714,64.99,0.56,34.45,2019
"3059053",45,10,23,78,57.69,12.82,29.49,2019
"3059055",27,0,5,32,84.38,0,15.62,2019
"3059059",51,10,21,82,62.2,12.2,25.61,2019
"3059063",619,35,105,759,81.55,4.61,13.83,2019
"3059212",152,0,14,166,91.57,0,8.43,2019
"3059214",50,0,4,54,92.59,0,7.41,2019
"3059218",284,21,31,336,84.52,6.25,9.23,2019
"3059485",194,0,43,237,81.86,0,18.14,2019
"3059448",91,2,48,141,64.54,1.42,34.04,2019
"3059451",39,13,9,61,63.93,21.31,14.75,2019
"3059454",85,1,11,97,87.63,1.03,11.34,2019
"3059521",489,22,479,990,49.39,2.22,48.38,2019
"1760970",2366,32,755,3153,75.04,1.01,23.95,2019
"3944509",3915,320,1227,5462,71.68,5.86,22.46,2019
"3944606",1196,33,933,2162,55.32,1.53,43.15,2019
"3944608",615,3,168,786,78.24,0.38,21.37,2019
"3944618",1729,85,500,2314,74.72,3.67,21.61,2019
"3944624",779,21,547,1347,57.83,1.56,40.61,2019
"3944883",9052,434,1748,11234,80.58,3.86,15.56,2019
"3944643",1118,15,347,1480,75.54,1.01,23.45,2019
"3944654",3482,238,2222,5942,58.6,4.01,37.39,2019
"3944675",586,11,339,936,62.61,1.18,36.22,2019
"3944677",884,21,154,1059,83.47,1.98,14.54,2019
"3944251",352,6,40,398,88.44,1.51,10.05,2019
"3944423",764,128,100,992,77.02,12.9,10.08,2019
"3944234",1145,79,132,1356,84.44,5.83,9.73,2019
"3944281",11047,313,1401,12761,86.57,2.45,10.98,2019
"3944010",482,51,37,570,84.56,8.95,6.49,2019
"3944017",6307,129,766,7202,87.57,1.79,10.64,2019
"3944039",11572,379,984,12935,89.46,2.93,7.61,2019
"3944052",7944,881,2655,11480,69.2,7.67,23.13,2019
"3944065",1556,19,214,1789,86.98,1.06,11.96,2019
"3944089",5702,244,662,6608,86.29,3.69,10.02,2019
"3944090",3958,113,823,4894,80.87,2.31,16.82,2019
"3944103",3633,301,3241,7175,50.63,4.2,45.17,2019
"3944119",4409,104,1260,5773,76.37,1.8,21.83,2019
"3944301",5267,87,815,6169,85.38,1.41,13.21,2019
"3944305",7546,331,1711,9588,78.7,3.45,17.85,2019
"3944306",7206,366,1561,9133,78.9,4.01,17.09,2019
"3944307",2012,213,748,2973,67.68,7.16,25.16,2019
"3944312",11426,282,1800,13508,84.59,2.09,13.33,2019
"3944319",7969,334,1423,9726,81.94,3.43,14.63,2019
"3944333",6501,173,717,7391,87.96,2.34,9.7,2019
"3944404",557,4,59,620,89.84,0.65,9.52,2019
"3944644",1731,13,390,2134,81.12,0.61,18.28,2019
"3944682",396,3,20,419,94.51,0.72,4.77,2019
"3944822",868,11,264,1143,75.94,0.96,23.1,2019
"3944095",11934,245,2193,14372,83.04,1.7,15.26,2019
"3944116",7843,225,1030,9098,86.21,2.47,11.32,2019
"3944651",232,7,63,302,76.82,2.32,20.86,2019
"3944699",218,6,157,381,57.22,1.57,41.21,2019
"3944401",1030,36,114,1180,87.29,3.05,9.66,2019
"3944470",1134,106,227,1467,77.3,7.23,15.47,2019
"3944511",6986,303,1851,9140,76.43,3.32,20.25,2019
"3944645",809,24,115,948,85.34,2.53,12.13,2019
"3944702",100,88,330,518,19.31,16.99,63.71,2019
"3944843",756,19,142,917,82.44,2.07,15.49,2019
"3944907",5387,149,1310,6846,78.69,2.18,19.14,2019
"3944844",151,10,36,197,76.65,5.08,18.27,2019
"3944864",978,88,199,1265,77.31,6.96,15.73,2019
"3944874",101,3,13,117,86.32,2.56,11.11,2019
"3944045",175,1,23,199,87.94,0.5,11.56,2019
"3944101",0,0,0,0,NA,NA,NA,2019
"3944149",6864,107,525,7496,91.57,1.43,7,2019
"3944265",0,0,0,0,NA,NA,NA,2019
"3944274",46,0,0,46,100,0,0,2019
"3944285",5,0,5,10,50,0,50,2019
"3944439",66,14,9,89,74.16,15.73,10.11,2019
"3944493",29,0,0,29,100,0,0,2019
"3944607",30,0,18,48,62.5,0,37.5,2019
"3944652",0,0,0,0,NA,NA,NA,2019
"3944687",8,0,19,27,29.63,0,70.37,2019
"2648667",0,0,0,0,NA,NA,NA,2019
"2648710",0,0,0,0,NA,NA,NA,2019
"2648816",12,0,0,12,100,0,0,2019
"2648825",0,0,0,0,NA,NA,NA,2019
"2648855",4928,203,705,5836,84.44,3.48,12.08,2019
"2648870",55,0,2,57,96.49,0,3.51,2019
"2648921",0,0,0,0,NA,NA,NA,2019
"2648879",5667,212,897,6776,83.63,3.13,13.24,2019
"2648204",5185,775,3519,9479,54.7,8.18,37.12,2019
"2648306",9076,87,394,9557,94.97,0.91,4.12,2019
"2648418",1264,19,179,1462,86.46,1.3,12.24,2019
"2648331",7978,92,327,8397,95.01,1.1,3.89,2019
"2648381",4951,9,521,5481,90.33,0.16,9.51,2019
"2648470",158,51,103,312,50.64,16.35,33.01,2019
"2648108",10324,100,726,11150,92.59,0.9,6.51,2019
"2648117",3157,142,553,3852,81.96,3.69,14.36,2019
"2648127",10122,376,2083,12581,80.45,2.99,16.56,2019
"2648134",7074,400,715,8189,86.38,4.88,8.73,2019
"2648173",4034,226,432,4692,85.98,4.82,9.21,2019
"2648218",1615,439,1001,3055,52.86,14.37,32.77,2019
"2648198",13284,544,2185,16013,82.96,3.4,13.65,2019
"2648207",7904,759,2891,11554,68.41,6.57,25.02,2019
"2648210",5659,184,2915,8758,64.62,2.1,33.28,2019
"2648219",12889,1152,5330,19371,66.54,5.95,27.52,2019
"2648346",8266,187,705,9158,90.26,2.04,7.7,2019
"2648356",2978,78,260,3316,89.81,2.35,7.84,2019
"2648360",4483,25,151,4659,96.22,0.54,3.24,2019
"2648362",5460,81,445,5986,91.21,1.35,7.43,2019
"2648427",843,51,264,1158,72.8,4.4,22.8,2019
"2648437",203,0,107,310,65.48,0,34.52,2019
"2648438",2296,20,136,2452,93.64,0.82,5.55,2019
"2648439",17805,534,1417,19756,90.12,2.7,7.17,2019
"2648440",22,0,30,52,42.31,0,57.69,2019
"2648042",10186,160,516,10862,93.78,1.47,4.75,2019
"2648005",1806,32,219,2057,87.8,1.56,10.65,2019
"2648027",1030,40,162,1232,83.6,3.25,13.15,2019
"2648060",13279,542,2593,16414,80.9,3.3,15.8,2019
"2648064",1245,22,214,1481,84.06,1.49,14.45,2019
"2648067",11268,253,791,12312,91.52,2.05,6.42,2019
"2648075",7766,196,1261,9223,84.2,2.13,13.67,2019
"2648097",1505,98,441,2044,73.63,4.79,21.58,2019
"2648098",6680,70,285,7035,94.95,1,4.05,2019
"2648104",14822,859,705,16386,90.46,5.24,4.3,2019
"2648892",1462,59,278,1799,81.27,3.28,15.45,2019
"2648912",6308,339,1154,7801,80.86,4.35,14.79,2019
"2648446",9800,399,1841,12040,81.4,3.31,15.29,2019
"2648462",4506,78,290,4874,92.45,1.6,5.95,2019
"2648463",1437,23,275,1735,82.82,1.33,15.85,2019
"2648464",652,13,135,800,81.5,1.62,16.88,2019
"2648467",836,67,230,1133,73.79,5.91,20.3,2019
"2648469",461,11,101,573,80.45,1.92,17.63,2019
"2648505",3972,722,3616,8310,47.8,8.69,43.51,2019
"2648611",2382,25,218,2625,90.74,0.95,8.3,2019
"2648612",2793,151,986,3930,71.07,3.84,25.09,2019
"2648613",270,6,150,426,63.38,1.41,35.21,2019
"2648615",914,51,201,1166,78.39,4.37,17.24,2019
"2648618",1505,77,478,2060,73.06,3.74,23.2,2019
"2648619",171,4,82,257,66.54,1.56,31.91,2019
"2648723",3663,212,1090,4965,73.78,4.27,21.95,2019
"3059740",137,0,45,182,75.27,0,24.73,2019
"3059747",61,4,13,78,78.21,5.13,16.67,2019
"3059758",504,31,171,706,71.39,4.39,24.22,2019
"3059803",6226,39,307,6572,94.74,0.59,4.67,2019
"3059831",136,1,52,189,71.96,0.53,27.51,2019
"3059847",2169,70,137,2376,91.29,2.95,5.77,2019
"3059854",63,3,11,77,81.82,3.9,14.29,2019
"3059860",3579,181,645,4405,81.25,4.11,14.64,2019
"3059003",289,9,135,433,66.74,2.08,31.18,2019
"2066872",274,7,106,387,70.8,1.81,27.39,2019
"2066021",875,20,87,982,89.1,2.04,8.86,2019
"2066035",192,26,68,286,67.13,9.09,23.78,2019
"2066062",26964,537,939,28440,94.81,1.89,3.3,2019
"2066076",736,28,178,942,78.13,2.97,18.9,2019
"2066087",550,24,220,794,69.27,3.02,27.71,2019
"2066090",912,5,274,1191,76.57,0.42,23.01,2019
"2066215",9487,444,886,10817,87.7,4.1,8.19,2019
"2066093",179,1,29,209,85.65,0.48,13.88,2019
"2066094",95,3,42,140,67.86,2.14,30,2019
"2066102",7332,383,2585,10300,71.18,3.72,25.1,2019
"2066424",150,9,35,194,77.32,4.64,18.04,2019
"2066427",365,7,91,463,78.83,1.51,19.65,2019
"2066429",224,0,26,250,89.6,0,10.4,2019
"2066439",768,19,251,1038,73.99,1.83,24.18,2019
"2066531",637,53,60,750,84.93,7.07,8,2019
"2066543",393,26,73,492,79.88,5.28,14.84,2019
"2066552",153,2,34,189,80.95,1.06,17.99,2019
"2066603",331,146,301,778,42.54,18.77,38.69,2019
"2066607",1500,118,1459,3077,48.75,3.83,47.42,2019
"2066608",1266,139,789,2194,57.7,6.34,35.96,2019
"2066611",3663,226,804,4693,78.05,4.82,17.13,2019
"2066733",679,32,164,875,77.6,3.66,18.74,2019
"2066754",86,2,84,172,50,1.16,48.84,2019
"2066763",1073,28,179,1280,83.83,2.19,13.98,2019
"2066776",307,40,163,510,60.2,7.84,31.96,2019
"2066838",30,8,17,55,54.55,14.55,30.91,2019
"2066864",128,8,40,176,72.73,4.55,22.73,2019
"2066871",411,6,117,534,76.97,1.12,21.91,2019
"2066933",84,4,68,156,53.85,2.56,43.59,2019
"2066938",380,9,77,466,81.55,1.93,16.52,2019
"2066941",43,0,33,76,56.58,0,43.42,2019
"2066945",297,4,121,422,70.38,0.95,28.67,2019
"2066007",2008,52,372,2432,82.57,2.14,15.3,2019
"2066012",3610,105,581,4296,84.03,2.44,13.52,2019
"2066013",565,69,125,759,74.44,9.09,16.47,2019
"2066026",140,21,55,216,64.81,9.72,25.46,2019
"2066027",1430,106,15,1551,92.2,6.83,0.97,2019
"2066033",176,11,81,268,65.67,4.1,30.22,2019
"2066214",4784,65,390,5239,91.32,1.24,7.44,2019
"2066217",1948,72,382,2402,81.1,3,15.9,2019
"2066056",494,27,326,847,58.32,3.19,38.49,2019
"2066061",20587,313,1341,22241,92.56,1.41,6.03,2019
"2066067",4403,268,1580,6251,70.44,4.29,25.28,2019
"2066072",364,24,59,447,81.43,5.37,13.2,2019
"2066078",293,3,115,411,71.29,0.73,27.98,2019
"2066088",740,8,151,899,82.31,0.89,16.8,2019
"2066219",5288,120,92,5500,96.15,2.18,1.67,2019
"2066227",2228,7,137,2372,93.93,0.3,5.78,2019
"2066401",553,18,143,714,77.45,2.52,20.03,2019
"3944881",12,0,0,12,100,0,0,2019
"3944901",0,0,0,0,NA,NA,NA,2019
"3944044",3748,235,392,4375,85.67,5.37,8.96,2019
"3944112",5450,567,3772,9789,55.67,5.79,38.53,2019
"3944224",14426,205,1601,16232,88.87,1.26,9.86,2019
"3944275",1055,87,131,1273,82.88,6.83,10.29,2019
"3944049",66,14,9,89,74.16,15.73,10.11,2019
"3945629",695,40,219,954,72.85,4.19,22.96,2019
"3945153",543,15,198,756,71.83,1.98,26.19,2019
"3945167",1083,9,397,1489,72.73,0.6,26.66,2019
"3945169",1504,40,288,1832,82.1,2.18,15.72,2019
"3945207",1547,82,652,2281,67.82,3.59,28.58,2019
"3945217",2492,17,493,3002,83.01,0.57,16.42,2019
"3945233",5222,82,545,5849,89.28,1.4,9.32,2019
"3945601",16735,1059,3172,20966,79.82,5.05,15.13,2019
"3945648",3440,95,1079,4614,74.56,2.06,23.39,2019
"3945658",493,8,415,916,53.82,0.87,45.31,2019
"3945672",414,0,76,490,84.49,0,15.51,2019
"3945679",738,12,275,1025,72,1.17,26.83,2019
"3945694",3708,82,876,4666,79.47,1.76,18.77,2019
"3945698",97,1,62,160,60.62,0.62,38.75,2019
"3945715",661,26,342,1029,64.24,2.53,33.24,2019
"3945734",123,4,56,183,67.21,2.19,30.6,2019
"3945761",593,21,204,818,72.49,2.57,24.94,2019
"3945771",911,64,345,1320,69.02,4.85,26.14,2019
"3945776",187,6,40,233,80.26,2.58,17.17,2019
"3945780",882,173,372,1427,61.81,12.12,26.07,2019
"3945784",977,30,352,1359,71.89,2.21,25.9,2019
"3945813",1101,62,339,1502,73.3,4.13,22.57,2019
"3945822",6892,234,1021,8147,84.6,2.87,12.53,2019
"3945828",2079,25,240,2344,88.69,1.07,10.24,2019
"3945835",160,5,49,214,74.77,2.34,22.9,2019
"3945841",263,27,78,368,71.47,7.34,21.2,2019
"3945844",1041,56,133,1230,84.63,4.55,10.81,2019
"3945846",1232,38,237,1507,81.75,2.52,15.73,2019
"3945853",453,13,58,524,86.45,2.48,11.07,2019
"3945855",59,1,6,66,89.39,1.52,9.09,2019
"3945856",1420,60,425,1905,74.54,3.15,22.31,2019
"3945859",139,0,52,191,72.77,0,27.23,2019
"3945869",1690,12,201,1903,88.81,0.63,10.56,2019
"3945879",1923,92,482,2497,77.01,3.68,19.3,2019
"3945880",834,22,243,1099,75.89,2,22.11,2019
"3945883",1148,37,161,1346,85.29,2.75,11.96,2019
"3945894",256,1,55,312,82.05,0.32,17.63,2019
"3945036",11070,198,932,12200,90.74,1.62,7.64,2019
"3945040",19266,127,796,20189,95.43,0.63,3.94,2019
"3945054",918,0,145,1063,86.36,0,13.64,2019
"3945056",7580,458,619,8657,87.56,5.29,7.15,2019
"3945112",17,0,3,20,85,0,15,2019
"3945115",7,0,31,38,18.42,0,81.58,2019
"3945148",401,11,125,537,74.67,2.05,23.28,2019
"3945150",11274,411,1412,13097,86.08,3.14,10.78,2019
"3945168",415,6,195,616,67.37,0.97,31.66,2019
"3945176",2773,179,703,3655,75.87,4.9,19.23,2019
"3945209",5259,84,627,5970,88.09,1.41,10.5,2019
"3945042",8716,378,1662,10756,81.03,3.51,15.45,2019
"3945066",8093,208,306,8607,94.03,2.42,3.56,2019
"3945102",7522,108,861,8491,88.59,1.27,10.14,2019
"3945106",3862,128,655,4645,83.14,2.76,14.1,2019
"2648628",766,30,115,911,84.08,3.29,12.62,2019
"2648657",2612,87,658,3357,77.81,2.59,19.6,2019
"2648727",326,19,88,433,75.29,4.39,20.32,2019
"2648729",405,31,163,599,67.61,5.18,27.21,2019
"2648730",1835,28,365,2228,82.36,1.26,16.38,2019
"2648743",37,0,0,37,100,0,0,2019
"2648750",3362,177,543,4082,82.36,4.34,13.3,2019
"2648766",330,27,167,524,62.98,5.15,31.87,2019
"2648813",6675,139,1068,7882,84.69,1.76,13.55,2019
"2648836",4015,201,770,4986,80.53,4.03,15.44,2019
"2648838",5714,201,1576,7491,76.28,2.68,21.04,2019
"2648849",1864,42,402,2308,80.76,1.82,17.42,2019
"2648864",8166,541,455,9162,89.13,5.9,4.97,2019
"2648873",420,3,66,489,85.89,0.61,13.5,2019
"2648906",8497,209,1869,10575,80.35,1.98,17.67,2019
"2648120",1788,109,292,2189,81.68,4.98,13.34,2019
"2648157",474,0,129,603,78.61,0,21.39,2019
"2648176",7525,226,568,8319,90.46,2.72,6.83,2019
"2648189",5026,187,444,5657,88.85,3.31,7.85,2019
"2648191",1404,23,159,1586,88.52,1.45,10.03,2019
"2648213",5278,677,1913,7868,67.08,8.6,24.31,2019
"2648216",1741,116,605,2462,70.71,4.71,24.57,2019
"2648223",7674,595,1830,10099,75.99,5.89,18.12,2019
"2648225",4385,165,912,5462,80.28,3.02,16.7,2019
"2648309",10007,279,888,11174,89.56,2.5,7.95,2019
"2648062",2942,86,362,3390,86.78,2.54,10.68,2019
"2648079",4119,131,605,4855,84.84,2.7,12.46,2019
"2648040",3573,103,560,4236,84.35,2.43,13.22,2019
"2648380",2454,0,139,2593,94.64,0,5.36,2019
"2648315",9577,148,1150,10875,88.06,1.36,10.57,2019
"2648324",6098,82,206,6386,95.49,1.28,3.23,2019
"2648341",5009,215,1576,6800,73.66,3.16,23.18,2019
"2648383",4191,23,442,4656,90.01,0.49,9.49,2019
"2648450",1718,112,516,2346,73.23,4.77,21.99,2019
"2648472",454,31,177,662,68.58,4.68,26.74,2019
"2648475",772,53,266,1091,70.76,4.86,24.38,2019
"2648507",9270,504,3446,13220,70.12,3.81,26.07,2019
"2648529",2631,148,878,3657,71.94,4.05,24.01,2019
"2648623",4403,74,315,4792,91.88,1.54,6.57,2019
"2648633",59,0,9,68,86.76,0,13.24,2019
"2648647",1234,29,642,1905,64.78,1.52,33.7,2019
"2648049",1930,48,226,2204,87.57,2.18,10.25,2019
"2648091",8878,196,2710,11784,75.34,1.66,23,2019
"2648126",9895,1258,1786,12939,76.47,9.72,13.8,2019
"2648128",3441,110,285,3836,89.7,2.87,7.43,2019
"2648141",6373,394,2235,9002,70.8,4.38,24.83,2019
"2648144",3372,78,394,3844,87.72,2.03,10.25,2019
"2648386",6409,125,519,7053,90.87,1.77,7.36,2019
"2648334",6864,250,830,7944,86.4,3.15,10.45,2019
"2648371",8332,131,631,9094,91.62,1.44,6.94,2019
"2648382",7907,114,394,8415,93.96,1.35,4.68,2019
"2648390",9473,127,823,10423,90.89,1.22,7.9,2019
"2648393",6566,110,580,7256,90.49,1.52,7.99,2019
"2648412",1611,97,279,1987,81.08,4.88,14.04,2019
"2648084",6309,62,289,6660,94.73,0.93,4.34,2019
"2648125",6053,475,1096,7624,79.39,6.23,14.38,2019
"2648143",0,0,0,0,NA,NA,NA,2019
"2648150",9431,118,842,10391,90.76,1.14,8.1,2019
"2648180",18549,2282,3199,24030,77.19,9.5,13.31,2019
"3169144",44,0,33,77,57.14,0,42.86,2019
"3169149",233,15,69,317,73.5,4.73,21.77,2019
"3169154",414,31,101,546,75.82,5.68,18.5,2019
"3169169",174,11,33,218,79.82,5.05,15.14,2019
"3169219",65,0,11,76,85.53,0,14.47,2019
"3169331",27,0,0,27,100,0,0,2019
"3169022",625,21,140,786,79.52,2.67,17.81,2019
"3169026",42,0,39,81,51.85,0,48.15,2019
"3169036",33,3,3,39,84.62,7.69,7.69,2019
"3858476",85,5,10,100,85,5,10,2019
"3858357",58,9,40,107,54.21,8.41,37.38,2019
"3858365",87,2,30,119,73.11,1.68,25.21,2019
"3858368",1280,25,336,1641,78,1.52,20.48,2019
"3858379",64,4,39,107,59.81,3.74,36.45,2019
"3858385",60,0,11,71,84.51,0,15.49,2019
"3858415",48,1,10,59,81.36,1.69,16.95,2019
"3858420",79,2,26,107,73.83,1.87,24.3,2019
"3858422",52,0,26,78,66.67,0,33.33,2019
"3858444",71,18,27,116,61.21,15.52,23.28,2019
"3858448",124,1,38,163,76.07,0.61,23.31,2019
"3858464",64,9,24,97,65.98,9.28,24.74,2019
"3858478",39,0,24,63,61.9,0,38.1,2019
"3858479",75,0,12,87,86.21,0,13.79,2019
"3858480",84,13,54,151,55.63,8.61,35.76,2019
"1762323",75,0,23,98,76.53,0,23.47,2019
"3858251",626,29,113,768,81.51,3.78,14.71,2019
"3858741",231,9,73,313,73.8,2.88,23.32,2019
"3858750",171,7,19,197,86.8,3.55,9.64,2019
"3858763",739,202,232,1173,63,17.22,19.78,2019
"3858769",32,42,25,99,32.32,42.42,25.25,2019
"3858781",238,2,39,279,85.3,0.72,13.98,2019
"3858784",891,114,195,1200,74.25,9.5,16.25,2019
"3858787",54,5,14,73,73.97,6.85,19.18,2019
"3858830",66,11,28,105,62.86,10.48,26.67,2019
"3858833",53,23,3,79,67.09,29.11,3.8,2019
"3858835",55,8,29,92,59.78,8.7,31.52,2019
"3858575",276,43,77,396,69.7,10.86,19.44,2019
"3858580",157,1,16,174,90.23,0.57,9.2,2019
"3858639",629,13,161,803,78.33,1.62,20.05,2019
"3858640",518,41,81,640,80.94,6.41,12.66,2019
"3858646",395,9,96,500,79,1.8,19.2,2019
"3858652",349,25,92,466,74.89,5.36,19.74,2019
"3858712",35,1,13,49,71.43,2.04,26.53,2019
"3858722",560,40,37,637,87.91,6.28,5.81,2019
"3858727",78,17,27,122,63.93,13.93,22.13,2019
"3858760",93,0,37,130,71.54,0,28.46,2019
"3858783",160,2,20,182,87.91,1.1,10.99,2019
"3858801",9909,1594,1154,12657,78.29,12.59,9.12,2019
"3858838",68,2,11,81,83.95,2.47,13.58,2019
"3858366",337,16,80,433,77.83,3.7,18.48,2019
"3858367",433,26,193,652,66.41,3.99,29.6,2019
"3858369",311,24,97,432,71.99,5.56,22.45,2019
"3858418",150,0,47,197,76.14,0,23.86,2019
"3858458",427,10,81,518,82.43,1.93,15.64,2019
"3858463",235,28,109,372,63.17,7.53,29.3,2019
"3858482",383,33,57,473,80.97,6.98,12.05,2019
"3858486",83,10,4,97,85.57,10.31,4.12,2019
"3858544",138,25,97,260,53.08,9.62,37.31,2019
"3858565",84,12,13,109,77.06,11.01,11.93,2019
"3945131",83,0,26,109,76.15,0,23.85,2019
"3945142",1060,104,335,1499,70.71,6.94,22.35,2019
"3945160",248,11,128,387,64.08,2.84,33.07,2019
"3945171",1958,54,396,2408,81.31,2.24,16.45,2019
"3945174",744,0,28,772,96.37,0,3.63,2019
"3945230",10515,280,1051,11846,88.76,2.36,8.87,2019
"3945220",5448,501,710,6659,81.81,7.52,10.66,2019
"3945226",2403,45,149,2597,92.53,1.73,5.74,2019
"3945227",7118,230,1297,8645,82.34,2.66,15,2019
"3945236",9235,151,1610,10996,83.99,1.37,14.64,2019
"3945237",6977,325,2117,9419,74.07,3.45,22.48,2019
"3945255",8173,137,568,8878,92.06,1.54,6.4,2019
"3945301",18,0,0,18,100,0,0,2019
"3945312",358,0,71,429,83.45,0,16.55,2019
"3945315",1398,53,124,1575,88.76,3.37,7.87,2019
"3945325",835,3,191,1029,81.15,0.29,18.56,2019
"3945344",5360,125,966,6451,83.09,1.94,14.97,2019
"3945348",235,12,74,321,73.21,3.74,23.05,2019
"3945359",622,14,74,710,87.61,1.97,10.42,2019
"3945363",548,7,86,641,85.49,1.09,13.42,2019
"3945402",3267,61,1138,4466,73.15,1.37,25.48,2019
"3945409",2705,143,144,2992,90.41,4.78,4.81,2019
"3945416",1817,25,388,2230,81.48,1.12,17.4,2019
"3945418",518,0,99,617,83.95,0,16.05,2019
"3945430",2793,32,228,3053,91.48,1.05,7.47,2019
"3945440",8100,137,742,8979,90.21,1.53,8.26,2019
"3945459",11191,257,1059,12507,89.48,2.05,8.47,2019
"3945613",812,9,242,1063,76.39,0.85,22.77,2019
"3945644",1486,58,339,1883,78.92,3.08,18,2019
"3945671",67,0,27,94,71.28,0,28.72,2019
"3945680",3814,144,853,4811,79.28,2.99,17.73,2019
"3945682",627,23,365,1015,61.77,2.27,35.96,2019
"3945695",190,28,61,279,68.1,10.04,21.86,2019
"3945697",1288,63,466,1817,70.89,3.47,25.65,2019
"3945723",1179,37,265,1481,79.61,2.5,17.89,2019
"3945742",982,63,188,1233,79.64,5.11,15.25,2019
"3945750",8464,500,2261,11225,75.4,4.45,20.14,2019
"3945764",2559,134,427,3120,82.02,4.29,13.69,2019
"3945778",238,31,96,365,65.21,8.49,26.3,2019
"3945779",277,8,35,320,86.56,2.5,10.94,2019
"3945804",4733,265,1205,6203,76.3,4.27,19.43,2019
"3945807",4027,175,605,4807,83.77,3.64,12.59,2019
"3945808",98,8,22,128,76.56,6.25,17.19,2019
"3945638",6283,228,1832,8343,75.31,2.73,21.96,2019
"3945002",4243,288,620,5151,82.37,5.59,12.04,2019
"3945701",8631,1016,1070,10717,80.54,9.48,9.98,2019
"1846774",5197,127,1005,6329,82.11,2.01,15.88,2019
"1846788",853,68,180,1101,77.48,6.18,16.35,2019
"1846791",303,0,26,329,92.1,0,7.9,2019
"1846798",487,2,98,587,82.96,0.34,16.7,2019
"1846835",12971,305,1159,14435,89.86,2.11,8.03,2019
"1846901",12689,640,3114,16443,77.17,3.89,18.94,2019
"1846902",12513,682,2428,15623,80.09,4.37,15.54,2019
"1846930",40,0,3,43,93.02,0,6.98,2019
"1846938",988,91,163,1242,79.55,7.33,13.12,2019
"1846947",8100,392,2176,10668,75.93,3.67,20.4,2019
"1846950",157,0,78,235,66.81,0,33.19,2019
"1846951",587,32,116,735,79.86,4.35,15.78,2019
"1846970",6789,341,1774,8904,76.25,3.83,19.92,2019
"1846349",1138,0,106,1244,91.48,0,8.52,2019
"1846368",12403,285,2881,15569,79.66,1.83,18.5,2019
"1846374",264,16,22,302,87.42,5.3,7.28,2019
"1846377",109,0,45,154,70.78,0,29.22,2019
"1846385",12926,247,1322,14495,89.18,1.7,9.12,2019
"1846408",4715,147,1574,6436,73.26,2.28,24.46,2019
"1846502",29,0,0,29,100,0,0,2019
"1846510",1062,103,355,1520,69.87,6.78,23.36,2019
"1846530",10324,198,331,10853,95.13,1.82,3.05,2019
"1846532",472,17,123,612,77.12,2.78,20.1,2019
"1846940",860,54,143,1057,81.36,5.11,13.53,2019
"1846989",1081,121,222,1424,75.91,8.5,15.59,2019
"1846819",3544,189,520,4253,83.33,4.44,12.23,2019
"1846845",7751,60,486,8297,93.42,0.72,5.86,2019
"1846110",159,3,43,205,77.56,1.46,20.98,2019
"1846130",892,45,122,1059,84.23,4.25,11.52,2019
"1846143",18779,528,1928,21235,88.43,2.49,9.08,2019
"1846148",1403,120,542,2065,67.94,5.81,26.25,2019
"1846151",9399,285,1849,11533,81.5,2.47,16.03,2019
"1846156",249,14,208,471,52.87,2.97,44.16,2019
"1846158",7456,164,1178,8798,84.75,1.86,13.39,2019
"1846202",7866,495,1447,9808,80.2,5.05,14.75,2019
"1846205",9053,434,2110,11597,78.06,3.74,18.19,2019
"1846975",4326,196,997,5519,78.38,3.55,18.06,2019
"1846404",4490,228,2343,7061,63.59,3.23,33.18,2019
"1846217",11114,467,698,12279,90.51,3.8,5.68,2019
"1846342",10016,260,1311,11587,86.44,2.24,11.31,2019
"1846035",338,14,82,434,77.88,3.23,18.89,2019
"1846543",569,17,347,933,60.99,1.82,37.19,2019
"1846792",1201,66,254,1521,78.96,4.34,16.7,2019
"1846702",767,27,150,944,81.25,2.86,15.89,2019
"1846787",1031,48,333,1412,73.02,3.4,23.58,2019
"1846065",918,34,228,1180,77.8,2.88,19.32,2019
"1846121",1673,48,285,2006,83.4,2.39,14.21,2019
"1846180",331,13,85,429,77.16,3.03,19.81,2019
"1846259",3508,40,92,3640,96.37,1.1,2.53,2019
"1846037",14242,95,328,14665,97.12,0.65,2.24,2019
"1846062",12258,188,764,13210,92.79,1.42,5.78,2019
"1846146",107,0,10,117,91.45,0,8.55,2019
"1846183",15,0,0,15,100,0,0,2019
"1846704",9,0,8,17,52.94,0,47.06,2019
"1846771",34,0,0,34,100,0,0,2019
"1846786",26,0,0,26,100,0,0,2019
"1846915",248,12,64,324,76.54,3.7,19.75,2019
"1846922",0,10,0,10,0,100,0,2019
"1846967",33,3,9,45,73.33,6.67,20,2019
"1846984",91,0,15,106,85.85,0,14.15,2019
"1846126",1541,69,282,1892,81.45,3.65,14.9,2019
"1846998",101,0,0,101,100,0,0,2019
"1846001",3046,157,918,4121,73.91,3.81,22.28,2019
"1846012",6780,173,1266,8219,82.49,2.1,15.4,2019
"1846030",931,31,243,1205,77.26,2.57,20.17,2019
"1846290",95,17,0,112,84.82,15.18,0,2019
"1846312",6237,668,3460,10365,60.17,6.44,33.38,2019
"1846376",75,1,4,80,93.75,1.25,5,2019
"1846383",13705,416,2185,16306,84.05,2.55,13.4,2019
"1846394",3634,198,1084,4916,73.92,4.03,22.05,2019
"1846402",1365,44,1281,2690,50.74,1.64,47.62,2019
"1846407",2519,164,1816,4499,55.99,3.65,40.36,2019
"2648185",17991,556,3189,21736,82.77,2.56,14.67,2019
"2648197",22507,1078,1932,25517,88.2,4.22,7.57,2019
"2648206",3478,640,2525,6643,52.36,9.63,38.01,2019
"2648238",5397,832,3765,9994,54,8.32,37.67,2019
"2648649",428,10,74,512,83.59,1.95,14.45,2019
"2648651",1799,57,474,2330,77.21,2.45,20.34,2019
"2648654",716,27,265,1008,71.03,2.68,26.29,2019
"2648656",1353,51,388,1792,75.5,2.85,21.65,2019
"2648725",808,48,197,1053,76.73,4.56,18.71,2019
"2965254",577,5,121,703,82.08,0.71,17.21,2019
"2965255",1340,15,282,1637,81.86,0.92,17.23,2019
"2965260",131,0,24,155,84.52,0,15.48,2019
"2965263",402,40,235,677,59.38,5.91,34.71,2019
"2965786",395,33,338,766,51.57,4.31,44.13,2019
"2965770",905,31,343,1279,70.76,2.42,26.82,2019
"2965054",174,51,42,267,65.17,19.1,15.73,2019
"2965624",508,0,95,603,84.25,0,15.75,2019
"2965729",110,0,0,110,100,0,0,2019
"2965708",3609,233,830,4672,77.25,4.99,17.77,2019
"2965715",29,0,0,29,100,0,0,2019
"2965724",431,63,150,644,66.93,9.78,23.29,2019
"2965760",222,0,72,294,75.51,0,24.49,2019
"2965762",108,12,47,167,64.67,7.19,28.14,2019
"2965784",3,0,4,7,42.86,0,57.14,2019
"2965807",19845,2685,3305,25835,76.81,10.39,12.79,2019
"2965231",910,60,326,1296,70.22,4.63,25.15,2019
"2965262",187,26,82,295,63.39,8.81,27.8,2019
"2965282",55,0,11,66,83.33,0,16.67,2019
"2965001",90,7,18,115,78.26,6.09,15.65,2019
"2965608",2268,318,853,3439,65.95,9.25,24.8,2019
"2965690",62,0,13,75,82.67,0,17.33,2019
"2965247",250,0,25,275,90.91,0,9.09,2019
"2965714",10616,314,1534,12464,85.17,2.52,12.31,2019
"2066833",142,11,58,211,67.3,5.21,27.49,2019
"2066840",210,8,19,237,88.61,3.38,8.02,2019
"2066758",72,2,42,116,62.07,1.72,36.21,2019
"2066767",141,2,69,212,66.51,0.94,32.55,2019
"2066782",32,1,24,57,56.14,1.75,42.11,2019
"2066842",107,3,77,187,57.22,1.6,41.18,2019
"2066850",75,1,19,95,78.95,1.05,20,2019
"2066852",233,6,46,285,81.75,2.11,16.14,2019
"2066853",142,4,46,192,73.96,2.08,23.96,2019
"2066858",123,5,40,168,73.21,2.98,23.81,2019
"2066860",433,18,159,610,70.98,2.95,26.07,2019
"2066930",86,2,20,108,79.63,1.85,18.52,2019
"2066939",134,29,72,235,57.02,12.34,30.64,2019
"2066944",45,2,30,77,58.44,2.6,38.96,2019
"2066946",26,0,35,61,42.62,0,57.38,2019
"2066955",29,0,10,39,74.36,0,25.64,2019
"2066757",882,79,364,1325,66.57,5.96,27.47,2019
"2066779",189,4,50,243,77.78,1.65,20.58,2019
"2066834",284,0,74,358,79.33,0,20.67,2019
"2066849",147,0,28,175,84,0,16,2019
"2066717",143,25,64,232,61.64,10.78,27.59,2019
"2066735",174,0,16,190,91.58,0,8.42,2019
"2066772",74,0,7,81,91.36,0,8.64,2019
"2066778",0,0,0,0,NA,NA,NA,2019
"2066859",68,0,36,104,65.38,0,34.62,2019
"2066869",190,3,111,304,62.5,0.99,36.51,2019
"3944825",33,1,6,40,82.5,2.5,15,2019
"3944830",5969,418,1364,7751,77.01,5.39,17.6,2019
"3943148",637,35,160,832,76.56,4.21,19.23,2019
"3943150",615,26,172,813,75.65,3.2,21.16,2019
"3943204",13242,583,2692,16517,80.17,3.53,16.3,2019
"3943212",10555,400,691,11646,90.63,3.43,5.93,2019
"3943214",11191,202,1035,12428,90.05,1.63,8.33,2019
"3943215",8376,272,1018,9666,86.65,2.81,10.53,2019
"3943223",5993,406,2434,8833,67.85,4.6,27.56,2019
"3943229",18310,264,2387,20961,87.35,1.26,11.39,2019
"3943231",7264,156,696,8116,89.5,1.92,8.58,2019
"3943232",15209,432,3303,18944,80.28,2.28,17.44,2019
"3943235",17344,343,713,18400,94.26,1.86,3.88,2019
"3943302",16098,487,3840,20425,78.82,2.38,18.8,2019
"3943138",5570,378,1343,7291,76.4,5.18,18.42,2019
"3943144",111,2,44,157,70.7,1.27,28.03,2019
"3943240",1927,36,85,2048,94.09,1.76,4.15,2019
"3943310",911,4,176,1091,83.5,0.37,16.13,2019
"3943324",1071,65,175,1311,81.69,4.96,13.35,2019
"3943342",934,0,153,1087,85.92,0,14.08,2019
"3943345",263,5,79,347,75.79,1.44,22.77,2019
"3943347",458,14,80,552,82.97,2.54,14.49,2019
"3943359",254,5,33,292,86.99,1.71,11.3,2019
"3943408",87,5,18,110,79.09,4.55,16.36,2019
"3943450",1240,25,181,1446,85.75,1.73,12.52,2019
"3943451",388,1,54,443,87.58,0.23,12.19,2019
"3943460",2445,75,161,2681,91.2,2.8,6.01,2019
"3943464",401,0,106,507,79.09,0,20.91,2019
"3943506",5032,87,1064,6183,81.38,1.41,17.21,2019
"3943511",417,16,72,505,82.57,3.17,14.26,2019
"3943469",1046,33,191,1270,82.36,2.6,15.04,2019
"3943512",9315,309,1903,11527,80.81,2.68,16.51,2019
"3943526",1832,70,366,2268,80.78,3.09,16.14,2019
"3943528",5464,201,699,6364,85.86,3.16,10.98,2019
"3943533",560,19,70,649,86.29,2.93,10.79,2019
"3943535",236,4,21,261,90.42,1.53,8.05,2019
"3943842",142,0,50,192,73.96,0,26.04,2019
"3943902",28,0,0,28,100,0,0,2019
"3943907",1756,14,512,2282,76.95,0.61,22.44,2019
"3943917",1136,46,255,1437,79.05,3.2,17.75,2019
"3943925",54,0,0,54,100,0,0,2019
"3943967",0,0,0,0,NA,NA,NA,2019
"3943972",25,0,0,25,100,0,0,2019
"3943974",21,0,16,37,56.76,0,43.24,2019
"3943032",10,0,0,10,100,0,0,2019
"3943036",112,0,26,138,81.16,0,18.84,2019
"3943623",7645,236,1083,8964,85.29,2.63,12.08,2019
"3943730",538,23,212,773,69.6,2.98,27.43,2019
"3943734",459,0,125,584,78.6,0,21.4,2019
"3943767",263,12,57,332,79.22,3.61,17.17,2019
"3943768",137,0,17,154,88.96,0,11.04,2019
"3943778",285,2,192,479,59.5,0.42,40.08,2019
"3943793",1372,48,661,2081,65.93,2.31,31.76,2019
"3943812",5822,282,1769,7873,73.95,3.58,22.47,2019
"3943824",647,4,598,1249,51.8,0.32,47.88,2019
"3943832",1888,100,1074,3062,61.66,3.27,35.08,2019
"3943844",1087,21,371,1479,73.5,1.42,25.08,2019
"3943845",1469,26,375,1870,78.56,1.39,20.05,2019
"3943910",1075,0,217,1292,83.2,0,16.8,2019
"1846514",13822,317,2342,16481,83.87,1.92,14.21,2019
"1846582",4270,236,647,5153,82.86,4.58,12.56,2019
"1846721",1374,45,334,1753,78.38,2.57,19.05,2019
"1846748",1541,27,102,1670,92.28,1.62,6.11,2019
"1846760",403,10,144,557,72.35,1.8,25.85,2019
"1846761",2498,85,1432,4015,62.22,2.12,35.67,2019
"1846776",531,36,131,698,76.07,5.16,18.77,2019
"1846793",1485,76,218,1779,83.47,4.27,12.25,2019
"1846797",1178,32,187,1397,84.32,2.29,13.39,2019
"1846391",1767,45,173,1985,89.02,2.27,8.72,2019
"1846045",20,0,0,20,100,0,0,2019
"1846056",650,47,141,838,77.57,5.61,16.83,2019
"1846057",443,20,54,517,85.69,3.87,10.44,2019
"1846531",404,0,156,560,72.14,0,27.86,2019
"1846542",1060,85,355,1500,70.67,5.67,23.67,2019
"1846545",8645,314,2462,11421,75.69,2.75,21.56,2019
"1846550",2881,181,1132,4194,68.69,4.32,26.99,2019
"1846556",124,94,5,223,55.61,42.15,2.24,2019
"1846565",1051,28,1322,2401,43.77,1.17,55.06,2019
"1846570",239,5,81,325,73.54,1.54,24.92,2019
"1846601",1206,245,781,2232,54.03,10.98,34.99,2019
"1846356",5706,164,581,6451,88.45,2.54,9.01,2019
"1846366",1608,70,453,2131,75.46,3.28,21.26,2019
"1846373",5341,161,204,5706,93.6,2.82,3.58,2019
"1846393",49,0,71,120,40.83,0,59.17,2019
"1846409",2067,49,718,2834,72.94,1.73,25.34,2019
"1846033",13583,64,261,13908,97.66,0.46,1.88,2019
"1846036",3600,169,968,4737,76,3.57,20.43,2019
"1846540",3055,65,680,3800,80.39,1.71,17.89,2019
"1846567",3044,191,579,3814,79.81,5.01,15.18,2019
"1846613",2482,198,961,3641,68.17,5.44,26.39,2019
"1846616",1599,114,401,2114,75.64,5.39,18.97,2019
"1846619",5255,386,1845,7486,70.2,5.16,24.65,2019
"1846701",2741,61,419,3221,85.1,1.89,13.01,2019
"1846711",1870,156,687,2713,68.93,5.75,25.32,2019
"1846740",626,45,506,1177,53.19,3.82,42.99,2019
"1846747",824,5,192,1021,80.71,0.49,18.81,2019
"1846240",8316,207,1273,9796,84.89,2.11,13,2019
"1846310",4184,131,919,5234,79.94,2.5,17.56,2019
"1846923",2608,64,539,3211,81.22,1.99,16.79,2019
"1846936",1827,118,233,2178,83.88,5.42,10.7,2019
"1846952",6012,734,1534,8280,72.61,8.86,18.53,2019
"1846957",174,26,57,257,67.7,10.12,22.18,2019
"1846968",36,0,0,36,100,0,0,2019
"1846982",859,16,163,1038,82.76,1.54,15.7,2019
"1846986",565,52,85,702,80.48,7.41,12.11,2019
"3945821",401,11,65,477,84.07,2.31,13.63,2019
"3945876",294,2,52,348,84.48,0.57,14.94,2019
"3945860",706,15,99,820,86.1,1.83,12.07,2019
"3945861",59,2,35,96,61.46,2.08,36.46,2019
"3945871",720,13,57,790,91.14,1.65,7.22,2019
"3945888",119,0,1,120,99.17,0,0.83,2019
"3945213",4578,158,721,5457,83.89,2.9,13.21,2019
"3945223",4559,164,832,5555,82.07,2.95,14.98,2019
"3945224",7565,267,1569,9401,80.47,2.84,16.69,2019
"3945243",5071,97,216,5384,94.19,1.8,4.01,2019
"3945244",9284,195,926,10405,89.23,1.87,8.9,2019
"3945251",7770,221,944,8935,86.96,2.47,10.57,2019
"3945252",1757,52,113,1922,91.42,2.71,5.88,2019
"1846511",1244,76,415,1735,71.7,4.38,23.92,2019
"1846526",9502,274,2061,11837,80.27,2.31,17.41,2019
"1846528",6502,155,1507,8164,79.64,1.9,18.46,2019
"1846544",10357,400,2093,12850,80.6,3.11,16.29,2019
"1846553",900,26,137,1063,84.67,2.45,12.89,2019
"1846571",568,9,824,1401,40.54,0.64,58.82,2019
"1846595",29,10,6,45,64.44,22.22,13.33,2019
"1846703",6141,331,1028,7500,81.88,4.41,13.71,2019
"1846705",477,64,163,704,67.76,9.09,23.15,2019
"1846714",4667,295,913,5875,79.44,5.02,15.54,2019
"1846731",219,0,40,259,84.56,0,15.44,2019
"1846766",246,7,40,293,83.96,2.39,13.65,2019
"1846767",2189,45,521,2755,79.46,1.63,18.91,2019
"1846011",5743,236,818,6797,84.49,3.47,12.03,2019
"1846013",6263,158,1506,7927,79.01,1.99,19,2019
"1846041",6282,330,1759,8371,75.04,3.94,21.01,2019
"1846044",1001,28,154,1183,84.62,2.37,13.02,2019
"1846075",2366,33,0,2399,98.62,1.38,0,2019
"1846111",67,3,16,86,77.91,3.49,18.6,2019
"1846115",579,67,132,778,74.42,8.61,16.97,2019
"1846125",25,0,0,25,100,0,0,2019
"1846127",89,0,29,118,75.42,0,24.58,2019
"1846149",633,26,60,719,88.04,3.62,8.34,2019
"1846157",1203,26,158,1387,86.73,1.87,11.39,2019
"1846171",515,25,99,639,80.59,3.91,15.49,2019
"1846806",6346,206,2011,8563,74.11,2.41,23.48,2019
"1846807",5948,226,467,6641,89.56,3.4,7.03,2019
"1846910",899,44,220,1163,77.3,3.78,18.92,2019
"1846919",727,38,221,986,73.73,3.85,22.41,2019
"1846931",43,7,39,89,48.31,7.87,43.82,2019
"1846953",5555,844,2107,8506,65.31,9.92,24.77,2019
"1846040",3821,151,596,4568,83.65,3.31,13.05,2019
"1846048",660,24,67,751,87.88,3.2,8.92,2019
"1846055",4218,16,173,4407,95.71,0.36,3.93,2019
"1846070",626,75,121,822,76.16,9.12,14.72,2019
"1846071",1098,58,183,1339,82,4.33,13.67,2019
"1846077",9879,168,349,10396,95.03,1.62,3.36,2019
"1846106",2011,0,378,2389,84.18,0,15.82,2019
"1846117",193,0,51,244,79.1,0,20.9,2019
"1846128",714,20,86,820,87.07,2.44,10.49,2019
"1846131",9935,361,1682,11978,82.94,3.01,14.04,2019
"1846133",255,29,53,337,75.67,8.61,15.73,2019
"1846160",1929,131,481,2541,75.91,5.16,18.93,2019
"1846163",4039,36,427,4502,89.72,0.8,9.48,2019
"1846165",416,36,152,604,68.87,5.96,25.17,2019
"1846181",1617,67,234,1918,84.31,3.49,12.2,2019
"1846182",526,0,131,657,80.06,0,19.94,2019
"1846186",540,54,102,696,77.59,7.76,14.66,2019
"1846208",6347,250,1775,8372,75.81,2.99,21.2,2019
"1846219",11011,477,4397,15885,69.32,3,27.68,2019
"1846239",8930,305,793,10028,89.05,3.04,7.91,2019
"1846241",8100,388,2150,10638,76.14,3.65,20.21,2019
"1846280",3096,23,155,3274,94.56,0.7,4.73,2019
"1846815",9403,156,1270,10829,86.83,1.44,11.73,2019
"1846803",2565,80,876,3521,72.85,2.27,24.88,2019
"1846804",10854,251,884,11989,90.53,2.09,7.37,2019
"1846808",6753,295,1331,8379,80.59,3.52,15.88,2019
"1846917",529,6,201,736,71.88,0.82,27.31,2019
"1846920",344,7,37,388,88.66,1.8,9.54,2019
"2066936",141,0,22,163,86.5,0,13.5,2019
"2066937",215,2,107,324,66.36,0.62,33.02,2019
"2066940",89,5,50,144,61.81,3.47,34.72,2019
"2066942",103,8,13,124,83.06,6.45,10.48,2019
"2066943",159,6,66,231,68.83,2.6,28.57,2019
"2066959",72,0,22,94,76.6,0,23.4,2019
"2066970",38,0,14,52,73.08,0,26.92,2019
"2066510",221,11,56,288,76.74,3.82,19.44,2019
"2066612",747,117,584,1448,51.59,8.08,40.33,2019
"3168960",67,0,18,85,78.82,0,21.18,2019
"3168360",119,11,62,192,61.98,5.73,32.29,2019
"3168361",824,25,181,1030,80,2.43,17.57,2019
"3168366",304,16,49,369,82.38,4.34,13.28,2019
"3168368",157,0,32,189,83.07,0,16.93,2019
"3168377",147,2,40,189,77.78,1.06,21.16,2019
"3168380",27,5,16,48,56.25,10.42,33.33,2019
"3168640",473,16,90,579,81.69,2.76,15.54,2019
"3168655",40,0,6,46,86.96,0,13.04,2019
"3168659",63,0,20,83,75.9,0,24.1,2019
"3168662",455,10,29,494,92.11,2.02,5.87,2019
"3168718",645,10,114,769,83.88,1.3,14.82,2019
"3168720",99,2,34,135,73.33,1.48,25.19,2019
"3168731",804,12,153,969,82.97,1.24,15.79,2019
"3168734",26,0,5,31,83.87,0,16.13,2019
"3168755",106,0,33,139,76.26,0,23.74,2019
"3168765",432,12,103,547,78.98,2.19,18.83,2019
"3168790",373,16,30,419,89.02,3.82,7.16,2019
"3168823",635,89,270,994,63.88,8.95,27.16,2019
"3168845",7063,237,875,8175,86.4,2.9,10.7,2019
"3168852",200,2,41,243,82.3,0.82,16.87,2019
"3168854",334,3,36,373,89.54,0.8,9.65,2019
"3168859",188,14,54,256,73.44,5.47,21.09,2019
"3168860",100,10,59,169,59.17,5.92,34.91,2019
"3168871",79,0,27,106,74.53,0,25.47,2019
"3168872",244,10,63,317,76.97,3.15,19.87,2019
"3168882",125,17,39,181,69.06,9.39,21.55,2019
"3168768",203,16,50,269,75.46,5.95,18.59,2019
"3168773",52,0,14,66,78.79,0,21.21,2019
"3168774",67,3,18,88,76.14,3.41,20.45,2019
"3168783",270,27,120,417,64.75,6.47,28.78,2019
"3168786",319,15,34,368,86.68,4.08,9.24,2019
"3168789",40,0,20,60,66.67,0,33.33,2019
"3168801",8820,275,1758,10853,81.27,2.53,16.2,2019
"3168803",8198,415,1300,9913,82.7,4.19,13.11,2019
"3168810",317,40,59,416,76.2,9.62,14.18,2019
"3168815",183,0,85,268,68.28,0,31.72,2019
"3168827",190,6,61,257,73.93,2.33,23.74,2019
"3168853",515,8,166,689,74.75,1.16,24.09,2019
"3168861",37,0,0,37,100,0,0,2019
"3168862",1006,47,277,1330,75.64,3.53,20.83,2019
"3168863",365,3,64,432,84.49,0.69,14.81,2019
"3168935",238,7,51,296,80.41,2.36,17.23,2019
"3168004",251,49,85,385,65.19,12.73,22.08,2019
"3168029",268,1,87,356,75.28,0.28,24.44,2019
"3168036",94,8,10,112,83.93,7.14,8.93,2019
"3168040",136,1,34,171,79.53,0.58,19.88,2019
"3168057",504,21,131,656,76.83,3.2,19.97,2019
"3168104",11550,259,2464,14273,80.92,1.81,17.26,2019
"3168116",10776,134,537,11447,94.14,1.17,4.69,2019
"3943933",531,11,211,753,70.52,1.46,28.02,2019
"3943951",19,0,0,19,100,0,0,2019
"3943906",2323,147,888,3358,69.18,4.38,26.44,2019
"3943928",18,0,29,47,38.3,0,61.7,2019
"3943934",85,0,96,181,46.96,0,53.04,2019
"3943935",2643,131,798,3572,73.99,3.67,22.34,2019
"3943945",789,28,440,1257,62.77,2.23,35,2019
"3943946",746,7,183,936,79.7,0.75,19.55,2019
"3943968",1958,150,651,2759,70.97,5.44,23.6,2019
"3943977",563,62,235,860,65.47,7.21,27.33,2019
"3943541",36,6,9,51,70.59,11.76,17.65,2019
"3943547",122,0,10,132,92.42,0,7.58,2019
"3943554",807,31,171,1009,79.98,3.07,16.95,2019
"3943609",6639,258,1839,8736,76,2.95,21.05,2019
"3943620",1813,132,531,2476,73.22,5.33,21.45,2019
"3943701",18054,635,4155,22844,79.03,2.78,18.19,2019
"3943739",593,32,99,724,81.91,4.42,13.67,2019
"3943713",1955,109,553,2617,74.7,4.17,21.13,2019
"3943718",933,48,217,1198,77.88,4.01,18.11,2019
"3943722",103,0,17,120,85.83,0,14.17,2019
"3943748",699,46,303,1048,66.7,4.39,28.91,2019
"3943758",937,39,261,1237,75.75,3.15,21.1,2019
"3943764",2402,155,625,3182,75.49,4.87,19.64,2019
"3943773",931,44,291,1266,73.54,3.48,22.99,2019
"3943811",232,10,85,327,70.95,3.06,25.99,2019
"3943843",270,10,142,422,63.98,2.37,33.65,2019
"3943915",308,3,225,536,57.46,0.56,41.98,2019
"3943942",810,58,228,1096,73.91,5.29,20.8,2019
"3943983",140,30,59,229,61.14,13.1,25.76,2019
"3943986",606,4,256,866,69.98,0.46,29.56,2019
"3943344",1859,72,365,2296,80.97,3.14,15.9,2019
"3943412",1367,51,164,1582,86.41,3.22,10.37,2019
"3943413",400,12,60,472,84.75,2.54,12.71,2019
"3943416",1027,20,294,1341,76.58,1.49,21.92,2019
"3943431",1354,28,404,1786,75.81,1.57,22.62,2019
"3943437",171,2,32,205,83.41,0.98,15.61,2019
"3943438",102,4,14,120,85,3.33,11.67,2019
"3943456",138,20,11,169,81.66,11.83,6.51,2019
"3943522",1164,27,165,1356,85.84,1.99,12.17,2019
"3943548",252,3,43,298,84.56,1.01,14.43,2019
"3943551",13994,417,1385,15796,88.59,2.64,8.77,2019
"3943605",7650,589,2225,10464,73.11,5.63,21.26,2019
"3943616",7148,229,1235,8612,83,2.66,14.34,2019
"3943720",336,4,181,521,64.49,0.77,34.74,2019
"3943732",454,8,174,636,71.38,1.26,27.36,2019
"3943735",147,0,0,147,100,0,0,2019
"3943754",307,15,158,480,63.96,3.12,32.92,2019
"3943760",408,21,132,561,72.73,3.74,23.53,2019
"3943762",1382,41,210,1633,84.63,2.51,12.86,2019
"3943830",1906,45,288,2239,85.13,2.01,12.86,2019
"3943837",475,50,151,676,70.27,7.4,22.34,2019
"3943901",614,14,152,780,78.72,1.79,19.49,2019
"3943908",406,0,172,578,70.24,0,29.76,2019
"3943913",491,9,142,642,76.48,1.4,22.12,2019
"3943914",51,0,16,67,76.12,0,23.88,2019
"3945303",814,25,90,929,87.62,2.69,9.69,2019
"3945304",2300,113,376,2789,82.47,4.05,13.48,2019
"3945320",4903,127,1028,6058,80.93,2.1,16.97,2019
"3945336",54,2,5,61,88.52,3.28,8.2,2019
"3945341",1266,94,248,1608,78.73,5.85,15.42,2019
"3945342",13849,323,1649,15821,87.54,2.04,10.42,2019
"3945353",53,0,11,64,82.81,0,17.19,2019
"3945365",9416,302,1903,11621,81.03,2.6,16.38,2019
"3945382",362,31,60,453,79.91,6.84,13.25,2019
"3945403",4500,158,1061,5719,78.69,2.76,18.55,2019
"3945415",4927,107,649,5683,86.7,1.88,11.42,2019
"3945424",17224,524,1546,19294,89.27,2.72,8.01,2019
"3945431",10781,248,1100,12129,88.89,2.04,9.07,2019
"3945433",565,0,17,582,97.08,0,2.92,2019
"3945434",4240,157,283,4680,90.6,3.35,6.05,2019
"3945439",3065,117,908,4090,74.94,2.86,22.2,2019
"3945502",5539,75,747,6361,87.08,1.18,11.74,2019
"3945503",11999,361,1942,14302,83.9,2.52,13.58,2019
"3945623",817,26,297,1140,71.67,2.28,26.05,2019
"3945867",344,3,42,389,88.43,0.77,10.8,2019
"3945872",1214,63,262,1539,78.88,4.09,17.02,2019
"3945889",514,20,50,584,88.01,3.42,8.56,2019
"3945383",2421,96,383,2900,83.48,3.31,13.21,2019
"3945322",7647,200,953,8800,86.9,2.27,10.83,2019
"3945330",308,0,32,340,90.59,0,9.41,2019
"3945354",179,0,71,250,71.6,0,28.4,2019
"3945404",3381,83,903,4367,77.42,1.9,20.68,2019
"3945405",6351,125,1621,8097,78.44,1.54,20.02,2019
"3945621",91,0,32,123,73.98,0,26.02,2019
"3945622",0,0,57,57,0,0,100,2019
"3945624",0,0,0,0,NA,NA,NA,2019
"3945628",1670,143,192,2005,83.29,7.13,9.58,2019
"3945681",482,0,155,637,75.67,0,24.33,2019
"3945631",4615,315,1219,6149,75.05,5.12,19.82,2019
"3945654",350,89,81,520,67.31,17.12,15.58,2019
"3945661",1925,102,717,2744,70.15,3.72,26.13,2019
"3945692",2577,73,756,3406,75.66,2.14,22.2,2019
"3945696",484,0,278,762,63.52,0,36.48,2019
"3945714",3077,139,807,4023,76.49,3.46,20.06,2019
"3945769",1749,69,784,2602,67.22,2.65,30.13,2019
"3945030",6605,100,1175,7880,83.82,1.27,14.91,2019
"3945041",0,0,0,0,NA,NA,NA,2019
"3945053",967,32,121,1120,86.34,2.86,10.8,2019
"3945069",17781,354,824,18959,93.79,1.87,4.35,2019
"3945118",1282,30,168,1480,86.62,2.03,11.35,2019
"3945132",86,0,58,144,59.72,0,40.28,2019
"3945152",3575,65,388,4028,88.75,1.61,9.63,2019
"3945164",86,4,19,109,78.9,3.67,17.43,2019
"3945211",12800,486,2093,15379,83.23,3.16,13.61,2019
"3945318",1674,15,356,2045,81.86,0.73,17.41,2019
"3945773",22,0,0,22,100,0,0,2019
"3945816",129,2,8,139,92.81,1.44,5.76,2019
"3945843",1087,48,310,1445,75.22,3.32,21.45,2019
"3945851",225,10,66,301,74.75,3.32,21.93,2019
"3945858",1044,12,114,1170,89.23,1.03,9.74,2019
"3945669",2997,143,661,3801,78.85,3.76,17.39,2019
"3945645",664,9,223,896,74.11,1,24.89,2019
"3945647",639,42,343,1024,62.4,4.1,33.5,2019
"3945656",1784,41,755,2580,69.15,1.59,29.26,2019
"1846928",1400,109,239,1748,80.09,6.24,13.67,2019
"1846554",1500,103,386,1989,75.41,5.18,19.41,2019
"1846555",1003,25,159,1187,84.5,2.11,13.4,2019
"1846574",2641,130,806,3577,73.83,3.63,22.53,2019
"1846590",1615,84,82,1781,90.68,4.72,4.6,2019
"1846706",6249,262,1195,7706,81.09,3.4,15.51,2019
"1846723",2685,38,419,3142,85.46,1.21,13.34,2019
"1846730",376,0,80,456,82.46,0,17.54,2019
"1846773",1027,39,171,1237,83.02,3.15,13.82,2019
"1847270",110,0,121,231,47.62,0,52.38,2019
"1847408",7448,462,938,8848,84.18,5.22,10.6,2019
"1847421",8782,327,2261,11370,77.24,2.88,19.89,2019
"1847441",2753,58,1073,3884,70.88,1.49,27.63,2019
"1847448",2602,198,501,3301,78.82,6,15.18,2019
"1847453",234,0,33,267,87.64,0,12.36,2019
"1847454",2023,177,680,2880,70.24,6.15,23.61,2019
"1847519",191,14,19,224,85.27,6.25,8.48,2019
"1847524",186,13,50,249,74.7,5.22,20.08,2019
"1847558",457,42,609,1108,41.25,3.79,54.96,2019
"1847272",586,16,186,788,74.37,2.03,23.6,2019
"1847282",85,14,29,128,66.41,10.94,22.66,2019
"1847331",6594,333,2335,9262,71.19,3.6,25.21,2019
"1847386",409,0,90,499,81.96,0,18.04,2019
"1847353",1617,77,491,2185,74,3.52,22.47,2019
"1847634",650,4,255,909,71.51,0.44,28.05,2019
"1847003",251,53,123,427,58.78,12.41,28.81,2019
"1847022",952,47,143,1142,83.36,4.12,12.52,2019
"1847030",519,16,138,673,77.12,2.38,20.51,2019
"1847032",883,50,181,1114,79.26,4.49,16.25,2019
"1847038",403,1,187,591,68.19,0.17,31.64,2019
"1847114",100,0,18,118,84.75,0,15.25,2019
"1847564",348,11,226,585,59.49,1.88,38.63,2019
"1847577",286,48,144,478,59.83,10.04,30.13,2019
"1847585",134,12,89,235,57.02,5.11,37.87,2019
"1847597",278,12,68,358,77.65,3.35,18.99,2019
"1847649",467,1,209,677,68.98,0.15,30.87,2019
"1847714",11427,347,2249,14023,81.49,2.47,16.04,2019
"1847715",10909,377,1767,13053,83.57,2.89,13.54,2019
"1847804",3657,43,1030,4730,77.32,0.91,21.78,2019
"1847838",573,3,171,747,76.71,0.4,22.89,2019
"1847842",3520,140,635,4295,81.96,3.26,14.78,2019
"1847876",0,0,0,0,NA,NA,NA,2019
"1847909",14679,686,1593,16958,86.56,4.05,9.39,2019
"1847922",456,19,110,585,77.95,3.25,18.8,2019
"1847924",95,0,0,95,100,0,0,2019
"1847928",631,8,145,784,80.48,1.02,18.49,2019
"1847941",497,9,51,557,89.23,1.62,9.16,2019
"1847943",225,37,54,316,71.2,11.71,17.09,2019
"1847946",743,17,102,862,86.19,1.97,11.83,2019
"1847948",485,5,107,597,81.24,0.84,17.92,2019
"1847949",405,2,61,468,86.54,0.43,13.03,2019
"1847957",446,3,283,732,60.93,0.41,38.66,2019
"1847018",1261,21,294,1576,80.01,1.33,18.65,2019
"1847041",2101,169,241,2511,83.67,6.73,9.6,2019
"1847043",1738,47,605,2390,72.72,1.97,25.31,2019
"1847102",1701,118,737,2556,66.55,4.62,28.83,2019
"1847116",179,0,86,265,67.55,0,32.45,2019
"1847119",3496,102,570,4168,83.88,2.45,13.68,2019
"1847124",1324,46,329,1699,77.93,2.71,19.36,2019
"3168715",506,14,77,597,84.76,2.35,12.9,2019
"3168716",256,32,143,431,59.4,7.42,33.18,2019
"3168729",608,21,209,838,72.55,2.51,24.94,2019
"3168007",3850,113,156,4119,93.47,2.74,3.79,2019
"3168010",10,3,0,13,76.92,23.08,0,2019
"3168019",139,10,14,163,85.28,6.13,8.59,2019
"3168025",10256,426,1997,12679,80.89,3.36,15.75,2019
"2067109",114,6,34,154,74.03,3.9,22.08,2019
"2067119",444,14,106,564,78.72,2.48,18.79,2019
"2271227",1117,44,321,1482,75.37,2.97,21.66,2019
"2271238",741,30,223,994,74.55,3.02,22.43,2019
"2271256",162,0,206,368,44.02,0,55.98,2019
"2271275",788,0,165,953,82.69,0,17.31,2019
"2271280",1226,144,318,1688,72.63,8.53,18.84,2019
"2271302",3359,180,1599,5138,65.38,3.5,31.12,2019
"2271323",238,15,85,338,70.41,4.44,25.15,2019
"2271052",2328,207,1355,3890,59.85,5.32,34.83,2019
"2271063",199,38,67,304,65.46,12.5,22.04,2019
"2271111",11461,2782,3172,17415,65.81,15.97,18.21,2019
"2271118",7813,148,1463,9424,82.91,1.57,15.52,2019
"2271234",852,29,389,1270,67.09,2.28,30.63,2019
"2271268",857,9,166,1032,83.04,0.87,16.09,2019
"2271277",256,0,280,536,47.76,0,52.24,2019
"2271301",6211,258,1669,8138,76.32,3.17,20.51,2019
"2271328",2328,14,349,2691,86.51,0.52,12.97,2019
"2271341",907,63,309,1279,70.91,4.93,24.16,2019
"2271356",156,48,105,309,50.49,15.53,33.98,2019
"3858262",32,0,11,43,74.42,0,25.58,2019
"3858266",74,0,16,90,82.22,0,17.78,2019
"3858274",318,31,72,421,75.53,7.36,17.1,2019
"3858316",1364,112,599,2075,65.73,5.4,28.87,2019
"3858329",644,80,274,998,64.53,8.02,27.45,2019
"3858331",45,0,21,66,68.18,0,31.82,2019
"3858332",134,12,31,177,75.71,6.78,17.51,2019
"3858344",319,43,67,429,74.36,10.02,15.62,2019
"3858005",291,3,24,318,91.51,0.94,7.55,2019
"3858017",118,5,18,141,83.69,3.55,12.77,2019
"3858027",463,12,164,639,72.46,1.88,25.67,2019
"3858051",586,23,58,667,87.86,3.45,8.7,2019
"3858060",469,4,113,586,80.03,0.68,19.28,2019
"3858068",145,3,15,163,88.96,1.84,9.2,2019
"3858069",41,0,10,51,80.39,0,19.61,2019
"3858075",3246,185,532,3963,81.91,4.67,13.42,2019
"3858202",0,0,0,0,NA,NA,NA,2019
"3858210",134,3,33,170,78.82,1.76,19.41,2019
"3858218",283,8,48,339,83.48,2.36,14.16,2019
"3858224",11,0,3,14,78.57,0,21.43,2019
"3858225",337,10,81,428,78.74,2.34,18.93,2019
"3858241",38,0,28,66,57.58,0,42.42,2019
"3858276",150,15,70,235,63.83,6.38,29.79,2019
"3858282",478,15,218,711,67.23,2.11,30.66,2019
"3858318",1406,35,277,1718,81.84,2.04,16.12,2019
"3858327",118,11,17,146,80.82,7.53,11.64,2019
"3858346",223,19,82,324,68.83,5.86,25.31,2019
"3858362",0,0,0,0,NA,NA,NA,2019
"3858370",164,58,169,391,41.94,14.83,43.22,2019
"3858424",101,0,15,116,87.07,0,12.93,2019
"3858438",267,21,54,342,78.07,6.14,15.79,2019
"3858460",65,7,25,97,67.01,7.22,25.77,2019
"3943961",136,6,29,171,79.53,3.51,16.96,2019
"3943962",27,0,6,33,81.82,0,18.18,2019
"3943749",602,0,412,1014,59.37,0,40.63,2019
"3943912",1938,78,776,2792,69.41,2.79,27.79,2019
"3943926",66,0,28,94,70.21,0,29.79,2019
"3943939",150,4,28,182,82.42,2.2,15.38,2019
"3943950",4204,174,711,5089,82.61,3.42,13.97,2019
"3943971",383,10,91,484,79.13,2.07,18.8,2019
"3943531",100,0,27,127,78.74,0,21.26,2019
"3943501",252,0,79,331,76.13,0,23.87,2019
"3943502",2116,67,346,2529,83.67,2.65,13.68,2019
"3943516",962,35,154,1151,83.58,3.04,13.38,2019
"3943540",491,12,70,573,85.69,2.09,12.22,2019
"3943570",996,16,245,1257,79.24,1.27,19.49,2019
"3943571",2506,26,232,2764,90.67,0.94,8.39,2019
"3943606",8315,538,1078,9931,83.73,5.42,10.85,2019
"3943607",6656,563,1810,9029,73.72,6.24,20.05,2019
"3943719",791,33,261,1085,72.9,3.04,24.06,2019
"3943721",0,18,29,47,0,38.3,61.7,2019
"3943005",39,0,28,67,58.21,0,41.79,2019
"3943015",18023,425,1536,19984,90.19,2.13,7.69,2019
"3943022",928,28,147,1103,84.13,2.54,13.33,2019
"3943050",9261,255,2213,11729,78.96,2.17,18.87,2019
"3943070",51,0,16,67,76.12,0,23.88,2019
"3943127",102,0,7,109,93.58,0,6.42,2019
"3943130",18938,835,3884,23657,80.05,3.53,16.42,2019
"3943003",856,6,185,1047,81.76,0.57,17.67,2019
"3943556",495,21,137,653,75.8,3.22,20.98,2019
"3943617",2601,30,120,2751,94.55,1.09,4.36,2019
"3943772",599,17,194,810,73.95,2.1,23.95,2019
"3943943",935,26,373,1334,70.09,1.95,27.96,2019
"3943030",52,0,0,52,100,0,0,2019
"3943117",35,26,0,61,57.38,42.62,0,2019
"3943330",30,0,11,41,73.17,0,26.83,2019
"3943403",0,0,5,5,0,0,100,2019
"3943433",25,0,16,41,60.98,0,39.02,2019
"3943434",20,0,4,24,83.33,0,16.67,2019
"3943446",28,2,9,39,71.79,5.13,23.08,2019
"3943463",0,9,26,35,0,25.71,74.29,2019
"3943505",30,0,11,41,73.17,0,26.83,2019
"3943519",67,0,28,95,70.53,0,29.47,2019
"3943523",10,0,0,10,100,0,0,2019
"3943711",17,0,8,25,68,0,32,2019
"3943733",8,0,0,8,100,0,0,2019
"3943736",13,2,14,29,44.83,6.9,48.28,2019
"3943750",19,0,21,40,47.5,0,52.5,2019
"3943759",14,3,7,24,58.33,12.5,29.17,2019
"3943761",24,0,0,24,100,0,0,2019
"3943786",7,0,5,12,58.33,0,41.67,2019
"3943805",0,0,42,42,0,0,100,2019
"3945673",103,0,101,204,50.49,0,49.51,2019
"3945674",80,0,12,92,86.96,0,13.04,2019
"3945688",99,6,106,211,46.92,2.84,50.24,2019
"3945249",4956,33,552,5541,89.44,0.6,9.96,2019
"3945306",803,10,115,928,86.53,1.08,12.39,2019
"3945308",1432,67,217,1716,83.45,3.9,12.65,2019
"3945311",1847,82,421,2350,78.6,3.49,17.91,2019
"3945321",271,12,70,353,76.77,3.4,19.83,2019
"3945327",3121,142,355,3618,86.26,3.92,9.81,2019
"3945331",7549,338,1875,9762,77.33,3.46,19.21,2019
"3945334",682,30,129,841,81.09,3.57,15.34,2019
"3945338",1653,101,284,2038,81.11,4.96,13.94,2019
"3945232",2146,56,504,2706,79.31,2.07,18.63,2019
"3945208",8112,125,481,8718,93.05,1.43,5.52,2019
"3945214",2310,182,1067,3559,64.91,5.11,29.98,2019
"3945218",1361,26,134,1521,89.48,1.71,8.81,2019
"3945238",15984,608,2466,19058,83.87,3.19,12.94,2019
"3945240",8707,207,1060,9974,87.3,2.08,10.63,2019
"3945245",7649,362,754,8765,87.27,4.13,8.6,2019
"3945302",1339,31,87,1457,91.9,2.13,5.97,2019
"3945314",1252,9,83,1344,93.15,0.67,6.18,2019
"3945317",292,0,55,347,84.15,0,15.85,2019
"3945323",1916,43,206,2165,88.5,1.99,9.52,2019
"3945337",529,29,47,605,87.44,4.79,7.77,2019
"3945349",147,2,9,158,93.04,1.27,5.7,2019
"3945356",7832,271,1780,9883,79.25,2.74,18.01,2019
"3945358",111,4,5,120,92.5,3.33,4.17,2019
"3945370",900,2,63,965,93.26,0.21,6.53,2019
"3945390",1021,19,251,1291,79.09,1.47,19.44,2019
"3945406",7227,198,1904,9329,77.47,2.12,20.41,2019
"3945410",5606,178,1318,7102,78.94,2.51,18.56,2019
"3945449",6560,201,1092,7853,83.53,2.56,13.91,2019
"3945506",4125,86,1010,5221,79.01,1.65,19.34,2019
"3945614",1066,131,602,1799,59.26,7.28,33.46,2019
"3945640",4896,229,1187,6312,77.57,3.63,18.81,2019
"3945660",1821,209,866,2896,62.88,7.22,29.9,2019
"3945678",220,16,162,398,55.28,4.02,40.7,2019
"3945710",1600,127,517,2244,71.3,5.66,23.04,2019
"3945716",108,9,70,187,57.75,4.81,37.43,2019
"3945740",126,13,35,174,72.41,7.47,20.11,2019
"3945746",106,0,46,152,69.74,0,30.26,2019
"3945772",522,19,206,747,69.88,2.54,27.58,2019
"3945789",49,0,50,99,49.49,0,50.51,2019
"3945805",7927,401,1224,9552,82.99,4.2,12.81,2019
"3945833",3383,79,795,4257,79.47,1.86,18.68,2019
"3945849",302,9,67,378,79.89,2.38,17.72,2019
"3945865",1654,37,218,1909,86.64,1.94,11.42,2019
"3945743",438,64,120,622,70.42,10.29,19.29,2019
"3945760",1108,26,453,1587,69.82,1.64,28.54,2019
"3945767",698,13,362,1073,65.05,1.21,33.74,2019
"3945768",392,15,253,660,59.39,2.27,38.33,2019
"3945801",6682,303,1694,8679,76.99,3.49,19.52,2019
"3945806",3854,101,500,4455,86.51,2.27,11.22,2019
"3945812",571,7,145,723,78.98,0.97,20.06,2019
"3945814",1027,31,158,1216,84.46,2.55,12.99,2019
"1847163",411,9,107,527,77.99,1.71,20.3,2019
"1847175",222,0,134,356,62.36,0,37.64,2019
"1847240",6704,293,1587,8584,78.1,3.41,18.49,2019
"1847260",395,27,281,703,56.19,3.84,39.97,2019
"1847281",331,0,201,532,62.22,0,37.78,2019
"1847302",8040,413,2472,10925,73.59,3.78,22.63,2019
"1847304",11214,658,1503,13375,83.84,4.92,11.24,2019
"1847325",119,0,99,218,54.59,0,45.41,2019
"1847326",353,84,189,626,56.39,13.42,30.19,2019
"1847340",934,102,138,1174,79.56,8.69,11.75,2019
"1847351",133,1,21,155,85.81,0.65,13.55,2019
"1847374",13861,1004,3771,18636,74.38,5.39,20.24,2019
"1847383",906,83,155,1144,79.2,7.26,13.55,2019
"1847393",384,24,98,506,75.89,4.74,19.37,2019
"1847406",0,0,0,0,NA,NA,NA,2019
"1847427",172,8,95,275,62.55,2.91,34.55,2019
"1847436",459,0,124,583,78.73,0,21.27,2019
"1847456",399,9,109,517,77.18,1.74,21.08,2019
"1847459",1029,18,351,1398,73.61,1.29,25.11,2019
"1847512",1290,24,366,1680,76.79,1.43,21.79,2019
"1847532",1403,24,292,1719,81.62,1.4,16.99,2019
"1847541",367,11,87,465,78.92,2.37,18.71,2019
"1847579",892,17,87,996,89.56,1.71,8.73,2019
"1847591",8480,129,1682,10291,82.4,1.25,16.34,2019
"1847613",895,50,177,1122,79.77,4.46,15.78,2019
"1847631",664,21,181,866,76.67,2.42,20.9,2019
"1847639",1224,7,276,1507,81.22,0.46,18.31,2019
"1847640",292,10,118,420,69.52,2.38,28.1,2019
"1847879",865,16,468,1349,64.12,1.19,34.69,2019
"1847882",2337,91,914,3342,69.93,2.72,27.35,2019
"1847884",63,0,23,86,73.26,0,26.74,2019
"1847923",1089,47,230,1366,79.72,3.44,16.84,2019
"1847942",273,7,37,317,86.12,2.21,11.67,2019
"1847950",235,0,64,299,78.6,0,21.4,2019
"1847954",813,16,100,929,87.51,1.72,10.76,2019
"1847958",35,0,25,60,58.33,0,41.67,2019
"1847354",296,23,112,431,68.68,5.34,25.99,2019
"1847358",267,22,97,386,69.17,5.7,25.13,2019
"1847975",262,6,51,319,82.13,1.88,15.99,2019
"1847977",728,0,195,923,78.87,0,21.13,2019
"1847991",346,9,31,386,89.64,2.33,8.03,2019
"1847969",29,0,10,39,74.36,0,25.64,2019
"1847995",517,4,67,588,87.93,0.68,11.39,2019
"1847006",3551,144,840,4535,78.3,3.18,18.52,2019
"1847031",1540,134,346,2020,76.24,6.63,17.13,2019
"1847037",1376,38,295,1709,80.51,2.22,17.26,2019
"1847042",1202,100,367,1669,72.02,5.99,21.99,2019
"1847108",611,7,297,915,66.78,0.77,32.46,2019
"1847111",4787,157,1082,6026,79.44,2.61,17.96,2019
"1847129",5569,210,2458,8237,67.61,2.55,29.84,2019
"1847160",12,0,19,31,38.71,0,61.29,2019
"1847230",484,13,112,609,79.47,2.13,18.39,2019
"1847710",6054,275,1928,8257,73.32,3.33,23.35,2019
"1847633",805,23,277,1105,72.85,2.08,25.07,2019
"1847654",29,3,6,38,76.32,7.89,15.79,2019
"1847666",482,23,211,716,67.32,3.21,29.47,2019
"1847833",300,7,37,344,87.21,2.03,10.76,2019
"1847834",6165,215,1378,7758,79.47,2.77,17.76,2019
"1847850",726,18,208,952,76.26,1.89,21.85,2019
"3858461",152,4,36,192,79.17,2.08,18.75,2019
"3858467",180,17,50,247,72.87,6.88,20.24,2019
"3858488",38,0,45,83,45.78,0,54.22,2019
"3858530",318,21,95,434,73.27,4.84,21.89,2019
"3858531",188,2,21,211,89.1,0.95,9.95,2019
"3858558",344,5,23,372,92.47,1.34,6.18,2019
"3858563",755,51,232,1038,72.74,4.91,22.35,2019
"3858566",36,4,16,56,64.29,7.14,28.57,2019
"3858348",265,10,62,337,78.64,2.97,18.4,2019
"4657014",505,25,79,609,82.92,4.11,12.97,2019
"4657021",74,0,28,102,72.55,0,27.45,2019
"4657073",188,50,33,271,69.37,18.45,12.18,2019
"4657218",85,5,42,132,64.39,3.79,31.82,2019
"4657237",192,7,61,260,73.85,2.69,23.46,2019
"4657241",315,12,48,375,84,3.2,12.8,2019
"4657217",93,0,22,115,80.87,0,19.13,2019
"4657541",45,0,0,45,100,0,0,2019
"4657601",1004,47,570,1621,61.94,2.9,35.16,2019
"4657754",1426,42,280,1748,81.58,2.4,16.02,2019
"4657646",90,0,12,102,88.24,0,11.76,2019
"4657755",32,0,5,37,86.49,0,13.51,2019
"4657242",151,0,13,164,92.07,0,7.93,2019
"4657245",38,1,13,52,73.08,1.92,25,2019
"4657246",87,4,11,102,85.29,3.92,10.78,2019
"4657264",102,8,16,126,80.95,6.35,12.7,2019
"4657278",193,9,48,250,77.2,3.6,19.2,2019
"4657322",112,12,26,150,74.67,8,17.33,2019
"4657349",484,24,98,606,79.87,3.96,16.17,2019
"4657370",208,14,49,271,76.75,5.17,18.08,2019
"4657455",23,0,10,33,69.7,0,30.3,2019
"4657544",172,0,33,205,83.9,0,16.1,2019
"4657649",84,0,7,91,92.31,0,7.69,2019
"4657724",69,6,3,78,88.46,7.69,3.85,2019
"4657794",14,9,49,72,19.44,12.5,68.06,2019
"4657005",3815,112,277,4204,90.75,2.66,6.59,2019
"4657359",252,8,64,324,77.78,2.47,19.75,2019
"4657427",256,0,7,263,97.34,0,2.66,2019
"4657448",128,17,46,191,67.02,8.9,24.08,2019
"4657522",159,4,48,211,75.36,1.9,22.75,2019
"4657269",81,0,52,133,60.9,0,39.1,2019
"4657117",0,0,0,0,NA,NA,NA,2019
"4657197",0,0,0,0,NA,NA,NA,2019
"4657429",32,0,14,46,69.57,0,30.43,2019
"4657439",8,0,33,41,19.51,0,80.49,2019
"4657630",16,0,0,16,100,0,0,2019
"4657639",27,0,57,84,32.14,0,67.86,2019
"4657741",20,0,0,20,100,0,0,2019
"4657776",0,0,0,0,NA,NA,NA,2019
"4657782",16,0,3,19,84.21,0,15.79,2019
"4657236",51,6,11,68,75,8.82,16.18,2019
"4657016",317,0,37,354,89.55,0,10.45,2019
"4657054",214,3,34,251,85.26,1.2,13.55,2019
"4657110",6264,195,827,7286,85.97,2.68,11.35,2019
"4657270",197,6,110,313,62.94,1.92,35.14,2019
"4657276",345,20,65,430,80.23,4.65,15.12,2019
"4657312",214,0,49,263,81.37,0,18.63,2019
"4657323",70,5,29,104,67.31,4.81,27.88,2019
"4657328",408,11,100,519,78.61,2.12,19.27,2019
"4657332",215,3,33,251,85.66,1.2,13.15,2019
"3943836",39,3,9,51,76.47,5.88,17.65,2019
"3943931",108,0,9,117,92.31,0,7.69,2019
"3943970",12,0,0,12,100,0,0,2019
"3943985",16,4,10,30,53.33,13.33,33.33,2019
"3943064",4284,75,420,4779,89.64,1.57,8.79,2019
"3943105",2467,44,389,2900,85.07,1.52,13.41,2019
"3943932",266,3,58,327,81.35,0.92,17.74,2019
"3943988",683,17,322,1022,66.83,1.66,31.51,2019
"3943107",961,12,196,1169,82.21,1.03,16.77,2019
"3943317",47,0,5,52,90.38,0,9.62,2019
"3943439",40,0,0,40,100,0,0,2019
"3943569",907,41,130,1078,84.14,3.8,12.06,2019
"3943614",11589,284,2430,14303,81.02,1.99,16.99,2019
"3943315",2387,86,353,2826,84.47,3.04,12.49,2019
"3943207",14107,530,3219,17856,79,2.97,18.03,2019
"3943217",612,11,104,727,84.18,1.51,14.31,2019
"3943311",6529,208,868,7605,85.85,2.74,11.41,2019
"3943316",1870,135,400,2405,77.75,5.61,16.63,2019
"3943343",405,13,74,492,82.32,2.64,15.04,2019
"3943442",340,3,67,410,82.93,0.73,16.34,2019
"3943457",411,19,134,564,72.87,3.37,23.76,2019
"3943612",9672,695,1722,12089,80.01,5.75,14.24,2019
"3943947",1664,45,454,2163,76.93,2.08,20.99,2019
"3943055",19984,815,3516,24315,82.19,3.35,14.46,2019
"3943061",1385,66,226,1677,82.59,3.94,13.48,2019
"3943066",466,24,31,521,89.44,4.61,5.95,2019
"3943078",6855,239,1199,8293,82.66,2.88,14.46,2019
"3943002",2474,0,0,2474,100,0,0,2019
"3943011",2622,69,251,2942,89.12,2.35,8.53,2019
"3943014",1033,0,300,1333,77.49,0,22.51,2019
"3943019",2432,56,599,3087,78.78,1.81,19.4,2019
"3943031",4392,51,564,5007,87.72,1.02,11.26,2019
"3943035",8791,131,83,9005,97.62,1.45,0.92,2019
"3943040",11077,201,1144,12422,89.17,1.62,9.21,2019
"3943056",6002,87,937,7026,85.43,1.24,13.34,2019
"3943062",9374,188,713,10275,91.23,1.83,6.94,2019
"3943065",14407,229,306,14942,96.42,1.53,2.05,2019
"3943072",1882,71,261,2214,85,3.21,11.79,2019
"3943081",23345,339,1269,24953,93.56,1.36,5.09,2019
"3943110",13422,430,1139,14991,89.53,2.87,7.6,2019
"3943125",4637,83,555,5275,87.91,1.57,10.52,2019
"3943136",272,0,62,334,81.44,0,18.56,2019
"3943137",864,42,50,956,90.38,4.39,5.23,2019
"3943963",476,11,141,628,75.8,1.75,22.45,2019
"3943001",835,35,123,993,84.09,3.52,12.39,2019
"3943008",853,62,179,1094,77.97,5.67,16.36,2019
"3943017",14946,331,462,15739,94.96,2.1,2.94,2019
"3943021",3908,47,159,4114,94.99,1.14,3.86,2019
"3943071",634,16,94,744,85.22,2.15,12.63,2019
"3943080",1545,60,309,1914,80.72,3.13,16.14,2019
"3945862",431,25,92,548,78.65,4.56,16.79,2019
"3945866",52,1,8,61,85.25,1.64,13.11,2019
"3945875",3748,103,517,4368,85.81,2.36,11.84,2019
"3945885",4348,135,780,5263,82.61,2.57,14.82,2019
"3945896",579,10,104,693,83.55,1.44,15.01,2019
"3945898",295,3,104,402,73.38,0.75,25.87,2019
"3945651",1403,67,692,2162,64.89,3.1,32.01,2019
"3945652",1011,14,246,1271,79.54,1.1,19.35,2019
"3945657",527,13,168,708,74.44,1.84,23.73,2019
"3945659",630,0,347,977,64.48,0,35.52,2019
"3945663",1872,124,468,2464,75.97,5.03,18.99,2019
"3945686",769,87,411,1267,60.69,6.87,32.44,2019
"3945724",721,88,175,984,73.27,8.94,17.78,2019
"3945735",461,56,90,607,75.95,9.23,14.83,2019
"3945745",332,2,154,488,68.03,0.41,31.56,2019
"3945775",309,0,116,425,72.71,0,27.29,2019
"3945809",52,4,0,56,92.86,7.14,0,2019
"3945820",157,10,31,198,79.29,5.05,15.66,2019
"3945003",190,5,43,238,79.83,2.1,18.07,2019
"3945005",10475,294,1731,12500,83.8,2.35,13.85,2019
"3945001",203,4,43,250,81.2,1.6,17.2,2019
"3945014",15012,428,1861,17301,86.77,2.47,10.76,2019
"3945052",1409,16,160,1585,88.9,1.01,10.09,2019
"3945065",1671,0,160,1831,91.26,0,8.74,2019
"3945068",3739,58,483,4280,87.36,1.36,11.29,2019
"3945107",2988,62,653,3703,80.69,1.67,17.63,2019
"3945120",913,13,310,1236,73.87,1.05,25.08,2019
"3945146",391,11,83,485,80.62,2.27,17.11,2019
"3945155",106,0,18,124,85.48,0,14.52,2019
"3945157",2823,95,621,3539,79.77,2.68,17.55,2019
"3945172",42,10,6,58,72.41,17.24,10.34,2019
"3945203",974,74,330,1378,70.68,5.37,23.95,2019
"3945229",3609,189,2299,6097,59.19,3.1,37.71,2019
"3945242",8060,171,605,8836,91.22,1.94,6.85,2019
"3945247",8671,67,750,9488,91.39,0.71,7.9,2019
"3945307",85,9,47,141,60.28,6.38,33.33,2019
"3945316",29,0,10,39,74.36,0,25.64,2019
"3945328",159,12,54,225,70.67,5.33,24,2019
"3945335",2264,79,374,2717,83.33,2.91,13.77,2019
"3945351",82,0,22,104,78.85,0,21.15,2019
"3945368",1576,70,280,1926,81.83,3.63,14.54,2019
"3945377",5664,195,1007,6866,82.49,2.84,14.67,2019
"3945378",120,2,15,137,87.59,1.46,10.95,2019
"3945380",1681,49,259,1989,84.51,2.46,13.02,2019
"3945419",5924,219,457,6600,89.76,3.32,6.92,2019
"3945830",1981,67,302,2350,84.3,2.85,12.85,2019
"3945013",17862,612,2615,21089,84.7,2.9,12.4,2019
"3945838",8,0,9,17,47.06,0,52.94,2019
"3945033",44,5,35,84,52.38,5.95,41.67,2019
"3945034",459,0,72,531,86.44,0,13.56,2019
"3945039",9099,112,290,9501,95.77,1.18,3.05,2019
"3945113",1510,11,136,1657,91.13,0.66,8.21,2019
"3945122",3252,140,585,3977,81.77,3.52,14.71,2019
"1847859",169,2,149,320,52.81,0.62,46.56,2019
"1847863",54,0,71,125,43.2,0,56.8,2019
"1847320",1262,64,282,1608,78.48,3.98,17.54,2019
"1847327",1249,44,525,1818,68.7,2.42,28.88,2019
"1847330",1592,105,337,2034,78.27,5.16,16.57,2019
"1847342",770,58,287,1115,69.06,5.2,25.74,2019
"1847346",1246,58,220,1524,81.76,3.81,14.44,2019
"1847355",828,64,262,1154,71.75,5.55,22.7,2019
"1847357",256,9,59,324,79.01,2.78,18.21,2019
"1846759",185,0,23,208,88.94,0,11.06,2019
"1846764",410,39,61,510,80.39,7.65,11.96,2019
"1846777",1933,69,449,2451,78.87,2.82,18.32,2019
"1846781",227,4,58,289,78.55,1.38,20.07,2019
"1846783",2211,13,221,2445,90.43,0.53,9.04,2019
"1846784",724,13,159,896,80.8,1.45,17.75,2019
"1846794",554,0,145,699,79.26,0,20.74,2019
"1846818",6777,205,658,7640,88.7,2.68,8.61,2019
"1846913",355,13,84,452,78.54,2.88,18.58,2019
"1846958",189,0,34,223,84.75,0,15.25,2019
"1846985",480,11,84,575,83.48,1.91,14.61,2019
"1846987",297,13,65,375,79.2,3.47,17.33,2019
"1846988",278,7,87,372,74.73,1.88,23.39,2019
"1846990",184,13,64,261,70.5,4.98,24.52,2019
"1846991",501,27,154,682,73.46,3.96,22.58,2019
"1846992",5235,455,1307,6997,74.82,6.5,18.68,2019
"1846996",2086,60,537,2683,77.75,2.24,20.01,2019
"1846201",7479,459,5110,13048,57.32,3.52,39.16,2019
"1846225",1607,82,439,2128,75.52,3.85,20.63,2019
"1846234",8877,210,555,9642,92.07,2.18,5.76,2019
"1846250",8001,277,854,9132,87.61,3.03,9.35,2019
"1846303",4868,50,511,5429,89.67,0.92,9.41,2019
"1846327",2880,164,952,3996,72.07,4.1,23.82,2019
"1846340",252,0,66,318,79.25,0,20.75,2019
"1846341",3132,62,527,3721,84.17,1.67,14.16,2019
"1846346",316,5,120,441,71.66,1.13,27.21,2019
"1846350",14117,390,3082,17589,80.26,2.22,17.52,2019
"1846360",13965,392,3596,17953,77.79,2.18,20.03,2019
"1846365",325,0,14,339,95.87,0,4.13,2019
"1846229",8715,200,2069,10984,79.34,1.82,18.84,2019
"1846235",8745,438,2947,12130,72.09,3.61,24.3,2019
"1846381",104,0,0,104,100,0,0,2019
"1846311",7469,127,548,8144,91.71,1.56,6.73,2019
"1846321",7755,42,838,8635,89.81,0.49,9.7,2019
"1846379",56,0,13,69,81.16,0,18.84,2019
"1846382",583,20,78,681,85.61,2.94,11.45,2019
"1846390",994,17,247,1258,79.01,1.35,19.63,2019
"1846392",2442,80,393,2915,83.77,2.74,13.48,2019
"1846405",2940,88,801,3829,76.78,2.3,20.92,2019
"1846508",34,0,18,52,65.38,0,34.62,2019
"1846524",612,8,243,863,70.92,0.93,28.16,2019
"1846534",3142,221,810,4173,75.29,5.3,19.41,2019
"1846562",1567,61,342,1970,79.54,3.1,17.36,2019
"1846563",6401,259,2097,8757,73.1,2.96,23.95,2019
"1846615",4363,297,1073,5733,76.1,5.18,18.72,2019
"1846506",2523,113,989,3625,69.6,3.12,27.28,2019
"1846507",2932,38,373,3343,87.71,1.14,11.16,2019
"1846517",7360,416,1235,9011,81.68,4.62,13.71,2019
"1846628",7238,527,2302,10067,71.9,5.23,22.87,2019
"1846710",1310,56,305,1671,78.4,3.35,18.25,2019
"4657335",96,6,37,139,69.06,4.32,26.62,2019
"4657342",161,1,46,208,77.4,0.48,22.12,2019
"4657344",36,0,11,47,76.6,0,23.4,2019
"4657348",209,1,14,224,93.3,0.45,6.25,2019
"4657358",11,0,6,17,64.71,0,35.29,2019
"4657361",16,0,24,40,40,0,60,2019
"4657385",435,16,67,518,83.98,3.09,12.93,2019
"4657422",82,15,16,113,72.57,13.27,14.16,2019
"4657468",153,7,19,179,85.47,3.91,10.61,2019
"2066019",67,0,68,135,49.63,0,50.37,2019
"2066097",390,13,127,530,73.58,2.45,23.96,2019
"2066207",5565,111,510,6186,89.96,1.79,8.24,2019
"2066436",2247,20,331,2598,86.49,0.77,12.74,2019
"2066544",104,17,27,148,70.27,11.49,18.24,2019
"2066714",29,3,41,73,39.73,4.11,56.16,2019
"2066414",1000,32,209,1241,80.58,2.58,16.84,2019
"2066417",117,2,29,148,79.05,1.35,19.59,2019
"2066419",148,9,11,168,88.1,5.36,6.55,2019
"2066423",252,8,89,349,72.21,2.29,25.5,2019
"2066425",179,2,48,229,78.17,0.87,20.96,2019
"2066024",175,10,99,284,61.62,3.52,34.86,2019
"2066218",2648,5,114,2767,95.7,0.18,4.12,2019
"2066514",473,7,28,508,93.11,1.38,5.51,2019
"2066549",599,24,100,723,82.85,3.32,13.83,2019
"2066095",253,9,140,402,62.94,2.24,34.83,2019
"2066018",1998,16,277,2291,87.21,0.7,12.09,2019
"2066006",2360,24,287,2671,88.36,0.9,10.75,2019
"2066008",89,7,20,116,76.72,6.03,17.24,2019
"2066017",147,1,33,181,81.22,0.55,18.23,2019
"2066046",6911,475,902,8288,83.39,5.73,10.88,2019
"2066205",5287,121,441,5849,90.39,2.07,7.54,2019
"2066213",11039,150,474,11663,94.65,1.29,4.06,2019
"2066220",2637,61,55,2753,95.79,2.22,2,2019
"2066226",4321,30,179,4530,95.39,0.66,3.95,2019
"2066403",237,0,59,296,80.07,0,19.93,2019
"2066422",119,0,16,135,88.15,0,11.85,2019
"2066434",1489,30,429,1948,76.44,1.54,22.02,2019
"2066732",78,0,19,97,80.41,0,19.59,2019
"2066734",69,0,19,88,78.41,0,21.59,2019
"2066052",747,29,166,942,79.3,3.08,17.62,2019
"2066075",648,45,412,1105,58.64,4.07,37.29,2019
"2066080",226,33,78,337,67.06,9.79,23.15,2019
"2066083",2970,101,278,3349,88.68,3.02,8.3,2019
"2066105",502,47,244,793,63.3,5.93,30.77,2019
"2066212",13206,152,1062,14420,91.58,1.05,7.36,2019
"2066440",612,9,121,742,82.48,1.21,16.31,2019
"2066501",85,6,37,128,66.41,4.69,28.91,2019
"2066502",15088,929,1498,17515,86.14,5.3,8.55,2019
"2066518",42,2,7,51,82.35,3.92,13.73,2019
"2066520",196,10,38,244,80.33,4.1,15.57,2019
"2066538",1078,29,312,1419,75.97,2.04,21.99,2019
"2066547",3097,99,270,3466,89.35,2.86,7.79,2019
"2066617",2646,164,485,3295,80.3,4.98,14.72,2019
"2066710",146,2,71,219,66.67,0.91,32.42,2019
"2066716",99,2,47,148,66.89,1.35,31.76,2019
"2066839",1398,18,175,1591,87.87,1.13,11,2019
"2066952",185,0,49,234,79.06,0,20.94,2019
"2066740",126,0,3,129,97.67,0,2.33,2019
"2066851",131,27,84,242,54.13,11.16,34.71,2019
"3943085",9610,57,540,10207,94.15,0.56,5.29,2019
"3943101",77,21,37,135,57.04,15.56,27.41,2019
"3943102",1410,89,171,1670,84.43,5.33,10.24,2019
"3943154",989,34,180,1203,82.21,2.83,14.96,2019
"3943156",43,2,24,69,62.32,2.9,34.78,2019
"3943157",187,3,45,235,79.57,1.28,19.15,2019
"3943206",8608,192,1617,10417,82.63,1.84,15.52,2019
"3943953",4163,89,775,5027,82.81,1.77,15.42,2019
"3943210",97,122,17,236,41.1,51.69,7.2,2019
"3943356",361,79,35,475,76,16.63,7.37,2019
"3943534",576,15,76,667,86.36,2.25,11.39,2019
"3943537",10507,229,754,11490,91.44,1.99,6.56,2019
"3943543",2609,65,536,3210,81.28,2.02,16.7,2019
"3943545",4928,203,639,5770,85.41,3.52,11.07,2019
"3943558",4292,112,929,5333,80.48,2.1,17.42,2019
"3943560",10773,240,1264,12277,87.75,1.95,10.3,2019
"3943608",3629,355,1185,5169,70.21,6.87,22.93,2019
"3943613",11467,691,1815,13973,82.07,4.95,12.99,2019
"3943615",14919,419,2636,17974,83,2.33,14.67,2019
"3943716",479,5,340,824,58.13,0.61,41.26,2019
"3943723",1564,85,409,2058,76,4.13,19.87,2019
"3943724",1958,86,853,2897,67.59,2.97,29.44,2019
"3943756",1555,68,545,2168,71.73,3.14,25.14,2019
"3943766",477,20,138,635,75.12,3.15,21.73,2019
"3943821",1302,88,258,1648,79,5.34,15.66,2019
"3943840",307,25,133,465,66.02,5.38,28.6,2019
"3943938",1799,64,372,2235,80.49,2.86,16.64,2019
"3943905",32,0,27,59,54.24,0,45.76,2019
"3943920",6919,341,1814,9074,76.25,3.76,19.99,2019
"3943930",289,29,26,344,84.01,8.43,7.56,2019
"3943940",86,0,22,108,79.63,0,20.37,2019
"3943318",1085,5,315,1405,77.22,0.36,22.42,2019
"3943319",290,0,95,385,75.32,0,24.68,2019
"3943322",91,5,37,133,68.42,3.76,27.82,2019
"3943348",648,91,174,913,70.97,9.97,19.06,2019
"3943358",964,27,128,1119,86.15,2.41,11.44,2019
"3943402",11659,965,1067,13691,85.16,7.05,7.79,2019
"3943432",450,0,72,522,86.21,0,13.79,2019
"3943458",134,0,27,161,83.23,0,16.77,2019
"3943524",421,26,68,515,81.75,5.05,13.2,2019
"3943529",66,5,17,88,75,5.68,19.32,2019
"3943536",40,0,0,40,100,0,0,2019
"3943549",470,0,55,525,89.52,0,10.48,2019
"3943566",2848,11,302,3161,90.1,0.35,9.55,2019
"3943604",2888,290,1245,4423,65.3,6.56,28.15,2019
"3943717",60,0,16,76,78.95,0,21.05,2019
"3943728",393,35,132,560,70.18,6.25,23.57,2019
"3943740",80,0,12,92,86.96,0,13.04,2019
"3943746",418,0,178,596,70.13,0,29.87,2019
"3943755",497,24,133,654,75.99,3.67,20.34,2019
"3945133",6674,250,2523,9447,70.65,2.65,26.71,2019
"3945154",2808,37,613,3458,81.2,1.07,17.73,2019
"3945156",18,0,4,22,81.82,0,18.18,2019
"3945159",1191,9,234,1434,83.05,0.63,16.32,2019
"3945204",1893,52,574,2519,75.15,2.06,22.79,2019
"3945850",1090,24,149,1263,86.3,1.9,11.8,2019
"3945886",159,3,67,229,69.43,1.31,29.26,2019
"3945890",201,5,30,236,85.17,2.12,12.71,2019
"3945015",3928,132,622,4682,83.9,2.82,13.28,2019
"3945782",94,19,49,162,58.02,11.73,30.25,2019
"3945881",449,4,86,539,83.3,0.74,15.96,2019
"3945827",676,11,108,795,85.03,1.38,13.58,2019
"3945882",884,54,196,1134,77.95,4.76,17.28,2019
"3945103",11121,357,1156,12634,88.02,2.83,9.15,2019
"3945202",6912,200,881,7993,86.48,2.5,11.02,2019
"3945373",12131,390,1461,13982,86.76,2.79,10.45,2019
"3945420",9747,231,1833,11811,82.52,1.96,15.52,2019
"3945612",1213,62,440,1715,70.73,3.62,25.66,2019
"3945690",4510,138,1160,5808,77.65,2.38,19.97,2019
"3945111",122,5,21,148,82.43,3.38,14.19,2019
"3945231",13889,483,2250,16622,83.56,2.91,13.54,2019
"3945360",96,2,74,172,55.81,1.16,43.02,2019
"3945616",466,0,210,676,68.93,0,31.07,2019
"3945650",112,0,52,164,68.29,0,31.71,2019
"1846051",1036,17,106,1159,89.39,1.47,9.15,2019
"1846064",4518,148,404,5070,89.11,2.92,7.97,2019
"1846074",11336,84,555,11975,94.66,0.7,4.63,2019
"1846124",2311,96,822,3229,71.57,2.97,25.46,2019
"1846155",0,31,32,63,0,49.21,50.79,2019
"1846161",821,63,144,1028,79.86,6.13,14.01,2019
"1846164",1448,48,144,1640,88.29,2.93,8.78,2019
"1846167",2281,122,155,2558,89.17,4.77,6.06,2019
"1846375",8382,94,827,9303,90.1,1.01,8.89,2019
"1846403",4314,150,1444,5908,73.02,2.54,24.44,2019
"1846504",905,86,341,1332,67.94,6.46,25.6,2019
"1846539",887,53,149,1089,81.45,4.87,13.68,2019
"1846552",2043,68,472,2583,79.09,2.63,18.27,2019
"1846561",3986,63,479,4528,88.03,1.39,10.58,2019
"1846345",57,0,19,76,75,0,25,2019
"1846738",2508,104,719,3331,75.29,3.12,21.59,2019
"1846745",661,0,176,837,78.97,0,21.03,2019
"1846755",4777,132,1119,6028,79.25,2.19,18.56,2019
"1846772",448,2,339,789,56.78,0.25,42.97,2019
"1846779",644,33,122,799,80.6,4.13,15.27,2019
"1846725",8088,336,1308,9732,83.11,3.45,13.44,2019
"1846733",6019,294,1363,7676,78.41,3.83,17.76,2019
"1846750",8398,439,1814,10651,78.85,4.12,17.03,2019
"1846763",680,13,78,771,88.2,1.69,10.12,2019
"1846770",905,34,218,1157,78.22,2.94,18.84,2019
"1846785",451,21,78,550,82,3.82,14.18,2019
"1846805",7438,328,1620,9386,79.25,3.49,17.26,2019
"1846058",772,11,105,888,86.94,1.24,11.82,2019
"1846063",164,7,29,200,82,3.5,14.5,2019
"1846732",866,44,191,1101,78.66,4,17.35,2019
"1846741",911,28,458,1397,65.21,2,32.78,2019
"1846742",986,57,264,1307,75.44,4.36,20.2,2019
"1846743",523,9,231,763,68.55,1.18,30.28,2019
"1846765",1608,64,238,1910,84.19,3.35,12.46,2019
"1846799",74,9,14,97,76.29,9.28,14.43,2019
"1846814",3997,54,207,4258,93.87,1.27,4.86,2019
"1846347",1582,49,159,1790,88.38,2.74,8.88,2019
"1846371",1004,0,199,1203,83.46,0,16.54,2019
"1846069",2360,13,463,2836,83.22,0.46,16.33,2019
"1846016",4657,294,2045,6996,66.57,4.2,29.23,2019
"1846307",20501,431,1894,22826,89.81,1.89,8.3,2019
"1846816",5348,242,1721,7311,73.15,3.31,23.54,2019
"1846825",10764,326,1310,12400,86.81,2.63,10.56,2019
"1846911",452,18,78,548,82.48,3.28,14.23,2019
"1846926",432,38,92,562,76.87,6.76,16.37,2019
"1846960",372,11,77,460,80.87,2.39,16.74,2019
"1846017",1915,63,333,2311,82.86,2.73,14.41,2019
"1846032",19153,289,771,20213,94.76,1.43,3.81,2019
"1846038",16309,124,476,16909,96.45,0.73,2.82,2019
"1846039",126,14,80,220,57.27,6.36,36.36,2019
"1846068",816,94,231,1141,71.52,8.24,20.25,2019
"1846072",2988,216,475,3679,81.22,5.87,12.91,2019
"1846103",40,0,8,48,83.33,0,16.67,2019
"1846104",363,0,56,419,86.63,0,13.37,2019
"1846105",556,0,119,675,82.37,0,17.63,2019
"1846118",1747,35,190,1972,88.59,1.77,9.63,2019
"1846122",4930,152,701,5783,85.25,2.63,12.12,2019
"1846123",11721,282,800,12803,91.55,2.2,6.25,2019
"1846140",13598,594,1783,15975,85.12,3.72,11.16,2019
"1846162",96,0,83,179,53.63,0,46.37,2019
"1846175",167,9,60,236,70.76,3.81,25.42,2019
"1846204",3593,29,474,4096,87.72,0.71,11.57,2019
"1846214",8411,445,1203,10059,83.62,4.42,11.96,2019
"1846216",1051,0,336,1387,75.78,0,24.22,2019
"1846237",13423,366,1270,15059,89.14,2.43,8.43,2019
"1846256",9382,161,841,10384,90.35,1.55,8.1,2019
"1846304",8293,124,1409,9826,84.4,1.26,14.34,2019
"1846322",7937,193,1244,9374,84.67,2.06,13.27,2019
"1846929",796,50,273,1119,71.13,4.47,24.4,2019
"1846932",1013,76,224,1313,77.15,5.79,17.06,2019
"1846943",45,0,29,74,60.81,0,39.19,2019
"1846974",576,40,164,780,73.85,5.13,21.03,2019
"1846979",1459,120,162,1741,83.8,6.89,9.3,2019
"1846301",236,6,33,275,85.82,2.18,12,2019
"1846323",6524,191,1373,8088,80.66,2.36,16.98,2019
"1846348",325,7,80,412,78.88,1.7,19.42,2019
"1846406",2405,299,1018,3722,64.62,8.03,27.35,2019
"1846410",13244,392,1841,15477,85.57,2.53,11.9,2019
"1846516",8887,357,2112,11356,78.26,3.14,18.6,2019
"1846537",78,9,86,173,45.09,5.2,49.71,2019
"1846538",1357,98,143,1598,84.92,6.13,8.95,2019
"1846795",1938,83,494,2515,77.06,3.3,19.64,2019
"1846802",3632,164,918,4714,77.05,3.48,19.47,2019
"1846809",3385,112,622,4119,82.18,2.72,15.1,2019
"1846933",2138,114,307,2559,83.55,4.45,12,2019
"1846939",584,38,205,827,70.62,4.59,24.79,2019
"1846941",317,15,32,364,87.09,4.12,8.79,2019
"1846946",17,0,9,26,65.38,0,34.62,2019
"2066780",142,0,36,178,79.78,0,20.22,2019
"2066801",9451,459,1557,11467,82.42,4,13.58,2019
"2066835",414,5,125,544,76.1,0.92,22.98,2019
"2066856",603,15,155,773,78.01,1.94,20.05,2019
"2066862",51,2,0,53,96.23,3.77,0,2019
"2066866",520,24,114,658,79.03,3.65,17.33,2019
"2066901",1826,154,507,2487,73.42,6.19,20.39,2019
"2066932",33,0,7,40,82.5,0,17.5,2019
"2066964",49,4,10,63,77.78,6.35,15.87,2019
"2067132",147,3,16,166,88.55,1.81,9.64,2019
"2067026",1392,75,187,1654,84.16,4.53,11.31,2019
"2067152",2978,167,549,3694,80.62,4.52,14.86,2019
"2067337",3684,85,1257,5026,73.3,1.69,25.01,2019
"2067458",46,11,33,90,51.11,12.22,36.67,2019
"2067519",65,2,12,79,82.28,2.53,15.19,2019
"3168733",393,40,91,524,75,7.63,17.37,2019
"3168735",234,24,71,329,71.12,7.29,21.58,2019
"3168742",63,3,8,74,85.14,4.05,10.81,2019
"3168747",41,2,3,46,89.13,4.35,6.52,2019
"3168757",232,6,72,310,74.84,1.94,23.23,2019
"3168761",123,3,38,164,75,1.83,23.17,2019
"3168764",303,15,56,374,81.02,4.01,14.97,2019
"3168770",459,26,164,649,70.72,4.01,25.27,2019
"3168812",155,3,42,200,77.5,1.5,21,2019
"3168813",179,7,44,230,77.83,3.04,19.13,2019
"3168814",282,23,74,379,74.41,6.07,19.53,2019
"3168817",112,6,34,152,73.68,3.95,22.37,2019
"3168821",22,1,2,25,88,4,8,2019
"3168824",514,13,59,586,87.71,2.22,10.07,2019
"3168034",238,14,38,290,82.07,4.83,13.1,2019
"3168039",184,8,117,309,59.55,2.59,37.86,2019
"3168045",585,56,174,815,71.78,6.87,21.35,2019
"3168446",882,24,279,1185,74.43,2.03,23.54,2019
"3168448",145,4,12,161,90.06,2.48,7.45,2019
"3168452",28,6,15,49,57.14,12.24,30.61,2019
"3168463",434,7,121,562,77.22,1.25,21.53,2019
"3168467",3255,117,448,3820,85.21,3.06,11.73,2019
"3168505",5892,158,755,6805,86.58,2.32,11.09,2019
"3168507",5533,91,826,6450,85.78,1.41,12.81,2019
"3168510",7874,242,1083,9199,85.6,2.63,11.77,2019
"3168527",267,0,18,285,93.68,0,6.32,2019
"3168622",87,1,23,111,78.38,0.9,20.72,2019
"3168008",4397,128,463,4988,88.15,2.57,9.28,2019
"3168626",222,4,60,286,77.62,1.4,20.98,2019
"3168466",577,3,136,716,80.59,0.42,18.99,2019
"3168504",6466,97,1206,7769,83.23,1.25,15.52,2019
"3168508",3992,373,819,5184,77.01,7.2,15.8,2019
"3168633",388,43,103,534,72.66,8.05,19.29,2019
"3168635",161,0,41,202,79.7,0,20.3,2019
"3168644",204,10,41,255,80,3.92,16.08,2019
"3168658",248,4,67,319,77.74,1.25,21,2019
"3168660",383,8,121,512,74.8,1.56,23.63,2019
"3168663",198,4,77,279,70.97,1.43,27.6,2019
"3168665",317,28,56,401,79.05,6.98,13.97,2019
"3168345",69,8,40,117,58.97,6.84,34.19,2019
"3168303",88,3,42,133,66.17,2.26,31.58,2019
"3168336",218,0,35,253,86.17,0,13.83,2019
"3168359",460,8,116,584,78.77,1.37,19.86,2019
"3168404",282,0,89,371,76.01,0,23.99,2019
"3943779",280,0,104,384,72.92,0,27.08,2019
"3943788",128,23,63,214,59.81,10.75,29.44,2019
"3943822",1394,52,499,1945,71.67,2.67,25.66,2019
"3943026",22128,472,1319,23919,92.51,1.97,5.51,2019
"3943037",62,0,45,107,57.94,0,42.06,2019
"3943045",782,8,37,827,94.56,0.97,4.47,2019
"3943067",462,9,46,517,89.36,1.74,8.9,2019
"3943077",68,6,14,88,77.27,6.82,15.91,2019
"3943111",93,0,32,125,74.4,0,25.6,2019
"3943115",390,9,146,545,71.56,1.65,26.79,2019
"3943135",1123,114,394,1631,68.85,6.99,24.16,2019
"3943145",716,12,117,845,84.73,1.42,13.85,2019
"3943152",275,0,86,361,76.18,0,23.82,2019
"3943155",784,58,148,990,79.19,5.86,14.95,2019
"3943158",158,0,0,158,100,0,0,2019
"3943162",2359,68,340,2767,85.25,2.46,12.29,2019
"3943164",612,37,136,785,77.96,4.71,17.32,2019
"3943205",4290,94,1093,5477,78.33,1.72,19.96,2019
"3943219",9094,318,2429,11841,76.8,2.69,20.51,2019
"3943224",14200,305,2845,17350,81.84,1.76,16.4,2019
"3943731",1507,68,473,2048,73.58,3.32,23.1,2019
"3943780",650,0,227,877,74.12,0,25.88,2019
"3943952",5276,268,1599,7143,73.86,3.75,22.39,2019
"3943228",18966,420,2741,22127,85.71,1.9,12.39,2019
"3943521",931,62,173,1166,79.85,5.32,14.84,2019
"3943044",1550,36,255,1841,84.19,1.96,13.85,2019
"3943147",13254,251,539,14044,94.37,1.79,3.84,2019
"3943221",13097,139,490,13726,95.42,1.01,3.57,2019
"3943430",1401,44,289,1734,80.8,2.54,16.67,2019
"3943527",627,9,133,769,81.53,1.17,17.3,2019
"3943013",186,20,71,277,67.15,7.22,25.63,2019
"3943076",2812,46,608,3466,81.13,1.33,17.54,2019
"3943151",99,5,15,119,83.19,4.2,12.61,2019
"3943202",8511,93,492,9096,93.57,1.02,5.41,2019
"3943337",354,4,128,486,72.84,0.82,26.34,2019
"3944460",8231,305,1873,10409,79.08,2.93,17.99,2019
"3944515",10231,400,1438,12069,84.77,3.31,11.91,2019
"3944601",11169,430,2542,14141,78.98,3.04,17.98,2019
"3944609",1211,95,196,1502,80.63,6.32,13.05,2019
"3944620",527,26,144,697,75.61,3.73,20.66,2019
"3944633",456,43,260,759,60.08,5.67,34.26,2019
"3944637",705,76,256,1037,67.98,7.33,24.69,2019
"3944640",76,0,4,80,95,0,5,2019
"3944659",43,1,11,55,78.18,1.82,20,2019
"3944004",10223,484,2669,13376,76.43,3.62,19.95,2019
"3944024",8041,139,1169,9349,86.01,1.49,12.5,2019
"3944046",541,44,253,838,64.56,5.25,30.19,2019
"3944047",2917,63,404,3384,86.2,1.86,11.94,2019
"3944054",4195,137,563,4895,85.7,2.8,11.5,2019
"3944055",4510,653,2264,7427,60.72,8.79,30.48,2019
"1846107",4210,179,651,5040,83.53,3.55,12.92,2019
"1846142",10131,199,1125,11455,88.44,1.74,9.82,2019
"1846144",33,0,49,82,40.24,0,59.76,2019
"1846150",313,8,155,476,65.76,1.68,32.56,2019
"1846168",11670,374,1351,13395,87.12,2.79,10.09,2019
"1846172",778,44,188,1010,77.03,4.36,18.61,2019
"1846203",10568,595,2927,14090,75,4.22,20.77,2019
"1846222",9213,349,2548,12110,76.08,2.88,21.04,2019
"1846224",10787,398,2454,13639,79.09,2.92,17.99,2019
"1846226",12685,727,4863,18275,69.41,3.98,26.61,2019
"1846228",5144,59,518,5721,89.91,1.03,9.05,2019
"1846231",2896,0,388,3284,88.19,0,11.81,2019
"1846254",12564,562,2645,15771,79.67,3.56,16.77,2019
"1846260",11459,426,1925,13810,82.98,3.08,13.94,2019
"1846278",2833,0,225,3058,92.64,0,7.36,2019
"1846031",821,82,54,957,85.79,8.57,5.64,2019
"1846034",2478,175,215,2868,86.4,6.1,7.5,2019
"1846047",18,0,0,18,100,0,0,2019
"1846050",632,19,113,764,82.72,2.49,14.79,2019
"1846076",486,7,140,633,76.78,1.11,22.12,2019
"1846112",12142,228,989,13359,90.89,1.71,7.4,2019
"1846113",4970,77,380,5427,91.58,1.42,7,2019
"1846120",1797,15,369,2181,82.39,0.69,16.92,2019
"1846166",492,2,269,763,64.48,0.26,35.26,2019
"1846173",2720,267,1050,4037,67.38,6.61,26.01,2019
"1846176",8567,438,2210,11215,76.39,3.91,19.71,2019
"1846184",4290,108,497,4895,87.64,2.21,10.15,2019
"1846218",5781,419,6259,12459,46.4,3.36,50.24,2019
"1846220",14822,215,1846,16883,87.79,1.27,10.93,2019
"1846614",9983,429,1968,12380,80.64,3.47,15.9,2019
"1846617",3172,95,553,3820,83.04,2.49,14.48,2019
"1846635",2158,96,374,2628,82.12,3.65,14.23,2019
"1846737",2559,193,512,3264,78.4,5.91,15.69,2019
"1846573",1079,22,228,1329,81.19,1.66,17.16,2019
"1846637",5541,415,463,6419,86.32,6.47,7.21,2019
"1846320",2954,369,1669,4992,59.17,7.39,33.43,2019
"1846536",875,100,243,1218,71.84,8.21,19.95,2019
"1846914",435,60,130,625,69.6,9.6,20.8,2019
"1846052",7607,361,1560,9528,79.84,3.79,16.37,2019
"1846147",994,54,213,1261,78.83,4.28,16.89,2019
"1846060",13472,85,1131,14688,91.72,0.58,7.7,2019
"1846580",6957,325,1256,8538,81.48,3.81,14.71,2019
"1846501",1044,12,232,1288,81.06,0.93,18.01,2019
"1846746",1198,65,355,1618,74.04,4.02,21.94,2019
"1846994",826,40,173,1039,79.5,3.85,16.65,2019
"1846049",364,29,85,478,76.15,6.07,17.78,2019
"1846135",5376,306,1326,7008,76.71,4.37,18.92,2019
"1846236",9298,112,1147,10557,88.07,1.06,10.86,2019
"1846319",6304,123,666,7093,88.88,1.73,9.39,2019
"1846221",7671,123,1532,9326,82.25,1.32,16.43,2019
"1846227",17773,1145,3280,22198,80.07,5.16,14.78,2019
"1846268",9184,324,1464,10972,83.7,2.95,13.34,2019
"1846324",6466,368,1534,8368,77.27,4.4,18.33,2019
"1846959",336,0,68,404,83.17,0,16.83,2019
"1846961",64,0,31,95,67.37,0,32.63,2019
"1846962",2675,236,567,3478,76.91,6.79,16.3,2019
"1846978",618,16,155,789,78.33,2.03,19.65,2019
"1847431",413,38,171,622,66.4,6.11,27.49,2019
"1847446",3015,83,1164,4262,70.74,1.95,27.31,2019
"1847455",29,0,0,29,100,0,0,2019
"1847513",598,32,194,824,72.57,3.88,23.54,2019
"1847529",350,2,64,416,84.13,0.48,15.38,2019
"1847531",238,0,167,405,58.77,0,41.23,2019
"1847720",5468,133,1365,6966,78.5,1.91,19.6,2019
"1847803",7674,228,937,8839,86.82,2.58,10.6,2019
"1847807",3585,324,885,4794,74.78,6.76,18.46,2019
"1847424",2831,86,654,3571,79.28,2.41,18.31,2019
"1847449",74,6,56,136,54.41,4.41,41.18,2019
"1847468",472,12,126,610,77.38,1.97,20.66,2019
"1847514",59,0,12,71,83.1,0,16.9,2019
"1847515",226,14,110,350,64.57,4,31.43,2019
"1847521",195,0,40,235,82.98,0,17.02,2019
"1847523",903,38,351,1292,69.89,2.94,27.17,2019
"1847551",263,11,52,326,80.67,3.37,15.95,2019
"1847557",512,30,106,648,79.01,4.63,16.36,2019
"1847567",1753,53,707,2513,69.76,2.11,28.13,2019
"1847575",337,17,64,418,80.62,4.07,15.31,2019
"1847620",4226,203,886,5315,79.51,3.82,16.67,2019
"1847660",1504,10,392,1906,78.91,0.52,20.57,2019
"1847017",139,12,91,242,57.44,4.96,37.6,2019
"1847024",869,26,379,1274,68.21,2.04,29.75,2019
"1847035",39,0,91,130,30,0,70,2019
"1847117",1141,30,359,1530,74.58,1.96,23.46,2019
"1847125",356,38,195,589,60.44,6.45,33.11,2019
"1847165",1789,61,519,2369,75.52,2.57,21.91,2019
"1847201",14037,557,2669,17263,81.31,3.23,15.46,2019
"1847001",3332,61,778,4171,79.88,1.46,18.65,2019
"1847010",46,13,45,104,44.23,12.5,43.27,2019
"1847011",226,17,44,287,78.75,5.92,15.33,2019
"1847012",3091,159,597,3847,80.35,4.13,15.52,2019
"1847016",306,7,31,344,88.95,2.03,9.01,2019
"1847023",402,5,180,587,68.48,0.85,30.66,2019
"1847115",640,10,399,1049,61.01,0.95,38.04,2019
"1847130",14519,522,3132,18173,79.89,2.87,17.23,2019
"1847140",676,12,330,1018,66.4,1.18,32.42,2019
"1847162",166,21,126,313,53.04,6.71,40.26,2019
"1847226",69,0,14,83,83.13,0,16.87,2019
"1847220",1393,43,544,1980,70.35,2.17,27.47,2019
"1847231",304,2,30,336,90.48,0.6,8.93,2019
"1847235",345,18,115,478,72.18,3.77,24.06,2019
"1847265",6108,232,1515,7855,77.76,2.95,19.29,2019
"1847273",660,26,116,802,82.29,3.24,14.46,2019
"1847344",31,0,9,40,77.5,0,22.5,2019
"1847361",70,5,6,81,86.42,6.17,7.41,2019
"1847390",1619,124,439,2182,74.2,5.68,20.12,2019
"1847955",335,4,88,427,78.45,0.94,20.61,2019
"1847980",370,3,74,447,82.77,0.67,16.55,2019
"1847338",827,32,259,1118,73.97,2.86,23.17,2019
"1847341",660,33,214,907,72.77,3.64,23.59,2019
"1847348",3012,266,671,3949,76.27,6.74,16.99,2019
"1847360",345,51,78,474,72.78,10.76,16.46,2019
"1847832",331,4,82,417,79.38,0.96,19.66,2019
"1760429",4505,159,883,5547,81.22,2.87,15.92,2019
"1760461",1548,75,176,1799,86.05,4.17,9.78,2019
"1760462",13602,326,1495,15423,88.19,2.11,9.69,2019
"1760466",7266,213,1225,8704,83.48,2.45,14.07,2019
"1760470",185,6,38,229,80.79,2.62,16.59,2019
"1760481",3867,128,764,4759,81.26,2.69,16.05,2019
"1760471",4048,148,741,4937,81.99,3,15.01,2019
"1760472",895,67,577,1539,58.15,4.35,37.49,2019
"1760479",323,5,46,374,86.36,1.34,12.3,2019
"2963555",983,32,262,1277,76.98,2.51,20.52,2019
"2963556",901,29,294,1224,73.61,2.37,24.02,2019
"2963559",446,46,89,581,76.76,7.92,15.32,2019
"2963566",23,0,15,38,60.53,0,39.47,2019
"2963627",957,55,195,1207,79.29,4.56,16.16,2019
"2963051",4382,201,556,5139,85.27,3.91,10.82,2019
"2067487",400,47,54,501,79.84,9.38,10.78,2019
"2067490",281,24,67,372,75.54,6.45,18.01,2019
"2067154",440,10,155,605,72.73,1.65,25.62,2019
"2067134",118,4,60,182,64.84,2.2,32.97,2019
"2067147",3261,3,610,3874,84.18,0.08,15.75,2019
"2067150",11,0,10,21,52.38,0,47.62,2019
"2067206",6254,235,679,7168,87.25,3.28,9.47,2019
"2067213",6111,501,2034,8646,70.68,5.79,23.53,2019
"2067333",826,11,354,1191,69.35,0.92,29.72,2019
"2067342",290,10,74,374,77.54,2.67,19.79,2019
"2067345",36,0,18,54,66.67,0,33.33,2019
"2067354",217,3,51,271,80.07,1.11,18.82,2019
"2067364",88,6,13,107,82.24,5.61,12.15,2019
"2067430",236,17,68,321,73.52,5.3,21.18,2019
"2067450",232,10,63,305,76.07,3.28,20.66,2019
"2067452",66,0,7,73,90.41,0,9.59,2019
"2067455",597,3,220,820,72.8,0.37,26.83,2019
"2067457",238,25,43,306,77.78,8.17,14.05,2019
"2067131",122,0,29,151,80.79,0,19.21,2019
"2067127",180,7,45,232,77.59,3.02,19.4,2019
"2067135",934,36,161,1131,82.58,3.18,14.24,2019
"2067146",697,14,91,802,86.91,1.75,11.35,2019
"2067156",4190,112,1114,5416,77.36,2.07,20.57,2019
"2067216",6767,380,1864,9011,75.1,4.22,20.69,2019
"2067349",262,29,129,420,62.38,6.9,30.71,2019
"2067401",16673,592,3288,20553,81.12,2.88,16,2019
"2067427",147,2,40,189,77.78,1.06,21.16,2019
"3168064",1362,11,244,1617,84.23,0.68,15.09,2019
"3168066",1815,48,364,2227,81.5,2.16,16.34,2019
"3168071",362,4,211,577,62.74,0.69,36.57,2019
"3168130",7338,105,432,7875,93.18,1.33,5.49,2019
"3168136",5757,94,162,6013,95.74,1.56,2.69,2019
"3168970",489,20,146,655,74.66,3.05,22.29,2019
"3168157",2386,10,265,2661,89.67,0.38,9.96,2019
"3168307",168,12,25,205,81.95,5.85,12.2,2019
"3168309",41,1,9,51,80.39,1.96,17.65,2019
"3168318",128,1,57,186,68.82,0.54,30.65,2019
"3168320",142,9,39,190,74.74,4.74,20.53,2019
"3168327",111,2,31,144,77.08,1.39,21.53,2019
"3168328",184,10,18,212,86.79,4.72,8.49,2019
"3168333",2375,39,469,2883,82.38,1.35,16.27,2019
"3168341",419,6,49,474,88.4,1.27,10.34,2019
"3168347",930,14,29,973,95.58,1.44,2.98,2019
"3168364",34,3,7,44,77.27,6.82,15.91,2019
"1760539",0,0,0,0,NA,NA,NA,2019
"1760026",4881,62,357,5300,92.09,1.17,6.74,2019
"1760051",8170,143,337,8650,94.45,1.65,3.9,2019
"1760124",7466,62,295,7823,95.44,0.79,3.77,2019
"1760133",10307,139,894,11340,90.89,1.23,7.88,2019
"1760144",23,5,0,28,82.14,17.86,0,2019
"1760156",9262,118,311,9691,95.57,1.22,3.21,2019
"1760169",10582,215,862,11659,90.76,1.84,7.39,2019
"1760189",10864,92,552,11508,94.4,0.8,4.8,2019
"1760403",6161,154,859,7174,85.88,2.15,11.97,2019
"1760404",6033,80,453,6566,91.88,1.22,6.9,2019
"1760428",3327,64,619,4010,82.97,1.6,15.44,2019
"1760484",1940,43,338,2321,83.58,1.85,14.56,2019
"1760487",8451,55,380,8886,95.1,0.62,4.28,2019
"1762419",70,7,6,83,84.34,8.43,7.23,2019
"1762446",115,8,34,157,73.25,5.1,21.66,2019
"1762448",1728,27,502,2257,76.56,1.2,22.24,2019
"1762465",308,8,63,379,81.27,2.11,16.62,2019
"1762469",190,0,11,201,94.53,0,5.47,2019
"1762471",2497,23,886,3406,73.31,0.68,26.01,2019
"1762477",255,5,41,301,84.72,1.66,13.62,2019
"1762478",135,5,24,164,82.32,3.05,14.63,2019
"1762481",120,13,46,179,67.04,7.26,25.7,2019
"1762515",309,0,119,428,72.2,0,27.8,2019
"1762538",174,0,38,212,82.08,0,17.92,2019
"1762563",1791,84,208,2083,85.98,4.03,9.99,2019
"1762573",558,10,76,644,86.65,1.55,11.8,2019
"1762611",345,6,99,450,76.67,1.33,22,2019
"1762613",1334,3,188,1525,87.48,0.2,12.33,2019
"1762630",126,8,32,166,75.9,4.82,19.28,2019
"1762047",383,0,155,538,71.19,0,28.81,2019
"1762053",135,2,61,198,68.18,1.01,30.81,2019
"1762058",231,10,116,357,64.71,2.8,32.49,2019
"1762061",598,11,55,664,90.06,1.66,8.28,2019
"1762062",3092,77,197,3366,91.86,2.29,5.85,2019
"1762070",6,0,0,6,100,0,0,2019
"1762082",749,28,219,996,75.2,2.81,21.99,2019
"1762084",495,31,104,630,78.57,4.92,16.51,2019
"1762085",44,0,17,61,72.13,0,27.87,2019
"1762086",461,0,101,562,82.03,0,17.97,2019
"1762633",191,3,41,235,81.28,1.28,17.45,2019
"1762634",264,6,51,321,82.24,1.87,15.89,2019
"1762639",102,0,18,120,85,0,15,2019
"1762665",400,21,127,548,72.99,3.83,23.18,2019
"1762673",137,1,37,175,78.29,0.57,21.14,2019
"1762674",478,6,136,620,77.1,0.97,21.94,2019
"1762689",182,15,32,229,79.48,6.55,13.97,2019
"1762702",10884,1126,3516,15526,70.1,7.25,22.65,2019
"1762707",2499,177,453,3129,79.87,5.66,14.48,2019
"1762817",167,8,52,227,73.57,3.52,22.91,2019
"1762822",843,40,340,1223,68.93,3.27,27.8,2019
"1762823",436,36,216,688,63.37,5.23,31.4,2019
"1762253",153,1,97,251,60.96,0.4,38.65,2019
"2067049",49,0,3,52,94.23,0,5.77,2019
"2067053",183,4,64,251,72.91,1.59,25.5,2019
"2067057",79,4,32,115,68.7,3.48,27.83,2019
"2067068",1256,90,403,1749,71.81,5.15,23.04,2019
"2067103",66,6,9,81,81.48,7.41,11.11,2019
"2067107",1033,93,320,1446,71.44,6.43,22.13,2019
"3168405",1039,18,209,1266,82.07,1.42,16.51,2019
"3168409",292,2,39,333,87.69,0.6,11.71,2019
"3168785",85,0,15,100,85,0,15,2019
"3168825",324,2,115,441,73.47,0.45,26.08,2019
"3168833",109,8,18,135,80.74,5.93,13.33,2019
"3168838",79,0,13,92,85.87,0,14.13,2019
"3168843",267,3,38,308,86.69,0.97,12.34,2019
"3168876",468,19,103,590,79.32,3.22,17.46,2019
"3168925",141,0,55,196,71.94,0,28.06,2019
"3169133",144,5,28,177,81.36,2.82,15.82,2019
"3169134",162,0,26,188,86.17,0,13.83,2019
"3169039",40,2,2,44,90.91,4.55,4.55,2019
"3169147",186,3,43,232,80.17,1.29,18.53,2019
"3169340",15,7,0,22,68.18,31.82,0,2019
"3169023",103,0,0,103,100,0,0,2019
"3169027",8,0,8,16,50,0,50,2019
"3169029",158,0,20,178,88.76,0,11.24,2019
"3169021",455,20,158,633,71.88,3.16,24.96,2019
"3169024",400,15,123,538,74.35,2.79,22.86,2019
"3169028",289,7,69,365,79.18,1.92,18.9,2019
"3169143",526,7,79,612,85.95,1.14,12.91,2019
"3169155",382,10,82,474,80.59,2.11,17.3,2019
"3169161",16,12,19,47,34.04,25.53,40.43,2019
"3169162",2745,103,544,3392,80.93,3.04,16.04,2019
"3169168",87,0,21,108,80.56,0,19.44,2019
"3169214",89,2,17,108,82.41,1.85,15.74,2019
"3169216",35,0,9,44,79.55,0,20.45,2019
"3169030",70,1,26,97,72.16,1.03,26.8,2019
"3169221",55,0,3,58,94.83,0,5.17,2019
"3169171",5,0,0,5,100,0,0,2019
"3169353",11,0,2,13,84.62,0,15.38,2019
"0571950",233,4,103,340,68.53,1.18,30.29,2019
"0571957",801,84,335,1220,65.66,6.89,27.46,2019
"0571968",1226,29,299,1554,78.89,1.87,19.24,2019
"2271068",1049,30,483,1562,67.16,1.92,30.92,2019
"2271070",393,30,252,675,58.22,4.44,37.33,2019
"2271079",25,0,61,86,29.07,0,70.93,2019
"2271109",4012,408,3141,7561,53.06,5.4,41.54,2019
"2271223",31,19,85,135,22.96,14.07,62.96,2019
"2271243",65,7,15,87,74.71,8.05,17.24,2019
"2271251",2190,0,894,3084,71.01,0,28.99,2019
"2271261",255,16,235,506,50.4,3.16,46.44,2019
"2271266",301,6,291,598,50.33,1,48.66,2019
"2271276",24,0,14,38,63.16,0,36.84,2019
"2271295",2630,371,1808,4809,54.69,7.71,37.6,2019
"2271343",1731,108,912,2751,62.92,3.93,33.15,2019
"2271350",887,123,546,1556,57.01,7.9,35.09,2019
"2271351",3108,107,1135,4350,71.45,2.46,26.09,2019
"2271401",58,9,0,67,86.57,13.43,0,2019
"2271410",37,0,7,44,84.09,0,15.91,2019
"2271425",47,0,0,47,100,0,0,2019
"2271426",67,0,31,98,68.37,0,31.63,2019
"2271459",3143,128,275,3546,88.64,3.61,7.76,2019
"0571642",132,0,175,307,43,0,57,2019
"0571651",57,0,14,71,80.28,0,19.72,2019
"0571655",4194,385,1216,5795,72.37,6.64,20.98,2019
"0571658",145,13,107,265,54.72,4.91,40.38,2019
"2271368",179,14,269,462,38.74,3.03,58.23,2019
"2271418",1432,38,874,2344,61.09,1.62,37.29,2019
"2067110",2879,81,314,3274,87.94,2.47,9.59,2019
"2067114",6776,267,1306,8349,81.16,3.2,15.64,2019
"2067120",261,19,114,394,66.24,4.82,28.93,2019
"2067133",2167,46,117,2330,93,1.97,5.02,2019
"2067137",140,1,78,219,63.93,0.46,35.62,2019
"2067138",124,3,12,139,89.21,2.16,8.63,2019
"2067143",10,4,5,19,52.63,21.05,26.32,2019
"2067205",6344,27,237,6608,96,0.41,3.59,2019
"2067024",287,8,98,393,73.03,2.04,24.94,2019
"2067066",135,8,25,168,80.36,4.76,14.88,2019
"2067067",599,11,41,651,92.01,1.69,6.3,2019
"2067123",174,14,31,219,79.45,6.39,14.16,2019
"2067142",124,0,35,159,77.99,0,22.01,2019
"2067149",308,0,34,342,90.06,0,9.94,2019
"2067210",2564,238,565,3367,76.15,7.07,16.78,2019
"2067219",3479,109,783,4371,79.59,2.49,17.91,2019
"2067301",4120,104,993,5217,78.97,1.99,19.03,2019
"2067332",37,3,2,42,88.1,7.14,4.76,2019
"2067355",38,0,25,63,60.32,0,39.68,2019
"2067357",3722,202,1048,4972,74.86,4.06,21.08,2019
"2067416",350,7,47,404,86.63,1.73,11.63,2019
"2067441",345,30,57,432,79.86,6.94,13.19,2019
"2067449",1006,32,283,1321,76.15,2.42,21.42,2019
"2067491",148,3,5,156,94.87,1.92,3.21,2019
"2067505",917,120,201,1238,74.07,9.69,16.24,2019
"2067514",231,14,101,346,66.76,4.05,29.19,2019
"2067515",20,0,2,22,90.91,0,9.09,2019
"2067522",641,25,51,717,89.4,3.49,7.11,2019
"2067525",332,13,86,431,77.03,3.02,19.95,2019
"2067561",384,18,104,506,75.89,3.56,20.55,2019
"2067568",73,9,20,102,71.57,8.82,19.61,2019
"2067579",954,65,178,1197,79.7,5.43,14.87,2019
"2067584",86,1,14,101,85.15,0.99,13.86,2019
"2067623",59,0,18,77,76.62,0,23.38,2019
"2067740",636,5,106,747,85.14,0.67,14.19,2019
"2067643",81,13,20,114,71.05,11.4,17.54,2019
"2067644",95,2,16,113,84.07,1.77,14.16,2019
"2067657",118,0,21,139,84.89,0,15.11,2019
"2067741",135,4,43,182,74.18,2.2,23.63,2019
"2067748",795,22,205,1022,77.79,2.15,20.06,2019
"2067753",130,0,39,169,76.92,0,23.08,2019
"2067758",371,2,101,474,78.27,0.42,21.31,2019
"2067831",344,8,72,424,81.13,1.89,16.98,2019
"2067835",835,18,165,1018,82.02,1.77,16.21,2019
"2067844",282,8,65,355,79.44,2.25,18.31,2019
"2067861",659,13,153,825,79.88,1.58,18.55,2019
"2067867",481,12,141,634,75.87,1.89,22.24,2019
"2067871",1644,57,282,1983,82.9,2.87,14.22,2019
"2067882",92,0,45,137,67.15,0,32.85,2019
"2067901",5838,79,1110,7027,83.08,1.12,15.8,2019
"2067950",529,45,154,728,72.66,6.18,21.15,2019
"2067002",4603,126,528,5257,87.56,2.4,10.04,2019
"2067003",743,62,197,1002,74.15,6.19,19.66,2019
"2270749",415,16,75,506,82.02,3.16,14.82,2019
"2270750",329,49,223,601,54.74,8.15,37.1,2019
"2270759",459,12,281,752,61.04,1.6,37.37,2019
"2270777",1149,20,270,1439,79.85,1.39,18.76,2019
"2270780",323,20,130,473,68.29,4.23,27.48,2019
"2270801",80,27,10,117,68.38,23.08,8.55,2019
"2271456",353,17,201,571,61.82,2.98,35.2,2019
"0571601",2919,297,2263,5479,53.28,5.42,41.3,2019
"0571724",85,62,61,208,40.87,29.81,29.33,2019
"0571726",275,10,330,615,44.72,1.63,53.66,2019
"0571765",393,44,413,850,46.24,5.18,48.59,2019
"0571845",504,68,274,846,59.57,8.04,32.39,2019
"0571861",422,8,336,766,55.09,1.04,43.86,2019
"0571913",16044,536,3387,19967,80.35,2.68,16.96,2019
"0571935",110,0,107,217,50.69,0,49.31,2019
"3059832",204,8,60,272,75,2.94,22.06,2019
"3059484",31,3,21,55,56.36,5.45,38.18,2019
"3059038",224,10,48,282,79.43,3.55,17.02,2019
"3059213",111,3,99,213,52.11,1.41,46.48,2019
"3059007",49,9,8,66,74.24,13.64,12.12,2019
"3059419",37,2,5,44,84.09,4.55,11.36,2019
"3059525",67,9,21,97,69.07,9.28,21.65,2019
"3059640",22,0,7,29,75.86,0,24.14,2019
"3059082",7,2,0,9,77.78,22.22,0,2019
"3059240",14,0,0,14,100,0,0,2019
"3059256",12,0,9,21,57.14,0,42.86,2019
"3059312",6,0,6,12,50,0,50,2019
"3059418",26,0,0,26,100,0,0,2019
"3059461",7,0,0,7,100,0,0,2019
"3059489",126,7,5,138,91.3,5.07,3.62,2019
"3059647",103,0,40,143,72.03,0,27.97,2019
"3059703",35,3,0,38,92.11,7.89,0,2019
"3059724",31,2,3,36,86.11,5.56,8.33,2019
"3059732",41,22,18,81,50.62,27.16,22.22,2019
"3059760",117,0,33,150,78,0,22,2019
"3059830",61,0,11,72,84.72,0,15.28,2019
"3059856",93,2,42,137,67.88,1.46,30.66,2019
"3059863",38,0,21,59,64.41,0,35.59,2019
"3059313",890,17,201,1108,80.32,1.53,18.14,2019
"3059474",1068,54,194,1316,81.16,4.1,14.74,2019
"3059639",277,11,249,537,51.58,2.05,46.37,2019
"3059752",1112,33,321,1466,75.85,2.25,21.9,2019
"3059827",76,2,41,119,63.87,1.68,34.45,2019
"3059540",115,0,14,129,89.15,0,10.85,2019
"3059247",151,3,18,172,87.79,1.74,10.47,2019
"3059252",20,0,10,30,66.67,0,33.33,2019
"3059253",22,0,8,30,73.33,0,26.67,2019
"3059301",3822,60,913,4795,79.71,1.25,19.04,2019
"3059326",59,4,26,89,66.29,4.49,29.21,2019
"3059336",55,9,10,74,74.32,12.16,13.51,2019
"3059337",245,8,73,326,75.15,2.45,22.39,2019
"3059347",108,0,34,142,76.06,0,23.94,2019
"3059411",60,0,30,90,66.67,0,33.33,2019
"3059412",448,28,192,668,67.07,4.19,28.74,2019
"3059425",1056,45,288,1389,76.03,3.24,20.73,2019
"3059602",8843,234,1181,10258,86.21,2.28,11.51,2019
"3059633",86,0,3,89,96.63,0,3.37,2019
"3059636",0,0,0,0,NA,NA,NA,2019
"3059638",188,29,52,269,69.89,10.78,19.33,2019
"3059714",6584,256,1225,8065,81.64,3.17,15.19,2019
"3059721",138,26,43,207,66.67,12.56,20.77,2019
"3059722",1465,68,406,1939,75.55,3.51,20.94,2019
"3059743",43,3,16,62,69.35,4.84,25.81,2019
"3059825",841,11,132,984,85.47,1.12,13.41,2019
"3059848",51,3,6,60,85,5,10,2019
"2270442",91,0,0,91,100,0,0,2019
"2270455",125,0,155,280,44.64,0,55.36,2019
"2270461",9368,304,779,10451,89.64,2.91,7.45,2019
"2270518",4341,144,720,5205,83.4,2.77,13.83,2019
"2270531",415,28,124,567,73.19,4.94,21.87,2019
"2270533",2065,47,610,2722,75.86,1.73,22.41,2019
"2270537",134,0,35,169,79.29,0,20.71,2019
"2270556",82,0,48,130,63.08,0,36.92,2019
"2270560",10648,402,3474,14524,73.31,2.77,23.92,2019
"2270570",8735,548,5305,14588,59.88,3.76,36.37,2019
"2270377",1008,88,366,1462,68.95,6.02,25.03,2019
"2270392",2498,113,602,3213,77.75,3.52,18.74,2019
"2270581",209,0,75,284,73.59,0,26.41,2019
"2270601",9118,466,4445,14029,64.99,3.32,31.68,2019
"2270605",12900,512,1698,15110,85.37,3.39,11.24,2019
"2270633",2121,0,542,2663,79.65,0,20.35,2019
"2270652",431,55,213,699,61.66,7.87,30.47,2019
"2270654",57,0,46,103,55.34,0,44.66,2019
"2270660",515,23,57,595,86.55,3.87,9.58,2019
"2270714",5470,298,888,6656,82.18,4.48,13.34,2019
"2270715",421,47,120,588,71.6,7.99,20.41,2019
"2270734",2485,32,73,2590,95.95,1.24,2.82,2019
"2270748",1103,83,474,1660,66.45,5,28.55,2019
"2270787",41,26,0,67,61.19,38.81,0,2019
"2270808",12325,268,779,13372,92.17,2,5.83,2019
"2270816",15359,606,1680,17645,87.04,3.43,9.52,2019
"2270774",2948,102,417,3467,85.03,2.94,12.03,2019
"2270756",72,0,86,158,45.57,0,54.43,2019
"2270762",356,0,44,400,89,0,11,2019
"2270773",63,0,29,92,68.48,0,31.52,2019
"2270775",2627,385,602,3614,72.69,10.65,16.66,2019
"2270776",896,14,354,1264,70.89,1.11,28.01,2019
"2270788",1037,19,307,1363,76.08,1.39,22.52,2019
"2270791",7932,157,1154,9243,85.82,1.7,12.49,2019
"2270805",5739,666,2680,9085,63.17,7.33,29.5,2019
"2270817",11871,148,473,12492,95.03,1.18,3.79,2019
"2270836",0,0,0,0,NA,NA,NA,2019
"2270465",114,11,60,185,61.62,5.95,32.43,2019
"2270471",7201,194,721,8116,88.73,2.39,8.88,2019
"2270501",7669,409,3377,11455,66.95,3.57,29.48,2019
"2270507",5482,151,779,6412,85.5,2.35,12.15,2019
"2270534",178,6,101,285,62.46,2.11,35.44,2019
"2270538",3874,80,1341,5295,73.16,1.51,25.33,2019
"2270549",869,35,353,1257,69.13,2.78,28.08,2019
"2270563",6209,219,825,7253,85.61,3.02,11.37,2019
"2270583",3377,52,786,4215,80.12,1.23,18.65,2019
"2270632",108,52,0,160,67.5,32.5,0,2019
"2270661",370,0,383,753,49.14,0,50.86,2019
"2270662",87,0,45,132,65.91,0,34.09,2019
"2270743",74,0,13,87,85.06,0,14.94,2019
"2270752",285,0,29,314,90.76,0,9.24,2019
"2270761",122,33,137,292,41.78,11.3,46.92,2019
"2270763",1208,23,269,1500,80.53,1.53,17.93,2019
"3059014",516,18,126,660,78.18,2.73,19.09,2019
"3059022",261,13,204,478,54.6,2.72,42.68,2019
"3059025",11,6,4,21,52.38,28.57,19.05,2019
"3059031",67,0,8,75,89.33,0,10.67,2019
"3059033",78,0,21,99,78.79,0,21.21,2019
"3059036",390,16,137,543,71.82,2.95,25.23,2019
"3059855",150,0,125,275,54.55,0,45.45,2019
"3059874",426,4,210,640,66.56,0.62,32.81,2019
"3059901",17808,419,2556,20783,85.69,2.02,12.3,2019
"3059911",3001,123,469,3593,83.52,3.42,13.05,2019
"3059913",205,8,57,270,75.93,2.96,21.11,2019
"3059914",89,11,26,126,70.63,8.73,20.63,2019
"3059925",360,19,100,479,75.16,3.97,20.88,2019
"3059926",139,0,58,197,70.56,0,29.44,2019
"3059931",111,4,21,136,81.62,2.94,15.44,2019
"1760185",9415,209,1047,10671,88.23,1.96,9.81,2019
"1760188",13605,316,901,14822,91.79,2.13,6.08,2019
"1760401",2555,29,456,3040,84.05,0.95,15,2019
"1760422",3394,96,191,3681,92.2,2.61,5.19,2019
"1760424",796,40,100,936,85.04,4.27,10.68,2019
"1760425",2595,56,307,2958,87.73,1.89,10.38,2019
"3059044",4076,117,838,5031,81.02,2.33,16.66,2019
"3059065",81,0,9,90,90,0,10,2019
"4657457",21,7,6,34,61.76,20.59,17.65,2019
"4657470",28,0,2,30,93.33,0,6.67,2019
"4657528",289,24,68,381,75.85,6.3,17.85,2019
"4657538",81,1,24,106,76.42,0.94,22.64,2019
"4657563",29,8,20,57,50.88,14.04,35.09,2019
"4657570",164,37,308,509,32.22,7.27,60.51,2019
"4657577",113,12,157,282,40.07,4.26,55.67,2019
"4657623",216,0,102,318,67.92,0,32.08,2019
"4657632",183,11,80,274,66.79,4.01,29.2,2019
"4657641",98,0,41,139,70.5,0,29.5,2019
"4657656",201,7,84,292,68.84,2.4,28.77,2019
"4657661",18,0,12,30,60,0,40,2019
"4657714",86,6,42,134,64.18,4.48,31.34,2019
"4657718",2473,47,301,2821,87.66,1.67,10.67,2019
"4657720",281,9,28,318,88.36,2.83,8.81,2019
"4657732",906,28,281,1215,74.57,2.3,23.13,2019
"4657745",675,16,259,950,71.05,1.68,27.26,2019
"4657758",41,17,0,58,70.69,29.31,0,2019
"4657760",402,40,108,550,73.09,7.27,19.64,2019
"4657779",167,0,0,167,100,0,0,2019
"4657027",33,0,1,34,97.06,0,2.94,2019
"4657219",169,15,73,257,65.76,5.84,28.4,2019
"4657233",43,0,23,66,65.15,0,34.85,2019
"4657235",274,15,61,350,78.29,4.29,17.43,2019
"4657238",135,25,55,215,62.79,11.63,25.58,2019
"4657247",96,0,6,102,94.12,0,5.88,2019
"4657251",46,2,9,57,80.7,3.51,15.79,2019
"4657346",43,0,11,54,79.63,0,20.37,2019
"4657279",396,45,95,536,73.88,8.4,17.72,2019
"4657311",417,5,55,477,87.42,1.05,11.53,2019
"4657317",155,7,88,250,62,2.8,35.2,2019
"4657324",115,2,28,145,79.31,1.38,19.31,2019
"4657355",388,71,128,587,66.1,12.1,21.81,2019
"4657374",131,7,24,162,80.86,4.32,14.81,2019
"4657375",199,36,76,311,63.99,11.58,24.44,2019
"4657381",177,3,45,225,78.67,1.33,20,2019
"4657426",9,0,0,9,100,0,0,2019
"4657432",85,4,57,146,58.22,2.74,39.04,2019
"4657437",470,36,236,742,63.34,4.85,31.81,2019
"4657449",64,0,36,100,64,0,36,2019
"4657467",65,5,22,92,70.65,5.43,23.91,2019
"4657501",5914,147,1157,7218,81.93,2.04,16.03,2019
"4657532",1041,45,212,1298,80.2,3.47,16.33,2019
"4657543",175,10,130,315,55.56,3.17,41.27,2019
"4657559",231,9,60,300,77,3,20,2019
"4657568",230,11,50,291,79.04,3.78,17.18,2019
"4657580",1359,60,349,1768,76.87,3.39,19.74,2019
"4657640",95,2,0,97,97.94,2.06,0,2019
"4657648",107,9,42,158,67.72,5.7,26.58,2019
"4657702",13166,265,1334,14765,89.17,1.79,9.03,2019
"4657750",34,0,18,52,65.38,0,34.62,2019
"1761416",62,4,45,111,55.86,3.6,40.54,2019
"1761421",401,32,137,570,70.35,5.61,24.04,2019
"1761430",249,19,46,314,79.3,6.05,14.65,2019
"1761747",471,24,81,576,81.77,4.17,14.06,2019
"1761743",60,0,16,76,78.95,0,21.05,2019
"1761744",595,16,98,709,83.92,2.26,13.82,2019
"1760433",4361,111,992,5464,79.81,2.03,18.16,2019
"1760451",11312,165,444,11921,94.89,1.38,3.72,2019
"1760456",1336,119,242,1697,78.73,7.01,14.26,2019
"1760473",6164,139,859,7162,86.07,1.94,11.99,2019
"1760476",889,21,173,1083,82.09,1.94,15.97,2019
"1760477",13203,340,1468,15011,87.96,2.27,9.78,2019
"1760517",11720,193,933,12846,91.23,1.5,7.26,2019
"1760518",1158,26,259,1443,80.25,1.8,17.95,2019
"1760523",3546,195,633,4374,81.07,4.46,14.47,2019
"1760531",629,11,88,728,86.4,1.51,12.09,2019
"1760542",6287,184,406,6877,91.42,2.68,5.9,2019
"1760545",4029,27,504,4560,88.36,0.59,11.05,2019
"1760551",1283,14,183,1480,86.69,0.95,12.36,2019
"1760564",13148,86,213,13447,97.78,0.64,1.58,2019
"1760604",460,41,0,501,91.82,8.18,0,2019
"1760612",9381,718,3137,13236,70.87,5.42,23.7,2019
"1760613",23972,1028,2072,27072,88.55,3.8,7.65,2019
"1760617",22560,525,5707,28792,78.36,1.82,19.82,2019
"1760618",29732,1043,4583,35358,84.09,2.95,12.96,2019
"1760624",7518,764,3666,11948,62.92,6.39,30.68,2019
"1760626",18147,953,3895,22995,78.92,4.14,16.94,2019
"1760630",17754,434,2684,20872,85.06,2.08,12.86,2019
"1760632",18859,1129,5025,25013,75.4,4.51,20.09,2019
"1760645",13070,728,2206,16004,81.67,4.55,13.78,2019
"1760653",11148,513,3326,14987,74.38,3.42,22.19,2019
"1760506",15464,382,2565,18411,83.99,2.07,13.93,2019
"1760511",512,20,102,634,80.76,3.15,16.09,2019
"1760519",17,0,0,17,100,0,0,2019
"1760520",982,22,67,1071,91.69,2.05,6.26,2019
"1760521",5792,87,203,6082,95.23,1.43,3.34,2019
"1760525",10231,257,1158,11646,87.85,2.21,9.94,2019
"1760536",44,1,4,49,89.8,2.04,8.16,2019
"1760541",997,24,140,1161,85.87,2.07,12.06,2019
"1760543",12459,238,597,13294,93.72,1.79,4.49,2019
"1760550",548,16,94,658,83.28,2.43,14.29,2019
"1760559",8723,241,1373,10337,84.39,2.33,13.28,2019
"1760654",11690,534,367,12591,92.84,4.24,2.91,2019
"1760657",34216,1054,1818,37088,92.26,2.84,4.9,2019
"1760659",11178,653,1654,13485,82.89,4.84,12.27,2019
"1760707",12091,454,2809,15354,78.75,2.96,18.29,2019
"1760714",8793,218,1939,10950,80.3,1.99,17.71,2019
"1760804",17125,1757,3480,22362,76.58,7.86,15.56,2019
"1760946",146,3,18,167,87.43,1.8,10.78,2019
"1760952",211,0,46,257,82.1,0,17.9,2019
"1760955",467,18,116,601,77.7,3,19.3,2019
"1760962",185,8,36,229,80.79,3.49,15.72,2019
"1760929",272,2,31,305,89.18,0.66,10.16,2019
"1760056",17754,356,2654,20764,85.5,1.71,12.78,2019
"1760193",13886,171,1104,15161,91.59,1.13,7.28,2019
"1760464",3132,233,474,3839,81.58,6.07,12.35,2019
"1760030",12603,141,1431,14175,88.91,0.99,10.1,2019
"1760107",11955,151,1074,13180,90.71,1.15,8.15,2019
"1760143",4096,110,253,4459,91.86,2.47,5.67,2019
"3168928",99,2,29,130,76.15,1.54,22.31,2019
"3168933",366,20,50,436,83.94,4.59,11.47,2019
"3168944",335,19,89,443,75.62,4.29,20.09,2019
"3168949",2174,167,448,2789,77.95,5.99,16.06,2019
"3168410",2879,78,636,3593,80.13,2.17,17.7,2019
"3168413",213,2,20,235,90.64,0.85,8.51,2019
"1761749",202,9,34,245,82.45,3.67,13.88,2019
"1761752",1382,25,284,1691,81.73,1.48,16.79,2019
"1761761",15282,2467,1734,19483,78.44,12.66,8.9,2019
"1761764",4157,233,775,5165,80.48,4.51,15,2019
"1761770",353,3,85,441,80.05,0.68,19.27,2019
"1761802",7257,594,1124,8975,80.86,6.62,12.52,2019
"1761811",194,3,59,256,75.78,1.17,23.05,2019
"1761841",426,29,72,527,80.83,5.5,13.66,2019
"1761842",938,58,199,1195,78.49,4.85,16.65,2019
"1761847",424,9,85,518,81.85,1.74,16.41,2019
"1761876",185,31,44,260,71.15,11.92,16.92,2019
"1761911",955,72,649,1676,56.98,4.3,38.72,2019
"1761920",7129,784,1196,9109,78.26,8.61,13.13,2019
"1761937",677,23,162,862,78.54,2.67,18.79,2019
"1761953",1967,78,569,2614,75.25,2.98,21.77,2019
"1761606",1643,230,425,2298,71.5,10.01,18.49,2019
"1761615",8230,212,1322,9764,84.29,2.17,13.54,2019
"1762338",375,0,113,488,76.84,0,23.16,2019
"1762341",1108,48,231,1387,79.88,3.46,16.65,2019
"1762345",118,1,52,171,69.01,0.58,30.41,2019
"1762351",511,23,135,669,76.38,3.44,20.18,2019
"1762352",76,6,35,117,64.96,5.13,29.91,2019
"1762353",1110,23,295,1428,77.73,1.61,20.66,2019
"1762358",204,0,27,231,88.31,0,11.69,2019
"1762990",187,0,131,318,58.81,0,41.19,2019
"1762976",76,0,68,144,52.78,0,47.22,2019
"1762977",229,6,50,285,80.35,2.11,17.54,2019
"1762982",255,3,69,327,77.98,0.92,21.1,2019
"1762992",138,1,133,272,50.74,0.37,48.9,2019
"1762995",1008,38,543,1589,63.44,2.39,34.17,2019
"1762441",2110,278,457,2845,74.17,9.77,16.06,2019
"1762447",1042,51,204,1297,80.34,3.93,15.73,2019
"1762462",242,0,93,335,72.24,0,27.76,2019
"1762466",815,1,276,1092,74.63,0.09,25.27,2019
"1762475",123,0,43,166,74.1,0,25.9,2019
"1762513",496,12,133,641,77.38,1.87,20.75,2019
"1762514",83,0,28,111,74.77,0,25.23,2019
"1762517",59,0,16,75,78.67,0,21.33,2019
"1762518",68,10,14,92,73.91,10.87,15.22,2019
"1762535",982,37,116,1135,86.52,3.26,10.22,2019
"1762544",534,14,107,655,81.53,2.14,16.34,2019
"1762547",330,11,48,389,84.83,2.83,12.34,2019
"1762550",912,33,159,1104,82.61,2.99,14.4,2019
"1762001",530,16,108,654,81.04,2.45,16.51,2019
"1762006",112,8,35,155,72.26,5.16,22.58,2019
"1762013",140,7,67,214,65.42,3.27,31.31,2019
"1762019",112,1,29,142,78.87,0.7,20.42,2019
"1762023",37,2,2,41,90.24,4.88,4.88,2019
"1762024",3384,158,745,4287,78.94,3.69,17.38,2019
"1762033",1630,29,339,1998,81.58,1.45,16.97,2019
"1762037",619,5,200,824,75.12,0.61,24.27,2019
"1762044",593,32,207,832,71.27,3.85,24.88,2019
"1762339",262,11,63,336,77.98,3.27,18.75,2019
"2067012",4,10,0,14,28.57,71.43,0,2019
"2067013",1061,23,149,1233,86.05,1.87,12.08,2019
"2067023",68,14,32,114,59.65,12.28,28.07,2019
"2067035",299,25,69,393,76.08,6.36,17.56,2019
"2067042",5100,188,1518,6806,74.93,2.76,22.3,2019
"2067101",1482,0,248,1730,85.66,0,14.34,2019
"3168415",225,0,40,265,84.91,0,15.09,2019
"3168419",74,0,7,81,91.36,0,8.64,2019
"3168443",312,13,50,375,83.2,3.47,13.33,2019
"3168450",684,32,250,966,70.81,3.31,25.88,2019
"3168453",105,0,70,175,60,0,40,2019
"3168455",181,0,14,195,92.82,0,7.18,2019
"3168456",472,7,33,512,92.19,1.37,6.45,2019
"3168002",796,26,117,939,84.77,2.77,12.46,2019
"3168014",92,0,25,117,78.63,0,21.37,2019
"3168020",180,18,92,290,62.07,6.21,31.72,2019
"3168022",8566,165,416,9147,93.65,1.8,4.55,2019
"3168044",152,0,74,226,67.26,0,32.74,2019
"3168048",4255,132,596,4983,85.39,2.65,11.96,2019
"3168517",207,0,0,207,100,0,0,2019
"3168629",397,25,124,546,72.71,4.58,22.71,2019
"3168638",571,13,164,748,76.34,1.74,21.93,2019
"3168643",367,1,84,452,81.19,0.22,18.58,2019
"3168666",488,8,82,578,84.43,1.38,14.19,2019
"3168736",186,12,48,246,75.61,4.88,19.51,2019
"3168739",1008,23,185,1216,82.89,1.89,15.21,2019
"3168740",332,10,58,400,83,2.5,14.5,2019
"3168741",219,4,66,289,75.78,1.38,22.84,2019
"3168753",46,0,13,59,77.97,0,22.03,2019
"3168777",232,12,53,297,78.11,4.04,17.85,2019
"3168779",794,31,194,1019,77.92,3.04,19.04,2019
"3168788",1391,86,433,1910,72.83,4.5,22.67,2019
"3168791",477,42,213,732,65.16,5.74,29.1,2019
"3168822",1663,73,438,2174,76.49,3.36,20.15,2019
"3168826",1294,59,342,1695,76.34,3.48,20.18,2019
"3168831",231,11,109,351,65.81,3.13,31.05,2019
"3168832",615,21,154,790,77.85,2.66,19.49,2019
"3168842",176,14,55,245,71.84,5.71,22.45,2019
"3168847",5871,271,855,6997,83.91,3.87,12.22,2019
"3168858",78,1,32,111,70.27,0.9,28.83,2019
"3168865",346,9,30,385,89.87,2.34,7.79,2019
"3168870",216,8,4,228,94.74,3.51,1.75,2019
"3168875",206,6,59,271,76.01,2.21,21.77,2019
"3168878",136,2,20,158,86.08,1.27,12.66,2019
"3168901",8354,274,2020,10648,78.46,2.57,18.97,2019
"3168923",30,0,5,35,85.71,0,14.29,2019
"3168938",185,4,43,232,79.74,1.72,18.53,2019
"3168939",379,10,144,533,71.11,1.88,27.02,2019
"3168961",185,11,104,300,61.67,3.67,34.67,2019
"3168973",150,2,20,172,87.21,1.16,11.63,2019
"3168038",415,35,113,563,73.71,6.22,20.07,2019
"3168047",563,22,132,717,78.52,3.07,18.41,2019
"3168059",1169,20,142,1331,87.83,1.5,10.67,2019
"3168061",729,26,246,1001,72.83,2.6,24.58,2019
"3168123",10792,209,466,11467,94.11,1.82,4.06,2019
"3168062",80,15,23,118,67.8,12.71,19.49,2019
"3168102",3712,272,432,4416,84.06,6.16,9.78,2019
"3168122",3893,23,296,4212,92.43,0.55,7.03,2019
"3168138",4544,8,298,4850,93.69,0.16,6.14,2019
"0571944",222,0,95,317,70.03,0,29.97,2019
"0571949",518,18,190,726,71.35,2.48,26.17,2019
"0571956",363,2,265,630,57.62,0.32,42.06,2019
"0571970",167,48,118,333,50.15,14.41,35.44,2019
"0571958",636,31,286,953,66.74,3.25,30.01,2019
"0571959",206,0,85,291,70.79,0,29.21,2019
"4657032",2493,88,116,2697,92.44,3.26,4.3,2019
"4657053",583,38,137,758,76.91,5.01,18.07,2019
"4657057",95,0,4,99,95.96,0,4.04,2019
"4657061",27,0,9,36,75,0,25,2019
"4657064",1966,11,145,2122,92.65,0.52,6.83,2019
"4657103",12186,353,1802,14341,84.97,2.46,12.57,2019
"4657106",17059,658,1520,19237,88.68,3.42,7.9,2019
"4657220",236,7,31,274,86.13,2.55,11.31,2019
"4657227",104,0,27,131,79.39,0,20.61,2019
"4657232",92,0,28,120,76.67,0,23.33,2019
"4657243",217,7,35,259,83.78,2.7,13.51,2019
"4657263",119,18,61,198,60.1,9.09,30.81,2019
"4657266",172,18,45,235,73.19,7.66,19.15,2019
"4657271",51,1,19,71,71.83,1.41,26.76,2019
"4657272",67,5,10,82,81.71,6.1,12.2,2019
"4657314",258,4,59,321,80.37,1.25,18.38,2019
"4657020",489,10,7,506,96.64,1.98,1.38,2019
"4657026",361,15,136,512,70.51,2.93,26.56,2019
"4657028",1088,45,179,1312,82.93,3.43,13.64,2019
"4657029",654,39,229,922,70.93,4.23,24.84,2019
"4657031",263,27,63,353,74.5,7.65,17.85,2019
"4657047",97,6,18,121,80.17,4.96,14.88,2019
"4657066",446,24,243,713,62.55,3.37,34.08,2019
"4657067",92,11,34,137,67.15,8.03,24.82,2019
"4657068",496,13,52,561,88.41,2.32,9.27,2019
"4657075",358,23,72,453,79.03,5.08,15.89,2019
"4657078",6397,304,1287,7988,80.08,3.81,16.11,2019
"4657201",9039,367,1670,11076,81.61,3.31,15.08,2019
"4657273",320,30,166,516,62.02,5.81,32.17,2019
"4657274",878,53,293,1224,71.73,4.33,23.94,2019
"4657313",339,21,159,519,65.32,4.05,30.64,2019
"4657321",140,2,21,163,85.89,1.23,12.88,2019
"4657330",135,0,61,196,68.88,0,31.12,2019
"4657331",149,7,11,167,89.22,4.19,6.59,2019
"4657334",275,7,69,351,78.35,1.99,19.66,2019
"4657353",264,10,78,352,75,2.84,22.16,2019
"4657356",349,26,204,579,60.28,4.49,35.23,2019
"4657363",303,14,67,384,78.91,3.65,17.45,2019
"4657364",0,0,0,0,NA,NA,NA,2019
"4657367",88,4,12,104,84.62,3.85,11.54,2019
"4657382",448,55,141,644,69.57,8.54,21.89,2019
"4657383",255,9,77,341,74.78,2.64,22.58,2019
"4657446",141,4,47,192,73.44,2.08,24.48,2019
"4657452",88,10,17,115,76.52,8.7,14.78,2019
"4657651",60,0,0,60,100,0,0,2019
"4657631",140,13,37,190,73.68,6.84,19.47,2019
"4657633",116,2,25,143,81.12,1.4,17.48,2019
"4657650",10,0,0,10,100,0,0,2019
"4657701",14461,791,3166,18418,78.52,4.29,17.19,2019
"4657716",56,2,59,117,47.86,1.71,50.43,2019
"4657722",62,0,22,84,73.81,0,26.19,2019
"4657752",164,25,216,405,40.49,6.17,53.33,2019
"4657762",183,9,62,254,72.05,3.54,24.41,2019
"3858065",9,0,5,14,64.29,0,35.71,2019
"3858076",0,0,0,0,NA,NA,NA,2019
"3858105",0,0,0,0,NA,NA,NA,2019
"3858205",0,0,0,0,NA,NA,NA,2019
"3858339",10,0,0,10,100,0,0,2019
"3858402",0,0,0,0,NA,NA,NA,2019
"0571962",190,0,130,320,59.38,0,40.62,2019
"0571964",1076,18,319,1413,76.15,1.27,22.58,2019
"2271325",327,6,105,438,74.66,1.37,23.97,2019
"0571635",2792,190,1447,4429,63.04,4.29,32.67,2019
"0571644",149,61,113,323,46.13,18.89,34.98,2019
"0571661",52,0,85,137,37.96,0,62.04,2019
"0571722",19,0,9,28,67.86,0,32.14,2019
"0571639",1447,95,827,2369,61.08,4.01,34.91,2019
"0571647",561,62,243,866,64.78,7.16,28.06,2019
"0571670",276,33,315,624,44.23,5.29,50.48,2019
"0571671",2320,132,896,3348,69.3,3.94,26.76,2019
"0571752",283,13,87,383,73.89,3.39,22.72,2019
"0571764",430,24,270,724,59.39,3.31,37.29,2019
"0571827",218,0,122,340,64.12,0,35.88,2019
"0571838",270,16,136,422,63.98,3.79,32.23,2019
"0571853",95,0,27,122,77.87,0,22.13,2019
"0571943",1075,100,557,1732,62.07,5.77,32.16,2019
"2271003",245,27,178,450,54.44,6,39.56,2019
"2271021",27,21,340,388,6.96,5.41,87.63,2019
"2271027",435,89,112,636,68.4,13.99,17.61,2019
"2271033",1177,93,173,1443,81.57,6.44,11.99,2019
"0571602",4099,362,1604,6065,67.58,5.97,26.45,2019
"0571638",687,52,540,1279,53.71,4.07,42.22,2019
"0571834",227,15,162,404,56.19,3.71,40.1,2019
"0571836",833,47,377,1257,66.27,3.74,29.99,2019
"0571837",1355,68,622,2045,66.26,3.33,30.42,2019
"0571847",218,0,58,276,78.99,0,21.01,2019
"0571858",469,18,419,906,51.77,1.99,46.25,2019
"0571860",568,25,293,886,64.11,2.82,33.07,2019
"0571866",188,8,37,233,80.69,3.43,15.88,2019
"0571961",291,7,111,409,71.15,1.71,27.14,2019
"2271354",478,9,197,684,69.88,1.32,28.8,2019
"2271358",160,27,150,337,47.48,8.01,44.51,2019
"2271373",1513,125,690,2328,64.99,5.37,29.64,2019
"2271378",370,114,429,913,40.53,12.49,46.99,2019
"2271404",172,0,166,338,50.89,0,49.11,2019
"2271407",220,0,105,325,67.69,0,32.31,2019
"2271422",555,17,112,684,81.14,2.49,16.37,2019
"2271427",191,2,14,207,92.27,0.97,6.76,2019
"2271449",2000,140,1325,3465,57.72,4.04,38.24,2019
"2271454",506,6,286,798,63.41,0.75,35.84,2019
"2271455",28,0,28,56,50,0,50,2019
"0571921",886,23,361,1270,69.76,1.81,28.43,2019
"2271336",330,82,284,696,47.41,11.78,40.8,2019
"2271339",79,0,7,86,91.86,0,8.14,2019
"2271342",1899,54,600,2553,74.38,2.12,23.5,2019
"2271360",10420,253,2105,12778,81.55,1.98,16.47,2019
"2271366",330,37,306,673,49.03,5.5,45.47,2019
"2271367",250,0,170,420,59.52,0,40.48,2019
"2271403",1311,38,293,1642,79.84,2.31,17.84,2019
"2271414",6,0,59,65,9.23,0,90.77,2019
"2271419",487,42,272,801,60.8,5.24,33.96,2019
"2271424",334,0,42,376,88.83,0,11.17,2019
"3059936",95,7,30,132,71.97,5.3,22.73,2019
"3059937",5159,109,562,5830,88.49,1.87,9.64,2019
"3059923",3148,156,827,4131,76.2,3.78,20.02,2019
"3059933",23,0,0,23,100,0,0,2019
"3059434",136,13,29,178,76.4,7.3,16.29,2019
"3059410",203,0,70,273,74.36,0,25.64,2019
"3168376",459,5,164,628,73.09,0.8,26.11,2019
"3168401",251,9,18,278,90.29,3.24,6.47,2019
"3168430",589,32,51,672,87.65,4.76,7.59,2019
"3168433",64,6,29,99,64.65,6.06,29.29,2019
"3168457",157,0,34,191,82.2,0,17.8,2019
"3168942",105,2,43,150,70,1.33,28.67,2019
"3168922",451,30,100,581,77.62,5.16,17.21,2019
"3168934",57,5,7,69,82.61,7.25,10.14,2019
"3168980",148,0,10,158,93.67,0,6.33,2019
"3168634",135,0,91,226,59.73,0,40.27,2019
"3168642",526,28,198,752,69.95,3.72,26.33,2019
"3168653",261,0,21,282,92.55,0,7.45,2019
"3168667",28,2,2,32,87.5,6.25,6.25,2019
"3168722",176,9,57,242,72.73,3.72,23.55,2019
"3168725",153,18,79,250,61.2,7.2,31.6,2019
"3168745",567,8,53,628,90.29,1.27,8.44,2019
"3168748",743,42,245,1030,72.14,4.08,23.79,2019
"3168756",621,38,165,824,75.36,4.61,20.02,2019
"3168759",60,3,31,94,63.83,3.19,32.98,2019
"3168763",1581,53,412,2046,77.27,2.59,20.14,2019
"3168332",30,6,15,51,58.82,11.76,29.41,2019
"3168339",435,3,43,481,90.44,0.62,8.94,2019
"3168348",110,1,11,122,90.16,0.82,9.02,2019
"3168381",33,6,39,78,42.31,7.69,50,2019
"3168414",85,11,29,125,68,8.8,23.2,2019
"3168421",281,29,23,333,84.38,8.71,6.91,2019
"3168346",166,3,53,222,74.77,1.35,23.87,2019
"3168349",385,7,65,457,84.25,1.53,14.22,2019
"3168367",103,7,33,143,72.03,4.9,23.08,2019
"3168371",563,30,78,671,83.9,4.47,11.62,2019
"3168375",42,0,15,57,73.68,0,26.32,2019
"3168406",141,2,65,208,67.79,0.96,31.25,2019
"3168417",105,0,33,138,76.09,0,23.91,2019
"3168423",351,7,106,464,75.65,1.51,22.84,2019
"3168439",229,3,34,266,86.09,1.13,12.78,2019
"3168440",29,0,20,49,59.18,0,40.82,2019
"3168441",82,0,5,87,94.25,0,5.75,2019
"3168442",122,2,48,172,70.93,1.16,27.91,2019
"3168454",233,1,44,278,83.81,0.36,15.83,2019
"3168458",45,5,21,71,63.38,7.04,29.58,2019
"3168462",1452,34,114,1600,90.75,2.12,7.12,2019
"3168516",16368,427,876,17671,92.63,2.42,4.96,2019
"3168520",896,19,33,948,94.51,2,3.48,2019
"3168526",2344,39,64,2447,95.79,1.59,2.62,2019
"3168623",131,0,45,176,74.43,0,25.57,2019
"3168710",258,10,44,312,82.69,3.21,14.1,2019
"3168713",770,88,140,998,77.15,8.82,14.03,2019
"3168717",85,0,19,104,81.73,0,18.27,2019
"3168730",606,13,165,784,77.3,1.66,21.05,2019
"3168758",410,8,127,545,75.23,1.47,23.3,2019
"3168338",126,4,28,158,79.75,2.53,17.72,2019
"3168322",147,0,46,193,76.17,0,23.83,2019
"3168335",181,4,39,224,80.8,1.79,17.41,2019
"2270819",1332,13,249,1594,83.56,0.82,15.62,2019
"2270431",1420,41,557,2018,70.37,2.03,27.6,2019
"2270445",3492,110,421,4023,86.8,2.73,10.46,2019
"2270447",4685,16,325,5026,93.22,0.32,6.47,2019
"2270451",0,0,0,0,NA,NA,NA,2019
"2270453",184,9,47,240,76.67,3.75,19.58,2019
"3059420",45,3,19,67,67.16,4.48,28.36,2019
"3059430",153,7,17,177,86.44,3.95,9.6,2019
"3059436",602,19,143,764,78.8,2.49,18.72,2019
"3059440",64,0,7,71,90.14,0,9.86,2019
"3059460",92,0,6,98,93.88,0,6.12,2019
"3059467",30,0,16,46,65.22,0,34.78,2019
"3059468",193,15,37,245,78.78,6.12,15.1,2019
"3059479",262,8,73,343,76.38,2.33,21.28,2019
"3059482",168,5,63,236,71.19,2.12,26.69,2019
"3059523",688,18,254,960,71.67,1.88,26.46,2019
"3059526",525,81,196,802,65.46,10.1,24.44,2019
"3059528",113,0,19,132,85.61,0,14.39,2019
"3059529",72,8,7,87,82.76,9.2,8.05,2019
"3059531",101,4,4,109,92.66,3.67,3.67,2019
"3059532",59,0,17,76,77.63,0,22.37,2019
"3059545",25,8,10,43,58.14,18.6,23.26,2019
"3059547",24,0,3,27,88.89,0,11.11,2019
"3059644",1255,89,315,1659,75.65,5.36,18.99,2019
"3059728",101,8,21,130,77.69,6.15,16.15,2019
"3059735",74,0,25,99,74.75,0,25.25,2019
"3059741",1542,60,241,1843,83.67,3.26,13.08,2019
"3059746",61,5,13,79,77.22,6.33,16.46,2019
"3059748",55,0,38,93,59.14,0,40.86,2019
"3059755",66,16,13,95,69.47,16.84,13.68,2019
"3059804",2644,186,400,3230,81.86,5.76,12.38,2019
"3059826",200,3,32,235,85.11,1.28,13.62,2019
"3059844",241,5,49,295,81.69,1.69,16.61,2019
"3059845",339,15,258,612,55.39,2.45,42.16,2019
"3059864",1873,113,601,2587,72.4,4.37,23.23,2019
"3059870",3553,230,619,4402,80.71,5.22,14.06,2019
"3059223",173,0,27,200,86.5,0,13.5,2019
"3059081",7,0,2,9,77.78,0,22.22,2019
"3059201",1022,59,465,1546,66.11,3.82,30.08,2019
"3059242",27,0,8,35,77.14,0,22.86,2019
"3059257",35,0,0,35,100,0,0,2019
"3059919",218,0,54,272,80.15,0,19.85,2019
"3059922",742,42,208,992,74.8,4.23,20.97,2019
"3059851",38,0,17,55,69.09,0,30.91,2019
"3059858",396,33,130,559,70.84,5.9,23.26,2019
"3059867",23,0,12,35,65.71,0,34.29,2019
"3059912",5019,166,763,5948,84.38,2.79,12.83,2019
"3059927",119,3,21,143,83.22,2.1,14.69,2019
"3059929",82,0,16,98,83.67,0,16.33,2019
"3059934",206,0,19,225,91.56,0,8.44,2019
"3059935",1031,72,355,1458,70.71,4.94,24.35,2019
"3059404",8928,195,1703,10826,82.47,1.8,15.73,2019
"3059255",457,39,412,908,50.33,4.3,45.37,2019
"3059276",11,0,0,11,100,0,0,2019
"3059322",12,0,6,18,66.67,0,33.33,2019
"3059343",20,0,3,23,86.96,0,13.04,2019
"3059421",548,26,223,797,68.76,3.26,27.98,2019
"3059424",5,0,0,5,100,0,0,2019
"3059442",656,18,158,832,78.85,2.16,18.99,2019
"1762223",5226,431,1162,6819,76.64,6.32,17.04,2019
"1762225",1296,63,25,1384,93.64,4.55,1.81,2019
"1762239",1581,16,427,2024,78.11,0.79,21.1,2019
"1762243",1906,17,382,2305,82.69,0.74,16.57,2019
"1762216",852,14,119,985,86.5,1.42,12.08,2019
"1762220",6067,198,1199,7464,81.28,2.65,16.06,2019
"2067105",48,4,14,66,72.73,6.06,21.21,2019
"2067106",109,15,13,137,79.56,10.95,9.49,2019
"2067215",1964,20,81,2065,95.11,0.97,3.92,2019
"2067340",123,0,71,194,63.4,0,36.6,2019
"2067347",152,0,22,174,87.36,0,12.64,2019
"2067351",81,2,65,148,54.73,1.35,43.92,2019
"2067732",158,16,18,192,82.29,8.33,9.38,2019
"2067734",101,0,16,117,86.32,0,13.68,2019
"2067735",1977,19,249,2245,88.06,0.85,11.09,2019
"2067749",835,25,193,1053,79.3,2.37,18.33,2019
"2067663",850,22,188,1060,80.19,2.08,17.74,2019
"2067737",198,0,20,218,90.83,0,9.17,2019
"2067209",4491,69,572,5132,87.51,1.34,11.15,2019
"2067212",15782,488,2324,18594,84.88,2.62,12.5,2019
"2067220",4583,311,514,5408,84.74,5.75,9.5,2019
"2067226",7345,218,359,7922,92.72,2.75,4.53,2019
"2067230",3820,89,130,4039,94.58,2.2,3.22,2019
"2067330",453,0,107,560,80.89,0,19.11,2019
"2067346",109,7,38,154,70.78,4.55,24.68,2019
"2067353",167,7,78,252,66.27,2.78,30.95,2019
"2067360",79,0,96,175,45.14,0,54.86,2019
"2067420",1451,58,339,1848,78.52,3.14,18.34,2019
"2067437",397,18,72,487,81.52,3.7,14.78,2019
"2067439",925,25,195,1145,80.79,2.18,17.03,2019
"2067444",166,13,96,275,60.36,4.73,34.91,2019
"2067447",120,2,51,173,69.36,1.16,29.48,2019
"2067482",40,0,0,40,100,0,0,2019
"2067545",45,0,28,73,61.64,0,38.36,2019
"2067546",751,19,153,923,81.37,2.06,16.58,2019
"2067557",159,0,50,209,76.08,0,23.92,2019
"2067563",112,2,24,138,81.16,1.45,17.39,2019
"2067564",65,0,22,87,74.71,0,25.29,2019
"2067565",159,12,40,211,75.36,5.69,18.96,2019
"2067574",59,1,13,73,80.82,1.37,17.81,2019
"2067626",74,1,17,92,80.43,1.09,18.48,2019
"2067846",9194,272,2046,11512,79.86,2.36,17.77,2019
"2067523",141,5,22,168,83.93,2.98,13.1,2019
"2067543",626,55,122,803,77.96,6.85,15.19,2019
"2067556",85,9,24,118,72.03,7.63,20.34,2019
"2067567",162,4,77,243,66.67,1.65,31.69,2019
"2067576",633,16,172,821,77.1,1.95,20.95,2019
"2067601",7904,356,1421,9681,81.64,3.68,14.68,2019
"2067635",30,0,19,49,61.22,0,38.78,2019
"2067649",97,2,20,119,81.51,1.68,16.81,2019
"3168105",7976,208,1445,9629,82.83,2.16,15.01,2019
"3168106",8268,137,1107,9512,86.92,1.44,11.64,2019
"3168110",2127,171,937,3235,65.75,5.29,28.96,2019
"3168111",5536,287,2312,8135,68.05,3.53,28.42,2019
"3168114",6914,130,1135,8179,84.53,1.59,13.88,2019
"3168117",2543,79,431,3053,83.3,2.59,14.12,2019
"3168134",10280,379,2011,12670,81.14,2.99,15.87,2019
"3168135",9421,128,270,9819,95.95,1.3,2.75,2019
"3168154",8868,285,678,9831,90.2,2.9,6.9,2019
"2270782",21,9,22,52,40.38,17.31,42.31,2019
"2270785",6346,640,973,7959,79.73,8.04,12.23,2019
"2270003",12924,271,2746,15941,81.07,1.7,17.23,2019
"2270006",4925,90,1004,6019,81.82,1.5,16.68,2019
"2270031",419,4,61,484,86.57,0.83,12.6,2019
"2270043",5965,193,1386,7544,79.07,2.56,18.37,2019
"1762230",2197,78,416,2691,81.64,2.9,15.46,2019
"1762237",733,29,263,1025,71.51,2.83,25.66,2019
"1762255",336,8,54,398,84.42,2.01,13.57,2019
"1762258",2799,171,400,3370,83.06,5.07,11.87,2019
"1762292",275,3,66,344,79.94,0.87,19.19,2019
"1762320",659,26,159,844,78.08,3.08,18.84,2019
"1762334",56,6,9,71,78.87,8.45,12.68,2019
"1762257",840,12,297,1149,73.11,1.04,25.85,2019
"1762261",26,0,11,37,70.27,0,29.73,2019
"1762269",10832,269,766,11867,91.28,2.27,6.45,2019
"1762272",541,2,129,672,80.51,0.3,19.2,2019
"1762273",66,0,5,71,92.96,0,7.04,2019
"1762275",1137,12,301,1450,78.41,0.83,20.76,2019
"1762277",389,16,123,528,73.67,3.03,23.3,2019
"1762324",338,9,135,482,70.12,1.87,28.01,2019
"1762326",717,18,287,1022,70.16,1.76,28.08,2019
"1760491",6950,224,510,7684,90.45,2.92,6.64,2019
"1760502",7522,59,184,7765,96.87,0.76,2.37,2019
"1760503",4918,169,144,5231,94.02,3.23,2.75,2019
"1760527",10697,119,674,11490,93.1,1.04,5.87,2019
"1760585",6877,66,181,7124,96.53,0.93,2.54,2019
"1760586",12855,241,480,13576,94.69,1.78,3.54,2019
"1760642",8464,336,691,9491,89.18,3.54,7.28,2019
"1760958",301,24,344,669,44.99,3.59,51.42,2019
"1760656",9614,323,2142,12079,79.59,2.67,17.73,2019
"1760920",64,3,2,69,92.75,4.35,2.9,2019
"1760096",2319,49,168,2536,91.44,1.93,6.62,2019
"1760141",101,0,0,101,100,0,0,2019
"1760416",3124,99,369,3592,86.97,2.76,10.27,2019
"1760546",5020,97,731,5848,85.84,1.66,12.5,2019
"1760628",16642,917,5305,22864,72.79,4.01,23.2,2019
"1760480",1834,61,175,2070,88.6,2.95,8.45,2019
"1760554",4015,228,171,4414,90.96,5.17,3.87,2019
"1760641",19674,845,4038,24557,80.12,3.44,16.44,2019
"1760942",1906,118,441,2465,77.32,4.79,17.89,2019
"1760450",7274,155,1220,8649,84.1,1.79,14.11,2019
"1761378",112,22,16,150,74.67,14.67,10.67,2019
"1761410",1134,89,319,1542,73.54,5.77,20.69,2019
"1761420",366,25,84,475,77.05,5.26,17.68,2019
"1761432",223,6,38,267,83.52,2.25,14.23,2019
"1761440",244,11,50,305,80,3.61,16.39,2019
"1761441",264,10,130,404,65.35,2.48,32.18,2019
"1761376",664,63,109,836,79.43,7.54,13.04,2019
"1761340",88,2,33,123,71.54,1.63,26.83,2019
"1761358",105,5,29,139,75.54,3.6,20.86,2019
"1761372",50,5,7,62,80.65,8.06,11.29,2019
"1761379",389,23,87,499,77.96,4.61,17.43,2019
"1761353",433,8,81,522,82.95,1.53,15.52,2019
"1761362",1871,72,439,2382,78.55,3.02,18.43,2019
"1761374",13,2,28,43,30.23,4.65,65.12,2019
"1761411",170,0,48,218,77.98,0,22.02,2019
"1761414",327,12,59,398,82.16,3.02,14.82,2019
"1761415",681,0,80,761,89.49,0,10.51,2019
"3168152",1992,94,363,2449,81.34,3.84,14.82,2019
"3168313",253,2,38,293,86.35,0.68,12.97,2019
"3168321",113,1,16,130,86.92,0.77,12.31,2019
"3168323",110,4,22,136,80.88,2.94,16.18,2019
"3168325",68,0,7,75,90.67,0,9.33,2019
"3168329",206,8,59,273,75.46,2.93,21.61,2019
"3858405",0,0,0,0,NA,NA,NA,2019
"3858452",7,12,0,19,36.84,63.16,0,2019
"3858503",12071,727,1156,13954,86.51,5.21,8.28,2019
"3858702",0,0,0,0,NA,NA,NA,2019
"3858705",0,0,0,0,NA,NA,NA,2019
"3858707",0,0,0,0,NA,NA,NA,2019
"3858006",156,4,26,186,83.87,2.15,13.98,2019
"3858001",12,0,2,14,85.71,0,14.29,2019
"3858008",89,3,6,98,90.82,3.06,6.12,2019
"3858009",14,0,0,14,100,0,0,2019
"3858012",969,51,90,1110,87.3,4.59,8.11,2019
"3858045",687,59,104,850,80.82,6.94,12.24,2019
"3858049",108,4,29,141,76.6,2.84,20.57,2019
"3858054",1025,28,264,1317,77.83,2.13,20.05,2019
"3858071",178,10,22,210,84.76,4.76,10.48,2019
"3858201",15486,1051,2175,18712,82.76,5.62,11.62,2019
"3858520",54,7,11,72,75,9.72,15.28,2019
"3858483",101,4,33,138,73.19,2.9,23.91,2019
"3858484",19,0,0,19,100,0,0,2019
"3858497",66,8,10,84,78.57,9.52,11.9,2019
"3858524",29,0,10,39,74.36,0,25.64,2019
"3858540",888,169,244,1301,68.26,12.99,18.75,2019
"3858545",1351,48,150,1549,87.22,3.1,9.68,2019
"3858549",79,7,18,104,75.96,6.73,17.31,2019
"3858562",115,8,48,171,67.25,4.68,28.07,2019
"3858601",8891,521,1476,10888,81.66,4.79,13.56,2019
"3858627",50,0,35,85,58.82,0,41.18,2019
"3858630",246,37,13,296,83.11,12.5,4.39,2019
"3858632",61,3,21,85,71.76,3.53,24.71,2019
"3858641",17,12,43,72,23.61,16.67,59.72,2019
"3858643",49,3,25,77,63.64,3.9,32.47,2019
"3858645",75,27,9,111,67.57,24.32,8.11,2019
"3858647",374,0,110,484,77.27,0,22.73,2019
"3858649",97,5,35,137,70.8,3.65,25.55,2019
"3858701",11640,436,1742,13818,84.24,3.16,12.61,2019
"3858703",8822,243,672,9737,90.6,2.5,6.9,2019
"3858765",93,23,42,158,58.86,14.56,26.58,2019
"3858775",45,5,13,63,71.43,7.94,20.63,2019
"3858789",113,5,21,139,81.29,3.6,15.11,2019
"3858792",82,10,35,127,64.57,7.87,27.56,2019
"3858793",180,4,48,232,77.59,1.72,20.69,2019
"3858794",62,0,6,68,91.18,0,8.82,2019
"3858847",110,0,26,136,80.88,0,19.12,2019
"3858430",41,14,6,61,67.21,22.95,9.84,2019
"3858472",178,3,14,195,91.28,1.54,7.18,2019
"3858523",1285,49,240,1574,81.64,3.11,15.25,2019
"3858301",3206,166,915,4287,74.78,3.87,21.34,2019
"1760803",6672,450,1604,8726,76.46,5.16,18.38,2019
"1760954",1569,87,384,2040,76.91,4.26,18.82,2019
"1760963",506,14,122,642,78.82,2.18,19,2019
"1760187",8930,334,619,9883,90.36,3.38,6.26,2019
"1760164",5229,212,1283,6724,77.77,3.15,19.08,2019
"1760173",5320,119,233,5672,93.79,2.1,4.11,2019
"3168164",10779,223,886,11888,90.67,1.88,7.45,2019
"3168315",49,0,7,56,87.5,0,12.5,2019
"3168316",228,0,20,248,91.94,0,8.06,2019
"3168319",183,7,25,215,85.12,3.26,11.63,2019
"3168324",42,0,7,49,85.71,0,14.29,2019
"3168352",1648,61,548,2257,73.02,2.7,24.28,2019
"3168342",200,5,47,252,79.37,1.98,18.65,2019
"3168701",10111,561,2022,12694,79.65,4.42,15.93,2019
"3168719",32,0,20,52,61.54,0,38.46,2019
"3168724",40,0,19,59,67.8,0,32.2,2019
"3168073",710,8,61,779,91.14,1.03,7.83,2019
"3168113",217,17,4,238,91.18,7.14,1.68,2019
"3168128",7053,126,574,7753,90.97,1.63,7.4,2019
"3168133",3533,81,149,3763,93.89,2.15,3.96,2019
"3168147",3292,198,425,3915,84.09,5.06,10.86,2019
"3168314",143,4,35,182,78.57,2.2,19.23,2019
"3168317",622,6,78,706,88.1,0.85,11.05,2019
"3168746",142,6,61,209,67.94,2.87,29.19,2019
"3168726",156,5,50,211,73.93,2.37,23.7,2019
"3168711",77,0,18,95,81.05,0,18.95,2019
"3168723",162,14,45,221,73.3,6.33,20.36,2019
"3168728",86,0,26,112,76.79,0,23.21,2019
"3168732",69,0,35,104,66.35,0,33.65,2019
"3168760",397,19,107,523,75.91,3.63,20.46,2019
"3168766",135,0,47,182,74.18,0,25.82,2019
"3168767",1162,30,218,1410,82.41,2.13,15.46,2019
"3168771",486,21,119,626,77.64,3.35,19.01,2019
"3168792",114,3,30,147,77.55,2.04,20.41,2019
"3168841",165,6,32,203,81.28,2.96,15.76,2019
"3168855",126,0,55,181,69.61,0,30.39,2019
"3168856",245,1,64,310,79.03,0.32,20.65,2019
"3168864",365,11,85,461,79.18,2.39,18.44,2019
"3168879",142,7,51,200,71,3.5,25.5,2019
"3168929",56,0,13,69,81.16,0,18.84,2019
"3168932",129,6,55,190,67.89,3.16,28.95,2019
"3168654",182,2,39,223,81.61,0.9,17.49,2019
"3168018",170,5,16,191,89.01,2.62,8.38,2019
"3168031",557,21,121,699,79.69,3,17.31,2019
"3168046",9318,222,585,10125,92.03,2.19,5.78,2019
"3168058",112,1,10,123,91.06,0.81,8.13,2019
"3168070",279,11,29,319,87.46,3.45,9.09,2019
"2067445",176,14,62,252,69.84,5.56,24.6,2019
"2067446",194,0,35,229,84.72,0,15.28,2019
"2067451",357,35,89,481,74.22,7.28,18.5,2019
"2067466",261,4,89,354,73.73,1.13,25.14,2019
"2067468",72,2,28,102,70.59,1.96,27.45,2019
"2067483",120,0,55,175,68.57,0,31.43,2019
"2067516",122,5,31,158,77.22,3.16,19.62,2019
"2067526",764,28,281,1073,71.2,2.61,26.19,2019
"2067553",62,0,13,75,82.67,0,17.33,2019
"2067001",391,9,66,466,83.91,1.93,14.16,2019
"2067010",4430,112,773,5315,83.35,2.11,14.54,2019
"2067020",479,22,72,573,83.6,3.84,12.57,2019
"2067028",96,0,33,129,74.42,0,25.58,2019
"2067030",748,10,79,837,89.37,1.19,9.44,2019
"2067036",23,0,3,26,88.46,0,11.54,2019
"2067050",584,14,89,687,85.01,2.04,12.95,2019
"2067051",126,2,65,193,65.28,1.04,33.68,2019
"2067054",394,11,124,529,74.48,2.08,23.44,2019
"2271429",789,72,379,1240,63.63,5.81,30.56,2019
"2271441",198,12,17,227,87.22,5.29,7.49,2019
"2271446",5676,447,1978,8101,70.07,5.52,24.42,2019
"2271447",275,26,238,539,51.02,4.82,44.16,2019
"2271452",23,0,38,61,37.7,0,62.3,2019
"2271461",665,48,189,902,73.73,5.32,20.95,2019
"2270506",14657,379,2089,17125,85.59,2.21,12.2,2019
"2270515",902,27,394,1323,68.18,2.04,29.78,2019
"2270611",5994,202,1029,7225,82.96,2.8,14.24,2019
"2270655",578,21,289,888,65.09,2.36,32.55,2019
"2270721",177,91,30,298,59.4,30.54,10.07,2019
"2270722",1447,200,716,2363,61.24,8.46,30.3,2019
"2270723",268,13,133,414,64.73,3.14,32.13,2019
"2270729",224,0,12,236,94.92,0,5.08,2019
"2270739",4324,8,353,4685,92.29,0.17,7.53,2019
"2270754",3422,399,631,4452,76.86,8.96,14.17,2019
"2270772",235,26,58,319,73.67,8.15,18.18,2019
"2270052",938,0,323,1261,74.39,0,25.61,2019
"2270091",79,0,3,82,96.34,0,3.66,2019
"2270113",1863,186,1486,3535,52.7,5.26,42.04,2019
"2270346",2796,226,1148,4170,67.05,5.42,27.53,2019
"2270355",319,11,97,427,74.71,2.58,22.72,2019
"2270002",6937,153,1418,8508,81.54,1.8,16.67,2019
"2270030",1132,40,140,1312,86.28,3.05,10.67,2019
"2270036",396,11,76,483,81.99,2.28,15.73,2019
"2270038",45,0,23,68,66.18,0,33.82,2019
"2270037",5403,28,639,6070,89.01,0.46,10.53,2019
"2270039",580,114,286,980,59.18,11.63,29.18,2019
"2270067",687,3,175,865,79.42,0.35,20.23,2019
"2270071",952,0,386,1338,71.15,0,28.85,2019
"2270072",15523,475,3773,19771,78.51,2.4,19.08,2019
"2270075",1416,62,312,1790,79.11,3.46,17.43,2019
"2270079",910,15,276,1201,75.77,1.25,22.98,2019
"2270083",665,0,324,989,67.24,0,32.76,2019
"2270087",2380,235,299,2914,81.67,8.06,10.26,2019
"2270128",5268,146,1713,7127,73.92,2.05,24.04,2019
"2270373",1775,60,678,2513,70.63,2.39,26.98,2019
"2270374",1989,41,678,2708,73.45,1.51,25.04,2019
"2270375",48,0,0,48,100,0,0,2019
"2270638",195,8,95,298,65.44,2.68,31.88,2019
"2270644",81,0,0,81,100,0,0,2019
"2270645",356,61,114,531,67.04,11.49,21.47,2019
"2270650",28,0,30,58,48.28,0,51.72,2019
"2270656",867,31,463,1361,63.7,2.28,34.02,2019
"2270665",3256,59,684,3999,81.42,1.48,17.1,2019
"2270711",1422,19,233,1674,84.95,1.14,13.92,2019
"2270719",1338,22,414,1774,75.42,1.24,23.34,2019
"2270740",529,28,59,616,85.88,4.55,9.58,2019
"2270744",1559,66,481,2106,74.03,3.13,22.84,2019
"2270651",22,0,30,52,42.31,0,57.69,2019
"2270657",1358,42,410,1810,75.03,2.32,22.65,2019
"2270753",119,30,141,290,41.03,10.34,48.62,2019
"2270783",980,31,239,1250,78.4,2.48,19.12,2019
"2270809",10123,249,756,11128,90.97,2.24,6.79,2019
"2270812",2725,102,715,3542,76.93,2.88,20.19,2019
"2270397",185,22,87,294,62.93,7.48,29.59,2019
"2270427",5344,101,2248,7693,69.47,1.31,29.22,2019
"2270443",2350,148,971,3469,67.74,4.27,27.99,2019
"2270446",1949,80,588,2617,74.47,3.06,22.47,2019
"4657256",28,0,17,45,62.22,0,37.78,2019
"4657042",2792,140,344,3276,85.23,4.27,10.5,2019
"4657035",314,26,69,409,76.77,6.36,16.87,2019
"4657037",327,10,53,390,83.85,2.56,13.59,2019
"4657041",22,0,19,41,53.66,0,46.34,2019
"4657046",199,51,84,334,59.58,15.27,25.15,2019
"2271463",2125,121,1020,3266,65.06,3.7,31.23,2019
"2271469",531,19,464,1014,52.37,1.87,45.76,2019
"2271486",1217,71,695,1983,61.37,3.58,35.05,2019
"0571631",111,19,79,209,53.11,9.09,37.8,2019
"0571640",765,37,459,1261,60.67,2.93,36.4,2019
"0571653",1098,38,584,1720,63.84,2.21,33.95,2019
"0571660",135,51,110,296,45.61,17.23,37.16,2019
"0571665",1438,51,775,2264,63.52,2.25,34.23,2019
"2271038",1013,37,820,1870,54.17,1.98,43.85,2019
"2271043",89,19,87,195,45.64,9.74,44.62,2019
"2271048",27,0,5,32,84.38,0,15.62,2019
"2271051",483,46,229,758,63.72,6.07,30.21,2019
"0571952",4,0,12,16,25,0,75,2019
"0571960",446,18,250,714,62.46,2.52,35.01,2019
"2271362",610,26,167,803,75.97,3.24,20.8,2019
"0571674",161,14,120,295,54.58,4.75,40.68,2019
"0571971",136,0,62,198,68.69,0,31.31,2019
"0571823",10,0,7,17,58.82,0,41.18,2019
"0571929",1101,39,519,1659,66.37,2.35,31.28,2019
"0571945",410,18,93,521,78.69,3.45,17.85,2019
"2271371",593,24,133,750,79.07,3.2,17.73,2019
"2271433",1125,31,330,1486,75.71,2.09,22.21,2019
"0571759",208,36,18,262,79.39,13.74,6.87,2019
"0571833",594,30,214,838,70.88,3.58,25.54,2019
"0571965",68,4,55,127,53.54,3.15,43.31,2019
"2271008",201,0,158,359,55.99,0,44.01,2019
"2271018",235,16,412,663,35.44,2.41,62.14,2019
"0571742",1210,118,664,1992,60.74,5.92,33.33,2019
"0571743",932,41,589,1562,59.67,2.62,37.71,2019
"0571747",147,120,161,428,34.35,28.04,37.62,2019
"2271462",371,67,237,675,54.96,9.93,35.11,2019
"2271467",1103,10,502,1615,68.3,0.62,31.08,2019
"2271472",122,0,1,123,99.19,0,0.81,2019
"2271483",2839,47,847,3733,76.05,1.26,22.69,2019
"2271485",845,8,72,925,91.35,0.86,7.78,2019
"0571643",232,39,243,514,45.14,7.59,47.28,2019
"0571646",1505,118,750,2373,63.42,4.97,31.61,2019
"0571654",1118,27,734,1879,59.5,1.44,39.06,2019
"0571663",170,0,81,251,67.73,0,32.27,2019
"0571666",24,0,12,36,66.67,0,33.33,2019
"0571675",532,24,267,823,64.64,2.92,32.44,2019
"0571677",37,5,37,79,46.84,6.33,46.84,2019
"0571701",5303,122,1884,7309,72.55,1.67,25.78,2019
"0571766",129,11,82,222,58.11,4.95,36.94,2019
"0571801",4508,154,1292,5954,75.71,2.59,21.7,2019
"0571937",547,33,281,861,63.53,3.83,32.64,2019
"0571969",114,4,35,153,74.51,2.61,22.88,2019
"2271108",4625,268,1794,6687,69.16,4.01,26.83,2019
"2271241",1919,146,1142,3207,59.84,4.55,35.61,2019
"0571652",270,24,178,472,57.2,5.08,37.71,2019
"2271069",87,3,139,229,37.99,1.31,60.7,2019
"2271235",1318,1,423,1742,75.66,0.06,24.28,2019
"2271016",605,10,241,856,70.68,1.17,28.15,2019
"3059833",1938,66,206,2210,87.69,2.99,9.32,2019
"3059834",635,0,191,826,76.88,0,23.12,2019
"3059842",38,0,0,38,100,0,0,2019
"3059843",98,3,19,120,81.67,2.5,15.83,2019
"3059846",540,0,127,667,80.96,0,19.04,2019
"3059868",658,13,150,821,80.15,1.58,18.27,2019
"2270062",3992,144,2114,6250,63.87,2.3,33.82,2019
"2270068",9543,528,1717,11788,80.96,4.48,14.57,2019
"2270070",4284,145,384,4813,89.01,3.01,7.98,2019
"2270114",5335,259,3943,9537,55.94,2.72,41.34,2019
"2270129",2335,31,573,2939,79.45,1.05,19.5,2019
"2270130",6188,222,1045,7455,83,2.98,14.02,2019
"2270131",9160,336,2499,11995,76.37,2.8,20.83,2019
"2270345",2851,78,842,3771,75.6,2.07,22.33,2019
"2270354",1135,128,507,1770,64.12,7.23,28.64,2019
"2270358",195,3,132,330,59.09,0.91,40,2019
"2270360",8887,256,1698,10841,81.98,2.36,15.66,2019
"2270363",6332,149,2199,8680,72.95,1.72,25.33,2019
"2270391",95,0,0,95,100,0,0,2019
"2270403",9488,171,1693,11352,83.58,1.51,14.91,2019
"2270435",5095,277,841,6213,82.01,4.46,13.54,2019
"2270437",2586,33,616,3235,79.94,1.02,19.04,2019
"2270449",1247,49,161,1457,85.59,3.36,11.05,2019
"2270513",130,0,0,130,100,0,0,2019
"2270514",636,18,196,850,74.82,2.12,23.06,2019
"2270516",168,0,34,202,83.17,0,16.83,2019
"2270535",4823,96,1378,6297,76.59,1.52,21.88,2019
"2270548",2969,72,614,3655,81.23,1.97,16.8,2019
"2270339",1697,54,601,2352,72.15,2.3,25.55,2019
"2270116",4362,226,1346,5934,73.51,3.81,22.68,2019
"2270118",9688,231,2572,12491,77.56,1.85,20.59,2019
"2270123",9975,312,1479,11766,84.78,2.65,12.57,2019
"2270353",298,0,223,521,57.2,0,42.8,2019
"2270357",697,27,366,1090,63.94,2.48,33.58,2019
"2270364",8221,151,2163,10535,78.04,1.43,20.53,2019
"2270395",1250,133,352,1735,72.05,7.67,20.29,2019
"2270422",3555,71,1312,4938,71.99,1.44,26.57,2019
"2270005",9359,140,1878,11377,82.26,1.23,16.51,2019
"2270047",4085,167,446,4698,86.95,3.55,9.49,2019
"2270356",438,0,328,766,57.18,0,42.82,2019
"2270390",1791,39,669,2499,71.67,1.56,26.77,2019
"2270058",10142,275,3519,13936,72.78,1.97,25.25,2019
"2270084",1374,205,778,2357,58.29,8.7,33.01,2019
"2270085",1299,0,389,1688,76.95,0,23.05,2019
"2270094",7898,260,2879,11037,71.56,2.36,26.08,2019
"2270726",16245,1101,2433,19779,82.13,5.57,12.3,2019
"2270730",882,105,426,1413,62.42,7.43,30.15,2019
"2270732",386,8,126,520,74.23,1.54,24.23,2019
"2270736",71,0,118,189,37.57,0,62.43,2019
"2270737",14099,302,1391,15792,89.28,1.91,8.81,2019
"2270755",528,12,180,720,73.33,1.67,25,2019
"2270760",1758,76,694,2528,69.54,3.01,27.45,2019
"2270764",4557,124,1233,5914,77.05,2.1,20.85,2019
"2270770",845,28,280,1153,73.29,2.43,24.28,2019
"2270778",995,58,188,1241,80.18,4.67,15.15,2019
"2270789",139,15,98,252,55.16,5.95,38.89,2019
"2270802",5783,819,2657,9259,62.46,8.85,28.7,2019
"2270807",3851,262,1344,5457,70.57,4.8,24.63,2019
"2270815",8650,269,1257,10176,85,2.64,12.35,2019
"4657763",86,7,28,121,71.07,5.79,23.14,2019
"4657767",34,13,5,52,65.38,25,9.62,2019
"4657769",1417,32,186,1635,86.67,1.96,11.38,2019
"4657770",604,42,516,1162,51.98,3.61,44.41,2019
"4657772",185,0,230,415,44.58,0,55.42,2019
"4657030",989,18,132,1139,86.83,1.58,11.59,2019
"3059875",1231,51,253,1535,80.2,3.32,16.48,2019
"3059910",165,0,29,194,85.05,0,14.95,2019
"3059918",254,0,15,269,94.42,0,5.58,2019
"3059920",505,8,94,607,83.2,1.32,15.49,2019
"3059745",36,0,10,46,78.26,0,21.74,2019
"3059716",816,23,72,911,89.57,2.52,7.9,2019
"3059725",2639,161,563,3363,78.47,4.79,16.74,2019
"3059733",73,2,23,98,74.49,2.04,23.47,2019
"3059823",568,61,104,733,77.49,8.32,14.19,2019
"3059837",149,10,31,190,78.42,5.26,16.32,2019
"3059457",3139,85,682,3906,80.36,2.18,17.46,2019
"3059464",130,12,56,198,65.66,6.06,28.28,2019
"3059477",114,4,5,123,92.68,3.25,4.07,2019
"3059542",64,0,3,67,95.52,0,4.48,2019
"3059546",32,0,21,53,60.38,0,39.62,2019
"3059631",89,6,11,106,83.96,5.66,10.38,2019
"3059710",60,20,33,113,53.1,17.7,29.2,2019
"3059720",90,10,17,117,76.92,8.55,14.53,2019
"3059749",576,27,136,739,77.94,3.65,18.4,2019
"1760073",17056,423,1459,18938,90.06,2.23,7.7,2019
"1760077",8717,222,1207,10146,85.92,2.19,11.9,2019
"1760089",14186,308,890,15384,92.21,2,5.79,2019
"1760110",9902,177,892,10971,90.26,1.61,8.13,2019
"1760115",14353,609,1465,16427,87.37,3.71,8.92,2019
"1760118",5898,73,487,6458,91.33,1.13,7.54,2019
"1760010",15664,202,907,16773,93.39,1.2,5.41,2019
"1760016",19450,583,2905,22938,84.79,2.54,12.66,2019
"1760022",2890,6,180,3076,93.95,0.2,5.85,2019
"1760035",10687,125,669,11481,93.08,1.09,5.83,2019
"1760072",333,14,28,375,88.8,3.73,7.47,2019
"1760081",3127,16,132,3275,95.48,0.49,4.03,2019
"1760099",8635,372,1277,10284,83.97,3.62,12.42,2019
"1760102",10969,272,550,11791,93.03,2.31,4.66,2019
"1760106",6221,119,935,7275,85.51,1.64,12.85,2019
"1760129",126,2,12,140,90,1.43,8.57,2019
"1760135",2418,32,136,2586,93.5,1.24,5.26,2019
"1760146",845,0,118,963,87.75,0,12.25,2019
"1760151",1432,78,68,1578,90.75,4.94,4.31,2019
"1760154",5662,114,702,6478,87.4,1.76,10.84,2019
"1760901",9070,612,3071,12753,71.12,4.8,24.08,2019
"1760917",131,24,26,181,72.38,13.26,14.36,2019
"1760921",501,15,100,616,81.33,2.44,16.23,2019
"1760002",7983,152,888,9023,88.47,1.68,9.84,2019
"1760014",16232,222,1006,17460,92.97,1.27,5.76,2019
"1760029",133,1,2,136,97.79,0.74,1.47,2019
"1760050",11128,102,1183,12413,89.65,0.82,9.53,2019
"1760060",12059,152,703,12914,93.38,1.18,5.44,2019
"1760131",4740,81,1194,6015,78.8,1.35,19.85,2019
"1760148",18321,327,1882,20530,89.24,1.59,9.17,2019
"1760165",993,78,210,1281,77.52,6.09,16.39,2019
"1760192",5201,72,96,5369,96.87,1.34,1.79,2019
"1760202",12018,385,904,13307,90.31,2.89,6.79,2019
"1760411",14823,575,4116,19514,75.96,2.95,21.09,2019
"1760490",5896,62,120,6078,97.01,1.02,1.97,2019
"1760514",3394,71,361,3826,88.71,1.86,9.44,2019
"1760537",205,0,16,221,92.76,0,7.24,2019
"1760540",14993,293,689,15975,93.85,1.83,4.31,2019
"1760601",7209,1462,270,8941,80.63,16.35,3.02,2019
"1760608",20429,1165,4327,25921,78.81,4.49,16.69,2019
"1760441",10396,254,1283,11933,87.12,2.13,10.75,2019
"1760409",10844,377,2622,13843,78.34,2.72,18.94,2019
"1760417",4571,273,812,5656,80.82,4.83,14.36,2019
"1760426",6993,376,2461,9830,71.14,3.83,25.04,2019
"1760446",10516,181,912,11609,90.58,1.56,7.86,2019
"1760447",4327,88,329,4744,91.21,1.85,6.94,2019
"1760449",3399,41,361,3801,89.42,1.08,9.5,2019
"1760452",8971,124,1211,10306,87.05,1.2,11.75,2019
"1760453",16734,902,3626,21262,78.7,4.24,17.05,2019
"2066517",571,15,121,707,80.76,2.12,17.11,2019
"2066527",65,12,17,94,69.15,12.77,18.09,2019
"2066528",260,8,77,345,75.36,2.32,22.32,2019
"2066535",895,23,148,1066,83.96,2.16,13.88,2019
"2066541",69,6,12,87,79.31,6.9,13.79,2019
"2066542",1025,19,72,1116,91.85,1.7,6.45,2019
"2066605",5330,216,1696,7242,73.6,2.98,23.42,2019
"2066606",3693,632,992,5317,69.46,11.89,18.66,2019
"2066615",1132,130,220,1482,76.38,8.77,14.84,2019
"2066618",2976,272,360,3608,82.48,7.54,9.98,2019
"2066725",1730,116,382,2228,77.65,5.21,17.15,2019
"2066746",71,0,17,88,80.68,0,19.32,2019
"2066756",314,2,78,394,79.7,0.51,19.8,2019
"2066049",12298,321,711,13330,92.26,2.41,5.33,2019
"2066015",251,18,66,335,74.93,5.37,19.7,2019
"2066025",2277,23,311,2611,87.21,0.88,11.91,2019
"2066030",7486,163,405,8054,92.95,2.02,5.03,2019
"2066066",871,10,187,1068,81.55,0.94,17.51,2019
"2066073",899,52,81,1032,87.11,5.04,7.85,2019
"2066092",987,129,307,1423,69.36,9.07,21.57,2019
"2066106",6485,456,1364,8305,78.09,5.49,16.42,2019
"2066204",8126,163,670,8959,90.7,1.82,7.48,2019
"2066209",7751,71,460,8282,93.59,0.86,5.55,2019
"2066211",1951,49,85,2085,93.57,2.35,4.08,2019
"2963363",525,29,236,790,66.46,3.67,29.87,2019
"2963370",5,0,4,9,55.56,0,44.44,2019
"2963377",603,46,250,899,67.07,5.12,27.81,2019
"2963389",1959,63,382,2404,81.49,2.62,15.89,2019
"2963435",1223,30,305,1558,78.5,1.93,19.58,2019
"2963954",182,3,107,292,62.33,1.03,36.64,2019
"2963956",260,0,151,411,63.26,0,36.74,2019
"2963829",367,20,100,487,75.36,4.11,20.53,2019
"2963863",1739,59,714,2512,69.23,2.35,28.42,2019
"2963868",256,8,118,382,67.02,2.09,30.89,2019
"2963937",725,14,385,1124,64.5,1.25,34.25,2019
"2963941",45,0,52,97,46.39,0,53.61,2019
"2963943",155,8,87,250,62,3.2,34.8,2019
"2963961",469,23,158,650,72.15,3.54,24.31,2019
"2963967",497,32,268,797,62.36,4.02,33.63,2019
"2963088",3511,97,370,3978,88.26,2.44,9.3,2019
"2963103",3917,163,946,5026,77.93,3.24,18.82,2019
"2963111",6018,338,2270,8626,69.77,3.92,26.32,2019
"2963118",8159,443,2875,11477,71.09,3.86,25.05,2019
"2963124",4016,220,458,4694,85.56,4.69,9.76,2019
"2963132",4843,72,487,5402,89.65,1.33,9.02,2019
"2963134",3991,215,1019,5225,76.38,4.11,19.5,2019
"2963138",6104,98,910,7112,85.83,1.38,12.8,2019
"2963347",790,31,92,913,86.53,3.4,10.08,2019
"2963362",2176,65,283,2524,86.21,2.58,11.21,2019
"2963376",26009,512,1966,28487,91.3,1.8,6.9,2019
"1760620",16178,1859,7286,25323,63.89,7.34,28.77,2019
"1760634",20413,802,4766,25981,78.57,3.09,18.34,2019
"1760637",14224,816,4419,19459,73.1,4.19,22.71,2019
"1760644",10133,742,5861,16736,60.55,4.43,35.02,2019
"1760910",159,5,47,211,75.36,2.37,22.27,2019
"1760911",450,7,47,504,89.29,1.39,9.33,2019
"1760913",460,18,133,611,75.29,2.95,21.77,2019
"1760928",251,7,42,300,83.67,2.33,14,2019
"1760961",226,8,49,283,79.86,2.83,17.31,2019
"1760605",13357,1095,490,14942,89.39,7.33,3.28,2019
"1760606",2097,104,0,2201,95.27,4.73,0,2019
"1760623",15764,1748,7484,24996,63.07,6.99,29.94,2019
"1760629",23478,1967,6482,31927,73.54,6.16,20.3,2019
"1760633",3722,183,815,4720,78.86,3.88,17.27,2019
"1760638",16029,926,3290,20245,79.18,4.57,16.25,2019
"1760640",28533,2070,4863,35466,80.45,5.84,13.71,2019
"1760649",15644,487,5329,21460,72.9,2.27,24.83,2019
"1760655",8872,164,1154,10190,87.07,1.61,11.32,2019
"1760661",5737,254,209,6200,92.53,4.1,3.37,2019
"1760827",8257,339,2282,10878,75.91,3.12,20.98,2019
"1760919",182,3,35,220,82.73,1.36,15.91,2019
"1760927",721,23,115,859,83.93,2.68,13.39,2019
"1760940",991,30,242,1263,78.46,2.38,19.16,2019
"1760631",9492,237,2314,12043,78.82,1.97,19.21,2019
"1760005",10537,437,1689,12663,83.21,3.45,13.34,2019
"1760015",9240,162,367,9769,94.58,1.66,3.76,2019
"1760018",7872,266,1854,9992,78.78,2.66,18.55,2019
"1760044",3807,57,112,3976,95.75,1.43,2.82,2019
"1760068",12838,206,1141,14185,90.5,1.45,8.04,2019
"3858047",1559,22,82,1663,93.75,1.32,4.93,2019
"3858219",10,5,0,15,66.67,33.33,0,2019
"3858269",98,1,20,119,82.35,0.84,16.81,2019
"3858631",347,37,149,533,65.1,6.94,27.95,2019
"3858773",264,29,47,340,77.65,8.53,13.82,2019
"3858015",109,4,12,125,87.2,3.2,9.6,2019
"3858216",38,4,11,53,71.7,7.55,20.75,2019
"3858021",153,2,24,179,85.47,1.12,13.41,2019
"3858203",5658,662,1086,7406,76.4,8.94,14.66,2019
"3858237",1607,55,631,2293,70.08,2.4,27.52,2019
"3858623",750,30,129,909,82.51,3.3,14.19,2019
"3858731",131,0,5,136,96.32,0,3.68,2019
"3858384",150,11,70,231,64.94,4.76,30.3,2019
"3858529",187,10,87,284,65.85,3.52,30.63,2019
"3858569",23,7,10,40,57.5,17.5,25,2019
"3858788",398,14,129,541,73.57,2.59,23.84,2019
"3858374",174,7,78,259,67.18,2.7,30.12,2019
"3858622",584,44,143,771,75.75,5.71,18.55,2019
"3858735",107,35,19,161,66.46,21.74,11.8,2019
"3858771",205,0,31,236,86.86,0,13.14,2019
"3858036",83,3,9,95,87.37,3.16,9.47,2019
"3858103",19192,932,3373,23497,81.68,3.97,14.36,2019
"3858277",51,13,0,64,79.69,20.31,0,2019
"3858002",6,0,5,11,54.55,0,45.45,2019
"2067062",1406,53,246,1705,82.46,3.11,14.43,2019
"2067118",257,11,35,303,84.82,3.63,11.55,2019
"2067122",65,0,13,78,83.33,0,16.67,2019
"2067124",2463,46,542,3051,80.73,1.51,17.76,2019
"2067502",8475,171,1431,10077,84.1,1.7,14.2,2019
"2067511",96,0,24,120,80,0,20,2019
"2963379",7158,200,1167,8525,83.96,2.35,13.69,2019
"2963383",4777,199,943,5919,80.71,3.36,15.93,2019
"2963388",155,31,113,299,51.84,10.37,37.79,2019
"2963433",0,0,0,0,NA,NA,NA,2019
"2963440",336,11,84,431,77.96,2.55,19.49,2019
"2963472",142,7,82,231,61.47,3.03,35.5,2019
"2963474",100,8,70,178,56.18,4.49,39.33,2019
"2963540",30,2,1,33,90.91,6.06,3.03,2019
"2963547",92,0,76,168,54.76,0,45.24,2019
"3169044",206,14,118,338,60.95,4.14,34.91,2019
"3169045",401,6,118,525,76.38,1.14,22.48,2019
"3169121",126,7,39,172,73.26,4.07,22.67,2019
"3169130",1614,113,374,2101,76.82,5.38,17.8,2019
"3169142",50,0,2,52,96.15,0,3.85,2019
"3169148",38,9,9,56,67.86,16.07,16.07,2019
"3169150",126,0,25,151,83.44,0,16.56,2019
"3169170",91,4,18,113,80.53,3.54,15.93,2019
"3169218",103,0,25,128,80.47,0,19.53,2019
"3169333",110,18,13,141,78.01,12.77,9.22,2019
"3169341",3395,131,716,4242,80.03,3.09,16.88,2019
"3169348",549,7,107,663,82.81,1.06,16.14,2019
"3169163",306,5,82,393,77.86,1.27,20.87,2019
"3169131",245,1,49,295,83.05,0.34,16.61,2019
"3169151",289,7,34,330,87.58,2.12,10.3,2019
"3169153",2269,72,402,2743,82.72,2.62,14.66,2019
"3169201",1373,23,346,1742,78.82,1.32,19.86,2019
"3169210",880,48,151,1079,81.56,4.45,13.99,2019
"3169220",12,0,2,14,85.71,0,14.29,2019
"3169335",4,0,8,12,33.33,0,66.67,2019
"3169346",182,16,63,261,69.73,6.13,24.14,2019
"3169352",204,13,36,253,80.63,5.14,14.23,2019
"3169357",1194,28,308,1530,78.04,1.83,20.13,2019
"3169343",789,27,250,1066,74.02,2.53,23.45,2019
"3169354",13,37,4,54,24.07,68.52,7.41,2019
"3169358",646,18,145,809,79.85,2.22,17.92,2019
"3169361",5534,286,1387,7207,76.79,3.97,19.25,2019
"3169032",189,2,29,220,85.91,0.91,13.18,2019
"3169033",944,22,165,1131,83.47,1.95,14.59,2019
"3169038",179,5,42,226,79.2,2.21,18.58,2019
"3169041",27,0,6,33,81.82,0,18.18,2019
"3169046",45,0,24,69,65.22,0,34.78,2019
"3169120",404,18,70,492,82.11,3.66,14.23,2019
"3169129",357,20,141,518,68.92,3.86,27.22,2019
"3169146",116,0,49,165,70.3,0,29.7,2019
"3169037",46,0,20,66,69.7,0,30.3,2019
"3169040",213,6,60,279,76.34,2.15,21.51,2019
"3169122",251,11,50,312,80.45,3.53,16.03,2019
"3169141",96,7,56,159,60.38,4.4,35.22,2019
"3169152",251,24,104,379,66.23,6.33,27.44,2019
"3169166",239,11,9,259,92.28,4.25,3.47,2019
"3169212",73,15,27,115,63.48,13.04,23.48,2019
"3169301",3380,112,656,4148,81.49,2.7,15.81,2019
"3169336",800,2,180,982,81.47,0.2,18.33,2019
"3169025",314,16,124,454,69.16,3.52,27.31,2019
"3169125",108,1,53,162,66.67,0.62,32.72,2019
"3169135",29,0,0,29,100,0,0,2019
"3169145",1036,17,325,1378,75.18,1.23,23.58,2019
"3169167",98,0,54,152,64.47,0,35.53,2019
"3169211",147,0,33,180,81.67,0,18.33,2019
"2067572",156,6,66,228,68.42,2.63,28.95,2019
"2067575",201,0,47,248,81.05,0,18.95,2019
"2067640",179,0,42,221,81,0,19,2019
"2067669",587,47,165,799,73.47,5.88,20.65,2019
"2067671",486,14,124,624,77.88,2.24,19.87,2019
"2067733",76,0,18,94,80.85,0,19.15,2019
"2067747",47,0,10,57,82.46,0,17.54,2019
"2067761",85,5,6,96,88.54,5.21,6.25,2019
"2067837",299,27,57,383,78.07,7.05,14.88,2019
"2067839",509,25,69,603,84.41,4.15,11.44,2019
"2067857",28,5,24,57,49.12,8.77,42.11,2019
"2067860",612,63,156,831,73.65,7.58,18.77,2019
"2067870",348,15,74,437,79.63,3.43,16.93,2019
"2067953",29,8,15,52,55.77,15.38,28.85,2019
"2067004",233,5,50,288,80.9,1.74,17.36,2019
"2067005",4518,124,1433,6075,74.37,2.04,23.59,2019
"2067008",244,6,97,347,70.32,1.73,27.95,2019
"2067016",161,2,23,186,86.56,1.08,12.37,2019
"2067021",11,2,0,13,84.62,15.38,0,2019
"2067031",825,32,93,950,86.84,3.37,9.79,2019
"2067037",9662,104,814,10580,91.32,0.98,7.69,2019
"2067045",929,44,441,1414,65.7,3.11,31.19,2019
"2067056",937,84,152,1173,79.88,7.16,12.96,2019
"2067059",234,18,69,321,72.9,5.61,21.5,2019
"2067512",55,0,13,68,80.88,0,19.12,2019
"2067518",18,6,0,24,75,25,0,2019
"2067524",180,4,54,238,75.63,1.68,22.69,2019
"2067530",5920,309,1252,7481,79.13,4.13,16.74,2019
"2067552",222,12,56,290,76.55,4.14,19.31,2019
"2067566",139,20,32,191,72.77,10.47,16.75,2019
"2067570",408,26,72,506,80.63,5.14,14.23,2019
"2067581",100,0,30,130,76.92,0,23.08,2019
"2067622",187,6,43,236,79.24,2.54,18.22,2019
"2067645",202,1,39,242,83.47,0.41,16.12,2019
"2067650",85,2,18,105,80.95,1.9,17.14,2019
"2067757",168,8,27,203,82.76,3.94,13.3,2019
"2067842",121,0,35,156,77.56,0,22.44,2019
"2067849",121,0,29,150,80.67,0,19.33,2019
"2067850",142,1,14,157,90.45,0.64,8.92,2019
"2067868",21,10,41,72,29.17,13.89,56.94,2019
"2067876",347,17,110,474,73.21,3.59,23.21,2019
"2067878",591,24,183,798,74.06,3.01,22.93,2019
"2067880",2027,85,466,2578,78.63,3.3,18.08,2019
"2067954",224,12,54,290,77.24,4.14,18.62,2019
"2067743",38,0,0,38,100,0,0,2019
"2067745",142,5,31,178,79.78,2.81,17.42,2019
"2067752",433,10,148,591,73.27,1.69,25.04,2019
"2067756",708,15,166,889,79.64,1.69,18.67,2019
"2067838",239,16,63,318,75.16,5.03,19.81,2019
"2067840",28,0,13,41,68.29,0,31.71,2019
"2067022",520,24,155,699,74.39,3.43,22.17,2019
"2067029",326,17,95,438,74.43,3.88,21.69,2019
"2067039",911,30,218,1159,78.6,2.59,18.81,2019
"0571763",435,26,235,696,62.5,3.74,33.76,2019
"2271209",0,0,0,0,NA,NA,NA,2019
"2271233",73,3,38,114,64.04,2.63,33.33,2019
"2271272",0,0,0,0,NA,NA,NA,2019
"2271279",28,0,23,51,54.9,0,45.1,2019
"2271405",1591,49,425,2065,77.05,2.37,20.58,2019
"3169334",604,47,200,851,70.98,5.52,23.5,2019
"3169347",486,6,119,611,79.54,0.98,19.48,2019
"3169367",132,0,20,152,86.84,0,13.16,2019
"3169356",532,32,166,730,72.88,4.38,22.74,2019
"3169365",8,0,0,8,100,0,0,2019
"3169165",590,44,130,764,77.23,5.76,17.02,2019
"3169128",47,0,20,67,70.15,0,29.85,2019
"3169042",7,0,2,9,77.78,0,22.22,2019
"3169101",10205,292,1791,12288,83.05,2.38,14.58,2019
"3858748",56,2,14,72,77.78,2.78,19.44,2019
"3858758",91,4,13,108,84.26,3.7,12.04,2019
"3858762",85,4,14,103,82.52,3.88,13.59,2019
"3858770",408,25,67,500,81.6,5,13.4,2019
"3858782",133,26,35,194,68.56,13.4,18.04,2019
"3858831",144,14,15,173,83.24,8.09,8.67,2019
"3858222",96,2,29,127,75.59,1.57,22.83,2019
"3858223",86,0,10,96,89.58,0,10.42,2019
"3858535",168,4,46,218,77.06,1.83,21.1,2019
"3858538",360,28,246,634,56.78,4.42,38.8,2019
"3858541",184,4,56,244,75.41,1.64,22.95,2019
"3858560",56,2,9,67,83.58,2.99,13.43,2019
"3858561",342,22,119,483,70.81,4.55,24.64,2019
"3858625",64,2,25,91,70.33,2.2,27.47,2019
"3858654",89,0,17,106,83.96,0,16.04,2019
"3858711",118,3,17,138,85.51,2.17,12.32,2019
"3858725",110,0,23,133,82.71,0,17.29,2019
"3858490",88,0,21,109,80.73,0,19.27,2019
"3858494",71,1,42,114,62.28,0.88,36.84,2019
"3858495",402,30,203,635,63.31,4.72,31.97,2019
"3858501",10870,523,1845,13238,82.11,3.95,13.94,2019
"3858504",8895,556,1629,11080,80.28,5.02,14.7,2019
"3858505",0,0,0,0,NA,NA,NA,2019
"3858564",27,0,21,48,56.25,0,43.75,2019
"3858007",34,0,6,40,85,0,15,2019
"3858016",84,15,1,100,84,15,1,2019
"3858032",248,23,40,311,79.74,7.4,12.86,2019
"3858053",312,22,192,526,59.32,4.18,36.5,2019
"3858061",119,8,36,163,73.01,4.91,22.09,2019
"3858067",95,0,12,107,88.79,0,11.21,2019
"3059487",410,13,101,524,78.24,2.48,19.27,2019
"3059463",21,0,37,58,36.21,0,63.79,2019
"3059471",125,3,36,164,76.22,1.83,21.95,2019
"3059480",126,12,57,195,64.62,6.15,29.23,2019
"3059524",170,2,71,243,69.96,0.82,29.22,2019
"3059527",180,7,92,279,64.52,2.51,32.97,2019
"3059634",1800,49,101,1950,92.31,2.51,5.18,2019
"3059635",2327,76,362,2765,84.16,2.75,13.09,2019
"3059648",162,8,68,238,68.07,3.36,28.57,2019
"3059701",11096,693,2642,14431,76.89,4.8,18.31,2019
"3059102",17616,728,2404,20748,84.9,3.51,11.59,2019
"3059338",37,0,4,41,90.24,0,9.76,2019
"3059452",203,0,39,242,83.88,0,16.12,2019
"3059501",4339,169,762,5270,82.33,3.21,14.46,2019
"3059642",3,9,18,30,10,30,60,2019
"3059736",46,7,2,55,83.64,12.73,3.64,2019
"3059824",407,25,112,544,74.82,4.6,20.59,2019
"3059469",44,0,8,52,84.62,0,15.38,2019
"3059729",842,188,118,1148,73.34,16.38,10.28,2019
"3059801",12458,567,1494,14519,85.8,3.91,10.29,2019
"0571662",0,0,87,87,0,0,100,2019
"0571711",21,0,0,21,100,0,0,2019
"0571772",0,0,2,2,0,0,100,2019
"0571998",0,0,0,0,NA,NA,NA,2019
"0571999",0,0,0,0,NA,NA,NA,2019
"2270810",14298,416,935,15649,91.37,2.66,5.97,2019
"2270814",3963,125,771,4859,81.56,2.57,15.87,2019
"2270001",13891,397,3229,17517,79.3,2.27,18.43,2019
"2270040",278,5,202,485,57.32,1.03,41.65,2019
"2270053",4662,174,1876,6712,69.46,2.59,27.95,2019
"2270112",1160,169,237,1566,74.07,10.79,15.13,2019
"2270115",12068,425,2082,14575,82.8,2.92,14.28,2019
"2270117",7751,351,3588,11690,66.3,3,30.69,2019
"2270125",4382,196,1601,6179,70.92,3.17,25.91,2019
"2270127",6694,280,2845,9819,68.17,2.85,28.97,2019
"2270344",1298,31,517,1846,70.31,1.68,28.01,2019
"2270359",2630,32,468,3130,84.03,1.02,14.95,2019
"2270122",11222,388,3015,14625,76.73,2.65,20.62,2019
"2270124",7516,193,465,8174,91.95,2.36,5.69,2019
"2270126",7460,356,2443,10259,72.72,3.47,23.81,2019
"2270163",0,0,0,0,NA,NA,NA,2019
"2270301",14105,248,2957,17310,81.48,1.43,17.08,2019
"2270401",6493,110,1111,7714,84.17,1.43,14.4,2019
"2270433",12819,278,1633,14730,87.03,1.89,11.09,2019
"2270041",700,27,330,1057,66.23,2.55,31.22,2019
"2270050",56,0,11,67,83.58,0,16.42,2019
"2270051",503,121,132,756,66.53,16.01,17.46,2019
"2270056",11368,334,2459,14161,80.28,2.36,17.36,2019
"2270065",15556,449,3217,19222,80.93,2.34,16.74,2019
"2270076",40,11,15,66,60.61,16.67,22.73,2019
"2270082",38,14,49,101,37.62,13.86,48.51,2019
"2270086",537,48,268,853,62.95,5.63,31.42,2019
"2270090",1915,113,721,2749,69.66,4.11,26.23,2019
"2270121",4090,228,1239,5557,73.6,4.1,22.3,2019
"2270394",4205,153,1244,5602,75.06,2.73,22.21,2019
"2270441",1136,28,558,1722,65.97,1.63,32.4,2019
"2270450",671,6,371,1048,64.03,0.57,35.4,2019
"2270503",10782,167,558,11507,93.7,1.45,4.85,2019
"2270543",1283,25,309,1617,79.34,1.55,19.11,2019
"2270578",4917,131,1008,6056,81.19,2.16,16.64,2019
"2270584",1854,174,820,2848,65.1,6.11,28.79,2019
"2270589",741,69,445,1255,59.04,5.5,35.46,2019
"2270591",1336,0,510,1846,72.37,0,27.63,2019
"2270630",563,0,250,813,69.25,0,30.75,2019
"2270648",2173,27,458,2658,81.75,1.02,17.23,2019
"2270811",3963,121,743,4827,82.1,2.51,15.39,2019
"2270585",62,0,51,113,54.87,0,45.13,2019
"2270663",8157,249,2120,10526,77.49,2.37,20.14,2019
"2270668",1631,36,705,2372,68.76,1.52,29.72,2019
"2270669",2643,159,949,3751,70.46,4.24,25.3,2019
"2270710",1455,123,116,1694,85.89,7.26,6.85,2019
"2270733",425,12,78,515,82.52,2.33,15.15,2019
"2270747",31,15,40,86,36.05,17.44,46.51,2019
"1760415",3998,221,1004,5223,76.55,4.23,19.22,2019
"1760439",7335,278,674,8287,88.51,3.35,8.13,2019
"1760455",4209,309,1040,5558,75.73,5.56,18.71,2019
"1760474",299,14,52,365,81.92,3.84,14.25,2019
"1760475",3440,91,650,4181,82.28,2.18,15.55,2019
"1760505",17074,473,4135,21682,78.75,2.18,19.07,2019
"3059932",509,0,99,608,83.72,0,16.28,2019
"3059029",297,16,54,367,80.93,4.36,14.71,2019
"3059713",66,0,17,83,79.52,0,20.48,2019
"3059727",47,6,23,76,61.84,7.89,30.26,2019
"3059731",29,7,19,55,52.73,12.73,34.55,2019
"3059739",49,9,70,128,38.28,7.03,54.69,2019
"3059802",7758,281,981,9020,86.01,3.12,10.88,2019
"3059808",7114,187,1083,8384,84.85,2.23,12.92,2019
"3059829",757,39,241,1037,73,3.76,23.24,2019
"1760458",4270,159,817,5246,81.4,3.03,15.57,2019
"1760435",15107,489,2812,18408,82.07,2.66,15.28,2019
"1760459",7629,208,1378,9215,82.79,2.26,14.95,2019
"1760465",5542,238,945,6725,82.41,3.54,14.05,2019
"1760468",1863,83,269,2215,84.11,3.75,12.14,2019
"1760469",1684,0,222,1906,88.35,0,11.65,2019
"1760538",8238,101,651,8990,91.64,1.12,7.24,2019
"1760552",1471,18,148,1637,89.86,1.1,9.04,2019
"1760555",4684,142,177,5003,93.62,2.84,3.54,2019
"1760556",654,16,67,737,88.74,2.17,9.09,2019
"1760561",8300,179,628,9107,91.14,1.97,6.9,2019
"1760614",30793,919,1890,33602,91.64,2.73,5.62,2019
"1760615",17039,1148,3257,21444,79.46,5.35,15.19,2019
"1760619",17488,1109,7924,26521,65.94,4.18,29.88,2019
"1760621",6107,863,3779,10749,56.81,8.03,35.16,2019
"1760636",6218,482,4295,10995,56.55,4.38,39.06,2019
"1760639",18447,1499,5667,25613,72.02,5.85,22.13,2019
"1760643",14316,781,2827,17924,79.87,4.36,15.77,2019
"1760647",29347,1151,4885,35383,82.94,3.25,13.81,2019
"1760935",353,3,27,383,92.17,0.78,7.05,2019
"1760936",1520,51,336,1907,79.71,2.67,17.62,2019
"1760948",592,13,67,672,88.1,1.93,9.97,2019
"1760950",3583,101,667,4351,82.35,2.32,15.33,2019
"1760960",336,6,46,388,86.6,1.55,11.86,2019
"1760969",15,4,3,22,68.18,18.18,13.64,2019
"1760973",102,11,19,132,77.27,8.33,14.39,2019
"1760004",18191,365,1354,19910,91.37,1.83,6.8,2019
"1760033",4118,57,549,4724,87.17,1.21,11.62,2019
"1760042",2887,55,329,3271,88.26,1.68,10.06,2019
"1760043",753,0,24,777,96.91,0,3.09,2019
"1760093",6587,47,182,6816,96.64,0.69,2.67,2019
"1760108",7723,189,730,8642,89.37,2.19,8.45,2019
"1760109",180,6,30,216,83.33,2.78,13.89,2019
"1760119",3401,54,184,3639,93.46,1.48,5.06,2019
"1760130",5740,163,1093,6996,82.05,2.33,15.62,2019
"1760136",2338,68,149,2555,91.51,2.66,5.83,2019
"1760150",662,6,76,744,88.98,0.81,10.22,2019
"1760178",7491,178,685,8354,89.67,2.13,8.2,2019
"1760191",4568,119,481,5168,88.39,2.3,9.31,2019
"1760195",1873,7,68,1948,96.15,0.36,3.49,2019
"1760421",1306,54,90,1450,90.07,3.72,6.21,2019
"1760431",7267,65,316,7648,95.02,0.85,4.13,2019
"1760432",4516,219,1326,6061,74.51,3.61,21.88,2019
"1760163",1389,61,318,1768,78.56,3.45,17.99,2019
"1760171",2956,34,653,3643,81.14,0.93,17.92,2019
"1760174",11194,205,1012,12411,90.19,1.65,8.15,2019
"1760194",6946,178,632,7756,89.56,2.29,8.15,2019
"1760305",3730,59,182,3971,93.93,1.49,4.58,2019
"1760420",1584,17,418,2019,78.45,0.84,20.7,2019
"1760423",9822,133,600,10555,93.06,1.26,5.68,2019
"1760020",3986,168,503,4657,85.59,3.61,10.8,2019
"1760034",668,0,83,751,88.95,0,11.05,2019
"1760047",13231,128,533,13892,95.24,0.92,3.84,2019
"1760070",4671,157,797,5625,83.04,2.79,14.17,2019
"1760008",7000,171,958,8129,86.11,2.1,11.78,2019
"1760160",5613,387,1891,7891,71.13,4.9,23.96,2019
"1760091",9091,145,460,9696,93.76,1.5,4.74,2019
"1760111",50,16,18,84,59.52,19.05,21.43,2019
"1760142",11248,204,911,12363,90.98,1.65,7.37,2019
"1760157",902,0,77,979,92.13,0,7.87,2019
"3059750",133,0,35,168,79.17,0,20.83,2019
"3059751",52,8,34,94,55.32,8.51,36.17,2019
"3059756",10,0,0,10,100,0,0,2019
"3059762",103,0,18,121,85.12,0,14.88,2019
"3059821",704,14,197,915,76.94,1.53,21.53,2019
"3059840",4980,89,981,6050,82.31,1.47,16.21,2019
"3059859",1013,41,317,1371,73.89,2.99,23.12,2019
"3059865",1008,42,229,1279,78.81,3.28,17.9,2019
"3059866",248,3,91,342,72.51,0.88,26.61,2019
"3059871",124,0,3,127,97.64,0,2.36,2019
"3059873",1055,3,318,1376,76.67,0.22,23.11,2019
"3059915",66,0,91,157,42.04,0,57.96,2019
"3059916",56,4,11,71,78.87,5.63,15.49,2019
"3059917",1385,132,254,1771,78.2,7.45,14.34,2019
"3059928",34,0,46,80,42.5,0,57.5,2019
"3059226",166,4,14,184,90.22,2.17,7.61,2019
"3059248",225,6,106,337,66.77,1.78,31.45,2019
"3059260",49,0,5,54,90.74,0,9.26,2019
"3059262",198,4,36,238,83.19,1.68,15.13,2019
"3059263",509,27,178,714,71.29,3.78,24.93,2019
"3059275",180,0,18,198,90.91,0,9.09,2019
"3059339",50,3,6,59,84.75,5.08,10.17,2019
"3059354",5,0,12,17,29.41,0,70.59,2019
"3059010",61,0,26,87,70.11,0,29.89,2019
"3059013",43,0,4,47,91.49,0,8.51,2019
"3059018",171,7,43,221,77.38,3.17,19.46,2019
"3059037",584,0,141,725,80.55,0,19.45,2019
"3059052",58,2,13,73,79.45,2.74,17.81,2019
"3059066",105,9,48,162,64.81,5.56,29.63,2019
"3059067",66,7,30,103,64.08,6.8,29.13,2019
"3059071",52,0,2,54,96.3,0,3.7,2019
"3059075",42,0,42,84,50,0,50,2019
"3059076",20,3,8,31,64.52,9.68,25.81,2019
"3059086",362,0,68,430,84.19,0,15.81,2019
"3059087",155,3,21,179,86.59,1.68,11.73,2019
"3059088",560,9,72,641,87.36,1.4,11.23,2019
"3059105",10938,307,1068,12313,88.83,2.49,8.67,2019
"3059211",31,0,13,44,70.45,0,29.55,2019
"3059317",408,36,57,501,81.44,7.19,11.38,2019
"3059318",38,0,5,43,88.37,0,11.63,2019
"3059330",2878,60,739,3677,78.27,1.63,20.1,2019
"3059333",3,0,0,3,100,0,0,2019
"3059012",78,9,14,101,77.23,8.91,13.86,2019
"1760430",6872,121,618,7611,90.29,1.59,8.12,2019
"1760603",504,32,16,552,91.3,5.8,2.9,2019
"1760914",8751,261,1086,10098,86.66,2.58,10.75,2019
"1760964",1501,41,387,1929,77.81,2.13,20.06,2019
"1760924",529,7,136,672,78.72,1.04,20.24,2019
"1760053",7211,118,1065,8394,85.91,1.41,12.69,2019
"3059101",14094,567,2602,17263,81.64,3.28,15.07,2019
"3059222",89,0,7,96,92.71,0,7.29,2019
"3059225",118,4,45,167,70.66,2.4,26.95,2019
"3059261",198,9,52,259,76.45,3.47,20.08,2019
"3059274",82,5,18,105,78.1,4.76,17.14,2019
"3059314",32,4,2,38,84.21,10.53,5.26,2019
"3059016",183,15,50,248,73.79,6.05,20.16,2019
"3059032",170,7,59,236,72.03,2.97,25,2019
"3059050",209,12,165,386,54.15,3.11,42.75,2019
"3059054",100,0,36,136,73.53,0,26.47,2019
"3059064",76,0,9,85,89.41,0,10.59,2019
"3059079",1075,11,245,1331,80.77,0.83,18.41,2019
"3059243",82,2,11,95,86.32,2.11,11.58,2019
"3059250",98,0,22,120,81.67,0,18.33,2019
"3059259",115,3,32,150,76.67,2,21.33,2019
"3059270",2770,79,733,3582,77.33,2.21,20.46,2019
"3059315",36,0,2,38,94.74,0,5.26,2019
"3059323",770,19,95,884,87.1,2.15,10.75,2019
"3059353",331,24,143,498,66.47,4.82,28.71,2019
"3059433",155,15,55,225,68.89,6.67,24.44,2019
"3059441",12,0,4,16,75,0,25,2019
"3059446",175,8,41,224,78.12,3.57,18.3,2019
"3059872",578,25,341,944,61.23,2.65,36.12,2019
"1760478",4953,165,775,5893,84.05,2.8,13.15,2019
"1760501",2616,236,682,3534,74.02,6.68,19.3,2019
"1760504",12504,195,633,13332,93.79,1.46,4.75,2019
"1760510",9445,281,1054,10780,87.62,2.61,9.78,2019
"1760512",343,0,86,429,79.95,0,20.05,2019
"1760513",6009,278,769,7056,85.16,3.94,10.9,2019
"1760516",10717,305,961,11983,89.44,2.55,8.02,2019
"1760526",4333,153,582,5068,85.5,3.02,11.48,2019
"1760532",10958,355,982,12295,89.13,2.89,7.99,2019
"1760549",74,0,0,74,100,0,0,2019
"1760534",2974,119,666,3759,79.12,3.17,17.72,2019
"1760544",8834,52,677,9563,92.38,0.54,7.08,2019
"1760548",3853,52,461,4366,88.25,1.19,10.56,2019
"1760557",45,0,49,94,47.87,0,52.13,2019
"1760607",11451,696,608,12755,89.78,5.46,4.77,2019
"1760609",15423,895,4572,20890,73.83,4.28,21.89,2019
"1760625",24821,1336,3511,29668,83.66,4.5,11.83,2019
"1760646",9266,285,1402,10953,84.6,2.6,12.8,2019
"1760652",10663,854,1959,13476,79.13,6.34,14.54,2019
"1760805",5659,369,953,6981,81.06,5.29,13.65,2019
"1760912",165,7,47,219,75.34,3.2,21.46,2019
"1760922",825,8,142,975,84.62,0.82,14.56,2019
"1760926",21,0,0,21,100,0,0,2019
"1760930",286,21,32,339,84.37,6.19,9.44,2019
"1760932",41,0,0,41,100,0,0,2019
"1760938",652,16,110,778,83.8,2.06,14.14,2019
"1760945",59,0,17,76,77.63,0,22.37,2019
"1760007",11783,175,1432,13390,88,1.31,10.69,2019
"1760012",3421,89,180,3690,92.71,2.41,4.88,2019
"1760013",8831,82,419,9332,94.63,0.88,4.49,2019
"2965333",143,13,65,221,64.71,5.88,29.41,2019
"2965340",4366,189,945,5500,79.38,3.44,17.18,2019
"2965345",153,0,18,171,89.47,0,10.53,2019
"2965348",336,23,146,505,66.53,4.55,28.91,2019
"2965438",536,60,475,1071,50.05,5.6,44.35,2019
"2965449",101,0,93,194,52.06,0,47.94,2019
"5554874",1197,22,283,1502,79.69,1.46,18.84,2019
"5554902",8279,485,1384,10148,81.58,4.78,13.64,2019
"2755024",11303,291,557,12151,93.02,2.39,4.58,2019
"2755025",8474,112,868,9454,89.63,1.18,9.18,2019
"2755026",131,6,30,167,78.44,3.59,17.96,2019
"2755036",15,0,22,37,40.54,0,59.46,2019
"2755038",7566,141,476,8183,92.46,1.72,5.82,2019
"2755053",328,8,51,387,84.75,2.07,13.18,2019
"2755065",383,6,64,453,84.55,1.32,14.13,2019
"2755066",6686,270,1083,8039,83.17,3.36,13.47,2019
"2755072",852,64,357,1273,66.93,5.03,28.04,2019
"2755085",161,3,23,187,86.1,1.6,12.3,2019
"2755089",602,14,66,682,88.27,2.05,9.68,2019
"2755092",3528,104,358,3990,88.42,2.61,8.97,2019
"2755103",3606,211,1115,4932,73.11,4.28,22.61,2019
"2755110",14500,291,1376,16167,89.69,1.8,8.51,2019
"2755307",1020,61,269,1350,75.56,4.52,19.93,2019
"2755113",15358,641,2022,18021,85.22,3.56,11.22,2019
"2755118",10053,453,1673,12179,82.54,3.72,13.74,2019
"2755127",7059,174,538,7771,90.84,2.24,6.92,2019
"2755150",60,0,11,71,84.51,0,15.49,2019
"2755320",1672,85,176,1933,86.5,4.4,9.11,2019
"2755324",387,12,79,478,80.96,2.51,16.53,2019
"2755331",6701,157,261,7119,94.13,2.21,3.67,2019
"2755342",607,20,131,758,80.08,2.64,17.28,2019
"2755785",71,9,32,112,63.39,8.04,28.57,2019
"2755792",3522,231,1165,4918,71.61,4.7,23.69,2019
"2755733",1653,26,209,1888,87.55,1.38,11.07,2019
"2755735",479,40,206,725,66.07,5.52,28.41,2019
"2755736",478,33,130,641,74.57,5.15,20.28,2019
"2755756",111,7,32,150,74,4.67,21.33,2019
"2755757",224,7,75,306,73.2,2.29,24.51,2019
"2755783",768,35,175,978,78.53,3.58,17.89,2019
"2755786",108,16,45,169,63.91,9.47,26.63,2019
"2755803",6358,260,740,7358,86.41,3.53,10.06,2019
"2755808",1924,133,508,2565,75.01,5.19,19.81,2019
"2755918",291,5,65,361,80.61,1.39,18.01,2019
"2755926",219,9,67,295,74.24,3.05,22.71,2019
"2755927",1353,45,204,1602,84.46,2.81,12.73,2019
"2755934",1098,38,172,1308,83.94,2.91,13.15,2019
"2755944",2502,96,145,2743,91.21,3.5,5.29,2019
"2755946",1098,22,209,1329,82.62,1.66,15.73,2019
"2755975",1470,23,347,1840,79.89,1.25,18.86,2019
"2755449",9446,128,436,10010,94.37,1.28,4.36,2019
"2755601",41,0,8,49,83.67,0,16.33,2019
"2755602",72,1,31,104,69.23,0.96,29.81,2019
"2755613",87,3,19,109,79.82,2.75,17.43,2019
"2755708",203,14,99,316,64.24,4.43,31.33,2019
"2755712",153,7,72,232,65.95,3.02,31.03,2019
"2755726",288,29,132,449,64.14,6.46,29.4,2019
"2755741",1265,26,331,1622,77.99,1.6,20.41,2019
"2755744",7296,230,1248,8774,83.15,2.62,14.22,2019
"2755751",565,19,121,705,80.14,2.7,17.16,2019
"2963782",81,5,31,117,69.23,4.27,26.5,2019
"2963873",1261,46,583,1890,66.72,2.43,30.85,2019
"2963965",792,0,291,1083,73.13,0,26.87,2019
"2963551",53,0,22,75,70.67,0,29.33,2019
"2963826",12,0,2,14,85.71,0,14.29,2019
"2963964",90,0,102,192,46.88,0,53.12,2019
"2755102",8045,346,928,9319,86.33,3.71,9.96,2019
"2755107",4412,130,628,5170,85.34,2.51,12.15,2019
"2755108",5748,224,371,6343,90.62,3.53,5.85,2019
"2755112",14715,535,1642,16892,87.11,3.17,9.72,2019
"2755304",15540,219,964,16723,92.93,1.31,5.76,2019
"2755322",1077,33,122,1232,87.42,2.68,9.9,2019
"2755325",1410,53,213,1676,84.13,3.16,12.71,2019
"2755330",11885,312,1307,13504,88.01,2.31,9.68,2019
"2755340",2690,0,195,2885,93.24,0,6.76,2019
"2755343",10575,373,1210,12158,86.98,3.07,9.95,2019
"2755301",4451,166,301,4918,90.5,3.38,6.12,2019
"2755077",4591,93,539,5223,87.9,1.78,10.32,2019
"2755109",11529,298,1190,13017,88.57,2.29,9.14,2019
"2755124",18128,450,1398,19976,90.75,2.25,7,2019
"2755311",13257,249,430,13936,95.13,1.79,3.09,2019
"2755312",450,21,120,591,76.14,3.55,20.3,2019
"2755321",1561,68,240,1869,83.52,3.64,12.84,2019
"2755334",840,44,269,1153,72.85,3.82,23.33,2019
"2755346",5967,87,202,6256,95.38,1.39,3.23,2019
"2755368",695,70,146,911,76.29,7.68,16.03,2019
"2755371",5086,194,949,6229,81.65,3.11,15.24,2019
"2755404",8355,931,2805,12091,69.1,7.7,23.2,2019
"2755409",4500,199,213,4912,91.61,4.05,4.34,2019
"2755430",6154,286,1212,7652,80.42,3.74,15.84,2019
"2755006",1203,63,300,1566,76.82,4.02,19.16,2019
"2755044",17740,341,917,18998,93.38,1.79,4.83,2019
"2755049",769,3,140,912,84.32,0.33,15.35,2019
"2755051",2995,145,684,3824,78.32,3.79,17.89,2019
"2755073",1066,27,118,1211,88.03,2.23,9.74,2019
"2755088",567,17,78,662,85.65,2.57,11.78,2019
"2755106",15456,428,2090,17974,85.99,2.38,11.63,2019
"2755116",9655,431,1223,11309,85.37,3.81,10.81,2019
"2755117",13341,377,2252,15970,83.54,2.36,14.1,2019
"2755121",3312,122,301,3735,88.67,3.27,8.06,2019
"2755001",1071,6,33,1110,96.49,0.54,2.97,2019
"2755012",670,24,69,763,87.81,3.15,9.04,2019
"2755031",627,15,65,707,88.68,2.12,9.19,2019
"2755040",4311,109,437,4857,88.76,2.24,9,2019
"2755041",2921,49,478,3448,84.72,1.42,13.86,2019
"2755042",3156,36,216,3408,92.61,1.06,6.34,2019
"2755063",2895,108,605,3608,80.24,2.99,16.77,2019
"2755070",2401,28,233,2662,90.2,1.05,8.75,2019
"2755074",770,9,83,862,89.33,1.04,9.63,2019
"2755802",845,68,448,1361,62.09,5,32.92,2019
"2755917",1121,26,265,1412,79.39,1.84,18.77,2019
"2755923",1526,39,289,1854,82.31,2.1,15.59,2019
"2755940",939,15,169,1123,83.62,1.34,15.05,2019
"2755303",15837,362,1778,17977,88.1,2.01,9.89,2019
"2755309",6015,94,315,6424,93.63,1.46,4.9,2019
"2755310",394,20,184,598,65.89,3.34,30.77,2019
"2755314",325,17,128,470,69.15,3.62,27.23,2019
"2755316",8493,195,479,9167,92.65,2.13,5.23,2019
"2755318",9678,133,781,10592,91.37,1.26,7.37,2019
"2964451",183,6,63,252,72.62,2.38,25,2019
"2964466",139,10,52,201,69.15,4.98,25.87,2019
"2964483",216,4,27,247,87.45,1.62,10.93,2019
"2964487",151,14,99,264,57.2,5.3,37.5,2019
"2964489",563,7,188,758,74.27,0.92,24.8,2019
"2964601",3144,213,1296,4653,67.57,4.58,27.85,2019
"5553224",6759,96,1022,7877,85.81,1.22,12.97,2019
"5553404",4305,108,1180,5593,76.97,1.93,21.1,2019
"5553529",681,36,116,833,81.75,4.32,13.93,2019
"5553549",3352,78,742,4172,80.35,1.87,17.79,2019
"5553550",341,11,88,440,77.5,2.5,20,2019
"5553108",1113,33,200,1346,82.69,2.45,14.86,2019
"5553110",6307,247,1128,7682,82.1,3.22,14.68,2019
"5553114",804,51,114,969,82.97,5.26,11.76,2019
"5553016",119,2,26,147,80.95,1.36,17.69,2019
"5553019",661,8,92,761,86.86,1.05,12.09,2019
"5553045",7774,63,662,8499,91.47,0.74,7.79,2019
"5553063",542,0,119,661,82,0,18,2019
"5553088",155,3,42,200,77.5,1.5,21,2019
"5553098",3740,164,741,4645,80.52,3.53,15.95,2019
"5553103",1355,22,95,1472,92.05,1.49,6.45,2019
"5553115",5212,355,838,6405,81.37,5.54,13.08,2019
"5553119",1868,30,230,2128,87.78,1.41,10.81,2019
"5553151",12093,436,982,13511,89.5,3.23,7.27,2019
"5553167",284,64,24,372,76.34,17.2,6.45,2019
"5553185",6615,118,593,7326,90.29,1.61,8.09,2019
"5553219",11890,416,2697,15003,79.25,2.77,17.98,2019
"5553222",9097,235,1894,11226,81.04,2.09,16.87,2019
"5553510",516,10,84,610,84.59,1.64,13.77,2019
"5553526",227,9,38,274,82.85,3.28,13.87,2019
"5553536",2921,120,468,3509,83.24,3.42,13.34,2019
"5553541",255,5,101,361,70.64,1.39,27.98,2019
"5553006",584,5,114,703,83.07,0.71,16.22,2019
"5553007",657,29,227,913,71.96,3.18,24.86,2019
"5553024",6480,223,590,7293,88.85,3.06,8.09,2019
"5553036",960,0,130,1090,88.07,0,11.93,2019
"5553057",504,11,98,613,82.22,1.79,15.99,2019
"5553058",1392,25,59,1476,94.31,1.69,4,2019
"5553118",2526,92,242,2860,88.32,3.22,8.46,2019
"5553140",9311,555,2039,11905,78.21,4.66,17.13,2019
"5553144",8431,148,1300,9879,85.34,1.5,13.16,2019
"5553146",2799,16,294,3109,90.03,0.51,9.46,2019
"5553150",8698,140,813,9651,90.13,1.45,8.42,2019
"5553189",9252,83,556,9891,93.54,0.84,5.62,2019
"5553190",5122,584,791,6497,78.84,8.99,12.17,2019
"5553203",852,83,50,985,86.5,8.43,5.08,2019
"5553207",13797,451,2340,16588,83.17,2.72,14.11,2019
"5553209",13520,544,4546,18610,72.65,2.92,24.43,2019
"5553220",9303,200,1748,11251,82.69,1.78,15.54,2019
"5553502",793,34,181,1008,78.67,3.37,17.96,2019
"5553504",613,16,215,844,72.63,1.9,25.47,2019
"5553507",714,13,67,794,89.92,1.64,8.44,2019
"5553511",14434,1022,3604,19060,75.73,5.36,18.91,2019
"5553517",642,12,80,734,87.47,1.63,10.9,2019
"5553522",335,8,69,412,81.31,1.94,16.75,2019
"5553525",1140,70,263,1473,77.39,4.75,17.85,2019
"5553559",1884,65,250,2199,85.68,2.96,11.37,2019
"5553561",727,5,64,796,91.33,0.63,8.04,2019
"5553569",374,7,89,470,79.57,1.49,18.94,2019
"2756140",16,0,4,20,80,0,20,2019
"2756155",136,3,15,154,88.31,1.95,9.74,2019
"2756159",911,32,222,1165,78.2,2.75,19.06,2019
"2756166",73,0,14,87,83.91,0,16.09,2019
"2756170",207,11,57,275,75.27,4,20.73,2019
"2756181",395,26,49,470,84.04,5.53,10.43,2019
"2965452",780,31,225,1036,75.29,2.99,21.72,2019
"2965470",264,10,151,425,62.12,2.35,35.53,2019
"2965769",546,44,327,917,59.54,4.8,35.66,2019
"2965779",543,51,355,949,57.22,5.37,37.41,2019
"2965787",344,2,159,505,68.12,0.4,31.49,2019
"2965803",13076,945,4030,18051,72.44,5.24,22.33,2019
"2965256",503,15,76,594,84.68,2.53,12.79,2019
"2965261",269,11,110,390,68.97,2.82,28.21,2019
"2965264",231,4,37,272,84.93,1.47,13.6,2019
"2965278",53,0,12,65,81.54,0,18.46,2019
"2965322",169,8,42,219,77.17,3.65,19.18,2019
"2965336",2126,27,231,2384,89.18,1.13,9.69,2019
"2965347",197,4,53,254,77.56,1.57,20.87,2019
"2965355",3300,136,1061,4497,73.38,3.02,23.59,2019
"2965440",130,0,11,141,92.2,0,7.8,2019
"2965456",188,4,50,242,77.69,1.65,20.66,2019
"2965464",262,65,122,449,58.35,14.48,27.17,2019
"2965351",669,44,159,872,76.72,5.05,18.23,2019
"2965444",250,45,119,414,60.39,10.87,28.74,2019
"2965468",0,43,0,43,0,100,0,2019
"2965534",197,30,85,312,63.14,9.62,27.24,2019
"2965536",8782,536,2287,11605,75.67,4.62,19.71,2019
"2965325",859,52,271,1182,72.67,4.4,22.93,2019
"2965327",69,2,27,98,70.41,2.04,27.55,2019
"2965329",136,14,27,177,76.84,7.91,15.25,2019
"2965335",53,6,5,64,82.81,9.38,7.81,2019
"2066223",9405,79,352,9836,95.62,0.8,3.58,2019
"2066404",157,0,13,170,92.35,0,7.65,2019
"2066406",133,1,41,175,76,0.57,23.43,2019
"2066408",96,5,13,114,84.21,4.39,11.4,2019
"2066413",639,14,175,828,77.17,1.69,21.14,2019
"2066515",109,0,21,130,83.85,0,16.15,2019
"2066521",494,25,159,678,72.86,3.69,23.45,2019
"2066526",248,15,62,325,76.31,4.62,19.08,2019
"2066534",1175,48,219,1442,81.48,3.33,15.19,2019
"2066548",258,7,66,331,77.95,2.11,19.94,2019
"2066554",207,5,20,232,89.22,2.16,8.62,2019
"2066619",631,92,133,856,73.71,10.75,15.54,2019
"2066713",1430,16,602,2048,69.82,0.78,29.39,2019
"2066720",3312,222,1168,4702,70.44,4.72,24.84,2019
"2066023",299,25,125,449,66.59,5.57,27.84,2019
"2066040",890,153,497,1540,57.79,9.94,32.27,2019
"2066064",1588,140,553,2281,69.62,6.14,24.24,2019
"2066070",902,6,155,1063,84.85,0.56,14.58,2019
"2066086",3037,264,393,3694,82.21,7.15,10.64,2019
"2066101",2881,236,1539,4656,61.88,5.07,33.05,2019
"2066104",6387,272,2596,9255,69.01,2.94,28.05,2019
"2066203",7118,184,727,8029,88.65,2.29,9.05,2019
"2066206",3956,35,229,4220,93.74,0.83,5.43,2019
"2066221",5626,27,90,5743,97.96,0.47,1.57,2019
"2066402",889,112,85,1086,81.86,10.31,7.83,2019
"2066407",161,0,34,195,82.56,0,17.44,2019
"2066409",1205,25,56,1286,93.7,1.94,4.35,2019
"2067363",55,0,6,61,90.16,0,9.84,2019
"2067423",73,0,6,79,92.41,0,7.59,2019
"2067474",66,0,42,108,61.11,0,38.89,2019
"2067484",250,14,103,367,68.12,3.81,28.07,2019
"2067854",452,8,97,557,81.15,1.44,17.41,2019
"2067865",330,4,113,447,73.83,0.89,25.28,2019
"2963045",0,0,0,0,NA,NA,NA,2019
"2963047",21,0,0,21,100,0,0,2019
"2963053",22,0,6,28,78.57,0,21.43,2019
"2963057",0,0,0,0,NA,NA,NA,2019
"2964020",1279,33,213,1525,83.87,2.16,13.97,2019
"2964035",319,14,75,408,78.19,3.43,18.38,2019
"2964040",1912,55,519,2486,76.91,2.21,20.88,2019
"2964048",1370,37,123,1530,89.54,2.42,8.04,2019
"2964071",186,12,54,252,73.81,4.76,21.43,2019
"2964001",242,6,59,307,78.83,1.95,19.22,2019
"2964145",1776,57,95,1928,92.12,2.96,4.93,2019
"2964151",10026,355,813,11194,89.57,3.17,7.26,2019
"2964455",129,1,34,164,78.66,0.61,20.73,2019
"2964467",37,0,46,83,44.58,0,55.42,2019
"2964475",85,4,62,151,56.29,2.65,41.06,2019
"2964479",243,4,96,343,70.85,1.17,27.99,2019
"2964480",52,2,46,100,52,2,46,2019
"2964486",138,1,53,192,71.88,0.52,27.6,2019
"2964102",0,0,0,0,NA,NA,NA,2019
"2964633",1357,39,541,1937,70.06,2.01,27.93,2019
"2964631",212,16,129,357,59.38,4.48,36.13,2019
"2964636",97,0,20,117,82.91,0,17.09,2019
"2964640",957,29,189,1175,81.45,2.47,16.09,2019
"2964642",256,21,114,391,65.47,5.37,29.16,2019
"2964645",52,0,19,71,73.24,0,26.76,2019
"2964667",106,3,12,121,87.6,2.48,9.92,2019
"2964688",160,6,60,226,70.8,2.65,26.55,2019
"2964722",138,3,47,188,73.4,1.6,25,2019
"2964742",729,26,185,940,77.55,2.77,19.68,2019
"2964744",2441,170,735,3346,72.95,5.08,21.97,2019
"2964755",772,53,169,994,77.67,5.33,17,2019
"2964769",177,22,53,252,70.24,8.73,21.03,2019
"2964781",31,0,6,37,83.78,0,16.22,2019
"2964790",262,21,127,410,63.9,5.12,30.98,2019
"2964833",8,1,12,21,38.1,4.76,57.14,2019
"2964855",777,82,103,962,80.77,8.52,10.71,2019
"2964857",93,19,23,135,68.89,14.07,17.04,2019
"2964870",4591,238,933,5762,79.68,4.13,16.19,2019
"2964873",262,15,47,324,80.86,4.63,14.51,2019
"2964017",86,18,73,177,48.59,10.17,41.24,2019
"2964019",637,14,124,775,82.19,1.81,16,2019
"2964066",10,0,0,10,100,0,0,2019
"2964067",1655,146,504,2305,71.8,6.33,21.87,2019
"2964082",5363,21,206,5590,95.94,0.38,3.69,2019
"2964105",2987,464,209,3660,81.61,12.68,5.71,2019
"2964113",4568,133,183,4884,93.53,2.72,3.75,2019
"2964131",8345,411,1667,10423,80.06,3.94,15.99,2019
"2964136",753,13,247,1013,74.33,1.28,24.38,2019
"2964421",187,0,136,323,57.89,0,42.11,2019
"2964426",123,0,46,169,72.78,0,27.22,2019
"2964457",66,2,20,88,75,2.27,22.73,2019
"2964428",198,10,77,285,69.47,3.51,27.02,2019
"2964432",15,5,7,27,55.56,18.52,25.93,2019
"1950551",43,0,3,46,93.48,0,6.52,2019
"1950560",220,20,38,278,79.14,7.19,13.67,2019
"1950568",525,7,84,616,85.23,1.14,13.64,2019
"1950577",146,0,28,174,83.91,0,16.09,2019
"1950583",943,23,216,1182,79.78,1.95,18.27,2019
"1950586",85,11,23,119,71.43,9.24,19.33,2019
"2964620",133,5,47,185,71.89,2.7,25.41,2019
"2964628",1663,61,678,2402,69.23,2.54,28.23,2019
"2964630",155,2,50,207,74.88,0.97,24.15,2019
"2964644",933,34,327,1294,72.1,2.63,25.27,2019
"2964063",7261,125,740,8126,89.36,1.54,9.11,2019
"2964070",1115,6,206,1327,84.02,0.45,15.52,2019
"2964078",3240,177,332,3749,86.42,4.72,8.86,2019
"2964079",4788,92,292,5172,92.58,1.78,5.65,2019
"2964014",8272,215,662,9149,90.41,2.35,7.24,2019
"2964062",1924,63,211,2198,87.53,2.87,9.6,2019
"2964093",9348,251,807,10406,89.83,2.41,7.76,2019
"2964123",2330,117,959,3406,68.41,3.44,28.16,2019
"2964127",4349,145,1842,6336,68.64,2.29,29.07,2019
"2964130",5479,408,2663,8550,64.08,4.77,31.15,2019
"2964139",660,24,33,717,92.05,3.35,4.6,2019
"2964150",1125,74,307,1506,74.7,4.91,20.39,2019
"2964156",2696,21,89,2806,96.08,0.75,3.17,2019
"2964422",118,0,38,156,75.64,0,24.36,2019
"2964424",1379,17,348,1744,79.07,0.97,19.95,2019
"2964441",44,0,15,59,74.58,0,25.42,2019
"2964459",127,0,45,172,73.84,0,26.16,2019
"2066032",1424,85,493,2002,71.13,4.25,24.63,2019
"2066041",191,15,93,299,63.88,5.02,31.1,2019
"1762560",424,29,100,553,76.67,5.24,18.08,2019
"1762570",128,12,40,180,71.11,6.67,22.22,2019
"1762617",220,10,86,316,69.62,3.16,27.22,2019
"1762638",389,14,121,524,74.24,2.67,23.09,2019
"1762640",1218,57,230,1505,80.93,3.79,15.28,2019
"1762663",68,2,22,92,73.91,2.17,23.91,2019
"1762685",726,40,181,947,76.66,4.22,19.11,2019
"1762692",694,22,127,843,82.33,2.61,15.07,2019
"1762703",8804,865,2312,11981,73.48,7.22,19.3,2019
"1762811",101,6,11,118,85.59,5.08,9.32,2019
"1762812",3399,82,952,4433,76.67,1.85,21.48,2019
"1762816",409,7,109,525,77.9,1.33,20.76,2019
"1762815",106,2,16,124,85.48,1.61,12.9,2019
"1762868",574,33,111,718,79.94,4.6,15.46,2019
"1762898",665,27,102,794,83.75,3.4,12.85,2019
"1762853",257,11,83,351,73.22,3.13,23.65,2019
"1762861",38,0,27,65,58.46,0,41.54,2019
"1762907",510,11,263,784,65.05,1.4,33.55,2019
"1762076",34,0,28,62,54.84,0,45.16,2019
"1762098",3,0,8,11,27.27,0,72.73,2019
"1762248",121,10,37,168,72.02,5.95,22.02,2019
"1762282",119,3,47,169,70.41,1.78,27.81,2019
"1762305",6626,139,909,7674,86.34,1.81,11.85,2019
"1762622",15,0,0,15,100,0,0,2019
"1762711",6301,164,647,7112,88.6,2.31,9.1,2019
"1762712",3771,284,185,4240,88.94,6.7,4.36,2019
"1762841",31,0,15,46,67.39,0,32.61,2019
"1762856",131,7,32,170,77.06,4.12,18.82,2019
"1762902",1662,33,283,1978,84.02,1.67,14.31,2019
"1762205",1676,293,1404,3373,49.69,8.69,41.62,2019
"2649744",239,12,83,334,71.56,3.59,24.85,2019
"2649747",674,20,182,876,76.94,2.28,20.78,2019
"2649757",367,93,54,514,71.4,18.09,10.51,2019
"2649760",190,29,61,280,67.86,10.36,21.79,2019
"2649764",164,0,0,164,100,0,0,2019
"2649770",6390,109,981,7480,85.43,1.46,13.11,2019
"2756185",187,4,26,217,86.18,1.84,11.98,2019
"2756209",778,26,107,911,85.4,2.85,11.75,2019
"2756226",88,2,14,104,84.62,1.92,13.46,2019
"2756285",355,18,104,477,74.42,3.77,21.8,2019
"2756262",199,10,47,256,77.73,3.91,18.36,2019
"2756274",60,2,23,85,70.59,2.35,27.06,2019
"2756283",1965,84,530,2579,76.19,3.26,20.55,2019
"2756291",154,1,29,184,83.7,0.54,15.76,2019
"2756294",19,2,8,29,65.52,6.9,27.59,2019
"2756297",266,3,77,346,76.88,0.87,22.25,2019
"2756326",489,27,134,650,75.23,4.15,20.62,2019
"2756331",648,24,181,853,75.97,2.81,21.22,2019
"2756340",735,43,268,1046,70.27,4.11,25.62,2019
"2756343",351,21,74,446,78.7,4.71,16.59,2019
"2756354",496,8,95,599,82.8,1.34,15.86,2019
"2756369",207,0,53,260,79.62,0,20.38,2019
"2756374",2704,339,241,3284,82.34,10.32,7.34,2019
"2756378",2392,69,676,3137,76.25,2.2,21.55,2019
"2756379",6059,284,644,6987,86.72,4.06,9.22,2019
"2756381",880,20,146,1046,84.13,1.91,13.96,2019
"2756384",119,0,49,168,70.83,0,29.17,2019
"2756401",10423,295,1774,12492,83.44,2.36,14.2,2019
"2756425",2853,62,331,3246,87.89,1.91,10.2,2019
"2756440",360,27,145,532,67.67,5.08,27.26,2019
"2756447",401,15,72,488,82.17,3.07,14.75,2019
"2756448",114,2,29,145,78.62,1.38,20,2019
"2756461",1140,21,139,1300,87.69,1.62,10.69,2019
"2756524",229,14,70,313,73.16,4.47,22.36,2019
"2756529",1540,46,135,1721,89.48,2.67,7.84,2019
"2756546",81,8,15,104,77.88,7.69,14.42,2019
"2756551",664,52,184,900,73.78,5.78,20.44,2019
"2756581",80,4,24,108,74.07,3.7,22.22,2019
"2756588",155,15,34,204,75.98,7.35,16.67,2019
"2756010",406,9,102,517,78.53,1.74,19.73,2019
"2756013",1587,51,379,2017,78.68,2.53,18.79,2019
"2756014",215,5,59,279,77.06,1.79,21.15,2019
"2756017",586,15,58,659,88.92,2.28,8.8,2019
"2756019",247,10,95,352,70.17,2.84,26.99,2019
"2756027",242,6,83,331,73.11,1.81,25.08,2019
"2756033",114,8,39,161,70.81,4.97,24.22,2019
"2756036",615,10,188,813,75.65,1.23,23.12,2019
"2756045",323,4,65,392,82.4,1.02,16.58,2019
"2756062",946,102,235,1283,73.73,7.95,18.32,2019
"2756069",1502,46,266,1814,82.8,2.54,14.66,2019
"2756081",1604,102,652,2358,68.02,4.33,27.65,2019
"2756087",1019,19,225,1263,80.68,1.5,17.81,2019
"2756098",675,30,190,895,75.42,3.35,21.23,2019
"2756110",554,25,141,720,76.94,3.47,19.58,2019
"2756111",137,4,39,180,76.11,2.22,21.67,2019
"2756117",98,11,25,134,73.13,8.21,18.66,2019
"2756127",117,5,45,167,70.06,2.99,26.95,2019
"2756128",657,25,130,812,80.91,3.08,16.01,2019
"2756129",269,0,67,336,80.06,0,19.94,2019
"2964065",8,0,0,8,100,0,0,2019
"2964092",17,0,0,17,100,0,0,2019
"2964420",28,0,6,34,82.35,0,17.65,2019
"2964654",17,0,5,22,77.27,0,22.73,2019
"2964765",4,0,9,13,30.77,0,69.23,2019
"2964165",118,0,0,118,100,0,0,2019
"2067869",489,12,76,577,84.75,2.08,13.17,2019
"2067436",195,3,63,261,74.71,1.15,24.14,2019
"2067443",541,13,95,649,83.36,2,14.64,2019
"2067454",237,12,59,308,76.95,3.9,19.16,2019
"2067459",71,6,21,98,72.45,6.12,21.43,2019
"2067473",565,21,210,796,70.98,2.64,26.38,2019
"2067475",44,6,7,57,77.19,10.53,12.28,2019
"2067478",20,1,10,31,64.52,3.23,32.26,2019
"2067510",56,2,39,97,57.73,2.06,40.21,2019
"2067521",58,0,3,61,95.08,0,4.92,2019
"2067529",59,1,18,78,75.64,1.28,23.08,2019
"2067544",1009,47,191,1247,80.91,3.77,15.32,2019
"2067548",546,9,114,669,81.61,1.35,17.04,2019
"2067559",4,0,0,4,100,0,0,2019
"2067560",568,17,142,727,78.13,2.34,19.53,2019
"2067578",385,20,152,557,69.12,3.59,27.29,2019
"2067621",147,6,7,160,91.88,3.75,4.38,2019
"2067631",52,0,18,70,74.29,0,25.71,2019
"2067639",60,1,11,72,83.33,1.39,15.28,2019
"2067651",142,7,50,199,71.36,3.52,25.13,2019
"2067658",37,0,14,51,72.55,0,27.45,2019
"2067664",95,0,18,113,84.07,0,15.93,2019
"2067673",35,0,8,43,81.4,0,18.6,2019
"2067731",244,3,74,321,76.01,0.93,23.05,2019
"2067654",1094,9,251,1354,80.8,0.66,18.54,2019
"2067659",50,0,0,50,100,0,0,2019
"2067660",44,0,0,44,100,0,0,2019
"2067661",1123,40,249,1412,79.53,2.83,17.63,2019
"2067665",1594,66,549,2209,72.16,2.99,24.85,2019
"2067672",1006,8,157,1171,85.91,0.68,13.41,2019
"2067674",19,0,9,28,67.86,0,32.14,2019
"2067701",2380,214,284,2878,82.7,7.44,9.87,2019
"2067739",62,6,19,87,71.26,6.9,21.84,2019
"2067764",145,0,10,155,93.55,0,6.45,2019
"2067801",7954,180,1906,10040,79.22,1.79,18.98,2019
"2067834",290,11,48,349,83.09,3.15,13.75,2019
"2067841",108,0,40,148,72.97,0,27.03,2019
"2067140",283,4,64,351,80.63,1.14,18.23,2019
"2067144",894,3,108,1005,88.96,0.3,10.75,2019
"2067361",451,37,222,710,63.52,5.21,31.27,2019
"2067410",3345,100,860,4305,77.7,2.32,19.98,2019
"2067417",44,0,17,61,72.13,0,27.87,2019
"2067425",163,20,24,207,78.74,9.66,11.59,2019
"2067438",64,0,24,88,72.73,0,27.27,2019
"2067456",1423,49,252,1724,82.54,2.84,14.62,2019
"2067470",162,0,35,197,82.23,0,17.77,2019
"2067480",484,28,101,613,78.96,4.57,16.48,2019
"2067520",94,0,25,119,78.99,0,21.01,2019
"2067009",245,16,108,369,66.4,4.34,29.27,2019
"2067038",230,6,39,275,83.64,2.18,14.18,2019
"2067047",205,8,135,348,58.91,2.3,38.79,2019
"2067061",31,1,25,57,54.39,1.75,43.86,2019
"2067065",82,2,9,93,88.17,2.15,9.68,2019
"2270343",1313,121,456,1890,69.47,6.4,24.13,2019
"2270380",6160,175,2314,8649,71.22,2.02,26.75,2019
"2270452",4180,71,844,5095,82.04,1.39,16.57,2019
"2270552",443,23,89,555,79.82,4.14,16.04,2019
"2270119",10696,560,4663,15919,67.19,3.52,29.29,2019
"2270420",2407,68,506,2981,80.74,2.28,16.97,2019
"1950593",16,0,3,19,84.21,0,15.79,2019
"1950599",140,2,38,180,77.78,1.11,21.11,2019
"1950605",78,1,37,116,67.24,0.86,31.9,2019
"1950634",291,2,68,361,80.61,0.55,18.84,2019
"1950641",324,9,172,505,64.16,1.78,34.06,2019
"1950647",697,28,140,865,80.58,3.24,16.18,2019
"1950659",1857,53,486,2396,77.5,2.21,20.28,2019
"1950660",436,12,58,506,86.17,2.37,11.46,2019
"1950662",2256,76,587,2919,77.29,2.6,20.11,2019
"1950671",57,3,17,77,74.03,3.9,22.08,2019
"1950674",1215,58,275,1548,78.49,3.75,17.76,2019
"1950677",4036,103,515,4654,86.72,2.21,11.07,2019
"1950682",656,15,47,718,91.36,2.09,6.55,2019
"1950833",766,38,157,961,79.71,3.95,16.34,2019
"1950836",97,5,54,156,62.18,3.21,34.62,2019
"1950702",6944,209,1194,8347,83.19,2.5,14.3,2019
"1950835",29,0,7,36,80.56,0,19.44,2019
"1950837",113,9,32,154,73.38,5.84,20.78,2019
"1950858",236,10,70,316,74.68,3.16,22.15,2019
"1950446",196,5,41,242,80.99,2.07,16.94,2019
"1950454",36,0,0,36,100,0,0,2019
"1950458",756,12,146,914,82.71,1.31,15.97,2019
"1950459",930,50,245,1225,75.92,4.08,20,2019
"1950466",455,16,179,650,70,2.46,27.54,2019
"1950471",218,17,49,284,76.76,5.99,17.25,2019
"1950479",212,10,38,260,81.54,3.85,14.62,2019
"1950524",166,31,35,232,71.55,13.36,15.09,2019
"1950026",185,5,70,260,71.15,1.92,26.92,2019
"1950060",771,8,233,1012,76.19,0.79,23.02,2019
"1950611",97,2,40,139,69.78,1.44,28.78,2019
"1950588",3781,82,590,4453,84.91,1.84,13.25,2019
"1950591",120,8,23,151,79.47,5.3,15.23,2019
"1950594",73,2,9,84,86.9,2.38,10.71,2019
"1950595",2926,128,793,3847,76.06,3.33,20.61,2019
"1950598",302,20,95,417,72.42,4.8,22.78,2019
"1950601",860,23,171,1054,81.59,2.18,16.22,2019
"1950613",14251,700,1379,16330,87.27,4.29,8.44,2019
"1950616",3317,93,1037,4447,74.59,2.09,23.32,2019
"1950627",905,44,334,1283,70.54,3.43,26.03,2019
"1950628",321,16,166,503,63.82,3.18,33,2019
"1950632",361,9,97,467,77.3,1.93,20.77,2019
"1950635",496,27,143,666,74.47,4.05,21.47,2019
"1950636",593,32,150,775,76.52,4.13,19.35,2019
"1950672",184,7,56,247,74.49,2.83,22.67,2019
"1950707",2612,84,732,3428,76.2,2.45,21.35,2019
"1950801",3193,158,674,4025,79.33,3.93,16.75,2019
"1950860",57,2,19,78,73.08,2.56,24.36,2019
"1950862",49,2,13,64,76.56,3.12,20.31,2019
"1950863",67,6,8,81,82.72,7.41,9.88,2019
"1950315",11400,448,2667,14515,78.54,3.09,18.37,2019
"1950401",10316,460,2433,13209,78.1,3.48,18.42,2019
"1950420",94,1,21,116,81.03,0.86,18.1,2019
"1950465",61,0,31,92,66.3,0,33.7,2019
"1952659",446,14,111,571,78.11,2.45,19.44,2019
"1952701",40,0,7,47,85.11,0,14.89,2019
"1952737",120,1,15,136,88.24,0.74,11.03,2019
"1952750",166,6,26,198,83.84,3.03,13.13,2019
"1952778",1509,57,160,1726,87.43,3.3,9.27,2019
"1952765",108,6,33,147,73.47,4.08,22.45,2019
"2649783",6348,257,1282,7887,80.49,3.26,16.25,2019
"2649788",978,37,131,1146,85.34,3.23,11.43,2019
"2649799",672,19,208,899,74.75,2.11,23.14,2019
"2649022",8488,753,3739,12980,65.39,5.8,28.81,2019
"2649028",1934,100,486,2520,76.75,3.97,19.29,2019
"2649796",124,0,37,161,77.02,0,22.98,2019
"2649718",198,25,77,300,66,8.33,25.67,2019
"2649826",63,0,25,88,71.59,0,28.41,2019
"2649839",143,4,26,173,82.66,2.31,15.03,2019
"2649852",40,0,9,49,81.63,0,18.37,2019
"2649854",2125,109,514,2748,77.33,3.97,18.7,2019
"2649864",18,0,33,51,35.29,0,64.71,2019
"2649870",1202,171,285,1658,72.5,10.31,17.19,2019
"2649885",590,35,146,771,76.52,4.54,18.94,2019
"2649891",191,5,59,255,74.9,1.96,23.14,2019
"2649905",453,12,130,595,76.13,2.02,21.85,2019
"2649910",93,12,33,138,67.39,8.7,23.91,2019
"2649922",212,18,57,287,73.87,6.27,19.86,2019
"2649963",262,3,114,379,69.13,0.79,30.08,2019
"2649017",7287,196,1431,8914,81.75,2.2,16.05,2019
"2649024",10807,228,910,11945,90.47,1.91,7.62,2019
"2649046",2574,206,698,3478,74.01,5.92,20.07,2019
"2649053",2438,21,289,2748,88.72,0.76,10.52,2019
"2649065",1988,131,403,2522,78.83,5.19,15.98,2019
"2649071",3305,34,261,3600,91.81,0.94,7.25,2019
"2649072",956,22,176,1154,82.84,1.91,15.25,2019
"2649080",5117,109,877,6103,83.84,1.79,14.37,2019
"2649083",2749,18,291,3058,89.9,0.59,9.52,2019
"2649746",1103,33,426,1562,70.61,2.11,27.27,2019
"2649765",1191,76,410,1677,71.02,4.53,24.45,2019
"2649766",694,54,196,944,73.52,5.72,20.76,2019
"2649774",633,11,143,787,80.43,1.4,18.17,2019
"2649793",47,6,35,88,53.41,6.82,39.77,2019
"2649802",2095,87,651,2833,73.95,3.07,22.98,2019
"2649808",87,0,32,119,73.11,0,26.89,2019
"2649816",205,12,77,294,69.73,4.08,26.19,2019
"2649835",279,1,117,397,70.28,0.25,29.47,2019
"2649840",208,6,58,272,76.47,2.21,21.32,2019
"2649871",178,2,38,218,81.65,0.92,17.43,2019
"2649874",291,19,74,384,75.78,4.95,19.27,2019
"2649878",1139,35,390,1564,72.83,2.24,24.94,2019
"2649879",352,10,127,489,71.98,2.04,25.97,2019
"2649895",189,5,50,244,77.46,2.05,20.49,2019
"2649908",693,36,206,935,74.12,3.85,22.03,2019
"2649918",40,4,19,63,63.49,6.35,30.16,2019
"2649919",77,0,10,87,88.51,0,11.49,2019
"2649925",171,20,36,227,75.33,8.81,15.86,2019
"2649241",847,14,208,1069,79.23,1.31,19.46,2019
"2649228",1808,86,239,2133,84.76,4.03,11.2,2019
"2649331",5725,161,830,6716,85.24,2.4,12.36,2019
"2649333",3764,47,575,4386,85.82,1.07,13.11,2019
"2649337",3728,146,1229,5103,73.06,2.86,24.08,2019
"2649341",12025,157,824,13006,92.46,1.21,6.34,2019
"5553826",382,12,127,521,73.32,2.3,24.38,2019
"5553911",397,10,86,493,80.53,2.03,17.44,2019
"5553934",1507,56,452,2015,74.79,2.78,22.43,2019
"5553951",699,30,184,913,76.56,3.29,20.15,2019
"5553953",96,4,20,120,80,3.33,16.67,2019
"5553956",1020,29,217,1266,80.57,2.29,17.14,2019
"2964436",298,2,18,318,93.71,0.63,5.66,2019
"2965614",157,2,55,214,73.36,0.93,25.7,2019
"2965616",9412,546,1534,11492,81.9,4.75,13.35,2019
"2965617",385,0,79,464,82.97,0,17.03,2019
"2965619",2420,93,435,2948,82.09,3.15,14.76,2019
"2965623",3,0,2,5,60,0,40,2019
"2965626",459,3,238,700,65.57,0.43,34,2019
"2965640",217,0,43,260,83.46,0,16.54,2019
"2965646",529,17,161,707,74.82,2.4,22.77,2019
"2965668",520,7,250,777,66.92,0.9,32.18,2019
"2965672",2957,193,458,3608,81.96,5.35,12.69,2019
"2965689",1540,233,417,2190,70.32,10.64,19.04,2019
"2965705",1112,29,408,1549,71.79,1.87,26.34,2019
"2965711",2874,226,964,4064,70.72,5.56,23.72,2019
"2965766",27,3,12,42,64.29,7.14,28.57,2019
"2965767",553,21,192,766,72.19,2.74,25.07,2019
"2965775",7493,358,2087,9938,75.4,3.6,21,2019
"2965781",2723,159,365,3247,83.86,4.9,11.24,2019
"2965783",18,0,21,39,46.15,0,53.85,2019
"2965793",1744,103,550,2397,72.76,4.3,22.95,2019
"2965274",554,9,104,667,83.06,1.35,15.59,2019
"2965339",142,8,34,184,77.17,4.35,18.48,2019
"2965320",12,0,9,21,57.14,0,42.86,2019
"2965332",385,33,144,562,68.51,5.87,25.62,2019
"2965337",476,25,182,683,69.69,3.66,26.65,2019
"2965459",1738,135,555,2428,71.58,5.56,22.86,2019
"2965461",16,0,27,43,37.21,0,62.79,2019
"2965479",70,0,23,93,75.27,0,24.73,2019
"2965484",0,0,17,17,0,0,100,2019
"2965501",14,0,46,60,23.33,0,76.67,2019
"2965564",42,0,0,42,100,0,0,2019
"2965571",467,15,292,774,60.34,1.94,37.73,2019
"2965605",4226,179,783,5188,81.46,3.45,15.09,2019
"2965625",2115,241,768,3124,67.7,7.71,24.58,2019
"2965627",122,0,124,246,49.59,0,50.41,2019
"2965630",111,2,1,114,97.37,1.75,0.88,2019
"2965632",722,65,206,993,72.71,6.55,20.75,2019
"2965637",416,0,69,485,85.77,0,14.23,2019
"2965638",155,28,35,218,71.1,12.84,16.06,2019
"2965660",74,0,5,79,93.67,0,6.33,2019
"2965679",768,10,161,939,81.79,1.06,17.15,2019
"2965723",919,96,280,1295,70.97,7.41,21.62,2019
"2965788",90,48,25,163,55.21,29.45,15.34,2019
"2965790",281,0,74,355,79.15,0,20.85,2019
"2965804",14717,1137,2558,18412,79.93,6.18,13.89,2019
"2965018",2117,177,628,2922,72.45,6.06,21.49,2019
"2965046",365,34,105,504,72.42,6.75,20.83,2019
"2965047",424,0,14,438,96.8,0,3.2,2019
"2965049",2700,56,173,2929,92.18,1.91,5.91,2019
"2965061",178,27,84,289,61.59,9.34,29.07,2019
"2965064",133,18,71,222,59.91,8.11,31.98,2019
"2965081",785,39,348,1172,66.98,3.33,29.69,2019
"2965324",370,1,207,578,64.01,0.17,35.81,2019
"2649027",38,14,51,103,36.89,13.59,49.51,2019
"2649032",755,15,319,1089,69.33,1.38,29.29,2019
"2649040",1013,12,351,1376,73.62,0.87,25.51,2019
"2649042",1435,67,463,1965,73.03,3.41,23.56,2019
"2649055",1863,161,398,2422,76.92,6.65,16.43,2019
"2649067",1295,73,381,1749,74.04,4.17,21.78,2019
"2270528",693,15,204,912,75.99,1.64,22.37,2019
"2270092",1760,31,509,2300,76.52,1.35,22.13,2019
"2270342",1289,34,389,1712,75.29,1.99,22.72,2019
"2270032",1242,102,339,1683,73.8,6.06,20.14,2019
"2270448",8446,179,612,9237,91.44,1.94,6.63,2019
"2270520",5491,74,1451,7016,78.26,1.05,20.68,2019
"2270631",103,0,56,159,64.78,0,35.22,2019
"2270658",200,14,71,285,70.18,4.91,24.91,2019
"2270725",451,30,126,607,74.3,4.94,20.76,2019
"2270767",5027,163,794,5984,84.01,2.72,13.27,2019
"2270818",3168,0,553,3721,85.14,0,14.86,2019
"2270139",0,0,0,0,NA,NA,NA,2019
"2270340",77,0,22,99,77.78,0,22.22,2019
"2270352",55,0,11,66,83.33,0,16.67,2019
"2270402",0,0,0,0,NA,NA,NA,2019
"2270519",39,0,39,78,50,0,50,2019
"2270575",0,14,16,30,0,46.67,53.33,2019
"2270803",0,0,0,0,NA,NA,NA,2019
"2270757",708,62,430,1200,59,5.17,35.83,2019
"2271006",3679,418,729,4826,76.23,8.66,15.11,2019
"2271024",322,22,291,635,50.71,3.46,45.83,2019
"2271073",411,55,408,874,47.03,6.29,46.68,2019
"2271075",1125,35,1604,2764,40.7,1.27,58.03,2019
"2271078",2040,93,400,2533,80.54,3.67,15.79,2019
"2271082",972,201,812,1985,48.97,10.13,40.91,2019
"2271110",743,157,83,983,75.58,15.97,8.44,2019
"2271115",5727,111,1212,7050,81.23,1.57,17.19,2019
"0571933",273,0,288,561,48.66,0,51.34,2019
"0571973",423,7,140,570,74.21,1.23,24.56,2019
"0571941",587,23,248,858,68.41,2.68,28.9,2019
"0571953",4136,412,1299,5847,70.74,7.05,22.22,2019
"0571972",100,6,44,150,66.67,4,29.33,2019
"2271417",1252,112,750,2114,59.22,5.3,35.48,2019
"2271430",782,11,290,1083,72.21,1.02,26.78,2019
"2271450",231,0,215,446,51.79,0,48.21,2019
"2271465",830,17,264,1111,74.71,1.53,23.76,2019
"2271474",129,0,45,174,74.14,0,25.86,2019
"0571603",8174,843,3791,12808,63.82,6.58,29.6,2019
"0571659",5,0,28,33,15.15,0,84.85,2019
"0571667",1624,207,959,2790,58.21,7.42,34.37,2019
"0571676",92,12,80,184,50,6.52,43.48,2019
"0571740",226,6,394,626,36.1,0.96,62.94,2019
"0571745",77,3,51,131,58.78,2.29,38.93,2019
"0571753",3750,293,1788,5831,64.31,5.02,30.66,2019
"0571758",80,0,56,136,58.82,0,41.18,2019
"0571770",885,107,351,1343,65.9,7.97,26.14,2019
"0571822",2531,89,1048,3668,69,2.43,28.57,2019
"0571832",2877,82,690,3649,78.84,2.25,18.91,2019
"0571839",70,0,65,135,51.85,0,48.15,2019
"0571846",656,57,285,998,65.73,5.71,28.56,2019
"0571855",148,29,50,227,65.2,12.78,22.03,2019
"0571859",147,0,97,244,60.25,0,39.75,2019
"0571922",40,0,17,57,70.18,0,29.82,2019
"1760021",1987,14,83,2084,95.35,0.67,3.98,2019
"1760031",12840,214,1049,14103,91.04,1.52,7.44,2019
"1760040",1565,18,314,1897,82.5,0.95,16.55,2019
"1760041",2799,79,413,3291,85.05,2.4,12.55,2019
"1760045",7189,98,318,7605,94.53,1.29,4.18,2019
"1760061",8991,228,681,9900,90.82,2.3,6.88,2019
"1952595",112,7,13,132,84.85,5.3,9.85,2019
"1952623",574,20,130,724,79.28,2.76,17.96,2019
"1952722",12976,335,1275,14586,88.96,2.3,8.74,2019
"1952747",642,18,136,796,80.65,2.26,17.09,2019
"1952769",217,1,24,242,89.67,0.41,9.92,2019
"1952804",8031,213,2330,10574,75.95,2.01,22.04,2019
"1952620",258,11,74,343,75.22,3.21,21.57,2019
"1952621",222,20,47,289,76.82,6.92,16.26,2019
"1952625",864,41,200,1105,78.19,3.71,18.1,2019
"1952627",4127,145,813,5085,81.16,2.85,15.99,2019
"1952637",800,10,147,957,83.59,1.04,15.36,2019
"1952647",69,8,9,86,80.23,9.3,10.47,2019
"1952650",251,9,41,301,83.39,2.99,13.62,2019
"1952660",33,0,26,59,55.93,0,44.07,2019
"1952730",1850,78,414,2342,78.99,3.33,17.68,2019
"1952746",362,4,43,409,88.51,0.98,10.51,2019
"1952755",698,12,67,777,89.83,1.54,8.62,2019
"1952766",216,25,107,348,62.07,7.18,30.75,2019
"1952768",504,3,104,611,82.49,0.49,17.02,2019
"1952772",1698,28,366,2092,81.17,1.34,17.5,2019
"1952803",6839,344,1533,8716,78.46,3.95,17.59,2019
"1952807",5408,146,976,6530,82.82,2.24,14.95,2019
"1952003",4451,242,561,5254,84.72,4.61,10.68,2019
"1952030",138,3,29,170,81.18,1.76,17.06,2019
"1952069",436,10,103,549,79.42,1.82,18.76,2019
"1952070",349,3,109,461,75.7,0.65,23.64,2019
"1952076",733,32,185,950,77.16,3.37,19.47,2019
"1952133",237,0,51,288,82.29,0,17.71,2019
"1952135",249,0,61,310,80.32,0,19.68,2019
"1952155",390,21,139,550,70.91,3.82,25.27,2019
"1952161",534,13,67,614,86.97,2.12,10.91,2019
"1952168",75,4,57,136,55.15,2.94,41.91,2019
"1952170",161,0,58,219,73.52,0,26.48,2019
"1952175",1092,71,309,1472,74.18,4.82,20.99,2019
"1952213",1351,9,148,1508,89.59,0.6,9.81,2019
"1952215",243,2,67,312,77.88,0.64,21.47,2019
"1952218",602,3,115,720,83.61,0.42,15.97,2019
"1952227",973,3,76,1052,92.49,0.29,7.22,2019
"1952229",266,17,32,315,84.44,5.4,10.16,2019
"1952245",8519,261,624,9404,90.59,2.78,6.64,2019
"1952247",1368,47,475,1890,72.38,2.49,25.13,2019
"1952257",68,0,24,92,73.91,0,26.09,2019
"1952321",114,12,28,154,74.03,7.79,18.18,2019
"1952053",270,11,83,364,74.18,3.02,22.8,2019
"1952057",2614,97,544,3255,80.31,2.98,16.71,2019
"1952068",1534,28,114,1676,91.53,1.67,6.8,2019
"1952073",444,19,60,523,84.89,3.63,11.47,2019
"1952079",267,0,84,351,76.07,0,23.93,2019
"1952154",265,16,110,391,67.77,4.09,28.13,2019
"1952156",151,5,52,208,72.6,2.4,25,2019
"1952162",874,113,317,1304,67.02,8.67,24.31,2019
"1952164",105,2,20,127,82.68,1.57,15.75,2019
"1952165",277,2,45,324,85.49,0.62,13.89,2019
"2755767",943,65,251,1259,74.9,5.16,19.94,2019
"2755769",842,34,254,1130,74.51,3.01,22.48,2019
"2755779",1277,30,195,1502,85.02,2,12.98,2019
"2755797",518,32,114,664,78.01,4.82,17.17,2019
"2755902",8995,501,865,10361,86.82,4.84,8.35,2019
"2755909",451,5,105,561,80.39,0.89,18.72,2019
"5553959",4564,121,535,5220,87.43,2.32,10.25,2019
"5553963",4173,98,1027,5298,78.77,1.85,19.38,2019
"5553001",707,14,102,823,85.91,1.7,12.39,2019
"5553005",7054,85,483,7622,92.55,1.12,6.34,2019
"5553012",6576,223,611,7410,88.74,3.01,8.25,2019
"5553014",2635,73,628,3336,78.99,2.19,18.82,2019
"5553711",19237,603,1365,21205,90.72,2.84,6.44,2019
"5553545",8273,427,1347,10047,82.34,4.25,13.41,2019
"5553020",1327,84,195,1606,82.63,5.23,12.14,2019
"5553027",7877,289,1075,9241,85.24,3.13,11.63,2019
"5553032",1567,17,338,1922,81.53,0.88,17.59,2019
"5553044",891,7,66,964,92.43,0.73,6.85,2019
"5553047",10,0,43,53,18.87,0,81.13,2019
"5553065",678,35,156,869,78.02,4.03,17.95,2019
"5553069",251,0,60,311,80.71,0,19.29,2019
"5553072",9828,173,709,10710,91.76,1.62,6.62,2019
"5553078",616,24,72,712,86.52,3.37,10.11,2019
"5553092",7610,192,693,8495,89.58,2.26,8.16,2019
"5553129",5171,58,614,5843,88.5,0.99,10.51,2019
"5553149",6822,122,590,7534,90.55,1.62,7.83,2019
"5553010",2549,76,350,2975,85.68,2.55,11.76,2019
"5553017",1917,22,117,2056,93.24,1.07,5.69,2019
"5553040",2763,61,374,3198,86.4,1.91,11.69,2019
"5553051",13757,319,1278,15354,89.6,2.08,8.32,2019
"5553080",1979,39,342,2360,83.86,1.65,14.49,2019
"5553104",1886,40,239,2165,87.11,1.85,11.04,2019
"5553120",3443,122,387,3952,87.12,3.09,9.79,2019
"5553156",1006,34,207,1247,80.67,2.73,16.6,2019
"5553178",952,24,175,1151,82.71,2.09,15.2,2019
"5553184",1232,102,242,1576,78.17,6.47,15.36,2019
"5553192",0,0,0,0,NA,NA,NA,2019
"5553218",10824,389,2662,13875,78.01,2.8,19.19,2019
"5553221",12627,281,3043,15951,79.16,1.76,19.08,2019
"5553227",8721,301,1847,10869,80.24,2.77,16.99,2019
"5553585",721,24,107,852,84.62,2.82,12.56,2019
"5553594",1838,41,315,2194,83.77,1.87,14.36,2019
"5553804",382,18,126,526,72.62,3.42,23.95,2019
"5553807",1645,28,313,1986,82.83,1.41,15.76,2019
"5553821",2633,126,576,3335,78.95,3.78,17.27,2019
"5553910",1105,69,442,1616,68.38,4.27,27.35,2019
"5553916",8050,139,1408,9597,83.88,1.45,14.67,2019
"5553928",35,2,6,43,81.4,4.65,13.95,2019
"5553937",252,18,113,383,65.8,4.7,29.5,2019
"5553946",1181,67,401,1649,71.62,4.06,24.32,2019
"5553949",2120,38,534,2692,78.75,1.41,19.84,2019
"5553955",2069,74,374,2517,82.2,2.94,14.86,2019
"5553181",2544,67,233,2844,89.45,2.36,8.19,2019
"5553816",183,3,74,260,70.38,1.15,28.46,2019
"5553817",44,0,33,77,57.14,0,42.86,2019
"5553913",7320,339,1320,8979,81.52,3.78,14.7,2019
"5553920",172,4,34,210,81.9,1.9,16.19,2019
"5553924",397,23,158,578,68.69,3.98,27.34,2019
"5553004",1135,18,123,1276,88.95,1.41,9.64,2019
"2755350",6754,134,873,7761,87.02,1.73,11.25,2019
"2755362",6143,180,665,6988,87.91,2.58,9.52,2019
"2755364",5755,51,378,6184,93.06,0.82,6.11,2019
"2755369",14306,139,930,15375,93.05,0.9,6.05,2019
"2755374",4822,62,369,5253,91.8,1.18,7.02,2019
"2755379",13606,390,1115,15111,90.04,2.58,7.38,2019
"2649073",1462,34,363,1859,78.64,1.83,19.53,2019
"2649088",1332,38,118,1488,89.52,2.55,7.93,2019
"2649116",98,0,27,125,78.4,0,21.6,2019
"2649119",27,0,8,35,77.14,0,22.86,2019
"2649125",781,87,221,1089,71.72,7.99,20.29,2019
"2649221",11742,497,2487,14726,79.74,3.37,16.89,2019
"2649235",565,63,181,809,69.84,7.79,22.37,2019
"2649240",3176,78,391,3645,87.13,2.14,10.73,2019
"2649252",749,51,237,1037,72.23,4.92,22.85,2019
"2649259",666,29,223,918,72.55,3.16,24.29,2019
"2649965",167,5,47,219,76.26,2.28,21.46,2019
"2649970",96,1,30,127,75.59,0.79,23.62,2019
"2649264",598,25,89,712,83.99,3.51,12.5,2019
"2649269",1990,48,226,2264,87.9,2.12,9.98,2019
"2649323",3168,19,368,3555,89.11,0.53,10.35,2019
"2649402",402,27,119,548,73.36,4.93,21.72,2019
"2649404",2435,101,511,3047,79.91,3.31,16.77,2019
"2649405",403,58,129,590,68.31,9.83,21.86,2019
"2649418",9510,156,1236,10902,87.23,1.43,11.34,2019
"2649127",3771,217,444,4432,85.09,4.9,10.02,2019
"2649129",237,21,24,282,84.04,7.45,8.51,2019
"2649201",13057,358,2013,15428,84.63,2.32,13.05,2019
"2649220",804,31,189,1024,78.52,3.03,18.46,2019
"2649752",219,27,69,315,69.52,8.57,21.9,2019
"2649753",732,33,172,937,78.12,3.52,18.36,2019
"2649759",536,12,167,715,74.97,1.68,23.36,2019
"2649762",228,1,102,331,68.88,0.3,30.82,2019
"2649769",560,32,89,681,82.23,4.7,13.07,2019
"2649801",3782,238,663,4683,80.76,5.08,14.16,2019
"2649817",189,7,39,235,80.43,2.98,16.6,2019
"2649827",266,6,148,420,63.33,1.43,35.24,2019
"2649834",53,0,31,84,63.1,0,36.9,2019
"2649838",155,0,72,227,68.28,0,31.72,2019
"2649876",449,0,66,515,87.18,0,12.82,2019
"2649881",97,6,22,125,77.6,4.8,17.6,2019
"2649893",514,16,169,699,73.53,2.29,24.18,2019
"2649901",99,3,33,135,73.33,2.22,24.44,2019
"2649912",304,20,137,461,65.94,4.34,29.72,2019
"2649927",153,10,38,201,76.12,4.98,18.91,2019
"2649929",66,8,15,89,74.16,8.99,16.85,2019
"2649938",2509,211,918,3638,68.97,5.8,25.23,2019
"2649968",677,51,190,918,73.75,5.56,20.7,2019
"2649971",172,18,22,212,81.13,8.49,10.38,2019
"2649453",966,9,191,1166,82.85,0.77,16.38,2019
"2649460",2667,50,256,2973,89.71,1.68,8.61,2019
"2649544",3504,92,438,4034,86.86,2.28,10.86,2019
"2649616",604,10,139,753,80.21,1.33,18.46,2019
"2649625",343,6,101,450,76.22,1.33,22.44,2019
"2649630",586,35,74,695,84.32,5.04,10.65,2019
"2649634",12,0,5,17,70.59,0,29.41,2019
"2649680",495,41,164,700,70.71,5.86,23.43,2019
"2649686",12533,362,1159,14054,89.18,2.58,8.25,2019
"2649689",461,19,112,592,77.87,3.21,18.92,2019
"5553579",641,23,66,730,87.81,3.15,9.04,2019
"5553580",166,9,50,225,73.78,4,22.22,2019
"5553018",2788,44,296,3128,89.13,1.41,9.46,2019
"5553021",1593,55,219,1867,85.32,2.95,11.73,2019
"5553022",7081,85,641,7807,90.7,1.09,8.21,2019
"5553033",1835,32,167,2034,90.22,1.57,8.21,2019
"1760069",2943,95,369,3407,86.38,2.79,10.83,2019
"1760071",1358,10,118,1486,91.39,0.67,7.94,2019
"1760084",5682,45,629,6356,89.4,0.71,9.9,2019
"1760088",1102,12,51,1165,94.59,1.03,4.38,2019
"1760112",1393,0,49,1442,96.6,0,3.4,2019
"1760123",14282,315,2259,16856,84.73,1.87,13.4,2019
"1760134",9902,77,430,10409,95.13,0.74,4.13,2019
"1760139",10544,158,712,11414,92.38,1.38,6.24,2019
"1760140",6008,209,175,6392,93.99,3.27,2.74,2019
"1760152",3898,58,528,4484,86.93,1.29,11.78,2019
"1760172",8532,67,490,9089,93.87,0.74,5.39,2019
"1760176",3122,90,1092,4304,72.54,2.09,25.37,2019
"1760177",6942,102,600,7644,90.82,1.33,7.85,2019
"1760180",557,0,10,567,98.24,0,1.76,2019
"1760181",9548,134,1047,10729,88.99,1.25,9.76,2019
"1760190",4075,57,304,4436,91.86,1.28,6.85,2019
"1760203",1467,8,55,1530,95.88,0.52,3.59,2019
"1760301",1437,66,178,1681,85.48,3.93,10.59,2019
"1760302",11624,445,1461,13530,85.91,3.29,10.8,2019
"1760304",5887,232,273,6392,92.1,3.63,4.27,2019
"1760949",177,5,29,211,83.89,2.37,13.74,2019
"1760953",753,13,246,1012,74.41,1.28,24.31,2019
"1760957",1713,24,391,2128,80.5,1.13,18.37,2019
"1760959",392,12,77,481,81.5,2.49,16.01,2019
"1760974",73,12,15,100,73,12,15,2019
"1760966",517,15,103,635,81.42,2.36,16.22,2019
"1760968",145,9,12,166,87.35,5.42,7.23,2019
"4657466",55,0,6,61,90.16,0,9.84,2019
"4657472",227,28,94,349,65.04,8.02,26.93,2019
"4657481",151,2,14,167,90.42,1.2,8.38,2019
"4657523",334,6,114,454,73.57,1.32,25.11,2019
"4657537",53,0,0,53,100,0,0,2019
"4657569",89,0,27,116,76.72,0,23.28,2019
"4657576",66,0,36,102,64.71,0,35.29,2019
"4657634",34,3,0,37,91.89,8.11,0,2019
"4657638",641,21,166,828,77.42,2.54,20.05,2019
"4657658",43,0,68,111,38.74,0,61.26,2019
"4657660",24,0,6,30,80,0,20,2019
"4657703",5571,267,402,6240,89.28,4.28,6.44,2019
"4657706",832,28,35,895,92.96,3.13,3.91,2019
"4657717",2503,62,675,3240,77.25,1.91,20.83,2019
"4657744",747,17,87,851,87.78,2,10.22,2019
"4657038",461,51,99,611,75.45,8.35,16.2,2019
"4657039",1081,44,246,1371,78.85,3.21,17.94,2019
"4657048",434,9,47,490,88.57,1.84,9.59,2019
"4657059",413,5,145,563,73.36,0.89,25.75,2019
"4657069",3946,155,324,4425,89.18,3.5,7.32,2019
"4657071",1053,129,103,1285,81.95,10.04,8.02,2019
"4657107",3815,40,275,4130,92.37,0.97,6.66,2019
"4657108",8440,147,266,8853,95.33,1.66,3,2019
"4657566",94,12,181,287,32.75,4.18,63.07,2019
"4657579",200,19,222,441,45.35,4.31,50.34,2019
"4657376",259,19,118,396,65.4,4.8,29.8,2019
"2066418",122,3,37,162,75.31,1.85,22.84,2019
"2066449",283,10,94,387,73.13,2.58,24.29,2019
"2066002",3578,161,1004,4743,75.44,3.39,21.17,2019
"2066865",402,11,77,490,82.04,2.24,15.71,2019
"2066846",1092,36,205,1333,81.92,2.7,15.38,2019
"2066857",366,2,83,451,81.15,0.44,18.4,2019
"2755925",385,11,34,430,89.53,2.56,7.91,2019
"2755936",572,25,124,721,79.33,3.47,17.2,2019
"2755953",272,10,67,349,77.94,2.87,19.2,2019
"2755973",82,7,16,105,78.1,6.67,15.24,2019
"2755979",254,5,82,341,74.49,1.47,24.05,2019
"2755007",667,22,248,937,71.18,2.35,26.47,2019
"2755020",1259,5,23,1287,97.82,0.39,1.79,2019
"2755021",8961,245,1768,10974,81.66,2.23,16.11,2019
"2755037",1350,60,474,1884,71.66,3.18,25.16,2019
"2755043",1315,29,113,1457,90.25,1.99,7.76,2019
"2755052",627,36,130,793,79.07,4.54,16.39,2019
"2755055",1266,41,115,1422,89.03,2.88,8.09,2019
"2755056",4344,85,598,5027,86.41,1.69,11.9,2019
"2755079",2918,63,232,3213,90.82,1.96,7.22,2019
"2755436",5235,181,325,5741,91.19,3.15,5.66,2019
"2755441",7196,250,331,7777,92.53,3.21,4.26,2019
"2755450",7,0,0,7,100,0,0,2019
"2755604",1389,52,283,1724,80.57,3.02,16.42,2019
"2755607",68,2,14,84,80.95,2.38,16.67,2019
"2755703",247,6,79,332,74.4,1.81,23.8,2019
"2755705",1021,68,300,1389,73.51,4.9,21.6,2019
"2755748",559,13,124,696,80.32,1.87,17.82,2019
"2755750",808,34,120,962,83.99,3.53,12.47,2019
"2755752",143,15,45,203,70.44,7.39,22.17,2019
"2755790",724,27,176,927,78.1,2.91,18.99,2019
"2755793",231,14,63,308,75,4.55,20.45,2019
"2755344",6135,163,749,7047,87.06,2.31,10.63,2019
"2755353",1135,39,180,1354,83.83,2.88,13.29,2019
"2755355",3130,191,644,3965,78.94,4.82,16.24,2019
"2755360",839,19,80,938,89.45,2.03,8.53,2019
"2755367",305,16,58,379,80.47,4.22,15.3,2019
"2755370",223,6,49,278,80.22,2.16,17.63,2019
"2755372",11265,210,651,12126,92.9,1.73,5.37,2019
"2755382",1245,50,154,1449,85.92,3.45,10.63,2019
"2755388",1871,116,192,2179,85.87,5.32,8.81,2019
"2755389",783,30,206,1019,76.84,2.94,20.22,2019
"2755408",13372,322,1656,15350,87.11,2.1,10.79,2019
"2755423",12957,393,1915,15265,84.88,2.57,12.55,2019
"2755431",6838,291,829,7958,85.93,3.66,10.42,2019
"2755447",8117,139,340,8596,94.43,1.62,3.96,2019
"2755713",352,27,98,477,73.79,5.66,20.55,2019
"2755448",9482,227,865,10574,89.67,2.15,8.18,2019
"2755612",244,23,5,272,89.71,8.46,1.84,2019
"2755716",102,3,46,151,67.55,1.99,30.46,2019
"2755720",5117,176,1431,6724,76.1,2.62,21.28,2019
"2755722",305,31,153,489,62.37,6.34,31.29,2019
"2755723",758,17,201,976,77.66,1.74,20.59,2019
"2755725",77,0,7,84,91.67,0,8.33,2019
"2755731",2428,39,437,2904,83.61,1.34,15.05,2019
"2755775",469,14,150,633,74.09,2.21,23.7,2019
"2755780",36,7,28,71,50.7,9.86,39.44,2019
"2755781",279,5,56,340,82.06,1.47,16.47,2019
"2755782",146,6,34,186,78.49,3.23,18.28,2019
"2964439",463,8,110,581,79.69,1.38,18.93,2019
"2964465",1495,99,297,1891,79.06,5.24,15.71,2019
"2964469",654,37,175,866,75.52,4.27,20.21,2019
"2964496",17,0,9,26,65.38,0,34.62,2019
"2964652",112,0,58,170,65.88,0,34.12,2019
"2964655",78,0,25,103,75.73,0,24.27,2019
"2755384",848,63,187,1098,77.23,5.74,17.03,2019
"2755030",409,1,98,508,80.51,0.2,19.29,2019
"2755071",1873,18,188,2079,90.09,0.87,9.04,2019
"2755341",1005,8,43,1056,95.17,0.76,4.07,2019
"2755317",7675,194,238,8107,94.67,2.39,2.94,2019
"2755336",2314,146,486,2946,78.55,4.96,16.5,2019
"2755357",994,28,143,1165,85.32,2.4,12.27,2019
"2755359",2080,25,139,2244,92.69,1.11,6.19,2019
"2755375",1458,4,54,1516,96.17,0.26,3.56,2019
"2755376",4779,185,411,5375,88.91,3.44,7.65,2019
"2755402",361,27,20,408,88.48,6.62,4.9,2019
"2755407",12482,549,1889,14920,83.66,3.68,12.66,2019
"2755414",9200,2070,760,12030,76.48,17.21,6.32,2019
"2755429",8075,368,1443,9886,81.68,3.72,14.6,2019
"2755435",5798,290,984,7072,81.99,4.1,13.91,2019
"2755438",6662,185,283,7130,93.44,2.59,3.97,2019
"2755439",3238,105,151,3494,92.67,3.01,4.32,2019
"2755906",6819,150,642,7611,89.59,1.97,8.44,2019
"2755963",1795,68,267,2130,84.27,3.19,12.54,2019
"2755950",35,2,23,60,58.33,3.33,38.33,2019
"2755951",488,15,150,653,74.73,2.3,22.97,2019
"2755952",791,17,153,961,82.31,1.77,15.92,2019
"2755960",1120,20,119,1259,88.96,1.59,9.45,2019
"2755985",595,29,106,730,81.51,3.97,14.52,2019
"2755990",263,15,100,378,69.58,3.97,26.46,2019
"2755969",366,6,25,397,92.19,1.51,6.3,2019
"2755805",3626,248,955,4829,75.09,5.14,19.78,2019
"2755971",937,35,170,1142,82.05,3.06,14.89,2019
"2755941",337,12,72,421,80.05,2.85,17.1,2019
"2755387",4288,156,381,4825,88.87,3.23,7.9,2019
"2755403",9502,731,1077,11310,84.01,6.46,9.52,2019
"2755315",1713,41,102,1856,92.3,2.21,5.5,2019
"2755352",2920,61,331,3312,88.16,1.84,9.99,2019
"2755354",881,12,191,1084,81.27,1.11,17.62,2019
"2755084",589,20,52,661,89.11,3.03,7.87,2019
"2755029",27,0,6,33,81.82,0,18.18,2019
"2755054",738,0,0,738,100,0,0,2019
"2755111",13,8,4,25,52,32,16,2019
"2755130",4376,142,1018,5536,79.05,2.57,18.39,2019
"2755155",0,0,0,0,NA,NA,NA,2019
"2755366",178,9,34,221,80.54,4.07,15.38,2019
"2755766",7,0,1,8,87.5,0,12.5,2019
"2755772",24,2,7,33,72.73,6.06,21.21,2019
"2755814",0,0,0,0,NA,NA,NA,2019
"2755905",0,0,0,0,NA,NA,NA,2019
"2755968",40,0,4,44,90.91,0,9.09,2019
"2755302",2573,54,418,3045,84.5,1.77,13.73,2019
"2755418",11300,262,1681,13243,85.33,1.98,12.69,2019
"2755422",10646,481,1573,12700,83.83,3.79,12.39,2019
"2755432",10744,276,1123,12143,88.48,2.27,9.25,2019
"2755444",4502,86,435,5023,89.63,1.71,8.66,2019
"2755616",2726,86,481,3293,82.78,2.61,14.61,2019
"2755702",202,0,29,231,87.45,0,12.55,2019
"2964458",35,0,18,53,66.04,0,33.96,2019
"2964473",455,6,186,647,70.32,0.93,28.75,2019
"2964476",105,0,31,136,77.21,0,22.79,2019
"2964491",674,30,194,898,75.06,3.34,21.6,2019
"2964507",4080,103,878,5061,80.62,2.04,17.35,2019
"2964623",108,7,35,150,72,4.67,23.33,2019
"5553039",1404,20,264,1688,83.18,1.18,15.64,2019
"5553050",2310,64,431,2805,82.35,2.28,15.37,2019
"5553075",1208,9,135,1352,89.35,0.67,9.99,2019
"5553079",498,23,92,613,81.24,3.75,15.01,2019
"5553090",7520,168,944,8632,87.12,1.95,10.94,2019
"5553094",6397,149,986,7532,84.93,1.98,13.09,2019
"5553128",2749,51,273,3073,89.46,1.66,8.88,2019
"5553139",853,33,119,1005,84.88,3.28,11.84,2019
"5553143",7311,191,1344,8846,82.65,2.16,15.19,2019
"5553154",13172,421,1121,14714,89.52,2.86,7.62,2019
"5553191",1029,2,220,1251,82.25,0.16,17.59,2019
"5553213",9876,277,1267,11420,86.48,2.43,11.09,2019
"5553216",9813,373,2985,13171,74.5,2.83,22.66,2019
"5553223",9576,480,2285,12341,77.6,3.89,18.52,2019
"5553226",7086,229,933,8248,85.91,2.78,11.31,2019
"5553235",3729,163,811,4703,79.29,3.47,17.24,2019
"5553515",830,35,132,997,83.25,3.51,13.24,2019
"5553530",1400,44,370,1814,77.18,2.43,20.4,2019
"5553532",5082,340,546,5968,85.15,5.7,9.15,2019
"5553538",5928,248,1205,7381,80.31,3.36,16.33,2019
"5553540",74,3,23,100,74,3,23,2019
"5554015",1149,45,160,1354,84.86,3.32,11.82,2019
"5554016",11161,287,1023,12471,89.5,2.3,8.2,2019
"5554023",1315,53,155,1523,86.34,3.48,10.18,2019
"5554024",1644,74,356,2074,79.27,3.57,17.16,2019
"5554612",1433,32,455,1920,74.64,1.67,23.7,2019
"5554621",418,17,86,521,80.23,3.26,16.51,2019
"5554637",76,0,22,98,77.55,0,22.45,2019
"5554651",343,22,171,536,63.99,4.1,31.9,2019
"5554967",112,12,55,179,62.57,6.7,30.73,2019
"5554844",113,0,22,135,83.7,0,16.3,2019
"5554875",389,12,107,508,76.57,2.36,21.06,2019
"5554911",8656,255,1429,10340,83.71,2.47,13.82,2019
"5554923",2893,168,793,3854,75.06,4.36,20.58,2019
"5554929",2953,74,816,3843,76.84,1.93,21.23,2019
"5554934",144,0,9,153,94.12,0,5.88,2019
"5554943",629,16,226,871,72.22,1.84,25.95,2019
"5554964",309,6,53,368,83.97,1.63,14.4,2019
"5554966",608,23,125,756,80.42,3.04,16.53,2019
"5554001",2581,80,614,3275,78.81,2.44,18.75,2019
"5554007",324,13,96,433,74.83,3,22.17,2019
"5554020",2466,83,359,2908,84.8,2.85,12.35,2019
"5554028",784,11,149,944,83.05,1.17,15.78,2019
"5554104",389,5,150,544,71.51,0.92,27.57,2019
"5554106",1520,49,438,2007,75.73,2.44,21.82,2019
"5554111",816,6,150,972,83.95,0.62,15.43,2019
"5554114",1885,47,524,2456,76.75,1.91,21.34,2019
"5554115",15883,368,1344,17595,90.27,2.09,7.64,2019
"5554129",996,11,263,1270,78.43,0.87,20.71,2019
"5554138",363,14,101,478,75.94,2.93,21.13,2019
"5554154",1774,64,491,2329,76.17,2.75,21.08,2019
"5554157",2154,59,239,2452,87.85,2.41,9.75,2019
"5554166",5709,191,1357,7257,78.67,2.63,18.7,2019
"2756137",361,31,106,498,72.49,6.22,21.29,2019
"2756158",158,4,20,182,86.81,2.2,10.99,2019
"2756161",111,11,19,141,78.72,7.8,13.48,2019
"2756175",1018,59,200,1277,79.72,4.62,15.66,2019
"2756221",238,14,38,290,82.07,4.83,13.1,2019
"2756229",623,6,107,736,84.65,0.82,14.54,2019
"2066863",12,0,7,19,63.16,0,36.84,2019
"2066958",98,0,10,108,90.74,0,9.26,2019
"2066962",109,3,24,136,80.15,2.21,17.65,2019
"2066966",218,7,89,314,69.43,2.23,28.34,2019
"2066091",99,23,57,179,55.31,12.85,31.84,2019
"2066109",7953,303,727,8983,88.53,3.37,8.09,2019
"2066202",7150,261,667,8078,88.51,3.23,8.26,2019
"2066210",8153,129,300,8582,95,1.5,3.5,2019
"2066949",213,19,74,306,69.61,6.21,24.18,2019
"2066748",850,9,274,1133,75.02,0.79,24.18,2019
"2066749",2479,103,704,3286,75.44,3.13,21.42,2019
"2066751",213,6,71,290,73.45,2.07,24.48,2019
"2066769",115,0,47,162,70.99,0,29.01,2019
"2066843",32,0,34,66,48.48,0,51.52,2019
"2066854",254,3,59,316,80.38,0.95,18.67,2019
"2066861",969,7,321,1297,74.71,0.54,24.75,2019
"2066935",835,21,283,1139,73.31,1.84,24.85,2019
"2066948",151,26,19,196,77.04,13.27,9.69,2019
"2066951",247,5,38,290,85.17,1.72,13.1,2019
"2066953",174,4,70,248,70.16,1.61,28.23,2019
"2066960",53,1,10,64,82.81,1.56,15.62,2019
"2066963",77,1,7,85,90.59,1.18,8.24,2019
"2066967",776,16,129,921,84.26,1.74,14.01,2019
"2066441",8256,447,1361,10064,82.03,4.44,13.52,2019
"2066442",3483,63,235,3781,92.12,1.67,6.22,2019
"2066524",696,63,191,950,73.26,6.63,20.11,2019
"2066533",359,105,124,588,61.05,17.86,21.09,2019
"2066539",758,96,109,963,78.71,9.97,11.32,2019
"2066550",157,1,29,187,83.96,0.53,15.51,2019
"2066609",2178,219,586,2983,73.01,7.34,19.64,2019
"2066610",3416,191,277,3884,87.95,4.92,7.13,2019
"2066701",3588,53,1060,4701,76.32,1.13,22.55,2019
"2066743",1174,58,351,1583,74.16,3.66,22.17,2019
"2066755",246,21,108,375,65.6,5.6,28.8,2019
"2066507",388,9,64,461,84.16,1.95,13.88,2019
"2066516",93,2,28,123,75.61,1.63,22.76,2019
"2066523",1197,20,327,1544,77.53,1.3,21.18,2019
"2066532",239,18,41,298,80.2,6.04,13.76,2019
"2066536",939,34,145,1118,83.99,3.04,12.97,2019
"2066537",330,7,83,420,78.57,1.67,19.76,2019
"2066616",1609,68,748,2425,66.35,2.8,30.85,2019
"2066711",175,4,69,248,70.56,1.61,27.82,2019
"2066039",176,16,38,230,76.52,6.96,16.52,2019
"2066014",103,0,36,139,74.1,0,25.9,2019
"2066016",106,0,28,134,79.1,0,20.9,2019
"2066020",404,5,125,534,75.66,0.94,23.41,2019
"2066042",175,27,83,285,61.4,9.47,29.12,2019
"2066044",9418,453,976,10847,86.83,4.18,9,2019
"2066050",643,59,129,831,77.38,7.1,15.52,2019
"2066058",85,1,27,113,75.22,0.88,23.89,2019
"2066071",3791,467,925,5183,73.14,9.01,17.85,2019
"2066079",268,13,49,330,81.21,3.94,14.85,2019
"2066111",3167,47,520,3734,84.82,1.26,13.93,2019
"2067071",85,0,8,93,91.4,0,8.6,2019
"2067111",79,5,19,103,76.7,4.85,18.45,2019
"2067159",37,0,11,48,77.08,0,22.92,2019
"2067202",614,158,325,1097,55.97,14.4,29.63,2019
"2067203",9831,312,2548,12691,77.46,2.46,20.08,2019
"2067208",6122,342,820,7284,84.05,4.7,11.26,2019
"2964658",1001,32,299,1332,75.15,2.4,22.45,2019
"2964664",131,1,36,168,77.98,0.6,21.43,2019
"2964671",593,2,189,784,75.64,0.26,24.11,2019
"2964681",45,2,5,52,86.54,3.85,9.62,2019
"2964683",2445,16,690,3151,77.59,0.51,21.9,2019
"2964723",238,13,87,338,70.41,3.85,25.74,2019
"2964739",307,13,39,359,85.52,3.62,10.86,2019
"2964743",76,5,24,105,72.38,4.76,22.86,2019
"2964780",151,0,45,196,77.04,0,22.96,2019
"2964783",231,10,101,342,67.54,2.92,29.53,2019
"2964784",367,39,79,485,75.67,8.04,16.29,2019
"2964856",1030,120,430,1580,65.19,7.59,27.22,2019
"2964015",10069,202,1309,11580,86.95,1.74,11.3,2019
"2964021",206,2,42,250,82.4,0.8,16.8,2019
"2964036",75,2,30,107,70.09,1.87,28.04,2019
"2964037",1714,68,512,2294,74.72,2.96,22.32,2019
"2964050",6619,307,2281,9207,71.89,3.33,24.77,2019
"2964052",7225,155,1610,8990,80.37,1.72,17.91,2019
"2964055",12108,219,2201,14528,83.34,1.51,15.15,2019
"2964060",4573,77,467,5117,89.37,1.5,9.13,2019
"2964080",4063,79,595,4737,85.77,1.67,12.56,2019
"2964085",2439,143,825,3407,71.59,4.2,24.21,2019
"2964098",1050,27,223,1300,80.77,2.08,17.15,2019
"2964106",3337,539,444,4320,77.25,12.48,10.28,2019
"2964110",5401,416,1183,7000,77.16,5.94,16.9,2019
"2964111",8078,963,1043,10084,80.11,9.55,10.34,2019
"2964116",6028,701,783,7512,80.24,9.33,10.42,2019
"2964118",14617,634,1504,16755,87.24,3.78,8.98,2019
"2964124",2863,222,1128,4213,67.96,5.27,26.77,2019
"2964149",128,0,23,151,84.77,0,15.23,2019
"2964153",2197,24,181,2402,91.47,1,7.54,2019
"2964453",58,0,23,81,71.6,0,28.4,2019
"2964423",269,7,40,316,85.13,2.22,12.66,2019
"2964430",292,2,57,351,83.19,0.57,16.24,2019
"2964431",113,2,25,140,80.71,1.43,17.86,2019
"2964454",721,38,234,993,72.61,3.83,23.56,2019
"2964463",474,11,143,628,75.48,1.75,22.77,2019
"2964481",269,9,76,354,75.99,2.54,21.47,2019
"2964485",2356,176,548,3080,76.49,5.71,17.79,2019
"2964492",635,20,72,727,87.35,2.75,9.9,2019
"2964494",267,10,81,358,74.58,2.79,22.63,2019
"2964074",226,5,54,285,79.3,1.75,18.95,2019
"2964089",4300,96,386,4782,89.92,2.01,8.07,2019
"2964101",15,0,0,15,100,0,0,2019
"2964108",3595,458,363,4416,81.41,10.37,8.22,2019
"2964120",125,2,39,166,75.3,1.2,23.49,2019
"2964133",12298,576,1948,14822,82.97,3.89,13.14,2019
"2964146",719,0,28,747,96.25,0,3.75,2019
"2964152",10189,142,426,10757,94.72,1.32,3.96,2019
"2964155",8099,251,372,8722,92.86,2.88,4.27,2019
"2964158",1788,113,14,1915,93.37,5.9,0.73,2019
"2964437",167,12,61,240,69.58,5,25.42,2019
"2964440",201,14,67,282,71.28,4.96,23.76,2019
"1950473",49,2,57,108,45.37,1.85,52.78,2019
"1950475",507,17,126,650,78,2.62,19.38,2019
"1950510",385,10,58,453,84.99,2.21,12.8,2019
"1950520",44,7,2,53,83.02,13.21,3.77,2019
"1950528",109,0,21,130,83.85,0,16.15,2019
"1950530",343,5,99,447,76.73,1.12,22.15,2019
"2964632",131,10,36,177,74.01,5.65,20.34,2019
"2964637",160,14,48,222,72.07,6.31,21.62,2019
"2964653",185,13,90,288,64.24,4.51,31.25,2019
"2964672",25,0,38,63,39.68,0,60.32,2019
"2964674",128,8,46,182,70.33,4.4,25.27,2019
"2964676",48,5,21,74,64.86,6.76,28.38,2019
"2964689",209,0,31,240,87.08,0,12.92,2019
"2964701",4279,266,991,5536,77.29,4.8,17.9,2019
"2964730",1930,97,724,2751,70.16,3.53,26.32,2019
"2964733",348,23,74,445,78.2,5.17,16.63,2019
"2964746",383,34,144,561,68.27,6.06,25.67,2019
"2964756",195,0,94,289,67.47,0,32.53,2019
"2964849",53,5,6,64,82.81,7.81,9.38,2019
"2964854",648,85,736,1469,44.11,5.79,50.1,2019
"2964861",121,36,201,358,33.8,10.06,56.15,2019
"2964747",1128,72,265,1465,77,4.91,18.09,2019
"2964750",107,2,58,167,64.07,1.2,34.73,2019
"2964752",199,25,67,291,68.38,8.59,23.02,2019
"2964761",404,20,92,516,78.29,3.88,17.83,2019
"2964767",304,0,16,320,95,0,5,2019
"2964779",638,49,306,993,64.25,4.93,30.82,2019
"2964804",11627,477,1920,14024,82.91,3.4,13.69,2019
"2964835",591,47,125,763,77.46,6.16,16.38,2019
"2964847",76,14,103,193,39.38,7.25,53.37,2019
"2964858",56,0,0,56,100,0,0,2019
"2964863",259,23,295,577,44.89,3.99,51.13,2019
"2964865",1613,114,561,2288,70.5,4.98,24.52,2019
"2964639",74,0,13,87,85.06,0,14.94,2019
"2964641",197,6,70,273,72.16,2.2,25.64,2019
"2964648",400,22,274,696,57.47,3.16,39.37,2019
"2964649",200,2,70,272,73.53,0.74,25.74,2019
"2964657",141,4,12,157,89.81,2.55,7.64,2019
"2964659",313,13,65,391,80.05,3.32,16.62,2019
"2964682",60,4,55,119,50.42,3.36,46.22,2019
"2964728",179,1,34,214,83.64,0.47,15.89,2019
"2964740",607,56,201,864,70.25,6.48,23.26,2019
"2964771",129,6,55,190,67.89,3.16,28.95,2019
"2964029",6031,149,422,6602,91.35,2.26,6.39,2019
"2964735",4629,206,850,5685,81.42,3.62,14.95,2019
"2964831",1333,337,563,2233,59.7,15.09,25.21,2019
"2964836",6452,400,1746,8598,75.04,4.65,20.31,2019
"2964841",150,13,35,198,75.76,6.57,17.68,2019
"2964843",833,68,438,1339,62.21,5.08,32.71,2019
"2964866",316,2,89,407,77.64,0.49,21.87,2019
"2964084",422,0,211,633,66.67,0,33.33,2019
"2964054",931,41,377,1349,69.01,3.04,27.95,2019
"2964128",3280,202,1449,4931,66.52,4.1,29.39,2019
"2964499",15,0,18,33,45.45,0,54.55,2019
"2964686",54,7,23,84,64.29,8.33,27.38,2019
"2964161",117,10,11,138,84.78,7.25,7.97,2019
"2964117",4676,218,822,5716,81.81,3.81,14.38,2019
"2964448",325,15,77,417,77.94,3.6,18.47,2019
"2964497",118,2,13,133,88.72,1.5,9.77,2019
"2649342",544,8,85,637,85.4,1.26,13.34,2019
"2649345",4364,36,868,5268,82.84,0.68,16.48,2019
"2649347",402,17,48,467,86.08,3.64,10.28,2019
"2649403",791,29,140,960,82.4,3.02,14.58,2019
"2649408",2762,82,887,3731,74.03,2.2,23.77,2019
"2649410",499,72,200,771,64.72,9.34,25.94,2019
"2649749",1380,139,364,1883,73.29,7.38,19.33,2019
"2649332",958,21,239,1218,78.65,1.72,19.62,2019
"2649338",555,29,196,780,71.15,3.72,25.13,2019
"2649411",458,9,159,626,73.16,1.44,25.4,2019
"2649421",1529,101,692,2322,65.85,4.35,29.8,2019
"2649435",1094,20,149,1263,86.62,1.58,11.8,2019
"2649440",322,69,219,610,52.79,11.31,35.9,2019
"2649444",7706,253,2079,10038,76.77,2.52,20.71,2019
"2649448",1142,91,265,1498,76.23,6.07,17.69,2019
"2649455",1324,48,449,1821,72.71,2.64,24.66,2019
"2649464",8986,268,1023,10277,87.44,2.61,9.95,2019
"2649503",13053,793,1926,15772,82.76,5.03,12.21,2019
"2649782",256,12,26,294,87.07,4.08,8.84,2019
"2649791",125,0,10,135,92.59,0,7.41,2019
"2649807",1249,19,244,1512,82.61,1.26,16.14,2019
"2649002",7349,74,1013,8436,87.11,0.88,12.01,2019
"2649030",572,25,277,874,65.45,2.86,31.69,2019
"2649033",629,18,76,723,87,2.49,10.51,2019
"2649051",728,22,197,947,76.87,2.32,20.8,2019
"2649057",1694,33,488,2215,76.48,1.49,22.03,2019
"2649068",5195,113,1063,6371,81.54,1.77,16.68,2019
"2649078",2963,109,657,3729,79.46,2.92,17.62,2019
"2649089",488,11,148,647,75.43,1.7,22.87,2019
"2649092",576,20,187,783,73.56,2.55,23.88,2019
"2649289",36,4,20,60,60,6.67,33.33,2019
"2649276",262,3,74,339,77.29,0.88,21.83,2019
"2649277",1092,19,278,1389,78.62,1.37,20.01,2019
"2649285",1826,71,235,2132,85.65,3.33,11.02,2019
"2649305",676,32,256,964,70.12,3.32,26.56,2019
"2649325",615,4,76,695,88.49,0.58,10.94,2019
"2649911",848,141,237,1226,69.17,11.5,19.33,2019
"2649913",2077,135,525,2737,75.89,4.93,19.18,2019
"2649915",142,2,28,172,82.56,1.16,16.28,2019
"2649952",31,0,8,39,79.49,0,20.51,2019
"2649961",26,3,17,46,56.52,6.52,36.96,2019
"2649962",81,6,25,112,72.32,5.36,22.32,2019
"2649267",1333,51,203,1587,83.99,3.21,12.79,2019
"2649268",380,14,89,483,78.67,2.9,18.43,2019
"2649270",1779,96,248,2123,83.8,4.52,11.68,2019
"2649284",865,58,246,1169,73.99,4.96,21.04,2019
"2649304",975,80,492,1547,63.03,5.17,31.8,2019
"2649306",3588,64,269,3921,91.51,1.63,6.86,2019
"2649307",5728,381,975,7084,80.86,5.38,13.76,2019
"2649309",455,12,267,734,61.99,1.63,36.38,2019
"2649310",691,48,317,1056,65.44,4.55,30.02,2019
"2649312",82,7,49,138,59.42,5.07,35.51,2019
"2649321",6070,171,581,6822,88.98,2.51,8.52,2019
"2649329",2256,54,745,3055,73.85,1.77,24.39,2019
"2649406",363,6,34,403,90.07,1.49,8.44,2019
"2649426",11439,209,865,12513,91.42,1.67,6.91,2019
"2649525",10569,145,877,11591,91.18,1.25,7.57,2019
"2649442",11243,479,3524,15246,73.74,3.14,23.11,2019
"2649446",796,61,110,967,82.32,6.31,11.38,2019
"5554180",1165,17,131,1313,88.73,1.29,9.98,2019
"5554201",1607,44,537,2188,73.45,2.01,24.54,2019
"5554205",645,14,123,782,82.48,1.79,15.73,2019
"5554207",56,0,4,60,93.33,0,6.67,2019
"5554212",451,22,15,488,92.42,4.51,3.07,2019
"5554217",2242,54,564,2860,78.39,1.89,19.72,2019
"2067214",3275,432,2330,6037,54.25,7.16,38.6,2019
"2067341",137,0,0,137,100,0,0,2019
"2067356",821,33,241,1095,74.98,3.01,22.01,2019
"2067547",598,25,191,814,73.46,3.07,23.46,2019
"2067550",1576,63,502,2141,73.61,2.94,23.45,2019
"2067422",417,40,128,585,71.28,6.84,21.88,2019
"2067554",1349,74,268,1691,79.78,4.38,15.85,2019
"2067573",52,4,32,88,59.09,4.55,36.36,2019
"2067628",43,0,2,45,95.56,0,4.44,2019
"2067629",62,1,0,63,98.41,1.59,0,2019
"2067632",91,0,24,115,79.13,0,20.87,2019
"2067634",72,3,6,81,88.89,3.7,7.41,2019
"2067638",77,0,62,139,55.4,0,44.6,2019
"2067642",651,14,198,863,75.43,1.62,22.94,2019
"2067646",277,0,55,332,83.43,0,16.57,2019
"2067653",168,1,27,196,85.71,0.51,13.78,2019
"2067656",41,0,0,41,100,0,0,2019
"2067625",100,3,18,121,82.64,2.48,14.88,2019
"2067637",896,43,170,1109,80.79,3.88,15.33,2019
"2067647",95,0,10,105,90.48,0,9.52,2019
"2067648",189,0,69,258,73.26,0,26.74,2019
"2067667",56,1,7,64,87.5,1.56,10.94,2019
"2067675",52,0,36,88,59.09,0,40.91,2019
"2067730",685,5,100,790,86.71,0.63,12.66,2019
"2067736",88,4,9,101,87.13,3.96,8.91,2019
"2067738",188,9,62,259,72.59,3.47,23.94,2019
"2067744",47,0,24,71,66.2,0,33.8,2019
"2067751",102,2,26,130,78.46,1.54,20,2019
"2067762",71,0,8,79,89.87,0,10.13,2019
"2067853",214,3,23,240,89.17,1.25,9.58,2019
"2067862",73,3,24,100,73,3,24,2019
"2067863",102,0,26,128,79.69,0,20.31,2019
"2067877",625,7,142,774,80.75,0.9,18.35,2019
"2067951",1192,58,383,1633,72.99,3.55,23.45,2019
"2067151",154,0,32,186,82.8,0,17.2,2019
"2067204",6576,178,1244,7998,82.22,2.23,15.55,2019
"2067211",5653,176,2359,8188,69.04,2.15,28.81,2019
"2067217",9636,241,1663,11540,83.5,2.09,14.41,2019
"2067218",7330,441,1768,9539,76.84,4.62,18.53,2019
"2067235",4335,53,110,4498,96.38,1.18,2.45,2019
"2067335",1063,13,338,1414,75.18,0.92,23.9,2019
"2067336",408,25,216,649,62.87,3.85,33.28,2019
"2067418",40,20,9,69,57.97,28.99,13.04,2019
"2067431",618,49,160,827,74.73,5.93,19.35,2019
"2067879",422,11,86,519,81.31,2.12,16.57,2019
"2067836",42,1,12,55,76.36,1.82,21.82,2019
"2067851",781,24,66,871,89.67,2.76,7.58,2019
"2067855",451,21,173,645,69.92,3.26,26.82,2019
"2067864",574,6,165,745,77.05,0.81,22.15,2019
"2067485",125,7,10,142,88.03,4.93,7.04,2019
"2067492",66,5,11,82,80.49,6.1,13.41,2019
"2067501",7552,389,1836,9777,77.24,3.98,18.78,2019
"2067513",26,0,13,39,66.67,0,33.33,2019
"2271202",5152,221,3284,8657,59.51,2.55,37.93,2019
"2271225",1948,91,496,2535,76.84,3.59,19.57,2019
"2271226",478,7,299,784,60.97,0.89,38.14,2019
"2271232",1201,270,1201,2672,44.95,10.1,44.95,2019
"2271245",1379,18,253,1650,83.58,1.09,15.33,2019
"2271250",38,0,66,104,36.54,0,63.46,2019
"1950539",172,7,38,217,79.26,3.23,17.51,2019
"1950117",42,0,22,64,65.62,0,34.38,2019
"1950141",161,7,38,206,78.16,3.4,18.45,2019
"1950212",1007,62,185,1254,80.3,4.94,14.75,2019
"1950680",378,11,93,482,78.42,2.28,19.29,2019
"1950167",228,5,15,248,91.94,2.02,6.05,2019
"1950144",825,34,221,1080,76.39,3.15,20.46,2019
"1950157",277,4,133,414,66.91,0.97,32.13,2019
"1950161",639,22,80,741,86.23,2.97,10.8,2019
"1950220",2728,88,789,3605,75.67,2.44,21.89,2019
"1950227",7,0,3,10,70,0,30,2019
"1950228",943,19,79,1041,90.59,1.83,7.59,2019
"1950239",15,0,16,31,48.39,0,51.61,2019
"1950242",169,10,46,225,75.11,4.44,20.44,2019
"1950244",703,8,50,761,92.38,1.05,6.57,2019
"1950257",293,11,85,389,75.32,2.83,21.85,2019
"1950250",721,48,161,930,77.53,5.16,17.31,2019
"1950316",4066,330,1302,5698,71.36,5.79,22.85,2019
"1950460",99,0,53,152,65.13,0,34.87,2019
"1950544",124,4,30,158,78.48,2.53,18.99,2019
"1950323",4570,142,167,4879,93.67,2.91,3.42,2019
"1950433",91,0,28,119,76.47,0,23.53,2019
"1950464",194,2,28,224,86.61,0.89,12.5,2019
"1950523",187,10,39,236,79.24,4.24,16.53,2019
"1950574",814,23,157,994,81.89,2.31,15.79,2019
"1950521",97,0,7,104,93.27,0,6.73,2019
"1950557",277,7,46,330,83.94,2.12,13.94,2019
"1950621",513,7,142,662,77.49,1.06,21.45,2019
"1950658",826,23,165,1014,81.46,2.27,16.27,2019
"1950841",832,54,221,1107,75.16,4.88,19.96,2019
"1950848",100,21,22,143,69.93,14.69,15.38,2019
"1950033",4,1,0,5,80,20,0,2019
"1950108",149,4,37,190,78.42,2.11,19.47,2019
"1950151",199,3,52,254,78.35,1.18,20.47,2019
"1950011",0,0,0,0,NA,NA,NA,2019
"1950012",3,5,0,8,37.5,62.5,0,2019
"1950023",12667,536,708,13911,91.06,3.85,5.09,2019
"1950127",0,0,0,0,NA,NA,NA,2019
"1950163",252,0,122,374,67.38,0,32.62,2019
"1950255",25,0,4,29,86.21,0,13.79,2019
"1950319",0,0,0,0,NA,NA,NA,2019
"1950324",1747,89,307,2143,81.52,4.15,14.33,2019
"1950327",3729,88,371,4188,89.04,2.1,8.86,2019
"1950467",32,0,4,36,88.89,0,11.11,2019
"1950620",13,0,6,19,68.42,0,31.58,2019
"1950664",17,0,0,17,100,0,0,2019
"1950839",10,1,13,24,41.67,4.17,54.17,2019
"1950842",28,5,4,37,75.68,13.51,10.81,2019
"1950046",571,5,52,628,90.92,0.8,8.28,2019
"1950070",438,6,132,576,76.04,1.04,22.92,2019
"1950174",391,15,138,544,71.88,2.76,25.37,2019
"1950028",485,16,164,665,72.93,2.41,24.66,2019
"1950130",489,5,67,561,87.17,0.89,11.94,2019
"1952209",368,6,72,446,82.51,1.35,16.14,2019
"1952220",131,0,16,147,89.12,0,10.88,2019
"1952221",100,0,9,109,91.74,0,8.26,2019
"1952235",258,8,72,338,76.33,2.37,21.3,2019
"1952531",1885,164,401,2450,76.94,6.69,16.37,2019
"1952540",421,2,181,604,69.7,0.33,29.97,2019
"2649424",15894,320,1683,17897,88.81,1.79,9.4,2019
"2649434",6,0,0,6,100,0,0,2019
"2649437",2122,114,503,2739,77.47,4.16,18.36,2019
"2649441",12422,368,2331,15121,82.15,2.43,15.42,2019
"2649452",619,11,113,743,83.31,1.48,15.21,2019
"2649099",1983,24,400,2407,82.38,1,16.62,2019
"2649102",502,29,36,567,88.54,5.11,6.35,2019
"2649130",513,0,88,601,85.36,0,14.64,2019
"2649237",920,26,178,1124,81.85,2.31,15.84,2019
"2649271",524,39,172,735,71.29,5.31,23.4,2019
"2649858",4237,241,1200,5678,74.62,4.24,21.13,2019
"2649868",1353,24,350,1727,78.34,1.39,20.27,2019
"2649873",37,0,13,50,74,0,26,2019
"2649880",337,17,121,475,70.95,3.58,25.47,2019
"2649896",459,22,121,602,76.25,3.65,20.1,2019
"2649917",62,0,20,82,75.61,0,24.39,2019
"2649921",136,0,18,154,88.31,0,11.69,2019
"2649931",2551,198,468,3217,79.3,6.15,14.55,2019
"2649942",102,9,21,132,77.27,6.82,15.91,2019
"2649946",1274,23,316,1613,78.98,1.43,19.59,2019
"2649955",117,15,17,149,78.52,10.07,11.41,2019
"2649958",261,0,83,344,75.87,0,24.13,2019
"2649646",2552,82,775,3409,74.86,2.41,22.73,2019
"2649650",1021,1,88,1110,91.98,0.09,7.93,2019
"2649675",316,22,59,397,79.6,5.54,14.86,2019
"2649953",833,66,262,1161,71.75,5.68,22.57,2019
"2649960",43,1,24,68,63.24,1.47,35.29,2019
"2649969",389,61,154,604,64.4,10.1,25.5,2019
"2649768",141,11,29,181,77.9,6.08,16.02,2019
"2649780",464,22,163,649,71.49,3.39,25.12,2019
"2649272",909,8,100,1017,89.38,0.79,9.83,2019
"2649279",269,30,62,361,74.52,8.31,17.17,2019
"2649282",132,0,9,141,93.62,0,6.38,2019
"2649288",373,12,157,542,68.82,2.21,28.97,2019
"2649315",7479,119,722,8320,89.89,1.43,8.68,2019
"2649336",1114,25,355,1494,74.56,1.67,23.76,2019
"2649339",601,30,175,806,74.57,3.72,21.71,2019
"2649344",1123,12,230,1365,82.27,0.88,16.85,2019
"2649009",16210,772,1457,18439,87.91,4.19,7.9,2019
"2649014",6695,84,1413,8192,81.73,1.03,17.25,2019
"2649029",472,9,119,600,78.67,1.5,19.83,2019
"2649034",853,29,127,1009,84.54,2.87,12.59,2019
"2649822",39,2,29,70,55.71,2.86,41.43,2019
"2649833",77,0,35,112,68.75,0,31.25,2019
"2649841",2446,82,390,2918,83.82,2.81,13.37,2019
"2649847",365,14,69,448,81.47,3.12,15.4,2019
"2649006",8616,1124,626,10366,83.12,10.84,6.04,2019
"2649548",10325,326,1371,12022,85.88,2.71,11.4,2019
"2649619",297,22,89,408,72.79,5.39,21.81,2019
"2649627",72,0,18,90,80,0,20,2019
"2649648",846,64,104,1014,83.43,6.31,10.26,2019
"2649667",183,9,35,227,80.62,3.96,15.42,2019
"2649688",722,36,198,956,75.52,3.77,20.71,2019
"5553011",780,13,101,894,87.25,1.45,11.3,2019
"5553013",1089,27,215,1331,81.82,2.03,16.15,2019
"5553015",880,22,142,1044,84.29,2.11,13.6,2019
"5553034",634,6,71,711,89.17,0.84,9.99,2019
"5553046",424,22,58,504,84.13,4.37,11.51,2019
"5553070",1686,20,169,1875,89.92,1.07,9.01,2019
"2756295",98,3,17,118,83.05,2.54,14.41,2019
"2756304",5653,371,849,6873,82.25,5.4,12.35,2019
"2756315",542,21,109,672,80.65,3.12,16.22,2019
"2756320",2721,142,410,3273,83.13,4.34,12.53,2019
"2756330",516,8,70,594,86.87,1.35,11.78,2019
"2756342",908,70,283,1261,72.01,5.55,22.44,2019
"2756359",1038,65,301,1404,73.93,4.63,21.44,2019
"2756368",1453,43,277,1773,81.95,2.43,15.62,2019
"2756371",26,5,14,45,57.78,11.11,31.11,2019
"2756373",978,18,204,1200,81.5,1.5,17,2019
"2756386",240,13,52,305,78.69,4.26,17.05,2019
"2756437",338,23,164,525,64.38,4.38,31.24,2019
"2756444",1175,16,185,1376,85.39,1.16,13.44,2019
"2756517",100,2,16,118,84.75,1.69,13.56,2019
"2756528",560,24,140,724,77.35,3.31,19.34,2019
"2756534",431,8,81,520,82.88,1.54,15.58,2019
"2756537",6097,456,1635,8188,74.46,5.57,19.97,2019
"2756540",628,22,171,821,76.49,2.68,20.83,2019
"2756178",518,42,184,744,69.62,5.65,24.73,2019
"2756187",3968,304,901,5173,76.71,5.88,17.42,2019
"2756208",675,70,281,1026,65.79,6.82,27.39,2019
"2756214",195,15,102,312,62.5,4.81,32.69,2019
"2756215",1502,105,371,1978,75.94,5.31,18.76,2019
"2756216",223,20,38,281,79.36,7.12,13.52,2019
"2756223",470,6,100,576,81.6,1.04,17.36,2019
"2756243",463,15,170,648,71.45,2.31,26.23,2019
"2756249",111,0,20,131,84.73,0,15.27,2019
"2756258",5020,253,647,5920,84.8,4.27,10.93,2019
"2756263",155,1,50,206,75.24,0.49,24.27,2019
"2756266",460,10,153,623,73.84,1.61,24.56,2019
"2756267",2164,102,353,2619,82.63,3.89,13.48,2019
"2756276",62,8,29,99,62.63,8.08,29.29,2019
"2756279",408,17,70,495,82.42,3.43,14.14,2019
"2756296",800,10,193,1003,79.76,1,19.24,2019
"2756309",446,45,71,562,79.36,8.01,12.63,2019
"2756323",183,0,54,237,77.22,0,22.78,2019
"2756382",454,13,118,585,77.61,2.22,20.17,2019
"2756387",2716,222,380,3318,81.86,6.69,11.45,2019
"2756687",12,2,6,20,60,10,30,2019
"2756710",169,28,45,242,69.83,11.57,18.6,2019
"2756760",112,9,35,156,71.79,5.77,22.44,2019
"2756630",634,35,187,856,74.07,4.09,21.85,2019
"2756644",211,21,69,301,70.1,6.98,22.92,2019
"2756647",218,3,39,260,83.85,1.15,15,2019
"2756651",182,7,38,227,80.18,3.08,16.74,2019
"2756662",217,13,44,274,79.2,4.74,16.06,2019
"2756667",182,5,43,230,79.13,2.17,18.7,2019
"2756676",540,15,116,671,80.48,2.24,17.29,2019
"2756711",0,0,0,0,NA,NA,NA,2019
"2756720",1,0,4,5,20,0,80,2019
"2756726",341,186,91,618,55.18,30.1,14.72,2019
"2756737",318,8,82,408,77.94,1.96,20.1,2019
"2756544",1585,49,405,2039,77.73,2.4,19.86,2019
"2648910",12304,460,2934,15698,78.38,2.93,18.69,2019
"2648430",12549,283,1539,14371,87.32,1.97,10.71,2019
"2648435",582,26,127,735,79.18,3.54,17.28,2019
"2648335",9807,135,776,10718,91.5,1.26,7.24,2019
"2648340",7445,129,2088,9662,77.05,1.34,21.61,2019
"2648348",8191,39,482,8712,94.02,0.45,5.53,2019
"2271254",687,66,1002,1755,39.15,3.76,57.09,2019
"2271264",207,5,194,406,50.99,1.23,47.78,2019
"2271282",1699,328,1392,3419,49.69,9.59,40.71,2019
"2271286",87,16,79,182,47.8,8.79,43.41,2019
"2271327",941,74,431,1446,65.08,5.12,29.81,2019
"2271345",22,0,21,43,51.16,0,48.84,2019
"2271353",434,18,269,721,60.19,2.5,37.31,2019
"2271355",793,52,330,1175,67.49,4.43,28.09,2019
"2271375",198,53,205,456,43.42,11.62,44.96,2019
"2271416",217,14,147,378,57.41,3.7,38.89,2019
"2271028",320,9,186,515,62.14,1.75,36.12,2019
"2271001",1159,17,724,1900,61,0.89,38.11,2019
"2271045",228,16,51,295,77.29,5.42,17.29,2019
"0571901",8801,429,2320,11550,76.2,3.71,20.09,2019
"0571909",6612,239,800,7651,86.42,3.12,10.46,2019
"0571923",4324,427,1303,6054,71.42,7.05,21.52,2019
"0571940",476,23,214,713,66.76,3.23,30.01,2019
"0571744",800,71,338,1209,66.17,5.87,27.96,2019
"0571835",308,3,130,441,69.84,0.68,29.48,2019
"0571865",39,0,36,75,52,0,48,2019
"2271029",22,12,39,73,30.14,16.44,53.42,2019
"2271032",725,40,189,954,76,4.19,19.81,2019
"2271040",1202,83,1647,2932,41,2.83,56.17,2019
"2271047",3385,82,916,4383,77.23,1.87,20.9,2019
"2271064",613,55,598,1266,48.42,4.34,47.24,2019
"2271065",308,14,177,499,61.72,2.81,35.47,2019
"2271030",581,0,85,666,87.24,0,12.76,2019
"2271260",619,30,455,1104,56.07,2.72,41.21,2019
"2271201",6795,304,1602,8701,78.09,3.49,18.41,2019
"2271203",10308,321,2834,13463,76.57,2.38,21.05,2019
"2271259",318,105,232,655,48.55,16.03,35.42,2019
"2271044",171,6,107,284,60.21,2.11,37.68,2019
"2271046",315,25,135,475,66.32,5.26,28.42,2019
"2271007",359,0,14,373,96.25,0,3.75,2019
"2271019",2081,79,806,2966,70.16,2.66,27.17,2019
"2271023",955,78,497,1530,62.42,5.1,32.48,2019
"2271049",861,54,417,1332,64.64,4.05,31.31,2019
"2271060",542,64,278,884,61.31,7.24,31.45,2019
"2271072",378,10,244,632,59.81,1.58,38.61,2019
"2271119",3637,133,692,4462,81.51,2.98,15.51,2019
"2271004",128,13,126,267,47.94,4.87,47.19,2019
"2271031",155,5,180,340,45.59,1.47,52.94,2019
"2271034",132,4,8,144,91.67,2.78,5.56,2019
"2271039",588,2,104,694,84.73,0.29,14.99,2019
"2271055",3929,225,3711,7865,49.96,2.86,47.18,2019
"2271220",4461,267,3402,8130,54.87,3.28,41.85,2019
"2271229",297,21,161,479,62,4.38,33.61,2019
"2271237",217,35,284,536,40.49,6.53,52.99,2019
"2271247",299,3,164,466,64.16,0.64,35.19,2019
"2271269",2207,468,1695,4370,50.5,10.71,38.79,2019
"2271270",10416,213,1755,12384,84.11,1.72,14.17,2019
"2271333",143,0,127,270,52.96,0,47.04,2019
"2271357",335,9,319,663,50.53,1.36,48.11,2019
"4657401",11120,624,2105,13849,80.29,4.51,15.2,2019
"4657421",21,0,0,21,100,0,0,2019
"4657424",61,2,19,82,74.39,2.44,23.17,2019
"4657428",167,12,55,234,71.37,5.13,23.5,2019
"4657435",107,0,19,126,84.92,0,15.08,2019
"4657436",149,5,42,196,76.02,2.55,21.43,2019
"1952563",478,1,128,607,78.75,0.16,21.09,2019
"1952574",227,6,103,336,67.56,1.79,30.65,2019
"1952639",618,33,110,761,81.21,4.34,14.45,2019
"1952577",5012,162,933,6107,82.07,2.65,15.28,2019
"1952619",215,0,37,252,85.32,0,14.68,2019
"1952573",38,0,18,56,67.86,0,32.14,2019
"1952332",635,28,138,801,79.28,3.5,17.23,2019
"1952334",71,0,8,79,89.87,0,10.13,2019
"1952340",1153,9,116,1278,90.22,0.7,9.08,2019
"1952347",429,19,109,557,77.02,3.41,19.57,2019
"1952550",193,7,44,244,79.1,2.87,18.03,2019
"1952002",5864,212,619,6695,87.59,3.17,9.25,2019
"1952044",44,0,6,50,88,0,12,2019
"1952045",775,16,157,948,81.75,1.69,16.56,2019
"1952050",161,0,23,184,87.5,0,12.5,2019
"1952134",108,0,17,125,86.4,0,13.6,2019
"1952203",736,36,94,866,84.99,4.16,10.85,2019
"1952207",145,2,20,167,86.83,1.2,11.98,2019
"1952210",207,10,43,260,79.62,3.85,16.54,2019
"1952217",192,2,44,238,80.67,0.84,18.49,2019
"1952242",0,0,0,0,NA,NA,NA,2019
"1952309",169,6,24,199,84.92,3.02,12.06,2019
"1952320",320,14,122,456,70.18,3.07,26.75,2019
"1952325",321,2,52,375,85.6,0.53,13.87,2019
"1952328",1000,23,57,1080,92.59,2.13,5.28,2019
"1952333",2305,35,153,2493,92.46,1.4,6.14,2019
"1952346",470,4,24,498,94.38,0.8,4.82,2019
"1952351",473,0,34,507,93.29,0,6.71,2019
"1952358",1277,44,212,1533,83.3,2.87,13.83,2019
"1952402",15227,459,1643,17329,87.87,2.65,9.48,2019
"1952411",2739,26,87,2852,96.04,0.91,3.05,2019
"1952543",99,0,31,130,76.15,0,23.85,2019
"1952576",191,3,64,258,74.03,1.16,24.81,2019
"1952580",220,0,34,254,86.61,0,13.39,2019
"1952583",111,8,42,161,68.94,4.97,26.09,2019
"1952591",983,22,269,1274,77.16,1.73,21.11,2019
"1952626",339,3,178,520,65.19,0.58,34.23,2019
"1952630",105,2,66,173,60.69,1.16,38.15,2019
"1952635",224,6,98,328,68.29,1.83,29.88,2019
"1952641",3708,150,813,4671,79.38,3.21,17.41,2019
"1952644",126,8,37,171,73.68,4.68,21.64,2019
"1952645",1064,19,329,1412,75.35,1.35,23.3,2019
"1952721",254,3,56,313,81.15,0.96,17.89,2019
"1952726",1629,73,122,1824,89.31,4,6.69,2019
"1952738",1045,17,339,1401,74.59,1.21,24.2,2019
"1952742",2473,12,549,3034,81.51,0.4,18.09,2019
"1952753",1851,8,215,2074,89.25,0.39,10.37,2019
"1952731",239,9,75,323,73.99,2.79,23.22,2019
"1952732",8507,374,2296,11177,76.11,3.35,20.54,2019
"1952757",71,0,12,83,85.54,0,14.46,2019
"1952761",9619,487,1953,12059,79.77,4.04,16.2,2019
"1952767",42,0,0,42,100,0,0,2019
"1952774",35,0,12,47,74.47,0,25.53,2019
"2755784",44,2,3,49,89.8,4.08,6.12,2019
"2755732",490,19,202,711,68.92,2.67,28.41,2019
"2755427",8679,108,862,9649,89.95,1.12,8.93,2019
"2755347",10914,225,348,11487,95.01,1.96,3.03,2019
"2755390",815,14,100,929,87.73,1.51,10.76,2019
"2755391",6199,180,393,6772,91.54,2.66,5.8,2019
"5553081",14661,463,2825,17949,81.68,2.58,15.74,2019
"5553925",2650,148,478,3276,80.89,4.52,14.59,2019
"5553929",859,42,228,1129,76.09,3.72,20.19,2019
"5553933",1060,30,180,1270,83.46,2.36,14.17,2019
"5553936",486,20,96,602,80.73,3.32,15.95,2019
"5553939",78,2,33,113,69.03,1.77,29.2,2019
"5553952",1127,40,269,1436,78.48,2.79,18.73,2019
"5553954",2341,65,451,2857,81.94,2.28,15.79,2019
"5553961",261,18,49,328,79.57,5.49,14.94,2019
"5553968",707,39,271,1017,69.52,3.83,26.65,2019
"5553557",116,7,35,158,73.42,4.43,22.15,2019
"5553705",10372,991,766,12129,85.51,8.17,6.32,2019
"5553919",827,20,185,1032,80.14,1.94,17.93,2019
"5553969",132,0,18,150,88,0,12,2019
"5553210",7210,206,2352,9768,73.81,2.11,24.08,2019
"5553038",1404,4,185,1593,88.14,0.25,11.61,2019
"5553105",10126,310,1145,11581,87.44,2.68,9.89,2019
"5553186",11882,249,1802,13933,85.28,1.79,12.93,2019
"5553516",772,10,130,912,84.65,1.1,14.25,2019
"5553827",67,9,25,101,66.34,8.91,24.75,2019
"5553528",2256,48,197,2501,90.2,1.92,7.88,2019
"5553556",909,55,217,1181,76.97,4.66,18.37,2019
"5553570",849,39,203,1091,77.82,3.57,18.61,2019
"5553571",23,0,13,36,63.89,0,36.11,2019
"5553573",973,45,319,1337,72.77,3.37,23.86,2019
"5553582",411,5,62,478,85.98,1.05,12.97,2019
"5553597",6699,332,433,7464,89.75,4.45,5.8,2019
"5553706",47,12,0,59,79.66,20.34,0,2019
"5553813",1816,32,443,2291,79.27,1.4,19.34,2019
"5553818",4698,141,713,5552,84.62,2.54,12.84,2019
"5553926",301,26,230,557,54.04,4.67,41.29,2019
"5553947",58,5,20,83,69.88,6.02,24.1,2019
"5553083",7231,253,851,8335,86.75,3.04,10.21,2019
"5553085",4226,205,678,5109,82.72,4.01,13.27,2019
"5553202",13473,537,1686,15696,85.84,3.42,10.74,2019
"5553205",1867,155,1289,3311,56.39,4.68,38.93,2019
"5553208",8390,313,3368,12071,69.51,2.59,27.9,2019
"5553211",12803,495,1211,14509,88.24,3.41,8.35,2019
"5553002",873,10,108,991,88.09,1.01,10.9,2019
"5553049",957,45,80,1082,88.45,4.16,7.39,2019
"5553097",1898,8,97,2003,94.76,0.4,4.84,2019
"5553195",64,0,13,77,83.12,0,16.88,2019
"5553505",110,5,33,148,74.32,3.38,22.3,2019
"5553560",1279,60,185,1524,83.92,3.94,12.14,2019
"5553555",3267,194,304,3765,86.77,5.15,8.07,2019
"5553587",368,20,122,510,72.16,3.92,23.92,2019
"5553901",4938,124,1093,6155,80.23,2.01,17.76,2019
"5553048",1158,35,246,1439,80.47,2.43,17.1,2019
"5553125",734,18,54,806,91.07,2.23,6.7,2019
"5553031",0,0,0,0,NA,NA,NA,2019
"5553295",0,0,0,0,NA,NA,NA,2019
"5553501",46,0,0,46,100,0,0,2019
"5553548",6195,376,1086,7657,80.91,4.91,14.18,2019
"2755710",525,32,92,649,80.89,4.93,14.18,2019
"2755711",152,13,34,199,76.38,6.53,17.09,2019
"2755717",144,0,5,149,96.64,0,3.36,2019
"2755746",5415,264,1478,7157,75.66,3.69,20.65,2019
"2755758",58,0,17,75,77.33,0,22.67,2019
"2755765",294,12,69,375,78.4,3.2,18.4,2019
"2756241",1416,62,170,1648,85.92,3.76,10.32,2019
"2756251",266,4,64,334,79.64,1.2,19.16,2019
"2756680",58,2,16,76,76.32,2.63,21.05,2019
"2756007",6930,257,1797,8984,77.14,2.86,20,2019
"2756028",454,3,89,546,83.15,0.55,16.3,2019
"2756037",521,1,100,622,83.76,0.16,16.08,2019
"2756225",236,8,92,336,70.24,2.38,27.38,2019
"2756232",806,31,191,1028,78.4,3.02,18.58,2019
"2756235",150,6,58,214,70.09,2.8,27.1,2019
"2756236",113,12,7,132,85.61,9.09,5.3,2019
"2756244",401,20,58,479,83.72,4.18,12.11,2019
"2756248",252,17,82,351,71.79,4.84,23.36,2019
"2756257",187,3,56,246,76.02,1.22,22.76,2019
"2756265",2532,83,704,3319,76.29,2.5,21.21,2019
"2756287",21,0,15,36,58.33,0,41.67,2019
"2756288",1715,55,238,2008,85.41,2.74,11.85,2019
"2756293",376,21,119,516,72.87,4.07,23.06,2019
"2756314",338,7,100,445,75.96,1.57,22.47,2019
"2756349",288,19,39,346,83.24,5.49,11.27,2019
"2756355",181,4,41,226,80.09,1.77,18.14,2019
"2756361",697,47,229,973,71.63,4.83,23.54,2019
"2756375",298,12,33,343,86.88,3.5,9.62,2019
"2756376",111,6,19,136,81.62,4.41,13.97,2019
"2756385",239,10,101,350,68.29,2.86,28.86,2019
"2756016",357,6,48,411,86.86,1.46,11.68,2019
"2756022",9,0,13,22,40.91,0,59.09,2019
"2756029",263,22,51,336,78.27,6.55,15.18,2019
"2756043",148,9,36,193,76.68,4.66,18.65,2019
"2756050",501,14,90,605,82.81,2.31,14.88,2019
"2756052",259,20,42,321,80.69,6.23,13.08,2019
"2756055",1377,47,290,1714,80.34,2.74,16.92,2019
"2756065",913,35,151,1099,83.08,3.18,13.74,2019
"2756089",58,0,19,77,75.32,0,24.68,2019
"2756091",126,3,16,145,86.9,2.07,11.03,2019
"2756093",4070,63,779,4912,82.86,1.28,15.86,2019
"2756096",1015,28,209,1252,81.07,2.24,16.69,2019
"2756678",381,22,87,490,77.76,4.49,17.76,2019
"2756713",349,8,53,410,85.12,1.95,12.93,2019
"2756732",340,63,89,492,69.11,12.8,18.09,2019
"2756736",358,11,59,428,83.64,2.57,13.79,2019
"2756751",1620,332,365,2317,69.92,14.33,15.75,2019
"2756757",315,17,54,386,81.61,4.4,13.99,2019
"2756762",862,57,155,1074,80.26,5.31,14.43,2019
"2756003",5228,90,880,6198,84.35,1.45,14.2,2019
"2756009",493,3,90,586,84.13,0.51,15.36,2019
"2756032",99,2,11,112,88.39,1.79,9.82,2019
"2756068",356,13,53,422,84.36,3.08,12.56,2019
"2756570",430,30,59,519,82.85,5.78,11.37,2019
"2756549",1490,100,341,1931,77.16,5.18,17.66,2019
"2756553",82,4,18,104,78.85,3.85,17.31,2019
"2756556",313,30,103,446,70.18,6.73,23.09,2019
"2756576",276,20,55,351,78.63,5.7,15.67,2019
"2756585",283,24,113,420,67.38,5.71,26.9,2019
"2648756",1461,19,476,1956,74.69,0.97,24.34,2019
"2648763",1661,76,291,2028,81.9,3.75,14.35,2019
"2648819",872,21,111,1004,86.85,2.09,11.06,2019
"2648822",904,30,112,1046,86.42,2.87,10.71,2019
"2648835",948,6,135,1089,87.05,0.55,12.4,2019
"2648658",1495,55,508,2058,72.64,2.67,24.68,2019
"4657441",194,3,35,232,83.62,1.29,15.09,2019
"4657445",590,8,140,738,79.95,1.08,18.97,2019
"4657451",709,74,109,892,79.48,8.3,12.22,2019
"4657456",203,21,62,286,70.98,7.34,21.68,2019
"4657460",112,0,19,131,85.5,0,14.5,2019
"4657469",1176,28,245,1449,81.16,1.93,16.91,2019
"4657520",35,5,11,51,68.63,9.8,21.57,2019
"4657533",595,22,199,816,72.92,2.7,24.39,2019
"4657552",135,22,69,226,59.73,9.73,30.53,2019
"4657560",44,2,84,130,33.85,1.54,64.62,2019
"4657002",325,44,39,408,79.66,10.78,9.56,2019
"4657003",624,0,64,688,90.7,0,9.3,2019
"4657004",1297,27,202,1526,84.99,1.77,13.24,2019
"4657015",232,2,67,301,77.08,0.66,22.26,2019
"4657022",1614,30,287,1931,83.58,1.55,14.86,2019
"4657052",97,0,15,112,86.61,0,13.39,2019
"4657058",570,32,108,710,80.28,4.51,15.21,2019
"4657063",309,21,42,372,83.06,5.65,11.29,2019
"4657065",131,13,21,165,79.39,7.88,12.73,2019
"4657248",251,8,114,373,67.29,2.14,30.56,2019
"4657257",150,0,74,224,66.96,0,33.04,2019
"4657261",121,10,38,169,71.6,5.92,22.49,2019
"4657268",130,18,47,195,66.67,9.23,24.1,2019
"4657301",6699,275,1103,8077,82.94,3.4,13.66,2019
"4657325",1078,50,219,1347,80.03,3.71,16.26,2019
"4657775",83,12,8,103,80.58,11.65,7.77,2019
"4657759",45,0,32,77,58.44,0,41.56,2019
"4657764",181,26,261,468,38.68,5.56,55.77,2019
"4657773",54,0,19,73,73.97,0,26.03,2019
"4657791",91,1,8,100,91,1,8,2019
"4657787",135,0,0,135,100,0,0,2019
"4657793",766,22,124,912,83.99,2.41,13.6,2019
"4657001",534,40,177,751,71.11,5.33,23.57,2019
"4657012",375,18,105,498,75.3,3.61,21.08,2019
"4657013",1298,46,331,1675,77.49,2.75,19.76,2019
"4657034",298,7,42,347,85.88,2.02,12.1,2019
"4657036",192,7,55,254,75.59,2.76,21.65,2019
"4657040",94,1,67,162,58.02,0.62,41.36,2019
"4657050",104,8,7,119,87.39,6.72,5.88,2019
"4657051",108,5,38,151,71.52,3.31,25.17,2019
"4657024",173,3,49,225,76.89,1.33,21.78,2019
"4657033",1795,48,160,2003,89.62,2.4,7.99,2019
"4657043",414,22,160,596,69.46,3.69,26.85,2019
"4657045",318,29,136,483,65.84,6,28.16,2019
"4657049",2571,92,268,2931,87.72,3.14,9.14,2019
"4657062",380,2,101,483,78.67,0.41,20.91,2019
"4657077",460,6,47,513,89.67,1.17,9.16,2019
"4657221",238,13,69,320,74.38,4.06,21.56,2019
"4657224",45,2,6,53,84.91,3.77,11.32,2019
"4657226",722,8,147,877,82.33,0.91,16.76,2019
"4657234",383,53,77,513,74.66,10.33,15.01,2019
"4657006",8227,356,1119,9702,84.8,3.67,11.53,2019
"4657010",199,5,27,231,86.15,2.16,11.69,2019
"2066115",0,0,0,0,NA,NA,NA,2019
"2066118",0,0,0,0,NA,NA,NA,2019
"2066724",343,0,100,443,77.43,0,22.57,2019
"2066736",1123,16,519,1658,67.73,0.97,31.3,2019
"2066738",82,1,28,111,73.87,0.9,25.23,2019
"2066739",1604,84,375,2063,77.75,4.07,18.18,2019
"2755405",6349,272,764,7385,85.97,3.68,10.35,2019
"2755410",8088,95,467,8650,93.5,1.1,5.4,2019
"2755412",6853,191,1688,8732,78.48,2.19,19.33,2019
"2755413",5617,284,759,6660,84.34,4.26,11.4,2019
"2755415",1686,196,96,1978,85.24,9.91,4.85,2019
"2755426",10910,253,943,12106,90.12,2.09,7.79,2019
"2755428",9429,406,2175,12010,78.51,3.38,18.11,2019
"2755445",3957,15,233,4205,94.1,0.36,5.54,2019
"2755606",100,0,18,118,84.75,0,15.25,2019
"2755614",927,53,179,1159,79.98,4.57,15.44,2019
"2755615",106,8,9,123,86.18,6.5,7.32,2019
"2755704",345,23,70,438,78.77,5.25,15.98,2019
"2755706",663,20,206,889,74.58,2.25,23.17,2019
"2755718",1015,73,226,1314,77.25,5.56,17.2,2019
"2755719",2245,67,282,2594,86.55,2.58,10.87,2019
"2755806",3369,178,710,4257,79.14,4.18,16.68,2019
"2755807",3406,101,727,4234,80.44,2.39,17.17,2019
"2755933",87,1,7,95,91.58,1.05,7.37,2019
"2755943",1054,37,182,1273,82.8,2.91,14.3,2019
"2755945",434,9,95,538,80.67,1.67,17.66,2019
"2755956",603,18,159,780,77.31,2.31,20.38,2019
"2755959",776,24,83,883,87.88,2.72,9.4,2019
"2755962",265,3,65,333,79.58,0.9,19.52,2019
"2755443",9840,325,732,10897,90.3,2.98,6.72,2019
"2755446",8989,186,380,9555,94.08,1.95,3.98,2019
"2755603",184,9,80,273,67.4,3.3,29.3,2019
"2755605",282,12,51,345,81.74,3.48,14.78,2019
"2755609",95,0,0,95,100,0,0,2019
"2755724",282,8,60,350,80.57,2.29,17.14,2019
"2755734",2152,77,452,2681,80.27,2.87,16.86,2019
"2755753",362,7,103,472,76.69,1.48,21.82,2019
"2755763",220,2,43,265,83.02,0.75,16.23,2019
"2755764",192,15,91,298,64.43,5.03,30.54,2019
"2755768",950,0,308,1258,75.52,0,24.48,2019
"2755771",566,18,131,715,79.16,2.52,18.32,2019
"2755795",436,28,131,595,73.28,4.71,22.02,2019
"2755812",3157,52,271,3480,90.72,1.49,7.79,2019
"2755921",1605,62,357,2024,79.3,3.06,17.64,2019
"2755931",128,4,25,157,81.53,2.55,15.92,2019
"2755935",279,6,51,336,83.04,1.79,15.18,2019
"2755947",3005,62,267,3334,90.13,1.86,8.01,2019
"2755955",844,14,54,912,92.54,1.54,5.92,2019
"2755972",1498,57,267,1822,82.22,3.13,14.65,2019
"2755974",689,31,163,883,78.03,3.51,18.46,2019
"2755981",1496,54,199,1749,85.53,3.09,11.38,2019
"2755982",151,0,33,184,82.07,0,17.93,2019
"2755991",457,24,85,566,80.74,4.24,15.02,2019
"2755964",1353,66,323,1742,77.67,3.79,18.54,2019
"2755967",321,12,41,374,85.83,3.21,10.96,2019
"2755983",543,19,119,681,79.74,2.79,17.47,2019
"2755345",8054,211,517,8782,91.71,2.4,5.89,2019
"2755349",1247,81,238,1566,79.63,5.17,15.2,2019
"2755356",1932,19,136,2087,92.57,0.91,6.52,2019
"2964442",291,0,67,358,81.28,0,18.72,2019
"2964075",3564,190,734,4488,79.41,4.23,16.35,2019
"2964053",1732,44,441,2217,78.12,1.98,19.89,2019
"2964068",12648,216,1154,14018,90.23,1.54,8.23,2019
"2964072",176,2,58,236,74.58,0.85,24.58,2019
"2964076",2826,175,708,3709,76.19,4.72,19.09,2019
"2755804",5275,93,396,5764,91.52,1.61,6.87,2019
"2755920",2625,108,213,2946,89.1,3.67,7.23,2019
"2755922",218,4,162,384,56.77,1.04,42.19,2019
"2755924",425,7,108,540,78.7,1.3,20,2019
"2755957",227,9,55,291,78.01,3.09,18.9,2019
"2755961",141,9,32,182,77.47,4.95,17.58,2019
"2755080",788,20,172,980,80.41,2.04,17.55,2019
"2755115",3112,80,359,3551,87.64,2.25,10.11,2019
"2755123",8931,170,402,9503,93.98,1.79,4.23,2019
"2755129",8816,97,133,9046,97.46,1.07,1.47,2019
"2755305",9029,167,739,9935,90.88,1.68,7.44,2019
"2755126",10043,329,800,11172,89.89,2.94,7.16,2019
"2755018",288,18,55,361,79.78,4.99,15.24,2019
"2755013",2206,88,240,2534,87.06,3.47,9.47,2019
"2755014",9071,134,534,9739,93.14,1.38,5.48,2019
"2755027",1027,32,149,1208,85.02,2.65,12.33,2019
"2755045",2685,84,321,3090,86.89,2.72,10.39,2019
"2755068",9816,95,607,10518,93.33,0.9,5.77,2019
"2755090",103,3,35,141,73.05,2.13,24.82,2019
"2755005",1483,17,121,1621,91.49,1.05,7.46,2019
"2755009",2778,41,379,3198,86.87,1.28,11.85,2019
"2755016",10991,299,738,12028,91.38,2.49,6.14,2019
"2755017",242,6,53,301,80.4,1.99,17.61,2019
"2755046",1815,24,110,1949,93.12,1.23,5.64,2019
"2755057",7063,222,753,8038,87.87,2.76,9.37,2019
"2755075",7008,143,910,8061,86.94,1.77,11.29,2019
"2755076",7609,373,873,8855,85.93,4.21,9.86,2019
"2755125",15282,247,791,16320,93.64,1.51,4.85,2019
"2755104",14466,612,1890,16968,85.25,3.61,11.14,2019
"2755105",9685,142,577,10404,93.09,1.36,5.55,2019
"2755114",1353,149,93,1595,84.83,9.34,5.83,2019
"2755119",13649,277,1483,15409,88.58,1.8,9.62,2019
"2755120",1720,81,130,1931,89.07,4.19,6.73,2019
"2755122",11945,189,854,12988,91.97,1.46,6.58,2019
"2755128",10238,192,1207,11637,87.98,1.65,10.37,2019
"2755306",5721,149,480,6350,90.09,2.35,7.56,2019
"2755308",2964,51,202,3217,92.14,1.59,6.28,2019
"2755319",1717,57,155,1929,89.01,2.95,8.04,2019
"2755328",2981,123,289,3393,87.86,3.63,8.52,2019
"2755337",16083,401,1868,18352,87.64,2.19,10.18,2019
"2755338",351,20,73,444,79.05,4.5,16.44,2019
"2755003",893,131,115,1139,78.4,11.5,10.1,2019
"2755060",10175,204,1449,11828,86.02,1.72,12.25,2019
"2755087",138,0,5,143,96.5,0,3.5,2019
"2755329",614,39,173,826,74.33,4.72,20.94,2019
"2755386",2508,13,171,2692,93.16,0.48,6.35,2019
"2755437",7002,147,730,7879,88.87,1.87,9.27,2019
"2755919",364,2,112,478,76.15,0.42,23.43,2019
"2755987",11583,467,1729,13779,84.06,3.39,12.55,2019
"2756621",1435,47,318,1800,79.72,2.61,17.67,2019
"2756629",89,0,15,104,85.58,0,14.42,2019
"2756174",130,3,18,151,86.09,1.99,11.92,2019
"2756218",165,9,42,216,76.39,4.17,19.44,2019
"2965250",166,17,60,243,68.31,7,24.69,2019
"2965251",5523,224,1386,7133,77.43,3.14,19.43,2019
"2965323",289,14,91,394,73.35,3.55,23.1,2019
"2965334",271,14,61,346,78.32,4.05,17.63,2019
"2965473",1950,119,151,2220,87.84,5.36,6.8,2019
"2965567",299,0,225,524,57.06,0,42.94,2019
"5554303",9056,338,2519,11913,76.02,2.84,21.14,2019
"5554405",918,44,185,1147,80.03,3.84,16.13,2019
"5554410",678,13,166,857,79.11,1.52,19.37,2019
"5554418",269,18,102,389,69.15,4.63,26.22,2019
"5554425",589,16,181,786,74.94,2.04,23.03,2019
"5554427",411,12,63,486,84.57,2.47,12.96,2019
"5554974",539,2,78,619,87.08,0.32,12.6,2019
"5554977",529,8,72,609,86.86,1.31,11.82,2019
"5554981",5627,108,942,6677,84.27,1.62,14.11,2019
"5554838",420,12,80,512,82.03,2.34,15.62,2019
"5554021",2125,53,360,2538,83.73,2.09,14.18,2019
"5554401",11202,286,1639,13127,85.34,2.18,12.49,2019
"5554440",985,22,221,1228,80.21,1.79,18,2019
"5554493",194,10,54,258,75.19,3.88,20.93,2019
"5554527",268,19,155,442,60.63,4.3,35.07,2019
"5554629",915,18,191,1124,81.41,1.6,16.99,2019
"5554769",233,10,29,272,85.66,3.68,10.66,2019
"5554856",553,23,102,678,81.56,3.39,15.04,2019
"5554982",2250,110,652,3012,74.7,3.65,21.65,2019
"5554125",152,5,108,265,57.36,1.89,40.75,2019
"5554174",966,16,368,1350,71.56,1.19,27.26,2019
"5554634",1142,33,458,1633,69.93,2.02,28.05,2019
"5554666",917,9,215,1141,80.37,0.79,18.84,2019
"5554819",819,22,231,1072,76.4,2.05,21.55,2019
"5554758",1486,39,366,1891,78.58,2.06,19.35,2019
"5554760",67,5,41,113,59.29,4.42,36.28,2019
"5554940",1500,42,247,1789,83.85,2.35,13.81,2019
"5554828",207,25,116,348,59.48,7.18,33.33,2019
"5554873",1190,36,208,1434,82.98,2.51,14.5,2019
"5554766",506,10,168,684,73.98,1.46,24.56,2019
"5554805",408,53,135,596,68.46,8.89,22.65,2019
"5554806",3490,251,1111,4852,71.93,5.17,22.9,2019
"5554835",307,24,98,429,71.56,5.59,22.84,2019
"5554110",1675,55,338,2068,81,2.66,16.34,2019
"5554701",14115,356,1698,16169,87.3,2.2,10.5,2019
"5554754",599,36,159,794,75.44,4.53,20.03,2019
"5554817",803,31,172,1006,79.82,3.08,17.1,2019
"5554006",212,12,60,284,74.65,4.23,21.13,2019
"5554014",756,18,113,887,85.23,2.03,12.74,2019
"5554113",1242,34,90,1366,90.92,2.49,6.59,2019
"5554832",141,5,36,182,77.47,2.75,19.78,2019
"5554839",114,2,26,142,80.28,1.41,18.31,2019
"5554862",80,1,32,113,70.8,0.88,28.32,2019
"5554880",10326,512,2450,13288,77.71,3.85,18.44,2019
"5554893",1358,48,377,1783,76.16,2.69,21.14,2019
"5554901",11519,716,1603,13838,83.24,5.17,11.58,2019
"5554904",8060,153,769,8982,89.74,1.7,8.56,2019
"5554611",363,7,84,454,79.96,1.54,18.5,2019
"5554562",802,0,123,925,86.7,0,13.3,2019
"5554727",1636,46,369,2051,79.77,2.24,17.99,2019
"5554750",331,16,50,397,83.38,4.03,12.59,2019
"5554153",2484,115,498,3097,80.21,3.71,16.08,2019
"5554540",362,22,98,482,75.1,4.56,20.33,2019
"2756650",235,12,44,291,80.76,4.12,15.12,2019
"2756660",91,3,23,117,77.78,2.56,19.66,2019
"2756671",563,44,268,875,64.34,5.03,30.63,2019
"2756252",389,4,109,502,77.49,0.8,21.71,2019
"2756282",448,37,116,601,74.54,6.16,19.3,2019
"2756284",538,24,220,782,68.8,3.07,28.13,2019
"2066741",53,0,24,77,68.83,0,31.17,2019
"2066773",210,7,95,312,67.31,2.24,30.45,2019
"2066775",40,0,29,69,57.97,0,42.03,2019
"2066777",117,12,143,272,43.01,4.41,52.57,2019
"2965559",2799,135,664,3598,77.79,3.75,18.45,2019
"2965603",64,0,24,88,72.73,0,27.27,2019
"2965613",5482,287,886,6655,82.37,4.31,13.31,2019
"2965629",154,0,108,262,58.78,0,41.22,2019
"2965635",175,3,31,209,83.73,1.44,14.83,2019
"2965667",690,58,351,1099,62.78,5.28,31.94,2019
"2965674",668,78,284,1030,64.85,7.57,27.57,2019
"2965541",91,0,25,116,78.45,0,21.55,2019
"2965552",540,87,201,828,65.22,10.51,24.28,2019
"2965556",1423,34,681,2138,66.56,1.59,31.85,2019
"2965560",4086,278,1563,5927,68.94,4.69,26.37,2019
"2965565",1375,74,592,2041,67.37,3.63,29.01,2019
"2965590",342,0,172,514,66.54,0,33.46,2019
"2965604",987,30,392,1409,70.05,2.13,27.82,2019
"2965609",165,22,108,295,55.93,7.46,36.61,2019
"2965620",71,0,0,71,100,0,0,2019
"2965644",694,63,135,892,77.8,7.06,15.13,2019
"2965652",922,35,410,1367,67.45,2.56,29.99,2019
"2965662",278,7,143,428,64.95,1.64,33.41,2019
"2965764",237,12,240,489,48.47,2.45,49.08,2019
"2965771",400,42,54,496,80.65,8.47,10.89,2019
"2965778",113,0,71,184,61.41,0,38.59,2019
"2965791",1223,59,558,1840,66.47,3.21,30.33,2019
"2965681",666,24,167,857,77.71,2.8,19.49,2019
"2965682",550,52,139,741,74.22,7.02,18.76,2019
"2965692",347,17,195,559,62.08,3.04,34.88,2019
"2965702",61,13,34,108,56.48,12.04,31.48,2019
"2965712",2710,114,617,3441,78.76,3.31,17.93,2019
"2965717",596,40,277,913,65.28,4.38,30.34,2019
"2965722",480,34,35,549,87.43,6.19,6.38,2019
"2965727",70,0,21,91,76.92,0,23.08,2019
"2965740",1157,30,219,1406,82.29,2.13,15.58,2019
"2965754",176,16,66,258,68.22,6.2,25.58,2019
"2965761",386,15,213,614,62.87,2.44,34.69,2019
"2965768",114,0,127,241,47.3,0,52.7,2019
"2965734",818,56,343,1217,67.21,4.6,28.18,2019
"2965014",696,17,314,1027,67.77,1.66,30.57,2019
"2965020",4099,205,1000,5304,77.28,3.87,18.85,2019
"2965024",313,34,104,451,69.4,7.54,23.06,2019
"2965034",111,0,250,361,30.75,0,69.25,2019
"2965040",346,27,115,488,70.9,5.53,23.57,2019
"2965053",552,20,31,603,91.54,3.32,5.14,2019
"2965062",7,0,0,7,100,0,0,2019
"2965067",88,34,29,151,58.28,22.52,19.21,2019
"2965101",7589,999,2211,10799,70.28,9.25,20.47,2019
"2965203",21570,558,2135,24263,88.9,2.3,8.8,2019
"2965232",74,2,36,112,66.07,1.79,32.14,2019
"2965240",2602,189,560,3351,77.65,5.64,16.71,2019
"2965243",549,19,194,762,72.05,2.49,25.46,2019
"2067025",1148,29,178,1355,84.72,2.14,13.14,2019
"2067073",124,0,22,146,84.93,0,15.07,2019
"2067117",587,14,76,677,86.71,2.07,11.23,2019
"2067460",5531,346,775,6652,83.15,5.2,11.65,2019
"2067428",424,20,138,582,72.85,3.44,23.71,2019
"2067432",1639,158,696,2493,65.74,6.34,27.92,2019
"2964081",8348,312,829,9489,87.98,3.29,8.74,2019
"2964083",8137,256,806,9199,88.46,2.78,8.76,2019
"2964086",7778,341,622,8741,88.98,3.9,7.12,2019
"2964096",294,19,123,436,67.43,4.36,28.21,2019
"2964012",8960,265,1239,10464,85.63,2.53,11.84,2019
"2964022",34,4,19,57,59.65,7.02,33.33,2019
"2964024",5172,173,843,6188,83.58,2.8,13.62,2019
"2964030",8762,354,918,10034,87.32,3.53,9.15,2019
"2964643",349,6,128,483,72.26,1.24,26.5,2019
"2964498",78,21,3,102,76.47,20.59,2.94,2019
"2964625",198,3,40,241,82.16,1.24,16.6,2019
"2964638",185,18,74,277,66.79,6.5,26.71,2019
"2964647",129,1,37,167,77.25,0.6,22.16,2019
"2964650",175,1,86,262,66.79,0.38,32.82,2019
"2964668",509,22,121,652,78.07,3.37,18.56,2019
"2964679",149,11,105,265,56.23,4.15,39.62,2019
"2964720",1041,82,310,1433,72.64,5.72,21.63,2019
"2964741",54,0,31,85,63.53,0,36.47,2019
"2964748",437,12,267,716,61.03,1.68,37.29,2019
"2964762",393,62,175,630,62.38,9.84,27.78,2019
"2964788",507,13,164,684,74.12,1.9,23.98,2019
"2964801",11705,1050,2474,15229,76.86,6.89,16.25,2019
"2964830",235,34,56,325,72.31,10.46,17.23,2019
"2964834",2844,282,333,3459,82.22,8.15,9.63,2019
"2964840",938,13,207,1158,81,1.12,17.88,2019
"2964842",230,19,95,344,66.86,5.52,27.62,2019
"2964844",1229,35,539,1803,68.16,1.94,29.89,2019
"2964848",111,37,80,228,48.68,16.23,35.09,2019
"2964862",990,69,403,1462,67.72,4.72,27.56,2019
"2964867",356,5,113,474,75.11,1.05,23.84,2019
"2964874",151,16,109,276,54.71,5.8,39.49,2019
"2964011",829,49,365,1243,66.69,3.94,29.36,2019
"2964018",275,51,21,347,79.25,14.7,6.05,2019
"2964109",3322,276,1074,4672,71.1,5.91,22.99,2019
"2964125",392,23,183,598,65.55,3.85,30.6,2019
"2964126",1565,24,676,2265,69.09,1.06,29.85,2019
"2964134",6768,313,1886,8967,75.48,3.49,21.03,2019
"2964138",8216,580,1689,10485,78.36,5.53,16.11,2019
"2964646",59,0,17,76,77.63,0,22.37,2019
"2964656",68,8,25,101,67.33,7.92,24.75,2019
"2964661",203,15,99,317,64.04,4.73,31.23,2019
"2964670",234,1,98,333,70.27,0.3,29.43,2019
"2964726",87,1,48,136,63.97,0.74,35.29,2019
"2964734",690,14,55,759,90.91,1.84,7.25,2019
"2964738",338,6,101,445,75.96,1.35,22.7,2019
"2964759",2208,155,798,3161,69.85,4.9,25.25,2019
"2964763",451,38,199,688,65.55,5.52,28.92,2019
"2964770",288,14,106,408,70.59,3.43,25.98,2019
"2964772",4535,228,738,5501,82.44,4.14,13.42,2019
"2964776",1082,54,531,1667,64.91,3.24,31.85,2019
"2964778",167,13,48,228,73.25,5.7,21.05,2019
"2964832",219,29,45,293,74.74,9.9,15.36,2019
"2964850",6268,446,1966,8680,72.21,5.14,22.65,2019
"1950222",123,2,79,204,60.29,0.98,38.73,2019
"1950254",67,0,22,89,75.28,0,24.72,2019
"2649261",83,0,17,100,83,0,17,2019
"2649320",19,0,3,22,86.36,0,13.64,2019
"2649519",9813,341,1128,11282,86.98,3.02,10,2019
"2649534",7609,307,845,8761,86.85,3.5,9.65,2019
"2965588",606,52,343,1001,60.54,5.19,34.27,2019
"2965622",1957,139,1065,3161,61.91,4.4,33.69,2019
"2965641",376,17,106,499,75.35,3.41,21.24,2019
"2965655",768,59,406,1233,62.29,4.79,32.93,2019
"2965657",29,0,12,41,70.73,0,29.27,2019
"2965663",610,34,262,906,67.33,3.75,28.92,2019
"2965669",779,14,173,966,80.64,1.45,17.91,2019
"2965680",390,48,86,524,74.43,9.16,16.41,2019
"2965685",257,11,47,315,81.59,3.49,14.92,2019
"2965706",4250,399,1169,5818,73.05,6.86,20.09,2019
"2965713",686,24,302,1012,67.79,2.37,29.84,2019
"2965728",0,0,0,0,NA,NA,NA,2019
"2965733",199,12,107,318,62.58,3.77,33.65,2019
"2965737",2794,92,399,3285,85.05,2.8,12.15,2019
"2965739",391,25,56,472,82.84,5.3,11.86,2019
"2965744",16,0,18,34,47.06,0,52.94,2019
"2965774",272,18,152,442,61.54,4.07,34.39,2019
"2965777",137,0,20,157,87.26,0,12.74,2019
"2965806",4221,653,1622,6496,64.98,10.05,24.97,2019
"2965809",4113,236,404,4753,86.53,4.97,8.5,2019
"2965457",38,0,7,45,84.44,0,15.56,2019
"2965401",10736,380,1935,13051,82.26,2.91,14.83,2019
"2965443",33,0,7,40,82.5,0,17.5,2019
"2965446",69,0,66,135,51.11,0,48.89,2019
"2965462",539,5,106,650,82.92,0.77,16.31,2019
"2965486",1038,23,332,1393,74.52,1.65,23.83,2019
"2965548",1483,84,664,2231,66.47,3.77,29.76,2019
"2965555",273,39,173,485,56.29,8.04,35.67,2019
"2965557",35,0,0,35,100,0,0,2019
"2965570",107,0,128,235,45.53,0,54.47,2019
"2965591",430,0,76,506,84.98,0,15.02,2019
"2965606",722,43,558,1323,54.57,3.25,42.18,2019
"2965650",360,0,167,527,68.31,0,31.69,2019
"2965017",240,32,202,474,50.63,6.75,42.62,2019
"2965023",491,19,130,640,76.72,2.97,20.31,2019
"2965075",236,19,71,326,72.39,5.83,21.78,2019
"2965080",293,0,177,470,62.34,0,37.66,2019
"2965083",82,0,12,94,87.23,0,12.77,2019
"2965244",126,12,8,146,86.3,8.22,5.48,2019
"2965258",127,10,75,212,59.91,4.72,35.38,2019
"2965270",4457,96,1349,5902,75.52,1.63,22.86,2019
"2965280",99,3,27,129,76.74,2.33,20.93,2019
"2965281",685,17,216,918,74.62,1.85,23.53,2019
"2965283",195,0,81,276,70.65,0,29.35,2019
"2965287",128,0,26,154,83.12,0,16.88,2019
"2965344",71,3,19,93,76.34,3.23,20.43,2019
"2965354",144,2,51,197,73.1,1.02,25.89,2019
"2965360",1353,14,434,1801,75.12,0.78,24.1,2019
"2965653",1952,61,374,2387,81.78,2.56,15.67,2019
"2965731",140,0,19,159,88.05,0,11.95,2019
"2965656",1487,96,296,1879,79.14,5.11,15.75,2019
"2965658",465,62,163,690,67.39,8.99,23.62,2019
"2965686",1927,17,215,2159,89.25,0.79,9.96,2019
"2649709",1266,55,384,1705,74.25,3.23,22.52,2019
"2649715",1129,23,176,1328,85.02,1.73,13.25,2019
"2649719",481,30,86,597,80.57,5.03,14.41,2019
"2649724",301,1,91,393,76.59,0.25,23.16,2019
"2649705",247,17,80,344,71.8,4.94,23.26,2019
"2649420",1706,129,487,2322,73.47,5.56,20.97,2019
"2648374",4934,112,208,5254,93.91,2.13,3.96,2019
"2648377",6942,166,675,7783,89.19,2.13,8.67,2019
"2648401",420,30,127,577,72.79,5.2,22.01,2019
"2648420",7139,317,1372,8828,80.87,3.59,15.54,2019
"2648422",2022,73,601,2696,75,2.71,22.29,2019
"2648145",1142,32,87,1261,90.56,2.54,6.9,2019
"2648094",7050,132,620,7802,90.36,1.69,7.95,2019
"2648103",21750,317,1385,23452,92.74,1.35,5.91,2019
"2648139",59,0,0,59,100,0,0,2019
"2648152",11061,204,1287,12552,88.12,1.63,10.25,2019
"2648154",12747,202,1379,14328,88.97,1.41,9.62,2019
"2648158",2470,92,517,3079,80.22,2.99,16.79,2019
"2648118",4275,245,476,4996,85.57,4.9,9.53,2019
"2648109",0,5,0,5,0,100,0,2019
"2648111",14550,1010,1531,17091,85.13,5.91,8.96,2019
"2648116",9949,266,845,11060,89.95,2.41,7.64,2019
"2648131",2505,132,342,2979,84.09,4.43,11.48,2019
"2648133",1678,88,390,2156,77.83,4.08,18.09,2019
"2648146",10479,1269,2496,14244,73.57,8.91,17.52,2019
"2648164",2807,36,256,3099,90.58,1.16,8.26,2019
"2648183",15030,671,1872,17573,85.53,3.82,10.65,2019
"2648192",8679,620,1771,11070,78.4,5.6,16,2019
"2648195",10191,449,2056,12696,80.27,3.54,16.19,2019
"2648205",9146,921,3097,13164,69.48,7,23.53,2019
"2648212",7095,665,3045,10805,65.66,6.15,28.18,2019
"2648214",6968,699,2322,9989,69.76,7,23.25,2019
"2648224",9308,1093,3817,14218,65.47,7.69,26.85,2019
"2648226",3613,231,418,4262,84.77,5.42,9.81,2019
"2648860",436,14,160,610,71.48,2.3,26.23,2019
"2648842",7672,139,1120,8931,85.9,1.56,12.54,2019
"2648845",237,12,73,322,73.6,3.73,22.67,2019
"2648858",13260,2199,1772,17231,76.95,12.76,10.28,2019
"2648876",1466,13,145,1624,90.27,0.8,8.93,2019
"2648883",2069,74,543,2686,77.03,2.76,20.22,2019
"2648884",1176,64,373,1613,72.91,3.97,23.12,2019
"2648885",290,6,78,374,77.54,1.6,20.86,2019
"2648886",528,16,245,789,66.92,2.03,31.05,2019
"2648080",8944,325,1446,10715,83.47,3.03,13.5,2019
"2648316",9862,307,701,10870,90.73,2.82,6.45,2019
"2648323",6141,66,195,6402,95.92,1.03,3.05,2019
"2648759",1113,49,286,1448,76.86,3.38,19.75,2019
"2648760",404,7,174,585,69.06,1.2,29.74,2019
"2648767",593,52,202,847,70.01,6.14,23.85,2019
"1950436",1912,96,323,2331,82.02,4.12,13.86,2019
"1950444",125,3,24,152,82.24,1.97,15.79,2019
"1950008",312,3,70,385,81.04,0.78,18.18,2019
"1950022",2748,206,817,3771,72.87,5.46,21.67,2019
"1950051",86,1,37,124,69.35,0.81,29.84,2019
"1950054",918,57,161,1136,80.81,5.02,14.17,2019
"1950056",485,11,59,555,87.39,1.98,10.63,2019
"1950106",260,15,68,343,75.8,4.37,19.83,2019
"1950118",335,3,61,399,83.96,0.75,15.29,2019
"1950119",121,0,19,140,86.43,0,13.57,2019
"2649459",346,18,168,532,65.04,3.38,31.58,2019
"2649601",6718,284,1733,8735,76.91,3.25,19.84,2019
"2649620",777,34,109,920,84.46,3.7,11.85,2019
"2649626",92,6,53,151,60.93,3.97,35.1,2019
"2649631",1769,98,611,2478,71.39,3.95,24.66,2019
"2649635",1200,48,222,1470,81.63,3.27,15.1,2019
"2067448",349,22,119,490,71.22,4.49,24.29,2019
"2067464",399,2,90,491,81.26,0.41,18.33,2019
"2067017",757,33,99,889,85.15,3.71,11.14,2019
"2067018",31,0,18,49,63.27,0,36.73,2019
"2067019",309,8,82,399,77.44,2.01,20.55,2019
"2067041",87,1,11,99,87.88,1.01,11.11,2019
"2067060",4475,61,743,5279,84.77,1.16,14.07,2019
"2067063",1072,34,305,1411,75.97,2.41,21.62,2019
"2067070",341,12,53,406,83.99,2.96,13.05,2019
"2067072",40,11,37,88,45.45,12.5,42.05,2019
"2067074",458,16,157,631,72.58,2.54,24.88,2019
"2067104",706,77,167,950,74.32,8.11,17.58,2019
"2067108",445,28,85,558,79.75,5.02,15.23,2019
"2067583",298,5,76,379,78.63,1.32,20.05,2019
"2067952",138,7,39,184,75,3.8,21.2,2019
"2067052",2244,74,271,2589,86.67,2.86,10.47,2019
"2067112",81,1,27,109,74.31,0.92,24.77,2019
"2067334",10,0,13,23,43.48,0,56.52,2019
"2067207",9663,415,1283,11361,85.05,3.65,11.29,2019
"2067344",256,4,104,364,70.33,1.1,28.57,2019
"2067859",182,2,56,240,75.83,0.83,23.33,2019
"2067058",572,17,161,750,76.27,2.27,21.47,2019
"2067467",817,27,282,1126,72.56,2.4,25.04,2019
"2067055",15,0,27,42,35.71,0,64.29,2019
"2067223",179,14,28,221,81,6.33,12.67,2019
"2067227",81,0,22,103,78.64,0,21.36,2019
"2067228",693,0,4,697,99.43,0,0.57,2019
"2067232",157,46,0,203,77.34,22.66,0,2019
"2067260",0,0,0,0,NA,NA,NA,2019
"2067843",73,0,30,103,70.87,0,29.13,2019
"2067155",59,11,22,92,64.13,11.96,23.91,2019
"2067442",44,7,12,63,69.84,11.11,19.05,2019
"2067481",179,17,47,243,73.66,7,19.34,2019
"3168776",4107,126,1131,5364,76.57,2.35,21.09,2019
"3168778",165,11,27,203,81.28,5.42,13.3,2019
"3168780",335,21,122,478,70.08,4.39,25.52,2019
"3168784",510,7,207,724,70.44,0.97,28.59,2019
"3168787",2179,60,223,2462,88.51,2.44,9.06,2019
"3168816",57,0,36,93,61.29,0,38.71,2019
"3168818",1954,38,245,2237,87.35,1.7,10.95,2019
"3168820",89,7,57,153,58.17,4.58,37.25,2019
"3168828",94,0,33,127,74.02,0,25.98,2019
"3168836",585,23,72,680,86.03,3.38,10.59,2019
"3168846",78,3,16,97,80.41,3.09,16.49,2019
"3168873",1137,45,275,1457,78.04,3.09,18.87,2019
"3168881",0,0,0,0,NA,NA,NA,2019
"3168924",396,20,72,488,81.15,4.1,14.75,2019
"3168926",203,4,71,278,73.02,1.44,25.54,2019
"3168930",499,30,70,599,83.31,5.01,11.69,2019
"3168936",73,8,33,114,64.04,7.02,28.95,2019
"3168940",206,0,27,233,88.41,0,11.59,2019
"3168941",236,24,64,324,72.84,7.41,19.75,2019
"3168946",5,0,6,11,45.45,0,54.55,2019
"2271406",39,0,0,39,100,0,0,2019
"2271423",1124,16,500,1640,68.54,0.98,30.49,2019
"2271432",226,27,127,380,59.47,7.11,33.42,2019
"2271435",817,48,488,1353,60.38,3.55,36.07,2019
"2271438",482,21,179,682,70.67,3.08,26.25,2019
"2271439",518,7,184,709,73.06,0.99,25.95,2019
"2649674",12,0,0,12,100,0,0,2019
"2649717",42,23,0,65,64.62,35.38,0,2019
"2649819",12,0,3,15,80,0,20,2019
"2649806",200,1,25,226,88.5,0.44,11.06,2019
"2649863",45,3,16,64,70.31,4.69,25,2019
"2649945",838,32,183,1053,79.58,3.04,17.38,2019
"2649047",4855,198,1302,6355,76.4,3.12,20.49,2019
"2649117",1455,85,222,1762,82.58,4.82,12.6,2019
"2649248",257,9,58,324,79.32,2.78,17.9,2019
"2649319",5262,167,880,6309,83.4,2.65,13.95,2019
"2649935",1928,155,743,2826,68.22,5.48,26.29,2019
"2649740",2654,77,491,3222,82.37,2.39,15.24,2019
"2649821",430,15,129,574,74.91,2.61,22.47,2019
"2649887",799,36,289,1124,71.09,3.2,25.71,2019
"2649729",513,13,140,666,77.03,1.95,21.02,2019
"2649805",138,0,20,158,87.34,0,12.66,2019
"2649812",280,14,112,406,68.97,3.45,27.59,2019
"2649814",421,12,93,526,80.04,2.28,17.68,2019
"2649818",300,4,124,428,70.09,0.93,28.97,2019
"2649825",78,0,20,98,79.59,0,20.41,2019
"2649831",247,12,73,332,74.4,3.61,21.99,2019
"2649853",347,6,187,540,64.26,1.11,34.63,2019
"2649892",686,16,141,843,81.38,1.9,16.73,2019
"2649902",39,14,38,91,42.86,15.38,41.76,2019
"2649916",957,19,124,1100,87,1.73,11.27,2019
"2649930",2110,159,449,2718,77.63,5.85,16.52,2019
"2649934",314,10,14,338,92.9,2.96,4.14,2019
"2649043",614,17,272,903,68,1.88,30.12,2019
"2649076",1177,35,238,1450,81.17,2.41,16.41,2019
"2649097",3632,146,525,4303,84.41,3.39,12.2,2019
"2649106",1739,141,384,2264,76.81,6.23,16.96,2019
"2649056",872,43,389,1304,66.87,3.3,29.83,2019
"2649007",3086,236,733,4055,76.1,5.82,18.08,2019
"2649012",1215,37,124,1376,88.3,2.69,9.01,2019
"2649045",1502,52,530,2084,72.07,2.5,25.43,2019
"2649052",221,6,99,326,67.79,1.84,30.37,2019
"2649103",2774,330,561,3665,75.69,9,15.31,2019
"2649064",985,47,355,1387,71.02,3.39,25.59,2019
"2649085",8562,584,1041,10187,84.05,5.73,10.22,2019
"2649090",4755,183,1277,6215,76.51,2.94,20.55,2019
"2649107",3305,242,597,4144,79.75,5.84,14.41,2019
"2649120",11775,727,2667,15169,77.63,4.79,17.58,2019
"2649227",331,10,138,479,69.1,2.09,28.81,2019
"2649246",1092,21,132,1245,87.71,1.69,10.6,2019
"2649249",1281,37,216,1534,83.51,2.41,14.08,2019
"2649251",1822,85,418,2325,78.37,3.66,17.98,2019
"2649265",1983,67,181,2231,88.88,3,8.11,2019
"2649701",368,19,72,459,80.17,4.14,15.69,2019
"2649716",303,7,35,345,87.83,2.03,10.14,2019
"2649093",6041,252,1065,7358,82.1,3.42,14.47,2019
"2649094",1319,85,261,1665,79.22,5.11,15.68,2019
"2649096",909,23,285,1217,74.69,1.89,23.42,2019
"2649098",1617,151,491,2259,71.58,6.68,21.74,2019
"1952142",462,25,132,619,74.64,4.04,21.32,2019
"1952157",590,25,180,795,74.21,3.14,22.64,2019
"1952169",116,3,24,143,81.12,2.1,16.78,2019
"1952202",318,12,40,370,85.95,3.24,10.81,2019
"1952205",2717,68,706,3491,77.83,1.95,20.22,2019
"1952216",441,8,112,561,78.61,1.43,19.96,2019
"2649651",2462,112,711,3285,74.95,3.41,21.64,2019
"2649111",994,103,273,1370,72.55,7.52,19.93,2019
"2649959",108,3,53,164,65.85,1.83,32.32,2019
"2649725",218,1,72,291,74.91,0.34,24.74,2019
"2649733",706,20,136,862,81.9,2.32,15.78,2019
"2649738",3530,89,659,4278,82.52,2.08,15.4,2019
"2649751",701,11,124,836,83.85,1.32,14.83,2019
"2649775",29,5,10,44,65.91,11.36,22.73,2019
"2649781",1483,78,298,1859,79.77,4.2,16.03,2019
"2649001",7612,219,1053,8884,85.68,2.47,11.85,2019
"2649008",6058,123,682,6863,88.27,1.79,9.94,2019
"2649015",9253,127,1806,11186,82.72,1.14,16.15,2019
"2649026",779,26,159,964,80.81,2.7,16.49,2019
"2649031",2320,107,631,3058,75.87,3.5,20.63,2019
"2649038",2567,372,913,3852,66.64,9.66,23.7,2019
"2649050",451,26,135,612,73.69,4.25,22.06,2019
"2649058",6046,180,1338,7564,79.93,2.38,17.69,2019
"2649061",450,0,132,582,77.32,0,22.68,2019
"2649066",172,5,41,218,78.9,2.29,18.81,2019
"2649087",2065,39,234,2338,88.32,1.67,10.01,2019
"2649095",731,20,142,893,81.86,2.24,15.9,2019
"2649112",3350,168,468,3986,84.04,4.21,11.74,2019
"2649115",123,29,80,232,53.02,12.5,34.48,2019
"2649229",1069,66,103,1238,86.35,5.33,8.32,2019
"2649233",903,3,190,1096,82.39,0.27,17.34,2019
"2649238",567,30,67,664,85.39,4.52,10.09,2019
"2649894",172,0,110,282,60.99,0,39.01,2019
"2649755",655,47,191,893,73.35,5.26,21.39,2019
"2649316",7536,65,514,8115,92.87,0.8,6.33,2019
"2649070",752,8,220,980,76.73,0.82,22.45,2019
"2649203",12800,332,2591,15723,81.41,2.11,16.48,2019
"2649303",272,0,76,348,78.16,0,21.84,2019
"2649036",7287,349,1384,9020,80.79,3.87,15.34,2019
"2649075",28,4,22,54,51.85,7.41,40.74,2019
"2649079",4382,176,692,5250,83.47,3.35,13.18,2019
"2649082",1754,38,556,2348,74.7,1.62,23.68,2019
"2649091",6041,197,1567,7805,77.4,2.52,20.08,2019
"2649128",1135,85,223,1443,78.66,5.89,15.45,2019
"2649232",648,31,274,953,68,3.25,28.75,2019
"2649253",1003,22,262,1287,77.93,1.71,20.36,2019
"2649254",1174,11,325,1510,77.75,0.73,21.52,2019
"2649286",5169,108,639,5916,87.37,1.83,10.8,2019
"2649318",439,30,83,552,79.53,5.43,15.04,2019
"2649327",2379,93,679,3151,75.5,2.95,21.55,2019
"2649101",984,64,172,1220,80.66,5.25,14.1,2019
"2649202",6437,573,1616,8626,74.62,6.64,18.73,2019
"2649283",986,15,128,1129,87.33,1.33,11.34,2019
"2649348",3972,152,721,4845,81.98,3.14,14.88,2019
"2649436",534,31,135,700,76.29,4.43,19.29,2019
"2649614",805,23,204,1032,78,2.23,19.77,2019
"2649855",10448,939,1417,12804,81.6,7.33,11.07,2019
"2649950",424,39,156,619,68.5,6.3,25.2,2019
"2649666",84,0,0,84,100,0,0,2019
"5553599",0,0,29,29,0,0,100,2019
"5553702",65,0,0,65,100,0,0,2019
"5553726",2270,44,70,2384,95.22,1.85,2.94,2019
"5553792",0,0,0,0,NA,NA,NA,2019
"5553802",22,0,3,25,88,0,12,2019
"5553534",4226,156,579,4961,85.18,3.14,11.67,2019
"2648432",199,35,44,278,71.58,12.59,15.83,2019
"2648434",37,2,7,46,80.43,4.35,15.22,2019
"2648503",7405,555,3599,11559,64.06,4.8,31.14,2019
"2648610",1027,31,325,1383,74.26,2.24,23.5,2019
"2648614",375,19,163,557,67.32,3.41,29.26,2019
"2648621",354,8,145,507,69.82,1.58,28.6,2019
"2648622",1852,52,391,2295,80.7,2.27,17.04,2019
"2648624",4745,228,1746,6719,70.62,3.39,25.99,2019
"2648721",182,0,62,244,74.59,0,25.41,2019
"2648722",1039,13,235,1287,80.73,1.01,18.26,2019
"2648737",399,7,194,600,66.5,1.17,32.33,2019
"2648746",2561,78,542,3181,80.51,2.45,17.04,2019
"2648009",8549,108,474,9131,93.63,1.18,5.19,2019
"2648017",4800,191,696,5687,84.4,3.36,12.24,2019
"2648044",18262,202,884,19348,94.39,1.04,4.57,2019
"2648414",779,1,188,968,80.48,0.1,19.42,2019
"2648415",3060,157,484,3701,82.68,4.24,13.08,2019
"2648417",882,33,169,1084,81.37,3.04,15.59,2019
"2648419",726,47,191,964,75.31,4.88,19.81,2019
"2648162",9263,439,1847,11549,80.21,3.8,15.99,2019
"2648166",3645,101,653,4399,82.86,2.3,14.84,2019
"2648169",7677,402,574,8653,88.72,4.65,6.63,2019
"2648188",14434,256,588,15278,94.48,1.68,3.85,2019
"2648190",78,0,0,78,100,0,0,2019
"2648201",5578,823,2016,8417,66.27,9.78,23.95,2019
"2648203",4971,750,4151,9872,50.35,7.6,42.05,2019
"2648208",2384,415,1384,4183,56.99,9.92,33.09,2019
"2648211",1330,76,650,2056,64.69,3.7,31.61,2019
"2648228",13318,998,5617,19933,66.81,5.01,28.18,2019
"2648230",5821,206,450,6477,89.87,3.18,6.95,2019
"2648239",11064,350,2315,13729,80.59,2.55,16.86,2019
"2648307",16434,377,1189,18000,91.3,2.09,6.61,2019
"2648350",2452,48,230,2730,89.82,1.76,8.42,2019
"2648357",2655,189,303,3147,84.37,6.01,9.63,2019
"2648359",3493,9,239,3741,93.37,0.24,6.39,2019
"2648363",2064,19,155,2238,92.23,0.85,6.93,2019
"2648413",2111,160,657,2928,72.1,5.46,22.44,2019
"2648423",11483,609,1904,13996,82.04,4.35,13.6,2019
"2648426",228,34,137,399,57.14,8.52,34.34,2019
"2648429",2858,197,778,3833,74.56,5.14,20.3,2019
"2648101",9337,502,1125,10964,85.16,4.58,10.26,2019
"2648122",2554,352,818,3724,68.58,9.45,21.97,2019
"2648124",9828,608,1196,11632,84.49,5.23,10.28,2019
"2648130",5354,144,288,5786,92.53,2.49,4.98,2019
"2648137",1690,144,238,2072,81.56,6.95,11.49,2019
"2648159",734,28,174,936,78.42,2.99,18.59,2019
"2648877",721,55,177,953,75.66,5.77,18.57,2019
"2648878",419,19,107,545,76.88,3.49,19.63,2019
"2648021",10239,426,1970,12635,81.04,3.37,15.59,2019
"2648023",1762,8,224,1994,88.37,0.4,11.23,2019
"2648035",12270,265,1943,14478,84.75,1.83,13.42,2019
"2648867",9102,273,2020,11395,79.88,2.4,17.73,2019
"2648893",1602,78,326,2006,79.86,3.89,16.25,2019
"2649712",2891,120,483,3494,82.74,3.43,13.82,2019
"2649721",4746,225,1252,6223,76.27,3.62,20.12,2019
"2649722",77,0,62,139,55.4,0,44.6,2019
"2649728",79,8,27,114,69.3,7.02,23.68,2019
"2649735",6798,235,1029,8062,84.32,2.91,12.76,2019
"2649730",659,16,166,841,78.36,1.9,19.74,2019
"2271466",200,0,43,243,82.3,0,17.7,2019
"2271480",158,6,53,217,72.81,2.76,24.42,2019
"2271104",4094,784,1490,6368,64.29,12.31,23.4,2019
"2271067",834,0,461,1295,64.4,0,35.6,2019
"2271071",662,37,312,1011,65.48,3.66,30.86,2019
"2271101",1089,313,1445,2847,38.25,10.99,50.76,2019
"2271105",7410,1067,1336,9813,75.51,10.87,13.61,2019
"2271219",271,32,199,502,53.98,6.37,39.64,2019
"2271253",17,7,53,77,22.08,9.09,68.83,2019
"2271263",1294,201,1473,2968,43.6,6.77,49.63,2019
"2271291",9760,508,3024,13292,73.43,3.82,22.75,2019
"2271303",7470,243,1217,8930,83.65,2.72,13.63,2019
"2271322",1742,105,546,2393,72.8,4.39,22.82,2019
"2271334",2265,78,1122,3465,65.37,2.25,32.38,2019
"2271340",186,0,156,342,54.39,0,45.61,2019
"2271346",664,59,279,1002,66.27,5.89,27.84,2019
"2271369",665,42,282,989,67.24,4.25,28.51,2019
"2271377",54,0,13,67,80.6,0,19.4,2019
"2271409",1609,20,409,2038,78.95,0.98,20.07,2019
"2271411",735,37,583,1355,54.24,2.73,43.03,2019
"2271457",6323,468,3189,9980,63.36,4.69,31.95,2019
"2271468",98,9,183,290,33.79,3.1,63.1,2019
"2271473",114,0,88,202,56.44,0,43.56,2019
"2271479",236,10,94,340,69.41,2.94,27.65,2019
"0571630",87,14,95,196,44.39,7.14,48.47,2019
"2271292",5370,98,2088,7556,71.07,1.3,27.63,2019
"2271316",12,0,9,21,57.14,0,42.86,2019
"2271326",160,16,132,308,51.95,5.19,42.86,2019
"2271331",273,52,98,423,64.54,12.29,23.17,2019
"0571749",705,34,390,1129,62.44,3.01,34.54,2019
"0571720",578,38,360,976,59.22,3.89,36.89,2019
"0571725",96,6,94,196,48.98,3.06,47.96,2019
"0571730",7717,739,3463,11919,64.75,6.2,29.05,2019
"0571751",151,41,159,351,43.02,11.68,45.3,2019
"0571762",582,26,301,909,64.03,2.86,33.11,2019
"0571820",8,0,0,8,100,0,0,2019
"0571825",143,3,25,171,83.63,1.75,14.62,2019
"0571826",272,5,134,411,66.18,1.22,32.6,2019
"0571841",248,12,128,388,63.92,3.09,32.99,2019
"0571842",696,24,147,867,80.28,2.77,16.96,2019
"0571851",528,48,225,801,65.92,5.99,28.09,2019
"0571852",2532,211,1020,3763,67.29,5.61,27.11,2019
"0571854",10548,488,2806,13842,76.2,3.53,20.27,2019
"0571857",1435,21,615,2071,69.29,1.01,29.7,2019
"0571862",130,2,185,317,41.01,0.63,58.36,2019
"2271037",5439,394,1447,7280,74.71,5.41,19.88,2019
"2271061",453,54,175,682,66.42,7.92,25.66,2019
"2271103",1246,102,1036,2384,52.27,4.28,43.46,2019
"2271106",9775,365,2829,12969,75.37,2.81,21.81,2019
"2271107",7361,1159,3553,12073,60.97,9.6,29.43,2019
"2271112",8889,1949,3098,13936,63.78,13.99,22.23,2019
"2271129",3874,183,1001,5058,76.59,3.62,19.79,2019
"2271222",547,27,611,1185,46.16,2.28,51.56,2019
"5554141",843,28,23,894,94.3,3.13,2.57,2019
"5554160",97,0,21,118,82.2,0,17.8,2019
"5554161",922,11,283,1216,75.82,0.9,23.27,2019
"5554169",995,8,41,1044,95.31,0.77,3.93,2019
"5554175",386,18,84,488,79.1,3.69,17.21,2019
"5554210",337,5,47,389,86.63,1.29,12.08,2019
"1952228",1076,24,82,1182,91.03,2.03,6.94,2019
"1952240",12920,644,1714,15278,84.57,4.22,11.22,2019
"1952251",159,0,76,235,67.66,0,32.34,2019
"1952254",285,12,85,382,74.61,3.14,22.25,2019
"1952312",18,3,4,25,72,12,16,2019
"1952315",420,11,71,502,83.67,2.19,14.14,2019
"1952323",275,4,67,346,79.48,1.16,19.36,2019
"1952335",241,0,77,318,75.79,0,24.21,2019
"1952336",793,46,94,933,84.99,4.93,10.08,2019
"1952339",1032,78,335,1445,71.42,5.4,23.18,2019
"1952403",8113,331,1300,9744,83.26,3.4,13.34,2019
"1952542",107,6,28,141,75.89,4.26,19.86,2019
"1952548",39,0,1,40,97.5,0,2.5,2019
"1952553",551,16,144,711,77.5,2.25,20.25,2019
"1952565",531,47,194,772,68.78,6.09,25.13,2019
"1952806",8762,236,1890,10888,80.47,2.17,17.36,2019
"1952037",333,7,107,447,74.5,1.57,23.94,2019
"1952032",454,44,109,607,74.79,7.25,17.96,2019
"1952054",279,1,67,347,80.4,0.29,19.31,2019
"1952065",332,10,105,447,74.27,2.24,23.49,2019
"1952072",98,0,15,113,86.73,0,13.27,2019
"1952074",107,0,24,131,81.68,0,18.32,2019
"1952078",202,13,79,294,68.71,4.42,26.87,2019
"1952101",4291,114,718,5123,83.76,2.23,14.02,2019
"1952758",93,0,6,99,93.94,0,6.06,2019
"1952035",311,10,74,395,78.73,2.53,18.73,2019
"1952038",134,43,26,203,66.01,21.18,12.81,2019
"1952039",262,1,76,339,77.29,0.29,22.42,2019
"1952047",204,11,56,271,75.28,4.06,20.66,2019
"1952031",1784,51,324,2159,82.63,2.36,15.01,2019
"1952046",743,35,106,884,84.05,3.96,11.99,2019
"1952214",1118,51,180,1349,82.88,3.78,13.34,2019
"1952224",694,13,117,824,84.22,1.58,14.2,2019
"1952231",61,0,38,99,61.62,0,38.38,2019
"1952232",65,1,9,75,86.67,1.33,12,2019
"1952236",241,13,31,285,84.56,4.56,10.88,2019
"1952248",601,8,108,717,83.82,1.12,15.06,2019
"1952329",283,9,60,352,80.4,2.56,17.05,2019
"1952585",299,10,95,404,74.01,2.48,23.51,2019
"1952537",1720,55,843,2618,65.7,2.1,32.2,2019
"1952554",424,7,161,592,71.62,1.18,27.2,2019
"1952569",150,7,120,277,54.15,2.53,43.32,2019
"1952588",9,0,0,9,100,0,0,2019
"1952646",125,6,20,151,82.78,3.97,13.25,2019
"1952656",829,7,233,1069,77.55,0.65,21.8,2019
"1952658",263,30,105,398,66.08,7.54,26.38,2019
"1952720",270,6,50,326,82.82,1.84,15.34,2019
"1952745",149,6,84,239,62.34,2.51,35.15,2019
"1952749",310,13,21,344,90.12,3.78,6.1,2019
"1952751",325,4,49,378,85.98,1.06,12.96,2019
"1952752",160,2,33,195,82.05,1.03,16.92,2019
"1952756",673,31,33,737,91.32,4.21,4.48,2019
"1952042",434,16,149,599,72.45,2.67,24.87,2019
"2755378",9580,146,522,10248,93.48,1.42,5.09,2019
"2755395",911,14,196,1121,81.27,1.25,17.48,2019
"2755396",697,14,199,910,76.59,1.54,21.87,2019
"2755397",909,50,102,1061,85.67,4.71,9.61,2019
"2755398",5041,138,307,5486,91.89,2.52,5.6,2019
"2755401",5990,485,270,6745,88.81,7.19,4,2019
"5553590",14321,398,1195,15914,89.99,2.5,7.51,2019
"5553066",12623,263,993,13879,90.95,1.89,7.15,2019
"5553073",5206,217,758,6181,84.23,3.51,12.26,2019
"5553074",4861,103,575,5539,87.76,1.86,10.38,2019
"5553086",2923,46,294,3263,89.58,1.41,9.01,2019
"5553089",6911,113,408,7432,92.99,1.52,5.49,2019
"5553091",738,23,100,861,85.71,2.67,11.61,2019
"5553121",6419,167,952,7538,85.16,2.22,12.63,2019
"5553122",2076,37,174,2287,90.77,1.62,7.61,2019
"5553126",2296,108,291,2695,85.19,4.01,10.8,2019
"5553130",2687,71,383,3141,85.55,2.26,12.19,2019
"5553132",11931,294,1428,13653,87.39,2.15,10.46,2019
"5553137",565,19,83,667,84.71,2.85,12.44,2019
"5553142",10904,309,1150,12363,88.2,2.5,9.3,2019
"5553147",6214,225,848,7287,85.28,3.09,11.64,2019
"5553158",5594,137,603,6334,88.32,2.16,9.52,2019
"5553168",2946,139,335,3420,86.14,4.06,9.8,2019
"5553172",7146,232,1229,8607,83.03,2.7,14.28,2019
"5553544",254,7,58,319,79.62,2.19,18.18,2019
"5553714",6102,173,832,7107,85.86,2.43,11.71,2019
"5553715",3904,554,422,4880,80,11.35,8.65,2019
"5553716",7089,289,739,8117,87.34,3.56,9.1,2019
"5553718",6056,292,350,6698,90.42,4.36,5.23,2019
"5553806",584,30,161,775,75.35,3.87,20.77,2019
"5553553",184,2,38,224,82.14,0.89,16.96,2019
"5553566",5116,260,1146,6522,78.44,3.99,17.57,2019
"5553574",1235,61,200,1496,82.55,4.08,13.37,2019
"5553578",2270,83,333,2686,84.51,3.09,12.4,2019
"5553215",13169,592,5347,19108,68.92,3.1,27.98,2019
"5553217",10522,127,788,11437,92,1.11,6.89,2019
"5553403",8161,410,1959,10530,77.5,3.89,18.6,2019
"5553405",8451,212,1554,10217,82.72,2.07,15.21,2019
"5553406",9272,210,1422,10904,85.03,1.93,13.04,2019
"5553503",655,34,141,830,78.92,4.1,16.99,2019
"5553521",1256,11,187,1454,86.38,0.76,12.86,2019
"5553527",3344,145,363,3852,86.81,3.76,9.42,2019
"5553531",1612,40,103,1755,91.85,2.28,5.87,2019
"5553537",263,2,63,328,80.18,0.61,19.21,2019
"5553565",1627,47,345,2019,80.58,2.33,17.09,2019
"5553572",3500,71,350,3921,89.26,1.81,8.93,2019
"5553003",49,0,14,63,77.78,0,22.22,2019
"5553023",465,6,69,540,86.11,1.11,12.78,2019
"5553029",7515,65,408,7988,94.08,0.81,5.11,2019
"5553035",787,18,133,938,83.9,1.92,14.18,2019
"5553037",3578,72,312,3962,90.31,1.82,7.87,2019
"5553042",2344,70,433,2847,82.33,2.46,15.21,2019
"5553059",633,7,102,742,85.31,0.94,13.75,2019
"5553061",1840,46,227,2113,87.08,2.18,10.74,2019
"5553076",1376,54,60,1490,92.35,3.62,4.03,2019
"5553093",695,15,77,787,88.31,1.91,9.78,2019
"5553095",9767,389,1531,11687,83.57,3.33,13.1,2019
"5553153",841,10,35,886,94.92,1.13,3.95,2019
"5553179",2326,45,149,2520,92.3,1.79,5.91,2019
"2756222",674,4,147,825,81.7,0.48,17.82,2019
"2756227",69,5,13,87,79.31,5.75,14.94,2019
"2756256",946,37,186,1169,80.92,3.17,15.91,2019
"2756260",277,2,68,347,79.83,0.58,19.6,2019
"2756273",1631,52,318,2001,81.51,2.6,15.89,2019
"2756277",849,88,325,1262,67.27,6.97,25.75,2019
"4657055",439,8,71,518,84.75,1.54,13.71,2019
"4657070",429,40,181,650,66,6.15,27.85,2019
"4657072",235,8,51,294,79.93,2.72,17.35,2019
"4657076",159,0,30,189,84.13,0,15.87,2019
"4657104",8748,460,2430,11638,75.17,3.95,20.88,2019
"4657223",400,9,83,492,81.3,1.83,16.87,2019
"4657231",548,22,146,716,76.54,3.07,20.39,2019
"4657262",1429,93,452,1974,72.39,4.71,22.9,2019
"4657018",406,26,72,504,80.56,5.16,14.29,2019
"4657025",984,46,177,1207,81.52,3.81,14.66,2019
"4657105",8599,171,828,9598,89.59,1.78,8.63,2019
"4657213",220,26,47,293,75.09,8.87,16.04,2019
"4657216",418,55,111,584,71.58,9.42,19.01,2019
"4657260",288,12,58,358,80.45,3.35,16.2,2019
"4657315",388,9,109,506,76.68,1.78,21.54,2019
"4657329",99,3,35,137,72.26,2.19,25.55,2019
"4657017",510,22,73,605,84.3,3.64,12.07,2019
"4657465",120,3,6,129,93.02,2.33,4.65,2019
"3059538",854,45,294,1193,71.58,3.77,24.64,2019
"3059544",53,4,13,70,75.71,5.71,18.57,2019
"3059008",148,0,76,224,66.07,0,33.93,2019
"3059024",128,0,72,200,64,0,36,2019
"3059027",314,4,53,371,84.64,1.08,14.29,2019
"3059041",547,30,131,708,77.26,4.24,18.5,2019
"3059344",166,0,16,182,91.21,0,8.79,2019
"3059414",268,18,143,429,62.47,4.2,33.33,2019
"3059416",106,0,11,117,90.6,0,9.4,2019
"3059444",38,4,44,86,44.19,4.65,51.16,2019
"3059462",55,17,12,84,65.48,20.24,14.29,2019
"3059465",12,0,8,20,60,0,40,2019
"3059483",173,0,46,219,79,0,21,2019
"3059520",312,16,82,410,76.1,3.9,20,2019
"3059522",482,34,177,693,69.55,4.91,25.54,2019
"3059535",27,0,7,34,79.41,0,20.59,2019
"3059601",11520,380,1975,13875,83.03,2.74,14.23,2019
"3059643",53,0,133,186,28.49,0,71.51,2019
"3059711",2963,80,946,3989,74.28,2.01,23.72,2019
"3059001",623,35,76,734,84.88,4.77,10.35,2019
"3059002",37,0,10,47,78.72,0,21.28,2019
"3059011",1016,56,275,1347,75.43,4.16,20.42,2019
"3059019",1328,26,249,1603,82.84,1.62,15.53,2019
"3059026",47,5,44,96,48.96,5.21,45.83,2019
"3059034",1233,96,353,1682,73.31,5.71,20.99,2019
"3059035",66,0,9,75,88,0,12,2019
"3059046",127,4,39,170,74.71,2.35,22.94,2019
"3059070",310,4,95,409,75.79,0.98,23.23,2019
"3059072",1527,21,421,1969,77.55,1.07,21.38,2019
"3059074",121,0,54,175,69.14,0,30.86,2019
"3059077",24,0,0,24,100,0,0,2019
"3059089",67,0,71,138,48.55,0,51.45,2019
"3059324",357,5,86,448,79.69,1.12,19.2,2019
"3059327",731,33,329,1093,66.88,3.02,30.1,2019
"3059349",337,9,93,439,76.77,2.05,21.18,2019
"2965710",415,0,76,491,84.52,0,15.48,2019
"2965738",6092,471,1051,7614,80.01,6.19,13.8,2019
"2965753",1476,38,261,1775,83.15,2.14,14.7,2019
"2965756",164,0,43,207,79.23,0,20.77,2019
"2965676",131,4,44,179,73.18,2.23,24.58,2019
"2965543",77,2,30,109,70.64,1.83,27.52,2019
"5554536",60,10,14,84,71.43,11.9,16.67,2019
"5554554",388,25,95,508,76.38,4.92,18.7,2019
"5554558",798,83,160,1041,76.66,7.97,15.37,2019
"5554615",3157,120,860,4137,76.31,2.9,20.79,2019
"5554642",661,15,155,831,79.54,1.81,18.65,2019
"5554655",493,29,179,701,70.33,4.14,25.53,2019
"5554669",2692,28,357,3077,87.49,0.91,11.6,2019
"5554740",686,17,160,863,79.49,1.97,18.54,2019
"5554742",1625,35,225,1885,86.21,1.86,11.94,2019
"5554761",346,9,90,445,77.75,2.02,20.22,2019
"5554763",333,16,114,463,71.92,3.46,24.62,2019
"5554768",1244,28,411,1683,73.92,1.66,24.42,2019
"5554213",480,12,58,550,87.27,2.18,10.55,2019
"5554235",6439,227,1444,8110,79.4,2.8,17.81,2019
"5554301",7837,142,1220,9199,85.19,1.54,13.26,2019
"5554313",13783,216,946,14945,92.22,1.45,6.33,2019
"5554409",4482,139,1066,5687,78.81,2.44,18.74,2019
"5554412",690,15,136,841,82.05,1.78,16.17,2019
"5554423",772,7,122,901,85.68,0.78,13.54,2019
"5554424",539,15,140,694,77.67,2.16,20.17,2019
"5554430",37,2,18,57,64.91,3.51,31.58,2019
"5554443",684,9,133,826,82.81,1.09,16.1,2019
"5554457",2941,69,637,3647,80.64,1.89,17.47,2019
"5554476",6777,72,795,7644,88.66,0.94,10.4,2019
"5554486",659,10,223,892,73.88,1.12,25,2019
"5554487",3610,76,740,4426,81.56,1.72,16.72,2019
"5554495",2728,78,550,3356,81.29,2.32,16.39,2019
"5554499",934,46,248,1228,76.06,3.75,20.2,2019
"5554514",700,6,147,853,82.06,0.7,17.23,2019
"5554526",230,8,108,346,66.47,2.31,31.21,2019
"5554564",104,7,76,187,55.61,3.74,40.64,2019
"5554616",747,19,238,1004,74.4,1.89,23.71,2019
"5554622",752,12,123,887,84.78,1.35,13.87,2019
"5554626",391,10,117,518,75.48,1.93,22.59,2019
"5554627",624,18,102,744,83.87,2.42,13.71,2019
"5554631",527,15,168,710,74.23,2.11,23.66,2019
"5554639",705,43,281,1029,68.51,4.18,27.31,2019
"5554656",5719,101,1249,7069,80.9,1.43,17.67,2019
"5554660",5241,148,1163,6552,79.99,2.26,17.75,2019
"5554731",212,10,77,299,70.9,3.34,25.75,2019
"5554737",193,5,18,216,89.35,2.31,8.33,2019
"5554772",345,6,78,429,80.42,1.4,18.18,2019
"5554812",1445,127,371,1943,74.37,6.54,19.09,2019
"5554824",659,33,285,977,67.45,3.38,29.17,2019
"5554846",159,5,48,212,75,2.36,22.64,2019
"5554864",451,10,52,513,87.91,1.95,10.14,2019
"5554870",603,27,88,718,83.98,3.76,12.26,2019
"5554927",213,0,0,213,100,0,0,2019
"5554945",1197,46,326,1569,76.29,2.93,20.78,2019
"5554962",368,14,121,503,73.16,2.78,24.06,2019
"5554984",1089,26,248,1363,79.9,1.91,18.2,2019
"5554517",49,2,8,59,83.05,3.39,13.56,2019
"5554534",932,46,221,1199,77.73,3.84,18.43,2019
"2756367",2121,24,234,2379,89.16,1.01,9.84,2019
"2756484",1201,13,289,1503,79.91,0.86,19.23,2019
"2756543",61,8,24,93,65.59,8.6,25.81,2019
"2756627",108,3,32,143,75.52,2.1,22.38,2019
"2756652",164,3,55,222,73.87,1.35,24.77,2019
"2756701",4461,286,828,5575,80.02,5.13,14.85,2019
"2755406",13631,513,1427,15571,87.54,3.29,9.16,2019
"2755411",6963,331,2170,9464,73.57,3.5,22.93,2019
"2755420",7185,276,1069,8530,84.23,3.24,12.53,2019
"2755421",9730,202,1787,11719,83.03,1.72,15.25,2019
"2755313",7859,273,884,9016,87.17,3.03,9.8,2019
"2755327",1293,0,53,1346,96.06,0,3.94,2019
"2755332",533,35,172,740,72.03,4.73,23.24,2019
"2755333",245,24,62,331,74.02,7.25,18.73,2019
"2755335",462,19,147,628,73.57,3.03,23.41,2019
"2755339",368,12,51,431,85.38,2.78,11.83,2019
"2755358",1776,60,227,2063,86.09,2.91,11,2019
"2755363",1401,41,194,1636,85.64,2.51,11.86,2019
"2755416",14899,442,1253,16594,89.79,2.66,7.55,2019
"2755373",1944,45,185,2174,89.42,2.07,8.51,2019
"2755381",666,11,141,818,81.42,1.34,17.24,2019
"2755385",415,19,93,527,78.75,3.61,17.65,2019
"2755417",9715,400,752,10867,89.4,3.68,6.92,2019
"2755970",308,15,64,387,79.59,3.88,16.54,2019
"2755976",2526,154,374,3054,82.71,5.04,12.25,2019
"2755977",48,0,21,69,69.57,0,30.43,2019
"2755992",1806,23,188,2017,89.54,1.14,9.32,2019
"2755442",4875,172,420,5467,89.17,3.15,7.68,2019
"2755425",3436,167,394,3997,85.96,4.18,9.86,2019
"2755433",12106,182,1473,13761,87.97,1.32,10.7,2019
"2755434",10068,219,1091,11378,88.49,1.92,9.59,2019
"2755454",1955,432,1067,3454,56.6,12.51,30.89,2019
"2755455",0,0,0,0,NA,NA,NA,2019
"2755707",1014,86,245,1345,75.39,6.39,18.22,2019
"2755709",1292,29,305,1626,79.46,1.78,18.76,2019
"2755721",1075,6,272,1353,79.45,0.44,20.1,2019
"2755738",150,9,49,208,72.12,4.33,23.56,2019
"2755742",109,2,24,135,80.74,1.48,17.78,2019
"2755749",163,0,37,200,81.5,0,18.5,2019
"2755760",1098,58,322,1478,74.29,3.92,21.79,2019
"2755787",212,5,41,258,82.17,1.94,15.89,2019
"2755798",204,6,48,258,79.07,2.33,18.6,2019
"2755810",2813,166,598,3577,78.64,4.64,16.72,2019
"2755811",9099,452,1572,11123,81.8,4.06,14.13,2019
"2755901",20261,974,1642,22877,88.56,4.26,7.18,2019
"2755904",9125,305,1139,10569,86.34,2.89,10.78,2019
"2755910",385,15,88,488,78.89,3.07,18.03,2019
"2755912",9191,371,1850,11412,80.54,3.25,16.21,2019
"2755929",399,22,54,475,84,4.63,11.37,2019
"2755932",714,17,94,825,86.55,2.06,11.39,2019
"2755939",510,40,212,762,66.93,5.25,27.82,2019
"2755949",551,36,120,707,77.93,5.09,16.97,2019
"2755954",466,18,113,597,78.06,3.02,18.93,2019
"2755965",871,36,164,1071,81.33,3.36,15.31,2019
"2755419",10213,135,389,10737,95.12,1.26,3.62,2019
"2755424",3305,80,122,3507,94.24,2.28,3.48,2019
"2755008",4741,140,1057,5938,79.84,2.36,17.8,2019
"2755011",3380,109,238,3727,90.69,2.92,6.39,2019
"2755019",693,10,48,751,92.28,1.33,6.39,2019
"2964859",369,28,114,511,72.21,5.48,22.31,2019
"2964461",255,25,38,318,80.19,7.86,11.95,2019
"2964468",4805,96,850,5751,83.55,1.67,14.78,2019
"2964470",496,2,174,672,73.81,0.3,25.89,2019
"2964482",798,43,195,1036,77.03,4.15,18.82,2019
"2964505",3773,118,1239,5130,73.55,2.3,24.15,2019
"2756278",1066,8,190,1264,84.34,0.63,15.03,2019
"2756292",142,6,63,211,67.3,2.84,29.86,2019
"2756301",10628,491,908,12027,88.37,4.08,7.55,2019
"2756311",243,10,58,311,78.14,3.22,18.65,2019
"2756318",359,9,59,427,84.07,2.11,13.82,2019
"2756332",570,15,84,669,85.2,2.24,12.56,2019
"2756336",507,29,104,640,79.22,4.53,16.25,2019
"2756353",2856,79,582,3517,81.21,2.25,16.55,2019
"2756433",580,18,167,765,75.82,2.35,21.83,2019
"2756449",590,13,107,710,83.1,1.83,15.07,2019
"2756465",760,10,139,909,83.61,1.1,15.29,2019
"2756481",656,29,156,841,78,3.45,18.55,2019
"2756482",2097,74,663,2834,73.99,2.61,23.39,2019
"2756527",229,7,83,319,71.79,2.19,26.02,2019
"2756531",711,35,124,870,81.72,4.02,14.25,2019
"2756536",108,12,53,173,62.43,6.94,30.64,2019
"2756542",925,35,222,1182,78.26,2.96,18.78,2019
"2756567",932,57,270,1259,74.03,4.53,21.45,2019
"2756572",1663,44,458,2165,76.81,2.03,21.15,2019
"2756573",2142,109,579,2830,75.69,3.85,20.46,2019
"2756587",494,8,107,609,81.12,1.31,17.57,2019
"2756601",11395,460,1780,13635,83.57,3.37,13.05,2019
"2756637",75,0,12,87,86.21,0,13.79,2019
"2756663",48,5,29,82,58.54,6.1,35.37,2019
"2756688",46,1,13,60,76.67,1.67,21.67,2019
"2756733",123,16,26,165,74.55,9.7,15.76,2019
"2756735",210,46,51,307,68.4,14.98,16.61,2019
"2756011",2705,30,353,3088,87.6,0.97,11.43,2019
"2756026",621,19,157,797,77.92,2.38,19.7,2019
"2756035",136,0,30,166,81.93,0,18.07,2019
"2756054",339,9,48,396,85.61,2.27,12.12,2019
"2756072",777,9,126,912,85.2,0.99,13.82,2019
"2756101",2006,137,402,2545,78.82,5.38,15.8,2019
"2756119",309,11,62,382,80.89,2.88,16.23,2019
"2756131",732,51,165,948,77.22,5.38,17.41,2019
"2756132",159,15,37,211,75.36,7.11,17.54,2019
"2756138",300,5,66,371,80.86,1.35,17.79,2019
"2756157",220,6,60,286,76.92,2.1,20.98,2019
"2756164",1932,91,376,2399,80.53,3.79,15.67,2019
"2756167",238,8,64,310,76.77,2.58,20.65,2019
"2756168",254,4,68,326,77.91,1.23,20.86,2019
"2756180",345,17,106,468,73.72,3.63,22.65,2019
"2756201",7490,196,1391,9077,82.52,2.16,15.32,2019
"2756025",162,4,20,186,87.1,2.15,10.75,2019
"2756031",4268,78,915,5261,81.13,1.48,17.39,2019
"2756041",360,11,81,452,79.65,2.43,17.92,2019
"2756051",234,10,60,304,76.97,3.29,19.74,2019
"2756074",673,21,100,794,84.76,2.64,12.59,2019
"2756075",74,2,6,82,90.24,2.44,7.32,2019
"2756255",110,0,30,140,78.57,0,21.43,2019
"2756090",227,12,42,281,80.78,4.27,14.95,2019
"2756097",1166,63,316,1545,75.47,4.08,20.45,2019
"2756122",168,19,69,256,65.62,7.42,26.95,2019
"1762903",955,91,136,1182,80.8,7.7,11.51,2019
"1762961",13,0,0,13,100,0,0,2019
"1762965",32,0,2,34,94.12,0,5.88,2019
"1762413",84,15,34,133,63.16,11.28,25.56,2019
"1762268",223,19,129,371,60.11,5.12,34.77,2019
"1762343",234,6,92,332,70.48,1.81,27.71,2019
"2965529",79,0,18,97,81.44,0,18.56,2019
"2965535",359,7,116,482,74.48,1.45,24.07,2019
"2965542",1305,162,498,1965,66.41,8.24,25.34,2019
"2965566",244,38,54,336,72.62,11.31,16.07,2019
"2965582",560,58,321,939,59.64,6.18,34.19,2019
"2965583",3779,280,487,4546,83.13,6.16,10.71,2019
"2965610",1430,51,399,1880,76.06,2.71,21.22,2019
"2965611",688,44,168,900,76.44,4.89,18.67,2019
"2965631",1705,43,284,2032,83.91,2.12,13.98,2019
"2965633",1137,66,312,1515,75.05,4.36,20.59,2019
"2965230",141,8,78,227,62.11,3.52,34.36,2019
"2965648",1718,45,496,2259,76.05,1.99,21.96,2019
"2965649",528,12,152,692,76.3,1.73,21.97,2019
"2965661",762,28,309,1099,69.34,2.55,28.12,2019
"2965707",701,16,160,877,79.93,1.82,18.24,2019
"2965720",183,3,174,360,50.83,0.83,48.33,2019
"2965721",9877,307,1444,11628,84.94,2.64,12.42,2019
"2965730",0,0,0,0,NA,NA,NA,2019
"2965735",5,0,27,32,15.62,0,84.38,2019
"2965742",3741,173,1075,4989,74.98,3.47,21.55,2019
"2965746",1495,90,942,2527,59.16,3.56,37.28,2019
"2965752",126,12,33,171,73.68,7.02,19.3,2019
"2965772",396,94,275,765,51.76,12.29,35.95,2019
"2965810",7932,652,763,9347,84.86,6.98,8.16,2019
"2965276",388,49,169,606,64.03,8.09,27.89,2019
"2965279",624,6,120,750,83.2,0.8,16,2019
"2965284",731,13,77,821,89.04,1.58,9.38,2019
"2965285",192,0,27,219,87.67,0,12.33,2019
"2965286",29,0,6,35,82.86,0,17.14,2019
"2965305",959,5,7,971,98.76,0.51,0.72,2019
"2965338",797,36,355,1188,67.09,3.03,29.88,2019
"2965349",826,20,208,1054,78.37,1.9,19.73,2019
"2965350",602,26,112,740,81.35,3.51,15.14,2019
"2965802",13956,1176,4099,19231,72.57,6.12,21.31,2019
"2965011",367,85,265,717,51.19,11.85,36.96,2019
"2965025",183,22,44,249,73.49,8.84,17.67,2019
"2965039",897,9,69,975,92,0.92,7.08,2019
"2965052",1001,58,213,1272,78.69,4.56,16.75,2019
"2965066",2068,57,303,2428,85.17,2.35,12.48,2019
"2965079",1501,66,199,1766,84.99,3.74,11.27,2019
"2965084",1531,162,669,2362,64.82,6.86,28.32,2019
"2965026",3161,332,1125,4618,68.45,7.19,24.36,2019
"2965043",3200,242,685,4127,77.54,5.86,16.6,2019
"2965058",224,6,208,438,51.14,1.37,47.49,2019
"2965059",220,60,29,309,71.2,19.42,9.39,2019
"2965076",195,16,85,296,65.88,5.41,28.72,2019
"2965082",287,0,91,378,75.93,0,24.07,2019
"2965085",330,14,151,495,66.67,2.83,30.51,2019
"2965202",15995,492,2828,19315,82.81,2.55,14.64,2019
"2965233",3350,153,761,4264,78.56,3.59,17.85,2019
"2965237",230,15,111,356,64.61,4.21,31.18,2019
"2965301",10293,311,2493,13097,78.59,2.37,19.03,2019
"2965330",131,2,38,171,76.61,1.17,22.22,2019
"3168337",129,2,26,157,82.17,1.27,16.56,2019
"3168344",143,4,23,170,84.12,2.35,13.53,2019
"3168350",67,1,25,93,72.04,1.08,26.88,2019
"3168351",330,6,53,389,84.83,1.54,13.62,2019
"3168357",97,4,27,128,75.78,3.12,21.09,2019
"3168365",92,0,25,117,78.63,0,21.37,2019
"2756761",111,47,21,179,62.01,26.26,11.73,2019
"2756728",411,132,73,616,66.72,21.43,11.85,2019
"2963072",1104,0,215,1319,83.7,0,16.3,2019
"2963438",122,15,19,156,78.21,9.62,12.18,2019
"2963441",336,4,108,448,75,0.89,24.11,2019
"2963445",993,68,354,1415,70.18,4.81,25.02,2019
"2963460",79,5,35,119,66.39,4.2,29.41,2019
"2963533",199,1,62,262,75.95,0.38,23.66,2019
"2963549",575,55,297,927,62.03,5.93,32.04,2019
"2963563",121,24,69,214,56.54,11.21,32.24,2019
"2963601",4705,159,1386,6250,75.28,2.54,22.18,2019
"2963622",249,15,104,368,67.66,4.08,28.26,2019
"2963663",212,8,84,304,69.74,2.63,27.63,2019
"2963629",368,4,167,539,68.27,0.74,30.98,2019
"2963633",184,1,49,234,78.63,0.43,20.94,2019
"2963654",234,0,39,273,85.71,0,14.29,2019
"2963665",70,0,31,101,69.31,0,30.69,2019
"2963750",4,0,4,8,50,0,50,2019
"2963771",885,50,193,1128,78.46,4.43,17.11,2019
"2963774",43,0,11,54,79.63,0,20.37,2019
"2963825",1194,27,391,1612,74.07,1.67,24.26,2019
"2963847",14,0,21,35,40,0,60,2019
"2963852",372,22,99,493,75.46,4.46,20.08,2019
"2963857",4046,174,922,5142,78.69,3.38,17.93,2019
"2963869",1110,23,368,1501,73.95,1.53,24.52,2019
"2963880",36,0,20,56,64.29,0,35.71,2019
"2963932",138,0,259,397,34.76,0,65.24,2019
"2963942",186,0,83,269,69.14,0,30.86,2019
"2963953",436,5,168,609,71.59,0.82,27.59,2019
"2963957",1807,57,561,2425,74.52,2.35,23.13,2019
"2963656",83,0,21,104,79.81,0,20.19,2019
"2963626",323,24,122,469,68.87,5.12,26.01,2019
"2963636",159,7,100,266,59.77,2.63,37.59,2019
"2963653",427,22,76,525,81.33,4.19,14.48,2019
"2963664",2413,92,1169,3674,65.68,2.5,31.82,2019
"2963736",1094,65,213,1372,79.74,4.74,15.52,2019
"2963543",47,2,30,79,59.49,2.53,37.97,2019
"2963660",682,72,367,1121,60.84,6.42,32.74,2019
"2963567",42,0,23,65,64.62,0,35.38,2019
"2963038",2343,32,49,2424,96.66,1.32,2.02,2019
"2963451",71,5,10,86,82.56,5.81,11.63,2019
"2963373",178,16,23,217,82.03,7.37,10.6,2019
"2963450",72,0,10,82,87.8,0,12.2,2019
"2963501",5808,462,1510,7780,74.65,5.94,19.41,2019
"2963828",45,4,21,70,64.29,5.71,30,2019
"2963462",516,13,110,639,80.75,2.03,17.21,2019
"2963620",297,25,160,482,61.62,5.19,33.2,2019
"2963867",302,9,99,410,73.66,2.2,24.15,2019
"2963781",305,2,151,458,66.59,0.44,32.97,2019
"2963853",73,0,12,85,85.88,0,14.12,2019
"2963473",83,0,10,93,89.25,0,10.75,2019
"2963557",63,0,29,92,68.48,0,31.52,2019
"2963637",417,0,169,586,71.16,0,28.84,2019
"1950450",969,48,251,1268,76.42,3.79,19.79,2019
"1950452",285,9,88,382,74.61,2.36,23.04,2019
"1950455",139,0,32,171,81.29,0,18.71,2019
"1950456",608,23,138,769,79.06,2.99,17.95,2019
"1950469",519,9,75,603,86.07,1.49,12.44,2019
"1950480",294,12,39,345,85.22,3.48,11.3,2019
"2964624",519,19,145,683,75.99,2.78,21.23,2019
"2964651",224,11,58,293,76.45,3.75,19.8,2019
"2964660",127,4,44,175,72.57,2.29,25.14,2019
"2964673",555,31,271,857,64.76,3.62,31.62,2019
"2964724",640,8,165,813,78.72,0.98,20.3,2019
"2964725",676,41,133,850,79.53,4.82,15.65,2019
"2964745",60,0,10,70,85.71,0,14.29,2019
"2964090",37,0,10,47,78.72,0,21.28,2019
"2964056",4842,182,765,5789,83.64,3.14,13.21,2019
"2964058",2128,82,294,2504,84.98,3.27,11.74,2019
"2964097",400,8,143,551,72.6,1.45,25.95,2019
"2964112",4127,436,270,4833,85.39,9.02,5.59,2019
"2964114",10818,492,1160,12470,86.75,3.95,9.3,2019
"2964129",2937,178,688,3803,77.23,4.68,18.09,2019
"2964132",3725,159,1571,5455,68.29,2.91,28.8,2019
"2964147",67,5,113,185,36.22,2.7,61.08,2019
"2964157",6163,123,117,6403,96.25,1.92,1.83,2019
"2964164",105,0,0,105,100,0,0,2019
"2964192",0,0,0,0,NA,NA,NA,2019
"2964402",797,23,219,1039,76.71,2.21,21.08,2019
"2964427",179,10,73,262,68.32,3.82,27.86,2019
"2964429",2933,158,758,3849,76.2,4.1,19.69,2019
"2964434",162,8,32,202,80.2,3.96,15.84,2019
"2964444",403,46,54,503,80.12,9.15,10.74,2019
"2964016",1540,49,282,1871,82.31,2.62,15.07,2019
"2964057",5168,159,656,5983,86.38,2.66,10.96,2019
"2964061",986,51,247,1284,76.79,3.97,19.24,2019
"2964064",6667,90,320,7077,94.21,1.27,4.52,2019
"2964077",564,10,107,681,82.82,1.47,15.71,2019
"2964088",431,11,87,529,81.47,2.08,16.45,2019
"2964119",10042,413,903,11358,88.41,3.64,7.95,2019
"2964137",3557,278,479,4314,82.45,6.44,11.1,2019
"2964449",141,8,96,245,57.55,3.27,39.18,2019
"2964456",466,5,126,597,78.06,0.84,21.11,2019
"2964471",120,1,26,147,81.63,0.68,17.69,2019
"2964474",241,12,62,315,76.51,3.81,19.68,2019
"2964477",1118,28,321,1467,76.21,1.91,21.88,2019
"2964484",271,4,106,381,71.13,1.05,27.82,2019
"2964490",534,16,183,733,72.85,2.18,24.97,2019
"2964493",159,0,44,203,78.33,0,21.67,2019
"2964501",3161,39,1292,4492,70.37,0.87,28.76,2019
"2964503",3882,182,756,4820,80.54,3.78,15.68,2019
"2964504",3263,37,937,4237,77.01,0.87,22.11,2019
"2964506",6992,241,1828,9061,77.17,2.66,20.17,2019
"2964622",129,6,52,187,68.98,3.21,27.81,2019
"2964635",151,9,60,220,68.64,4.09,27.27,2019
"2964034",3181,18,135,3334,95.41,0.54,4.05,2019
"2964167",146,0,0,146,100,0,0,2019
"2964154",4098,96,317,4511,90.84,2.13,7.03,2019
"2964163",300,35,51,386,77.72,9.07,13.21,2019
"2964166",76,0,13,89,85.39,0,14.61,2019
"2964438",49,4,29,82,59.76,4.88,35.37,2019
"2964443",512,11,92,615,83.25,1.79,14.96,2019
"2649126",360,5,120,485,74.23,1.03,24.74,2019
"2649224",3719,78,1249,5046,73.7,1.55,24.75,2019
"2649234",923,48,102,1073,86.02,4.47,9.51,2019
"2649255",441,28,286,755,58.41,3.71,37.88,2019
"2649266",1034,20,294,1348,76.71,1.48,21.81,2019
"2649274",952,59,243,1254,75.92,4.7,19.38,2019
"1762473",379,22,121,522,72.61,4.21,23.18,2019
"1762571",406,7,177,590,68.81,1.19,30,2019
"1762952",784,24,428,1236,63.43,1.94,34.63,2019
"2965032",430,41,183,654,65.75,6.27,27.98,2019
"2965035",521,21,157,699,74.54,3,22.46,2019
"2965037",1502,136,488,2126,70.65,6.4,22.95,2019
"2965041",1772,37,553,2362,75.02,1.57,23.41,2019
"2965051",1051,263,473,1787,58.81,14.72,26.47,2019
"2965068",202,1,56,259,77.99,0.39,21.62,2019
"2965074",730,128,256,1114,65.53,11.49,22.98,2019
"2965078",1014,52,362,1428,71.01,3.64,25.35,2019
"2965246",16,0,4,20,80,0,20,2019
"2965010",2079,101,252,2432,85.49,4.15,10.36,2019
"2965013",856,34,385,1275,67.14,2.67,30.2,2019
"2965016",420,71,81,572,73.43,12.41,14.16,2019
"2965048",21,0,33,54,38.89,0,61.11,2019
"2965050",48,20,135,203,23.65,9.85,66.5,2019
"2965063",1038,54,144,1236,83.98,4.37,11.65,2019
"2965065",2173,89,160,2422,89.72,3.67,6.61,2019
"2965069",208,16,25,249,83.53,6.43,10.04,2019
"2965072",537,52,95,684,78.51,7.6,13.89,2019
"2965077",119,0,38,157,75.8,0,24.2,2019
"2965109",12041,1867,2548,16456,73.17,11.35,15.48,2019
"2965201",13466,2233,1490,17189,78.34,12.99,8.67,2019
"2965236",377,12,192,581,64.89,2.07,33.05,2019
"2965239",424,12,88,524,80.92,2.29,16.79,2019
"2965257",487,1,100,588,82.82,0.17,17.01,2019
"2965265",4450,155,1336,5941,74.9,2.61,22.49,2019
"2965725",993,9,203,1205,82.41,0.75,16.85,2019
"2965732",325,6,17,348,93.39,1.72,4.89,2019
"2965747",1213,153,111,1477,82.13,10.36,7.52,2019
"2965757",2245,79,515,2839,79.08,2.78,18.14,2019
"2965759",440,3,92,535,82.24,0.56,17.2,2019
"2965773",245,0,34,279,87.81,0,12.19,2019
"2965785",1573,149,455,2177,72.26,6.84,20.9,2019
"2965248",1043,36,287,1366,76.35,2.64,21.01,2019
"2965259",817,68,176,1061,77,6.41,16.59,2019
"2965275",848,18,274,1140,74.39,1.58,24.04,2019
"2965326",643,21,242,906,70.97,2.32,26.71,2019
"2965436",27,0,0,27,100,0,0,2019
"2965439",37,19,8,64,57.81,29.69,12.5,2019
"2965441",1732,48,521,2301,75.27,2.09,22.64,2019
"2965453",2403,130,880,3413,70.41,3.81,25.78,2019
"2965463",240,72,98,410,58.54,17.56,23.9,2019
"2965466",469,6,180,655,71.6,0.92,27.48,2019
"2965483",1229,209,357,1795,68.47,11.64,19.89,2019
"2965550",858,6,351,1215,70.62,0.49,28.89,2019
"2965589",3,0,31,34,8.82,0,91.18,2019
"2965601",189,3,48,240,78.75,1.25,20,2019
"2964401",375,7,101,483,77.64,1.45,20.91,2019
"2964433",21,1,3,25,84,4,12,2019
"2964445",75,0,42,117,64.1,0,35.9,2019
"2964446",355,30,110,495,71.72,6.06,22.22,2019
"2649829",6043,243,1620,7906,76.44,3.07,20.49,2019
"2649877",6,0,2,8,75,0,25,2019
"2649948",189,6,61,256,73.83,2.34,23.83,2019
"2649060",752,0,25,777,96.78,0,3.22,2019
"2649113",559,53,166,778,71.85,6.81,21.34,2019
"2649256",1216,30,285,1531,79.43,1.96,18.62,2019
"3168372",1142,12,71,1225,93.22,0.98,5.8,2019
"3168403",59,0,22,81,72.84,0,27.16,2019
"3168434",2762,123,339,3224,85.67,3.82,10.51,2019
"3168628",307,3,56,366,83.88,0.82,15.3,2019
"3168632",1287,14,276,1577,81.61,0.89,17.5,2019
"3168305",1406,104,349,1859,75.63,5.59,18.77,2019
"3168340",319,15,86,420,75.95,3.57,20.48,2019
"3168355",1815,69,357,2241,80.99,3.08,15.93,2019
"3168362",18,0,7,25,72,0,28,2019
"3168370",717,5,190,912,78.62,0.55,20.83,2019
"3168378",244,5,41,290,84.14,1.72,14.14,2019
"3168416",71,6,16,93,76.34,6.45,17.2,2019
"3168420",446,8,129,583,76.5,1.37,22.13,2019
"3168422",174,9,11,194,89.69,4.64,5.67,2019
"3168428",461,11,13,485,95.05,2.27,2.68,2019
"3168431",126,3,19,148,85.14,2.03,12.84,2019
"3168512",5264,30,151,5445,96.68,0.55,2.77,2019
"3168521",12258,311,1192,13761,89.08,2.26,8.66,2019
"3168528",2219,140,101,2460,90.2,5.69,4.11,2019
"3168620",1011,16,162,1189,85.03,1.35,13.62,2019
"3168112",3260,160,885,4305,75.73,3.72,20.56,2019
"3168107",6805,179,2245,9229,73.73,1.94,24.33,2019
"3168108",3825,215,1067,5107,74.9,4.21,20.89,2019
"3168124",5611,152,744,6507,86.23,2.34,11.43,2019
"3168127",8672,195,1133,10000,86.72,1.95,11.33,2019
"3168142",1700,63,50,1813,93.77,3.47,2.76,2019
"3168304",101,3,8,112,90.18,2.68,7.14,2019
"3168015",366,41,45,452,80.97,9.07,9.96,2019
"3168037",760,50,119,929,81.81,5.38,12.81,2019
"3168042",18,1,9,28,64.29,3.57,32.14,2019
"3168050",185,26,77,288,64.24,9.03,26.74,2019
"3168063",83,1,30,114,72.81,0.88,26.32,2019
"3168065",450,27,114,591,76.14,4.57,19.29,2019
"3168067",193,26,103,322,59.94,8.07,31.99,2019
"3168068",32,4,2,38,84.21,10.53,5.26,2019
"3168118",3437,55,45,3537,97.17,1.55,1.27,2019
"3168131",4666,198,547,5411,86.23,3.66,10.11,2019
"3168132",4940,145,559,5644,87.53,2.57,9.9,2019
"3168144",8496,393,1034,9923,85.62,3.96,10.42,2019
"3168310",4792,113,1033,5938,80.7,1.9,17.4,2019
"3168331",284,2,69,355,80,0.56,19.44,2019
"3168424",222,6,70,298,74.5,2.01,23.49,2019
"3168444",24,1,1,26,92.31,3.85,3.85,2019
"3168461",255,0,76,331,77.04,0,22.96,2019
"3168503",5293,188,803,6284,84.23,2.99,12.78,2019
"3168506",11298,350,1347,12995,86.94,2.69,10.37,2019
"3168522",3893,141,320,4354,89.41,3.24,7.35,2019
"3168601",9016,295,1889,11200,80.5,2.63,16.87,2019
"3168631",128,7,43,178,71.91,3.93,24.16,2019
"3168637",115,3,36,154,74.68,1.95,23.38,2019
"3168641",394,7,90,491,80.24,1.43,18.33,2019
"3168781",425,11,128,564,75.35,1.95,22.7,2019
"2067352",174,5,43,222,78.38,2.25,19.37,2019
"2270454",9070,332,1931,11333,80.03,2.93,17.04,2019
"2270456",575,8,243,826,69.61,0.97,29.42,2019
"2270463",20,0,26,46,43.48,0,56.52,2019
"2270464",162,0,0,162,100,0,0,2019
"2270466",2418,94,542,3054,79.17,3.08,17.75,2019
"2270508",15139,268,1133,16540,91.53,1.62,6.85,2019
"1950211",4399,180,476,5055,87.02,3.56,9.42,2019
"1950214",282,0,15,297,94.95,0,5.05,2019
"1950233",457,3,71,531,86.06,0.56,13.37,2019
"1950235",109,22,31,162,67.28,13.58,19.14,2019
"1950237",973,16,255,1244,78.22,1.29,20.5,2019
"1950541",316,7,63,386,81.87,1.81,16.32,2019
"1950548",1940,94,487,2521,76.95,3.73,19.32,2019
"1950567",94,1,24,119,78.99,0.84,20.17,2019
"1950569",241,15,88,344,70.06,4.36,25.58,2019
"1950570",55,5,14,74,74.32,6.76,18.92,2019
"1950606",220,3,73,296,74.32,1.01,24.66,2019
"1950609",134,19,21,174,77.01,10.92,12.07,2019
"1950643",958,49,64,1071,89.45,4.58,5.98,2019
"1950651",1155,51,262,1468,78.68,3.47,17.85,2019
"1950665",889,41,284,1214,73.23,3.38,23.39,2019
"1950670",772,41,130,943,81.87,4.35,13.79,2019
"1950676",720,23,157,900,80,2.56,17.44,2019
"1950648",1270,48,152,1470,86.39,3.27,10.34,2019
"1950669",750,52,181,983,76.3,5.29,18.41,2019
"1950675",766,25,158,949,80.72,2.63,16.65,2019
"1950020",459,13,146,618,74.27,2.1,23.62,2019
"1950021",9898,334,705,10937,90.5,3.05,6.45,2019
"1950029",196,11,71,278,70.5,3.96,25.54,2019
"1950049",2127,71,612,2810,75.69,2.53,21.78,2019
"1950052",43,4,15,62,69.35,6.45,24.19,2019
"1950112",3831,88,734,4653,82.33,1.89,15.77,2019
"1950511",2538,99,572,3209,79.09,3.09,17.82,2019
"1950531",91,4,12,107,85.05,3.74,11.21,2019
"1950554",628,15,149,792,79.29,1.89,18.81,2019
"1950556",55,3,48,106,51.89,2.83,45.28,2019
"1950561",184,3,27,214,85.98,1.4,12.62,2019
"1950566",163,8,25,196,83.16,4.08,12.76,2019
"1950576",111,3,26,140,79.29,2.14,18.57,2019
"1950585",422,13,89,524,80.53,2.48,16.98,2019
"1950057",95,0,27,122,77.87,0,22.13,2019
"1950064",72,1,3,76,94.74,1.32,3.95,2019
"1950102",53,14,0,67,79.1,20.9,0,2019
"1950111",4931,104,356,5391,91.47,1.93,6.6,2019
"1950116",52,0,16,68,76.47,0,23.53,2019
"1950143",204,0,51,255,80,0,20,2019
"1950563",973,39,156,1168,83.3,3.34,13.36,2019
"1950581",287,8,70,365,78.63,2.19,19.18,2019
"1950604",617,2,189,808,76.36,0.25,23.39,2019
"1950607",123,2,33,158,77.85,1.27,20.89,2019
"1950622",1133,38,112,1283,88.31,2.96,8.73,2019
"1950624",555,13,70,638,86.99,2.04,10.97,2019
"1950652",24,2,16,42,57.14,4.76,38.1,2019
"1950653",232,13,27,272,85.29,4.78,9.93,2019
"1950654",164,2,29,195,84.1,1.03,14.87,2019
"1950668",387,7,69,463,83.59,1.51,14.9,2019
"1950673",56,1,11,68,82.35,1.47,16.18,2019
"1950542",310,6,98,414,74.88,1.45,23.67,2019
"1950573",14,5,14,33,42.42,15.15,42.42,2019
"1952151",639,33,184,856,74.65,3.86,21.5,2019
"1952255",493,4,114,611,80.69,0.65,18.66,2019
"1952330",251,4,81,336,74.7,1.19,24.11,2019
"1952404",13420,1061,2444,16925,79.29,6.27,14.44,2019
"1952048",134,0,26,160,83.75,0,16.25,2019
"1952208",1039,22,278,1339,77.6,1.64,20.76,2019
"2649302",2662,51,220,2933,90.76,1.74,7.5,2019
"2649326",1374,30,284,1688,81.4,1.78,16.82,2019
"2649335",75,0,0,75,100,0,0,2019
"2649340",800,17,231,1048,76.34,1.62,22.04,2019
"2649343",1447,80,400,1927,75.09,4.15,20.76,2019
"2649349",2137,109,875,3121,68.47,3.49,28.04,2019
"2649412",3473,146,749,4368,79.51,3.34,17.15,2019
"2649415",2162,101,331,2594,83.35,3.89,12.76,2019
"2649431",5986,337,1230,7553,79.25,4.46,16.28,2019
"2649445",7273,218,890,8381,86.78,2.6,10.62,2019
"2649451",1689,93,365,2147,78.67,4.33,17,2019
"2649507",9814,350,2132,12296,79.81,2.85,17.34,2019
"2649509",8746,137,1128,10011,87.36,1.37,11.27,2019
"2649512",6770,91,788,7649,88.51,1.19,10.3,2019
"2649622",899,33,186,1118,80.41,2.95,16.64,2019
"2649628",59,0,10,69,85.51,0,14.49,2019
"2649776",507,24,235,766,66.19,3.13,30.68,2019
"2649779",1496,69,428,1993,75.06,3.46,21.48,2019
"2649820",106,5,39,150,70.67,3.33,26,2019
"2649837",3150,55,744,3949,79.77,1.39,18.84,2019
"2649849",3931,279,876,5086,77.29,5.49,17.22,2019
"2649866",2637,131,412,3180,82.92,4.12,12.96,2019
"2649872",45,0,24,69,65.22,0,34.78,2019
"2649886",196,4,37,237,82.7,1.69,15.61,2019
"2649903",23,2,20,45,51.11,4.44,44.44,2019
"2649920",1296,104,450,1850,70.05,5.62,24.32,2019
"2649947",146,21,48,215,67.91,9.77,22.33,2019
"2649967",144,20,49,213,67.61,9.39,23,2019
"2649419",2301,63,430,2794,82.36,2.25,15.39,2019
"2649423",13894,428,2441,16763,82.88,2.55,14.56,2019
"2649425",1034,61,221,1316,78.57,4.64,16.79,2019
"2649428",8778,287,1024,10089,87.01,2.84,10.15,2019
"2649457",3138,183,526,3847,81.57,4.76,13.67,2019
"2649508",12588,403,1810,14801,85.05,2.72,12.23,2019
"2649546",11241,506,1380,13127,85.63,3.85,10.51,2019
"2649613",227,13,51,291,78.01,4.47,17.53,2019
"2649615",1406,38,285,1729,81.32,2.2,16.48,2019
"2649621",1316,14,176,1506,87.38,0.93,11.69,2019
"2649623",303,7,134,444,68.24,1.58,30.18,2019
"2649629",798,40,132,970,82.27,4.12,13.61,2019
"2649632",353,23,71,447,78.97,5.15,15.88,2019
"2649638",243,3,108,354,68.64,0.85,30.51,2019
"2649643",2419,36,249,2704,89.46,1.33,9.21,2019
"2649655",884,56,327,1267,69.77,4.42,25.81,2019
"2649659",2021,104,551,2676,75.52,3.89,20.59,2019
"2649663",1531,102,586,2219,69,4.6,26.41,2019
"2649684",14026,578,2211,16815,83.41,3.44,13.15,2019
"2649706",1449,97,235,1781,81.36,5.45,13.19,2019
"2649710",125,9,66,200,62.5,4.5,33,2019
"2649713",725,33,117,875,82.86,3.77,13.37,2019
"2649720",3194,296,562,4052,78.83,7.31,13.87,2019
"2649726",407,14,86,507,80.28,2.76,16.96,2019
"2649727",2260,106,628,2994,75.48,3.54,20.98,2019
"1952052",1036,96,267,1399,74.05,6.86,19.09,2019
"5553583",2080,81,374,2535,82.05,3.2,14.75,2019
"5553809",1222,33,286,1541,79.3,2.14,18.56,2019
"5553576",731,51,96,878,83.26,5.81,10.93,2019
"5553575",5503,87,501,6091,90.35,1.43,8.23,2019
"5553577",464,11,107,582,79.73,1.89,18.38,2019
"2649037",6762,200,1806,8768,77.12,2.28,20.6,2019
"2649048",8819,212,878,9909,89,2.14,8.86,2019
"2649074",21,9,50,80,26.25,11.25,62.5,2019
"2649084",0,0,7,7,0,0,100,2019
"2649104",0,0,0,0,NA,NA,NA,2019
"2649815",114,0,25,139,82.01,0,17.99,2019
"2649836",237,30,105,372,63.71,8.06,28.23,2019
"2649848",36,0,10,46,78.26,0,21.74,2019
"2649861",181,4,56,241,75.1,1.66,23.24,2019
"2649862",1118,90,231,1439,77.69,6.25,16.05,2019
"2649883",27,1,17,45,60,2.22,37.78,2019
"2649884",73,4,49,126,57.94,3.17,38.89,2019
"2649230",3749,179,555,4483,83.63,3.99,12.38,2019
"2649236",1650,51,186,1887,87.44,2.7,9.86,2019
"2649242",4244,202,1238,5684,74.67,3.55,21.78,2019
"2649245",1332,47,475,1854,71.84,2.54,25.62,2019
"2649247",1752,71,461,2284,76.71,3.11,20.18,2019
"2649250",1924,89,460,2473,77.8,3.6,18.6,2019
"2649262",336,20,150,506,66.4,3.95,29.64,2019
"2649263",25,0,0,25,100,0,0,2019
"2649287",688,25,92,805,85.47,3.11,11.43,2019
"2649301",6542,71,204,6817,95.97,1.04,2.99,2019
"2649322",379,26,116,521,72.74,4.99,22.26,2019
"2649328",1128,47,343,1518,74.31,3.1,22.6,2019
"2649330",1332,84,369,1785,74.62,4.71,20.67,2019
"2649401",5484,933,451,6868,79.85,13.58,6.57,2019
"2649417",11017,345,1269,12631,87.22,2.73,10.05,2019
"2649450",599,15,316,930,64.41,1.61,33.98,2019
"2649456",7133,136,763,8032,88.81,1.69,9.5,2019
"2649458",34,0,16,50,68,0,32,2019
"2649504",12485,482,2454,15421,80.96,3.13,15.91,2019
"2649505",11272,469,1741,13482,83.61,3.48,12.91,2019
"2649506",11389,271,920,12580,90.53,2.15,7.31,2019
"2649611",97,0,3,100,97,0,3,2019
"2649612",487,5,114,606,80.36,0.83,18.81,2019
"2649617",1039,18,204,1261,82.39,1.43,16.18,2019
"2649636",184,8,4,196,93.88,4.08,2.04,2019
"2649637",1149,0,133,1282,89.63,0,10.37,2019
"2649640",534,10,88,632,84.49,1.58,13.92,2019
"2649649",1889,95,219,2203,85.75,4.31,9.94,2019
"2649654",211,19,15,245,86.12,7.76,6.12,2019
"2649679",335,26,114,475,70.53,5.47,24,2019
"2649707",7790,302,1829,9921,78.52,3.04,18.44,2019
"2649736",163,5,78,246,66.26,2.03,31.71,2019
"2649642",184,15,161,360,51.11,4.17,44.72,2019
"2649645",479,21,110,610,78.52,3.44,18.03,2019
"2649653",643,11,165,819,78.51,1.34,20.15,2019
"2649656",406,21,205,632,64.24,3.32,32.44,2019
"2649004",5674,109,590,6373,89.03,1.71,9.26,2019
"2649010",4923,155,1644,6722,73.24,2.31,24.46,2019
"2649011",658,7,151,816,80.64,0.86,18.5,2019
"2649013",1433,62,399,1894,75.66,3.27,21.07,2019
"2649021",1864,126,411,2401,77.63,5.25,17.12,2019
"5553182",2802,47,500,3349,83.67,1.4,14.93,2019
"5553183",1008,8,65,1081,93.25,0.74,6.01,2019
"5553188",12598,384,1431,14413,87.41,2.66,9.93,2019
"5553204",7795,448,4830,13073,59.63,3.43,36.95,2019
"5553206",4791,286,2902,7979,60.05,3.58,36.37,2019
"5553214",11763,545,3334,15642,75.2,3.48,21.31,2019
"2270524",58,5,51,114,50.88,4.39,44.74,2019
"2270525",3948,178,1075,5201,75.91,3.42,20.67,2019
"2270544",2509,65,1182,3756,66.8,1.73,31.47,2019
"2270554",1331,78,708,2117,62.87,3.68,33.44,2019
"2270555",2708,22,272,3002,90.21,0.73,9.06,2019
"2270559",710,30,243,983,72.23,3.05,24.72,2019
"2270580",111,0,0,111,100,0,0,2019
"2270634",7505,232,1892,9629,77.94,2.41,19.65,2019
"2270639",157,0,43,200,78.5,0,21.5,2019
"2270646",137,0,157,294,46.6,0,53.4,2019
"2270653",949,8,295,1252,75.8,0.64,23.56,2019
"2270436",218,0,99,317,68.77,0,31.23,2019
"2270444",2513,62,1171,3746,67.08,1.66,31.26,2019
"2270458",12164,361,1573,14098,86.28,2.56,11.16,2019
"2270592",8072,41,382,8495,95.02,0.48,4.5,2019
"2270049",371,11,189,571,64.97,1.93,33.1,2019
"2270057",1103,173,378,1654,66.69,10.46,22.85,2019
"2270080",363,18,146,527,68.88,3.42,27.7,2019
"2270341",1074,69,492,1635,65.69,4.22,30.09,2019
"2270372",838,13,197,1048,79.96,1.24,18.8,2019
"2270393",200,22,81,303,66.01,7.26,26.73,2019
"2270426",1116,57,638,1811,61.62,3.15,35.23,2019
"2270460",6440,266,939,7645,84.24,3.48,12.28,2019
"2270462",1385,60,678,2123,65.24,2.83,31.94,2019
"2270510",7486,368,1857,9711,77.09,3.79,19.12,2019
"2270512",2933,71,617,3621,81,1.96,17.04,2019
"2270526",4847,194,1682,6723,72.1,2.89,25.02,2019
"2270529",3755,180,709,4644,80.86,3.88,15.27,2019
"2270546",4702,145,1627,6474,72.63,2.24,25.13,2019
"2270577",942,122,440,1504,62.63,8.11,29.26,2019
"2270582",5187,386,1716,7289,71.16,5.3,23.54,2019
"2270586",4999,146,2316,7461,67,1.96,31.04,2019
"2270615",3278,178,1250,4706,69.66,3.78,26.56,2019
"2270637",298,0,24,322,92.55,0,7.45,2019
"2270659",394,30,108,532,74.06,5.64,20.3,2019
"2270706",6284,444,737,7465,84.18,5.95,9.87,2019
"2270541",69,10,55,134,51.49,7.46,41.04,2019
"2270517",7782,168,1923,9873,78.82,1.7,19.48,2019
"2270523",207,0,85,292,70.89,0,29.11,2019
"2270532",498,0,453,951,52.37,0,47.63,2019
"2270542",1188,6,276,1470,80.82,0.41,18.78,2019
"2270550",0,0,0,0,NA,NA,NA,2019
"2270576",219,0,73,292,75,0,25,2019
"2270607",8655,391,2435,11481,75.39,3.41,21.21,2019
"2270640",48,3,72,123,39.02,2.44,58.54,2019
"2270647",2416,175,799,3390,71.27,5.16,23.57,2019
"2270806",9740,659,1837,12236,79.6,5.39,15.01,2019
"2270820",5691,519,818,7028,80.98,7.38,11.64,2019
"2270558",0,0,0,0,NA,NA,NA,2019
"2270643",90,0,79,169,53.25,0,46.75,2019
"2270712",78,23,35,136,57.35,16.91,25.74,2019
"2270769",13781,217,1238,15236,90.45,1.42,8.13,2019
"2270438",4956,132,2182,7270,68.17,1.82,30.01,2019
"3059351",68,7,8,83,81.93,8.43,9.64,2019
"3059401",4729,189,1412,6330,74.71,2.99,22.31,2019
"3059405",10262,339,2882,13483,76.11,2.51,21.38,2019
"3059417",1251,44,911,2206,56.71,1.99,41.3,2019
"3059422",850,25,243,1118,76.03,2.24,21.74,2019
"3059456",55,0,33,88,62.5,0,37.5,2019
"1952557",0,0,0,0,NA,NA,NA,2019
"1952657",22,2,4,28,78.57,7.14,14.29,2019
"1952535",304,3,98,405,75.06,0.74,24.2,2019
"1952549",163,17,89,269,60.59,6.32,33.09,2019
"1952552",257,6,92,355,72.39,1.69,25.92,2019
"1952555",107,2,43,152,70.39,1.32,28.29,2019
"1952556",4159,225,727,5111,81.37,4.4,14.22,2019
"1952561",355,10,35,400,88.75,2.5,8.75,2019
"1952567",230,8,84,322,71.43,2.48,26.09,2019
"1952571",474,39,90,603,78.61,6.47,14.93,2019
"1952581",118,0,26,144,81.94,0,18.06,2019
"1952590",251,10,212,473,53.07,2.11,44.82,2019
"1952593",66,0,13,79,83.54,0,16.46,2019
"1952601",9844,272,2462,12578,78.26,2.16,19.57,2019
"1952632",3687,245,1359,5291,69.68,4.63,25.69,2019
"1952638",173,4,35,212,81.6,1.89,16.51,2019
"1952640",400,29,110,539,74.21,5.38,20.41,2019
"1952649",283,9,71,363,77.96,2.48,19.56,2019
"1952651",150,8,104,262,57.25,3.05,39.69,2019
"1952653",1103,42,222,1367,80.69,3.07,16.24,2019
"1952654",520,3,106,629,82.67,0.48,16.85,2019
"1952727",100,9,50,159,62.89,5.66,31.45,2019
"1952729",297,8,62,367,80.93,2.18,16.89,2019
"1952748",3161,83,306,3550,89.04,2.34,8.62,2019
"1952754",439,5,143,587,74.79,0.85,24.36,2019
"1952760",178,0,48,226,78.76,0,21.24,2019
"1952773",907,11,176,1094,82.91,1.01,16.09,2019
"1952776",1223,46,314,1583,77.26,2.91,19.84,2019
"1952777",367,7,80,454,80.84,1.54,17.62,2019
"1952801",495,27,223,745,66.44,3.62,29.93,2019
"1952802",2604,123,1114,3841,67.79,3.2,29,2019
"1952001",14011,722,2459,17192,81.5,4.2,14.3,2019
"1952033",1021,48,212,1281,79.7,3.75,16.55,2019
"1952040",2041,54,347,2442,83.58,2.21,14.21,2019
"1952049",461,15,87,563,81.88,2.66,15.45,2019
"1952132",726,26,105,857,84.71,3.03,12.25,2019
"1952136",1951,102,436,2489,78.38,4.1,17.52,2019
"1952140",176,24,73,273,64.47,8.79,26.74,2019
"1952141",382,6,116,504,75.79,1.19,23.02,2019
"1952146",340,6,80,426,79.81,1.41,18.78,2019
"1952147",337,13,85,435,77.47,2.99,19.54,2019
"1952171",292,5,101,398,73.37,1.26,25.38,2019
"1952223",377,35,34,446,84.53,7.85,7.62,2019
"1952225",99,0,25,124,79.84,0,20.16,2019
"1952249",296,7,87,390,75.9,1.79,22.31,2019
"1952302",14272,448,1985,16705,85.44,2.68,11.88,2019
"1952317",7355,169,272,7796,94.34,2.17,3.49,2019
"1952324",592,19,71,682,86.8,2.79,10.41,2019
"1952337",207,6,75,288,71.88,2.08,26.04,2019
"1952341",418,0,35,453,92.27,0,7.73,2019
"1952352",463,4,113,580,79.83,0.69,19.48,2019
"1952362",331,28,62,421,78.62,6.65,14.73,2019
"1952624",123,0,6,129,95.35,0,4.65,2019
"5554826",239,17,77,333,71.77,5.11,23.12,2019
"5554837",1218,49,373,1640,74.27,2.99,22.74,2019
"5554841",71,4,40,115,61.74,3.48,34.78,2019
"5554853",1339,36,443,1818,73.65,1.98,24.37,2019
"5554855",204,6,29,239,85.36,2.51,12.13,2019
"5554865",211,2,41,254,83.07,0.79,16.14,2019
"5553581",3207,96,1072,4375,73.3,2.19,24.5,2019
"5553593",8693,177,462,9332,93.15,1.9,4.95,2019
"5553703",14466,1321,842,16629,86.99,7.94,5.06,2019
"5553719",12697,334,584,13615,93.26,2.45,4.29,2019
"5553801",266,11,101,378,70.37,2.91,26.72,2019
"5553803",412,11,97,520,79.23,2.12,18.65,2019
"5553805",1505,35,445,1985,75.82,1.76,22.42,2019
"5553810",108,4,31,143,75.52,2.8,21.68,2019
"5553820",770,12,172,954,80.71,1.26,18.03,2019
"5553930",409,6,101,516,79.26,1.16,19.57,2019
"5553931",78,3,10,91,85.71,3.3,10.99,2019
"5553943",253,5,100,358,70.67,1.4,27.93,2019
"5553948",2560,115,631,3306,77.43,3.48,19.09,2019
"5553950",1632,55,334,2021,80.75,2.72,16.53,2019
"5553935",74,9,13,96,77.08,9.38,13.54,2019
"5553825",111,2,63,176,63.07,1.14,35.8,2019
"5553923",562,13,175,750,74.93,1.73,23.33,2019
"5553932",859,33,111,1003,85.64,3.29,11.07,2019
"5553941",964,39,211,1214,79.41,3.21,17.38,2019
"5553960",1147,54,239,1440,79.65,3.75,16.6,2019
"5553965",3773,231,660,4664,80.9,4.95,14.15,2019
"5553506",329,14,100,443,74.27,3.16,22.57,2019
"5553508",1967,35,191,2193,89.69,1.6,8.71,2019
"5553518",472,14,118,604,78.15,2.32,19.54,2019
"5553523",1910,42,190,2142,89.17,1.96,8.87,2019
"5553533",2538,37,453,3028,83.82,1.22,14.96,2019
"5553586",682,13,215,910,74.95,1.43,23.63,2019
"5553598",974,17,36,1027,94.84,1.66,3.51,2019
"5553704",18362,721,1778,20861,88.02,3.46,8.52,2019
"5553808",393,0,99,492,79.88,0,20.12,2019
"5553811",1040,42,196,1278,81.38,3.29,15.34,2019
"5553922",302,3,86,391,77.24,0.77,21.99,2019
"5553944",681,13,200,894,76.17,1.45,22.37,2019
"5553964",1179,30,265,1474,79.99,2.04,17.98,2019
"5553543",535,14,138,687,77.87,2.04,20.09,2019
"5553551",3014,79,372,3465,86.98,2.28,10.74,2019
"5553554",280,18,101,399,70.18,4.51,25.31,2019
"5553558",4466,66,266,4798,93.08,1.38,5.54,2019
"5553170",717,32,124,873,82.13,3.67,14.2,2019
"5553177",2192,44,309,2545,86.13,1.73,12.14,2019
"5553212",10048,434,2713,13195,76.15,3.29,20.56,2019
"5553225",7668,327,1902,9897,77.48,3.3,19.22,2019
"5553228",5169,199,881,6249,82.72,3.18,14.1,2019
"5553233",2756,356,1419,4531,60.83,7.86,31.32,2019
"5553402",11832,280,1531,13643,86.73,2.05,11.22,2019
"5553520",2055,63,535,2653,77.46,2.37,20.17,2019
"5553546",10369,676,1227,12272,84.49,5.51,10,2019
"5553562",10254,304,778,11336,90.46,2.68,6.86,2019
"5553563",3527,197,534,4258,82.83,4.63,12.54,2019
"5553588",1409,68,242,1719,81.97,3.96,14.08,2019
"5553589",6866,170,1081,8117,84.59,2.09,13.32,2019
"5553713",8539,423,837,9799,87.14,4.32,8.54,2019
"5553717",5663,78,296,6037,93.8,1.29,4.9,2019
"2755032",1173,41,107,1321,88.8,3.1,8.1,2019
"2755033",10134,201,1450,11785,85.99,1.71,12.3,2019
"2755047",965,19,39,1023,94.33,1.86,3.81,2019
"2755069",1423,56,288,1767,80.53,3.17,16.3,2019
"2755082",12512,375,1066,13953,89.67,2.69,7.64,2019
"2755101",4031,211,443,4685,86.04,4.5,9.46,2019
"5682609",6651,347,794,7792,85.36,4.45,10.19,2019
"5682633",3157,267,420,3844,82.13,6.95,10.93,2019
"5682712",87,59,0,146,59.59,40.41,0,2019
"5682727",335,0,127,462,72.51,0,27.49,2019
"5682732",610,4,9,623,97.91,0.64,1.44,2019
"5682831",85,0,34,119,71.43,0,28.57,2019
"5682837",12,0,12,24,50,0,50,2019
"5682923",179,0,0,179,100,0,0,2019
"5682939",585,25,75,685,85.4,3.65,10.95,2019
"5682410",600,19,168,787,76.24,2.41,21.35,2019
"5682426",918,31,219,1168,78.6,2.65,18.75,2019
"5682430",25,0,7,32,78.12,0,21.88,2019
"5682501",5628,275,1294,7197,78.2,3.82,17.98,2019
"5682635",36,4,30,70,51.43,5.71,42.86,2019
"5682640",25,0,0,25,100,0,0,2019
"5682711",46,9,0,55,83.64,16.36,0,2019
"5682718",8809,151,389,9349,94.22,1.62,4.16,2019
"5682832",258,0,40,298,86.58,0,13.42,2019
"5682937",1257,11,208,1476,85.16,0.75,14.09,2019
"5682844",10,0,0,10,100,0,0,2019
"5682930",4753,93,351,5197,91.46,1.79,6.75,2019
"5682934",21,0,5,26,80.77,0,19.23,2019
"5682836",319,11,95,425,75.06,2.59,22.35,2019
"5682007",6889,278,1273,8440,81.62,3.29,15.08,2019
"5682009",12458,329,1032,13819,90.15,2.38,7.47,2019
"5682058",7,0,0,7,100,0,0,2019
"5682070",7438,322,828,8588,86.61,3.75,9.64,2019
"5682215",47,1,17,65,72.31,1.54,26.15,2019
"5682242",15,0,1,16,93.75,0,6.25,2019
"5682322",32,8,9,49,65.31,16.33,18.37,2019
"5682329",120,9,61,190,63.16,4.74,32.11,2019
"5682428",48,20,5,73,65.75,27.4,6.85,2019
"5682431",1036,67,185,1288,80.43,5.2,14.36,2019
"5682510",67,0,35,102,65.69,0,34.31,2019
"5682515",136,13,17,166,81.93,7.83,10.24,2019
"5682520",4014,102,881,4997,80.33,2.04,17.63,2019
"5682643",85,1,30,116,73.28,0.86,25.86,2019
"5682929",0,62,0,62,0,100,0,2019
"5682005",0,0,0,0,NA,NA,NA,2019
"5682073",0,0,0,0,NA,NA,NA,2019
"5682229",0,1,0,1,0,100,0,2019
"5682334",186,0,36,222,83.78,0,16.22,2019
"5682450",73,0,0,73,100,0,0,2019
"5682630",0,0,0,0,NA,NA,NA,2019
"5682638",0,0,0,0,NA,NA,NA,2019
"5682646",0,0,0,0,NA,NA,NA,2019
"5682648",10,0,0,10,100,0,0,2019
"5682715",0,0,0,0,NA,NA,NA,2019
"5682720",187,48,102,337,55.49,14.24,30.27,2019
"5682932",129,15,20,164,78.66,9.15,12.2,2019
"0880434",9,0,13,22,40.91,0,59.09,2019
"0880446",1514,16,137,1667,90.82,0.96,8.22,2019
"0880447",901,0,52,953,94.54,0,5.46,2019
"0485610",333,0,118,451,73.84,0,26.16,2019
"0485614",11135,462,1507,13104,84.97,3.53,11.5,2019
"0485624",412,23,101,536,76.87,4.29,18.84,2019
"0485629",7759,173,627,8559,90.65,2.02,7.33,2019
"0485630",737,19,181,937,78.66,2.03,19.32,2019
"0485715",7262,129,602,7993,90.85,1.61,7.53,2019
"0485193",1001,113,431,1545,64.79,7.31,27.9,2019
"0485194",2562,47,405,3014,85,1.56,13.44,2019
"0485209",14667,493,1105,16265,90.18,3.03,6.79,2019
"0485266",5341,41,98,5480,97.46,0.75,1.79,2019
"0485286",14043,173,319,14535,96.62,1.19,2.19,2019
"0485295",14256,187,346,14789,96.4,1.26,2.34,2019
"0485297",9543,126,176,9845,96.93,1.28,1.79,2019
"0485298",9964,147,126,10237,97.33,1.44,1.23,2019
"0485341",0,0,0,0,NA,NA,NA,2019
"0485343",29,0,36,65,44.62,0,55.38,2019
"0485352",123,10,61,194,63.4,5.15,31.44,2019
"0485371",54,11,26,91,59.34,12.09,28.57,2019
"0485377",1595,49,106,1750,91.14,2.8,6.06,2019
"0485383",16946,107,232,17285,98.04,0.62,1.34,2019
"0485387",4266,49,407,4722,90.34,1.04,8.62,2019
"0485388",8709,111,151,8971,97.08,1.24,1.68,2019
"0485392",12076,126,640,12842,94.04,0.98,4.98,2019
"0485395",9345,106,619,10070,92.8,1.05,6.15,2019
"0485396",6520,51,283,6854,95.13,0.74,4.13,2019
"0485551",81,0,50,131,61.83,0,38.17,2019
"0485620",191,13,41,245,77.96,5.31,16.73,2019
"0485622",3174,110,318,3602,88.12,3.05,8.83,2019
"0485626",331,0,34,365,90.68,0,9.32,2019
"0485658",4513,73,336,4922,91.69,1.48,6.83,2019
"0485707",0,0,0,0,NA,NA,NA,2019
"0485723",0,0,0,0,NA,NA,NA,2019
"0485724",0,0,0,0,NA,NA,NA,2019
"0485726",0,0,0,0,NA,NA,NA,2019
"0485755",6855,102,269,7226,94.87,1.41,3.72,2019
"0485756",9947,200,1070,11217,88.68,1.78,9.54,2019
"0485757",5270,85,903,6258,84.21,1.36,14.43,2019
"0485912",62,22,51,135,45.93,16.3,37.78,2019
"0485203",11191,321,1164,12676,88.28,2.53,9.18,2019
"0485301",13820,735,7542,22097,62.54,3.33,34.13,2019
"0485365",15900,371,2737,19008,83.65,1.95,14.4,2019
"0486031",98,2,430,530,18.49,0.38,81.13,2019
"0486034",169,10,404,583,28.99,1.72,69.3,2019
"0486017",427,0,94,521,81.96,0,18.04,2019
"0486021",434,0,308,742,58.49,0,41.51,2019
"0486036",111,7,43,161,68.94,4.35,26.71,2019
"0486052",0,0,0,0,NA,NA,NA,2019
"0486303",7249,161,1307,8717,83.16,1.85,14.99,2019
"0486325",2148,34,331,2513,85.48,1.35,13.17,2019
"0486327",3802,167,655,4624,82.22,3.61,14.17,2019
"0486023",510,32,217,759,67.19,4.22,28.59,2019
"0486030",111,5,272,388,28.61,1.29,70.1,2019
"0486540",21,7,240,268,7.84,2.61,89.55,2019
"0486511",432,4,585,1021,42.31,0.39,57.3,2019
"0486044",277,11,666,954,29.04,1.15,69.81,2019
"0486046",2068,48,481,2597,79.63,1.85,18.52,2019
"0486336",5602,103,614,6319,88.65,1.63,9.72,2019
"0486506",88,8,299,395,22.28,2.03,75.7,2019
"0486043",81,0,493,574,14.11,0,85.89,2019
"0485711",14074,621,2142,16837,83.59,3.69,12.72,2019
"0485713",12405,468,3751,16624,74.62,2.82,22.56,2019
"0485730",13386,413,1592,15391,86.97,2.68,10.34,2019
"0485901",5777,290,1024,7091,81.47,4.09,14.44,2019
"0485925",1500,80,143,1723,87.06,4.64,8.3,2019
"0485012",3225,168,286,3679,87.66,4.57,7.77,2019
"2756666",101,31,107,239,42.26,12.97,44.77,2019
"2756716",3031,101,371,3503,86.53,2.88,10.59,2019
"2756722",99,6,34,139,71.22,4.32,24.46,2019
"2756727",239,11,48,298,80.2,3.69,16.11,2019
"2756738",497,23,102,622,79.9,3.7,16.4,2019
"2756116",271,14,22,307,88.27,4.56,7.17,2019
"2756121",216,17,57,290,74.48,5.86,19.66,2019
"2756123",166,4,38,208,79.81,1.92,18.27,2019
"2756136",401,21,112,534,75.09,3.93,20.97,2019
"2756142",305,20,92,417,73.14,4.8,22.06,2019
"2756150",937,44,168,1149,81.55,3.83,14.62,2019
"2756151",252,7,77,336,75,2.08,22.92,2019
"2756152",411,18,155,584,70.38,3.08,26.54,2019
"2756169",230,5,26,261,88.12,1.92,9.96,2019
"2756183",418,16,134,568,73.59,2.82,23.59,2019
"2756186",117,9,17,143,81.82,6.29,11.89,2019
"2756435",967,61,199,1227,78.81,4.97,16.22,2019
"2756452",762,39,129,930,81.94,4.19,13.87,2019
"2756455",611,12,110,733,83.36,1.64,15.01,2019
"2756458",152,0,17,169,89.94,0,10.06,2019
"2756466",980,60,323,1363,71.9,4.4,23.7,2019
"2756748",203,4,39,246,82.52,1.63,15.85,2019
"2756750",781,38,194,1013,77.1,3.75,19.15,2019
"2756755",26,0,7,33,78.79,0,21.21,2019
"2756759",78,8,9,95,82.11,8.42,9.47,2019
"2756477",841,54,270,1165,72.19,4.64,23.18,2019
"2756443",465,3,120,588,79.08,0.51,20.41,2019
"2756468",1624,54,182,1860,87.31,2.9,9.78,2019
"2756475",488,9,116,613,79.61,1.47,18.92,2019
"2756521",221,17,62,300,73.67,5.67,20.67,2019
"2756522",138,4,40,182,75.82,2.2,21.98,2019
"2756649",3127,136,793,4056,77.1,3.35,19.55,2019
"2756626",65,16,43,124,52.42,12.9,34.68,2019
"2756633",1223,23,463,1709,71.56,1.35,27.09,2019
"2756634",459,11,133,603,76.12,1.82,22.06,2019
"2756655",608,18,157,783,77.65,2.3,20.05,2019
"2756672",674,44,236,954,70.65,4.61,24.74,2019
"2756548",246,7,81,334,73.65,2.1,24.25,2019
"2756550",128,4,48,180,71.11,2.22,26.67,2019
"2756557",732,43,266,1041,70.32,4.13,25.55,2019
"2756565",11,1,9,21,52.38,4.76,42.86,2019
"2756575",183,40,60,283,64.66,14.13,21.2,2019
"2756583",57,0,9,66,86.36,0,13.64,2019
"2756623",613,179,272,1064,57.61,16.82,25.56,2019
"2756139",135,7,35,177,76.27,3.95,19.77,2019
"2756434",50,4,27,81,61.73,4.94,33.33,2019
"2756438",752,23,276,1051,71.55,2.19,26.26,2019
"2756446",444,22,179,645,68.84,3.41,27.75,2019
"2756721",3456,76,637,4169,82.9,1.82,15.28,2019
"2756715",124,0,22,146,84.93,0,15.07,2019
"2756725",273,11,53,337,81.01,3.26,15.73,2019
"2756734",104,26,60,190,54.74,13.68,31.58,2019
"2756756",144,41,49,234,61.54,17.52,20.94,2019
"1950036",5722,295,891,6908,82.83,4.27,12.9,2019
"1950055",287,3,51,341,84.16,0.88,14.96,2019
"1950058",668,44,109,821,81.36,5.36,13.28,2019
"1950061",655,19,17,691,94.79,2.75,2.46,2019
"1950065",204,7,123,334,61.08,2.1,36.83,2019
"1950067",103,0,18,121,85.12,0,14.88,2019
"0880701",4892,105,902,5899,82.93,1.78,15.29,2019
"0880723",2530,73,328,2931,86.32,2.49,11.19,2019
"0880750",63,0,28,91,69.23,0,30.77,2019
"0880751",5756,244,824,6824,84.35,3.58,12.08,2019
"0880818",98,18,38,154,63.64,11.69,24.68,2019
"0880864",491,17,80,588,83.5,2.89,13.61,2019
"0880904",8674,208,1287,10169,85.3,2.05,12.66,2019
"0880908",6075,38,302,6415,94.7,0.59,4.71,2019
"0880909",13737,439,2021,16197,84.81,2.71,12.48,2019
"0880913",85,0,0,85,100,0,0,2019
"0880209",12077,769,808,13654,88.45,5.63,5.92,2019
"0880212",7964,260,802,9026,88.23,2.88,8.89,2019
"0880214",9813,666,1620,12099,81.11,5.5,13.39,2019
"0880227",13736,354,868,14958,91.83,2.37,5.8,2019
"0880440",725,39,187,951,76.24,4.1,19.66,2019
"0880448",0,0,0,0,NA,NA,NA,2019
"0880452",1155,123,215,1493,77.36,8.24,14.4,2019
"0880463",74,8,0,82,90.24,9.76,0,2019
"0880465",5941,64,135,6140,96.76,1.04,2.2,2019
"0880480",428,0,105,533,80.3,0,19.7,2019
"0880513",4397,60,359,4816,91.3,1.25,7.45,2019
"0880534",5787,64,244,6095,94.95,1.05,4,2019
"0880536",828,15,61,904,91.59,1.66,6.75,2019
"0880550",10124,227,469,10820,93.57,2.1,4.33,2019
"0880747",142,1,10,153,92.81,0.65,6.54,2019
"0880624",280,0,88,368,76.09,0,23.91,2019
"0880651",1232,66,201,1499,82.19,4.4,13.41,2019
"0880745",67,9,24,100,67,9,24,2019
"0880735",117,5,23,145,80.69,3.45,15.86,2019
"0880831",7544,234,308,8086,93.3,2.89,3.81,2019
"0880920",13201,239,400,13840,95.38,1.73,2.89,2019
"0880207",9272,100,1206,10578,87.65,0.95,11.4,2019
"0880229",15359,286,2560,18205,84.37,1.57,14.06,2019
"0880233",14691,235,1894,16820,87.34,1.4,11.26,2019
"0880301",10667,185,666,11518,92.61,1.61,5.78,2019
"0880302",10911,616,429,11956,91.26,5.15,3.59,2019
"0880422",1951,0,168,2119,92.07,0,7.93,2019
"0880424",2862,178,425,3465,82.6,5.14,12.27,2019
"0880805",126,5,56,187,67.38,2.67,29.95,2019
"0880810",408,7,86,501,81.44,1.4,17.17,2019
"0880820",297,0,57,354,83.9,0,16.1,2019
"0880828",651,32,106,789,82.51,4.06,13.43,2019
"0880834",155,0,19,174,89.08,0,10.92,2019
"0880903",5831,241,1023,7095,82.18,3.4,14.42,2019
"0880922",9632,176,232,10040,95.94,1.75,2.31,2019
"0880925",3478,10,121,3609,96.37,0.28,3.35,2019
"0880122",11799,249,599,12647,93.29,1.97,4.74,2019
"0880481",177,5,14,196,90.31,2.55,7.14,2019
"0880648",441,17,39,497,88.73,3.42,7.85,2019
"0880403",7460,185,516,8161,91.41,2.27,6.32,2019
"0880420",269,10,55,334,80.54,2.99,16.47,2019
"0880426",2,0,25,27,7.41,0,92.59,2019
"0880433",3441,52,130,3623,94.98,1.44,3.59,2019
"3587532",3786,181,2508,6475,58.47,2.8,38.73,2019
"3587548",304,0,195,499,60.92,0,39.08,2019
"3587549",262,0,76,338,77.51,0,22.49,2019
"3587564",99,0,0,99,100,0,0,2019
"3587710",502,27,187,716,70.11,3.77,26.12,2019
"3587712",100,0,0,100,100,0,0,2019
"0485737",8702,103,781,9586,90.78,1.07,8.15,2019
"0485741",13104,277,1088,14469,90.57,1.91,7.52,2019
"0485748",7393,101,309,7803,94.75,1.29,3.96,2019
"0485922",12,0,0,12,100,0,0,2019
"0485009",6763,345,5855,12963,52.17,2.66,45.17,2019
"0485019",5395,291,2072,7758,69.54,3.75,26.71,2019
"0485031",5161,390,2397,7948,64.93,4.91,30.16,2019
"0485035",12026,603,2511,15140,79.43,3.98,16.59,2019
"0485054",3920,31,158,4109,95.4,0.75,3.85,2019
"0485234",14941,284,445,15670,95.35,1.81,2.84,2019
"0485251",18740,572,1587,20899,89.67,2.74,7.59,2019
"0485263",1402,53,26,1481,94.67,3.58,1.76,2019
"0485268",11099,250,690,12039,92.19,2.08,5.73,2019
"0485305",3958,42,393,4393,90.1,0.96,8.95,2019
"0485342",639,32,157,828,77.17,3.86,18.96,2019
"0485349",6292,255,1707,8254,76.23,3.09,20.68,2019
"0485353",8973,340,1388,10701,83.85,3.18,12.97,2019
"0485354",1817,60,416,2293,79.24,2.62,18.14,2019
"0485390",3509,243,833,4585,76.53,5.3,18.17,2019
"0485540",949,6,102,1057,89.78,0.57,9.65,2019
"0485541",7736,188,1873,9797,78.96,1.92,19.12,2019
"0485616",1747,77,584,2408,72.55,3.2,24.25,2019
"0485545",79,92,144,315,25.08,29.21,45.71,2019
"0485552",1892,34,233,2159,87.63,1.57,10.79,2019
"0485608",0,0,0,0,NA,NA,NA,2019
"0485618",331,9,267,607,54.53,1.48,43.99,2019
"0485638",697,9,195,901,77.36,1,21.64,2019
"3588114",16,0,0,16,100,0,0,2019
"3588120",67,5,29,101,66.34,4.95,28.71,2019
"3588126",12,0,0,12,100,0,0,2019
"3588134",14,0,0,14,100,0,0,2019
"3588301",242,40,146,428,56.54,9.35,34.11,2019
"3588265",72,0,0,72,100,0,0,2019
"3588268",0,0,38,38,0,0,100,2019
"3588416",13,0,20,33,39.39,0,60.61,2019
"3588053",63,0,60,123,51.22,0,48.78,2019
"3588024",22,0,17,39,56.41,0,43.59,2019
"3588051",44,0,10,54,81.48,0,18.52,2019
"3588063",2412,121,1868,4401,54.81,2.75,42.44,2019
"3588116",156,2,38,196,79.59,1.02,19.39,2019
"3588132",81,0,12,93,87.1,0,12.9,2019
"3588135",379,0,117,496,76.41,0,23.59,2019
"3588201",7460,289,2277,10026,74.41,2.88,22.71,2019
"3588210",5152,203,1362,6717,76.7,3.02,20.28,2019
"3588240",9952,493,2464,12909,77.09,3.82,19.09,2019
"3588253",194,40,86,320,60.62,12.5,26.88,2019
"3588255",12,0,0,12,100,0,0,2019
"3588310",11859,461,2445,14765,80.32,3.12,16.56,2019
"3588323",0,0,0,0,NA,NA,NA,2019
"3588324",75,0,3,78,96.15,0,3.85,2019
"3588344",0,0,12,12,0,0,100,2019
"3588418",67,0,16,83,80.72,0,19.28,2019
"3588422",38,7,7,52,73.08,13.46,13.46,2019
"0693252",386,20,163,569,67.84,3.51,28.65,2019
"0693270",1171,73,383,1627,71.97,4.49,23.54,2019
"0693291",15109,265,2055,17429,86.69,1.52,11.79,2019
"0693304",11521,625,2835,14981,76.9,4.17,18.92,2019
"0693306",18004,613,3248,21865,82.34,2.8,14.85,2019
"0693307",18021,547,4017,22585,79.79,2.42,17.79,2019
"0485016",13447,1047,2344,16838,79.86,6.22,13.92,2019
"0485029",13456,505,3111,17072,78.82,2.96,18.22,2019
"0485037",12902,367,1447,14716,87.67,2.49,9.83,2019
"0485041",12363,585,4385,17333,71.33,3.38,25.3,2019
"0485050",11148,248,680,12076,92.32,2.05,5.63,2019
"0485085",8477,88,275,8840,95.89,1,3.11,2019
"0485212",10701,132,240,11073,96.64,1.19,2.17,2019
"0485255",17859,297,445,18601,96.01,1.6,2.39,2019
"0485259",9284,76,297,9657,96.14,0.79,3.08,2019
"0485303",8160,390,1354,9904,82.39,3.94,13.67,2019
"0485309",0,0,0,0,NA,NA,NA,2019
"0485344",2924,89,971,3984,73.39,2.23,24.37,2019
"0485355",3415,68,138,3621,94.31,1.88,3.81,2019
"0485535",0,0,0,0,NA,NA,NA,2019
"0485536",148,24,25,197,75.13,12.18,12.69,2019
"0485645",468,76,228,772,60.62,9.84,29.53,2019
"0485650",5755,88,661,6504,88.48,1.35,10.16,2019
"0485716",12448,471,2059,14978,83.11,3.14,13.75,2019
"0485204",18577,735,2621,21933,84.7,3.35,11.95,2019
"0485260",17033,338,772,18143,93.88,1.86,4.26,2019
"0485264",284,62,83,429,66.2,14.45,19.35,2019
"0485307",2996,39,352,3387,88.46,1.15,10.39,2019
"0485308",23027,491,1232,24750,93.04,1.98,4.98,2019
"0485310",6427,99,139,6665,96.43,1.49,2.09,2019
"0485322",178,12,101,291,61.17,4.12,34.71,2019
"0485325",455,9,207,671,67.81,1.34,30.85,2019
"0485337",538,23,231,792,67.93,2.9,29.17,2019
"0485340",10245,158,657,11060,92.63,1.43,5.94,2019
"0485003",2980,191,930,4101,72.67,4.66,22.68,2019
"0485014",9664,638,2864,13166,73.4,4.85,21.75,2019
"0485017",8395,1080,2404,11879,70.67,9.09,20.24,2019
"0485021",11938,591,3825,16354,73,3.61,23.39,2019
"0485045",2488,16,24,2528,98.42,0.63,0.95,2019
"0485086",14082,259,696,15037,93.65,1.72,4.63,2019
"0485210",12084,642,2000,14726,82.06,4.36,13.58,2019
"0485262",5303,17,204,5524,96,0.31,3.69,2019
"0485296",13477,250,405,14132,95.37,1.77,2.87,2019
"0485332",512,64,201,777,65.89,8.24,25.87,2019
"0485334",292,89,133,514,56.81,17.32,25.88,2019
"0485008",17914,567,3923,22404,79.96,2.53,17.51,2019
"0485022",19466,489,2376,22331,87.17,2.19,10.64,2019
"0485023",10826,540,1380,12746,84.94,4.24,10.83,2019
"0485024",9411,228,539,10178,92.46,2.24,5.3,2019
"0485032",23957,1044,3126,28127,85.17,3.71,11.11,2019
"0485048",12985,272,348,13605,95.44,2,2.56,2019
"0485087",2916,32,156,3104,93.94,1.03,5.03,2019
"0485621",5021,124,2274,7419,67.68,1.67,30.65,2019
"0485550",513,75,649,1237,41.47,6.06,52.47,2019
"0485554",210,0,87,297,70.71,0,29.29,2019
"0485615",3548,33,359,3940,90.05,0.84,9.11,2019
"0485632",288,12,81,381,75.59,3.15,21.26,2019
"0485633",2,0,7,9,22.22,0,77.78,2019
"0485640",41,23,20,84,48.81,27.38,23.81,2019
"0690716",2698,95,877,3670,73.51,2.59,23.9,2019
"0690717",7294,240,943,8477,86.04,2.83,11.12,2019
"0690731",18510,623,3562,22695,81.56,2.75,15.7,2019
"0690744",11871,538,2379,14788,80.27,3.64,16.09,2019
"0690746",7228,207,770,8205,88.09,2.52,9.38,2019
"0690822",0,0,0,0,NA,NA,NA,2019
"1950071",401,15,96,512,78.32,2.93,18.75,2019
"1950129",1689,196,317,2202,76.7,8.9,14.4,2019
"1950150",297,32,94,423,70.21,7.57,22.22,2019
"1950155",112,0,39,151,74.17,0,25.83,2019
"1950201",2838,198,316,3352,84.67,5.91,9.43,2019
"1950027",107,1,45,153,69.93,0.65,29.41,2019
"1950041",25,0,0,25,100,0,0,2019
"1950066",43,3,16,62,69.35,4.84,25.81,2019
"1950069",358,3,58,419,85.44,0.72,13.84,2019
"1950072",783,20,94,897,87.29,2.23,10.48,2019
"1950074",126,10,36,172,73.26,5.81,20.93,2019
"1950514",490,23,128,641,76.44,3.59,19.97,2019
"1950515",84,0,7,91,92.31,0,7.69,2019
"1950527",98,0,4,102,96.08,0,3.92,2019
"1950536",1392,41,360,1793,77.64,2.29,20.08,2019
"1950543",521,13,76,610,85.41,2.13,12.46,2019
"1950575",286,9,56,351,81.48,2.56,15.95,2019
"1950619",713,13,210,936,76.18,1.39,22.44,2019
"1950630",598,17,142,757,79,2.25,18.76,2019
"1950645",341,6,89,436,78.21,1.38,20.41,2019
"1950650",284,7,61,352,80.68,1.99,17.33,2019
"1950655",285,12,25,322,88.51,3.73,7.76,2019
"1950667",246,1,54,301,81.73,0.33,17.94,2019
"1950703",5379,220,2177,7776,69.17,2.83,28,2019
"1950847",23,4,12,39,58.97,10.26,30.77,2019
"1950859",188,2,69,259,72.59,0.77,26.64,2019
"1950078",54,4,28,86,62.79,4.65,32.56,2019
"1950101",10,0,2,12,83.33,0,16.67,2019
"1950104",32,0,12,44,72.73,0,27.27,2019
"1950122",423,32,65,520,81.35,6.15,12.5,2019
"1950126",2022,67,717,2806,72.06,2.39,25.55,2019
"1950128",142,7,36,185,76.76,3.78,19.46,2019
"1950136",152,0,26,178,85.39,0,14.61,2019
"1950142",317,18,58,393,80.66,4.58,14.76,2019
"1950160",182,6,16,204,89.22,2.94,7.84,2019
"1950165",54,0,2,56,96.43,0,3.57,2019
"1950166",572,5,78,655,87.33,0.76,11.91,2019
"1950206",144,20,45,209,68.9,9.57,21.53,2019
"1950207",689,23,155,867,79.47,2.65,17.88,2019
"1950216",897,82,83,1062,84.46,7.72,7.82,2019
"1950218",49,9,15,73,67.12,12.33,20.55,2019
"1950219",4430,230,556,5216,84.93,4.41,10.66,2019
"1950232",132,0,68,200,66,0,34,2019
"1950236",605,28,39,672,90.03,4.17,5.8,2019
"1950246",242,3,60,305,79.34,0.98,19.67,2019
"1950247",727,3,189,919,79.11,0.33,20.57,2019
"1950263",8898,219,583,9700,91.73,2.26,6.01,2019
"1950272",52,6,7,65,80,9.23,10.77,2019
"1950274",76,10,5,91,83.52,10.99,5.49,2019
"1950275",168,6,83,257,65.37,2.33,32.3,2019
"1950313",5079,142,1339,6560,77.42,2.16,20.41,2019
"1950317",11441,529,2810,14780,77.41,3.58,19.01,2019
"1950325",5968,176,448,6592,90.53,2.67,6.8,2019
"1951249",1138,30,218,1386,82.11,2.16,15.73,2019
"1951331",512,8,51,571,89.67,1.4,8.93,2019
"1951333",172,0,50,222,77.48,0,22.52,2019
"1951342",406,13,123,542,74.91,2.4,22.69,2019
"1951354",432,8,55,495,87.27,1.62,11.11,2019
"1951364",280,3,68,351,79.77,0.85,19.37,2019
"3587722",149,16,114,279,53.41,5.73,40.86,2019
"3587724",0,0,27,27,0,0,100,2019
"3587743",60,2,64,126,47.62,1.59,50.79,2019
"3587830",154,46,203,403,38.21,11.41,50.37,2019
"3587901",2003,120,997,3120,64.2,3.85,31.96,2019
"3587941",146,0,196,342,42.69,0,57.31,2019
"3587005",107,0,38,145,73.79,0,26.21,2019
"3587032",46,0,44,90,51.11,0,48.89,2019
"3587040",0,5,124,129,0,3.88,96.12,2019
"3587063",38,6,29,73,52.05,8.22,39.73,2019
"3587068",1174,136,545,1855,63.29,7.33,29.38,2019
"3587305",210,7,738,955,21.99,0.73,77.28,2019
"3587420",1243,118,1948,3309,37.56,3.57,58.87,2019
"3587421",295,42,209,546,54.03,7.69,38.28,2019
"3587455",112,17,418,547,20.48,3.11,76.42,2019
"3587501",6529,196,964,7689,84.91,2.55,12.54,2019
"3587520",317,25,207,549,57.74,4.55,37.7,2019
"3587567",289,3,126,418,69.14,0.72,30.14,2019
"3587730",3,0,7,10,30,0,70,2019
"3587745",228,0,81,309,73.79,0,26.21,2019
"3587733",26,3,17,46,56.52,6.52,36.96,2019
"3587821",138,0,88,226,61.06,0,38.94,2019
"3587021",761,18,369,1148,66.29,1.57,32.14,2019
"3587046",61,0,9,70,87.14,0,12.86,2019
"3587051",311,27,29,367,84.74,7.36,7.9,2019
"3587117",0,0,0,0,NA,NA,NA,2019
"3587144",13200,354,890,14444,91.39,2.45,6.16,2019
"3587499",50,10,98,158,31.65,6.33,62.03,2019
"3587506",4488,78,1400,5966,75.23,1.31,23.47,2019
"3587507",14484,518,3080,18082,80.1,2.86,17.03,2019
"3587508",7189,106,595,7890,91.12,1.34,7.54,2019
"3587523",109,0,90,199,54.77,0,45.23,2019
"3587538",116,0,159,275,42.18,0,57.82,2019
"3587554",0,0,0,0,NA,NA,NA,2019
"3587574",18,0,26,44,40.91,0,59.09,2019
"3587746",10,12,24,46,21.74,26.09,52.17,2019
"3587749",29,0,28,57,50.88,0,49.12,2019
"3587530",93,0,91,184,50.54,0,49.46,2019
"3587729",29,0,3,32,90.62,0,9.38,2019
"3587028",21,0,61,82,25.61,0,74.39,2019
"3587375",291,45,487,823,35.36,5.47,59.17,2019
"3587527",93,0,137,230,40.43,0,59.57,2019
"4984620",263,31,34,328,80.18,9.45,10.37,2019
"4984628",212,12,44,268,79.1,4.48,16.42,2019
"4984629",879,13,106,998,88.08,1.3,10.62,2019
"4984630",121,0,10,131,92.37,0,7.63,2019
"4984634",344,6,68,418,82.3,1.44,16.27,2019
"4984647",1086,14,239,1339,81.11,1.05,17.85,2019
"4984663",8654,205,694,9553,90.59,2.15,7.26,2019
"4984710",42,3,8,53,79.25,5.66,15.09,2019
"4984004",2598,138,83,2819,92.16,4.9,2.94,2019
"4984529",74,0,47,121,61.16,0,38.84,2019
"4984531",7,0,185,192,3.65,0,96.35,2019
"0694929",88,0,8,96,91.67,0,8.33,2019
"0694065",5009,12,176,5197,96.38,0.23,3.39,2019
"0694066",13649,226,1188,15063,90.61,1.5,7.89,2019
"0694086",18309,314,941,19564,93.59,1.6,4.81,2019
"0694304",1699,55,92,1846,92.04,2.98,4.98,2019
"0694110",24909,410,2185,27504,90.57,1.49,7.94,2019
"0693420",10465,318,951,11734,89.19,2.71,8.1,2019
"0693454",9831,185,1650,11666,84.27,1.59,14.14,2019
"0693458",11369,149,1658,13176,86.29,1.13,12.58,2019
"0693461",259,9,255,523,49.52,1.72,48.76,2019
"0693536",18377,770,2280,21427,85.77,3.59,10.64,2019
"0693546",2528,57,369,2954,85.58,1.93,12.49,2019
"0693591",1627,100,221,1948,83.52,5.13,11.34,2019
"0693609",1166,57,318,1541,75.67,3.7,20.64,2019
"0693616",498,19,190,707,70.44,2.69,26.87,2019
"0693618",6009,478,1735,8222,73.08,5.81,21.1,2019
"0693626",745,12,92,849,87.75,1.41,10.84,2019
"0693501",1350,96,473,1919,70.35,5,24.65,2019
"0693505",3247,87,871,4205,77.22,2.07,20.71,2019
"0693526",224,30,52,306,73.2,9.8,16.99,2019
"0693530",10,0,0,10,100,0,0,2019
"0693552",8656,248,902,9806,88.27,2.53,9.2,2019
"0693560",5926,196,1026,7148,82.9,2.74,14.35,2019
"0693608",213,16,132,361,59,4.43,36.57,2019
"0693669",86,0,0,86,100,0,0,2019
"0693701",2097,170,1150,3417,61.37,4.98,33.66,2019
"0693728",4704,105,1023,5832,80.66,1.8,17.54,2019
"0693924",2361,34,149,2544,92.81,1.34,5.86,2019
"0693925",296,15,119,430,68.84,3.49,27.67,2019
"0693933",7695,567,826,9088,84.67,6.24,9.09,2019
"0693638",8830,478,2906,12214,72.29,3.91,23.79,2019
"0693651",541,0,126,667,81.11,0,18.89,2019
"0693660",668,20,329,1017,65.68,1.97,32.35,2019
"0693664",184,0,25,209,88.04,0,11.96,2019
"0693667",680,29,155,864,78.7,3.36,17.94,2019
"0693673",117,0,70,187,62.57,0,37.43,2019
"0693711",14411,386,1132,15929,90.47,2.42,7.11,2019
"0693720",16923,174,1028,18125,93.37,0.96,5.67,2019
"0693907",6433,76,871,7380,87.17,1.03,11.8,2019
"0693921",1596,22,125,1743,91.57,1.26,7.17,2019
"0693930",3275,84,988,4347,75.34,1.93,22.73,2019
"0693012",12072,211,926,13209,91.39,1.6,7.01,2019
"0693030",11679,238,2700,14617,79.9,1.63,18.47,2019
"0693040",421,4,99,524,80.34,0.76,18.89,2019
"0693110",5805,128,524,6457,89.9,1.98,8.12,2019
"0693212",2779,123,1484,4386,63.36,2.8,33.83,2019
"0693218",155,13,90,258,60.08,5.04,34.88,2019
"0693260",47,0,57,104,45.19,0,54.81,2019
"0693261",337,19,325,681,49.49,2.79,47.72,2019
"0693263",3742,103,1980,5825,64.24,1.77,33.99,2019
"0693267",1250,55,558,1863,67.1,2.95,29.95,2019
"0693274",16799,493,4176,21468,78.25,2.3,19.45,2019
"0693276",32,4,13,49,65.31,8.16,26.53,2019
"0693422",11147,363,1283,12793,87.13,2.84,10.03,2019
"0693455",14236,233,1049,15518,91.74,1.5,6.76,2019
"0693612",11185,362,1944,13491,82.91,2.68,14.41,2019
"0693621",57,0,0,57,100,0,0,2019
"0693627",35,0,0,35,100,0,0,2019
"0693634",2,0,0,2,100,0,0,2019
"0695387",109,0,49,158,68.99,0,31.01,2019
"0695403",14140,316,1647,16103,87.81,1.96,10.23,2019
"0695409",11043,318,949,12310,89.71,2.58,7.71,2019
"0695422",4302,128,1532,5962,72.16,2.15,25.7,2019
"0695423",1141,48,479,1668,68.41,2.88,28.72,2019
"0695425",3667,150,295,4112,89.18,3.65,7.17,2019
"0690008",11216,740,2902,14858,75.49,4.98,19.53,2019
"0690013",4372,230,2706,7308,59.82,3.15,37.03,2019
"0690016",12614,1050,3554,17218,73.26,6.1,20.64,2019
"0690017",8192,589,2729,11510,71.17,5.12,23.71,2019
"0690036",16977,792,790,18559,91.48,4.27,4.26,2019
"0690064",10232,105,746,11083,92.32,0.95,6.73,2019
"0690065",13473,353,1588,15414,87.41,2.29,10.3,2019
"0690241",11285,459,1432,13176,85.65,3.48,10.87,2019
"0690248",3096,215,466,3777,81.97,5.69,12.34,2019
"0690270",4495,562,1627,6684,67.25,8.41,24.34,2019
"0690275",14467,253,824,15544,93.07,1.63,5.3,2019
"0690305",4854,228,732,5814,83.49,3.92,12.59,2019
"0690401",3877,181,545,4603,84.23,3.93,11.84,2019
"0690402",4795,42,162,4999,95.92,0.84,3.24,2019
"0690404",8894,397,666,9957,89.32,3.99,6.69,2019
"0690670",4210,100,552,4862,86.59,2.06,11.35,2019
"0690745",13201,238,1497,14936,88.38,1.59,10.02,2019
"0690806",10134,300,2354,12788,79.25,2.35,18.41,2019
"0690813",12557,664,3971,17192,73.04,3.86,23.1,2019
"0690001",10462,659,2548,13669,76.54,4.82,18.64,2019
"0690012",10298,328,2590,13216,77.92,2.48,19.6,2019
"0690034",22897,489,1862,25248,90.69,1.94,7.37,2019
"0690061",5104,255,2037,7396,69.01,3.45,27.54,2019
"0690066",22532,1137,2116,25785,87.38,4.41,8.21,2019
"0690638",12719,366,1265,14350,88.63,2.55,8.82,2019
"0690712",9515,115,708,10338,92.04,1.11,6.85,2019
"0690804",12506,380,2069,14955,83.62,2.54,13.83,2019
"0690807",11033,353,1355,12741,86.59,2.77,10.63,2019
"0690810",7782,380,1238,9400,82.79,4.04,13.17,2019
"0690501",12567,230,1445,14242,88.24,1.61,10.15,2019
"0690660",13470,431,2951,16852,79.93,2.56,17.51,2019
"0690704",1334,136,83,1553,85.9,8.76,5.34,2019
"0690720",7297,74,472,7843,93.04,0.94,6.02,2019
"0690723",11343,775,2089,14207,79.84,5.46,14.7,2019
"0690803",15151,593,974,16718,90.63,3.55,5.83,2019
"0690022",11975,949,4679,17603,68.03,5.39,26.58,2019
"0690019",19862,1086,3516,24464,81.19,4.44,14.37,2019
"0690028",13645,683,2075,16403,83.19,4.16,12.65,2019
"0690037",12411,633,4655,17699,70.12,3.58,26.3,2019
"0690041",8631,76,954,9661,89.34,0.79,9.87,2019
"0690048",10794,166,676,11636,92.76,1.43,5.81,2019
"0690057",11279,650,5369,17298,65.2,3.76,31.04,2019
"0690067",1237,70,114,1421,87.05,4.93,8.02,2019
"0690068",10745,157,414,11316,94.95,1.39,3.66,2019
"0690069",11612,108,768,12488,92.99,0.86,6.15,2019
"0690210",7292,79,565,7936,91.89,1,7.12,2019
"0690221",8659,1154,2331,12144,71.3,9.5,19.19,2019
"0690232",5924,227,447,6598,89.78,3.44,6.77,2019
"0690240",6517,317,710,7544,86.39,4.2,9.41,2019
"0690247",12628,643,2730,16001,78.92,4.02,17.06,2019
"0690274",8595,199,359,9153,93.9,2.17,3.92,2019
"0690293",6302,78,224,6604,95.43,1.18,3.39,2019
"0690301",9699,436,1911,12046,80.52,3.62,15.86,2019
"0692064",14873,210,900,15983,93.06,1.31,5.63,2019
"0692069",13616,273,1067,14956,91.04,1.83,7.13,2019
"0692086",560,13,85,658,85.11,1.98,12.92,2019
"0692126",23951,330,937,25218,94.98,1.31,3.72,2019
"0692130",19531,129,248,19908,98.11,0.65,1.25,2019
"0692236",11485,210,3906,15601,73.62,1.35,25.04,2019
"1951001",784,24,120,928,84.48,2.59,12.93,2019
"1951002",934,24,119,1077,86.72,2.23,11.05,2019
"1951011",21,1,7,29,72.41,3.45,24.14,2019
"1951030",606,55,64,725,83.59,7.59,8.83,2019
"1951040",1249,59,324,1632,76.53,3.62,19.85,2019
"1951041",2188,18,197,2403,91.05,0.75,8.2,2019
"1951049",202,2,55,259,77.99,0.77,21.24,2019
"1951060",186,3,58,247,75.3,1.21,23.48,2019
"1951649",103,20,9,132,78.03,15.15,6.82,2019
"1951565",106,8,47,161,65.84,4.97,29.19,2019
"1951572",157,1,72,230,68.26,0.43,31.3,2019
"1951638",441,2,122,565,78.05,0.35,21.59,2019
"1951654",126,0,11,137,91.97,0,8.03,2019
"1951630",60,9,16,85,70.59,10.59,18.82,2019
"1951653",466,29,94,589,79.12,4.92,15.96,2019
"1951355",377,17,41,435,86.67,3.91,9.43,2019
"1951360",3445,141,536,4122,83.58,3.42,13,2019
"1951365",125,6,25,156,80.13,3.85,16.03,2019
"1951401",4272,133,918,5323,80.26,2.5,17.25,2019
"1951430",256,10,45,311,82.32,3.22,14.47,2019
"1951443",553,26,91,670,82.54,3.88,13.58,2019
"1951458",460,19,109,588,78.23,3.23,18.54,2019
"1951459",20,2,7,29,68.97,6.9,24.14,2019
"1951022",249,19,14,282,88.3,6.74,4.96,2019
"1951442",2546,53,719,3318,76.73,1.6,21.67,2019
"1951465",261,0,82,343,76.09,0,23.91,2019
"1951467",206,2,48,256,80.47,0.78,18.75,2019
"1951520",74,0,17,91,81.32,0,18.68,2019
"1951533",331,13,81,425,77.88,3.06,19.06,2019
"1951540",125,0,16,141,88.65,0,11.35,2019
"1951555",1606,88,433,2127,75.51,4.14,20.36,2019
"1951564",113,19,55,187,60.43,10.16,29.41,2019
"1951573",392,1,61,454,86.34,0.22,13.44,2019
"1951639",276,29,63,368,75,7.88,17.12,2019
"1951640",565,47,88,700,80.71,6.71,12.57,2019
"1951647",65,1,15,81,80.25,1.23,18.52,2019
"1951652",535,16,121,672,79.61,2.38,18.01,2019
"1951006",276,12,148,436,63.3,2.75,33.94,2019
"1951016",433,24,98,555,78.02,4.32,17.66,2019
"1951018",124,11,14,149,83.22,7.38,9.4,2019
"1951037",149,9,25,183,81.42,4.92,13.66,2019
"1951044",92,1,20,113,81.42,0.88,17.7,2019
"1951048",207,2,47,256,80.86,0.78,18.36,2019
"1951023",919,34,258,1211,75.89,2.81,21.3,2019
"1951026",246,13,74,333,73.87,3.9,22.22,2019
"1951033",149,5,22,176,84.66,2.84,12.5,2019
"1951038",520,24,186,730,71.23,3.29,25.48,2019
"1951046",604,9,126,739,81.73,1.22,17.05,2019
"1951050",877,22,164,1063,82.5,2.07,15.43,2019
"1951537",2333,74,529,2936,79.46,2.52,18.02,2019
"1951543",133,14,78,225,59.11,6.22,34.67,2019
"1951545",67,7,59,133,50.38,5.26,44.36,2019
"1951553",344,22,69,435,79.08,5.06,15.86,2019
"5554003",337,3,28,368,91.58,0.82,7.61,2019
"5554017",5866,110,906,6882,85.24,1.6,13.16,2019
"5554112",812,12,209,1033,78.61,1.16,20.23,2019
"5554119",165,1,69,235,70.21,0.43,29.36,2019
"5554937",6609,237,799,7645,86.45,3.1,10.45,2019
"5554022",7252,152,960,8364,86.7,1.82,11.48,2019
"0694112",21315,273,1827,23415,91.03,1.17,7.8,2019
"0694132",9118,258,938,10314,88.4,2.5,9.09,2019
"0694511",610,12,284,906,67.33,1.32,31.35,2019
"0694513",19232,293,1165,20690,92.95,1.42,5.63,2019
"0694533",21473,547,2018,24038,89.33,2.28,8.4,2019
"0694061",12556,271,1115,13942,90.06,1.94,8,2019
"0691945",7351,198,1054,8603,85.45,2.3,12.25,2019
"0691377",5018,150,135,5303,94.63,2.83,2.55,2019
"0691403",10762,44,594,11400,94.4,0.39,5.21,2019
"0691411",8191,238,1064,9493,86.28,2.51,11.21,2019
"0691506",6435,320,767,7522,85.55,4.25,10.2,2019
"0691752",7858,241,695,8794,89.36,2.74,7.9,2019
"0691754",9665,131,1494,11290,85.61,1.16,13.23,2019
"0691763",8328,386,1519,10233,81.38,3.77,14.84,2019
"0691765",14186,156,777,15119,93.83,1.03,5.14,2019
"0691709",23986,285,1018,25289,94.85,1.13,4.03,2019
"0691731",6146,226,1891,8263,74.38,2.74,22.89,2019
"0691733",8564,181,2281,11026,77.67,1.64,20.69,2019
"0691737",7350,36,588,7974,92.17,0.45,7.37,2019
"0691741",8128,152,616,8896,91.37,1.71,6.92,2019
"0691745",14891,174,1259,16324,91.22,1.07,7.71,2019
"0691768",6672,136,1237,8045,82.93,1.69,15.38,2019
"0691780",9953,233,1169,11355,87.65,2.05,10.3,2019
"0691792",7778,81,726,8585,90.6,0.94,8.46,2019
"0691917",189,0,21,210,90,0,10,2019
"0691931",167,0,0,167,100,0,0,2019
"0691325",10880,149,891,11920,91.28,1.25,7.47,2019
"0691326",12137,135,506,12778,94.98,1.06,3.96,2019
"0691345",4584,116,702,5402,84.86,2.15,13,2019
"0691356",10619,329,854,11802,89.98,2.79,7.24,2019
"0691402",15035,515,4289,19839,75.79,2.6,21.62,2019
"0691436",5230,64,306,5600,93.39,1.14,5.46,2019
"0691501",6872,149,1036,8057,85.29,1.85,12.86,2019
"0691605",11239,1497,3535,16271,69.07,9.2,21.73,2019
"0691723",5271,188,774,6233,84.57,3.02,12.42,2019
"0691739",11294,158,211,11663,96.84,1.35,1.81,2019
"0691740",7202,182,924,8308,86.69,2.19,11.12,2019
"0691744",15983,234,2752,18969,84.26,1.23,14.51,2019
"0691746",5366,81,1223,6670,80.45,1.21,18.34,2019
"0691750",10869,280,961,12110,89.75,2.31,7.94,2019
"0691759",144,4,9,157,91.72,2.55,5.73,2019
"0691762",14121,759,2756,17636,80.07,4.3,15.63,2019
"0694062",9565,181,444,10190,93.87,1.78,4.36,2019
"0694080",19162,409,1871,21442,89.37,1.91,8.73,2019
"0694114",15753,318,774,16845,93.52,1.89,4.59,2019
"0694402",8877,127,538,9542,93.03,1.33,5.64,2019
"0694519",6376,110,438,6924,92.09,1.59,6.33,2019
"0694563",6834,60,273,7167,95.35,0.84,3.81,2019
"0694520",11960,270,1439,13669,87.5,1.98,10.53,2019
"0694538",20355,228,1639,22222,91.6,1.03,7.38,2019
"0694559",9063,196,951,10210,88.77,1.92,9.31,2019
"0694578",12291,211,2000,14502,84.75,1.45,13.79,2019
"0694580",8052,46,781,8879,90.69,0.52,8.8,2019
"0692386",904,0,96,1000,90.4,0,9.6,2019
"0692397",1590,39,163,1792,88.73,2.18,9.1,2019
"0692549",958,95,143,1196,80.1,7.94,11.96,2019
"0692563",17245,260,584,18089,95.33,1.44,3.23,2019
"0692591",12219,297,582,13098,93.29,2.27,4.44,2019
"0692610",5416,80,107,5603,96.66,1.43,1.91,2019
"0695454",870,0,206,1076,80.86,0,19.14,2019
"0695456",418,17,17,452,92.48,3.76,3.76,2019
"0695459",197,0,49,246,80.08,0,19.92,2019
"0695464",647,21,308,976,66.29,2.15,31.56,2019
"0695493",100,0,83,183,54.64,0,45.36,2019
"0695525",488,36,128,652,74.85,5.52,19.63,2019
"0695526",81,6,35,122,66.39,4.92,28.69,2019
"0695548",277,30,147,454,61.01,6.61,32.38,2019
"0695555",104,18,52,174,59.77,10.34,29.89,2019
"0695570",847,77,102,1026,82.55,7.5,9.94,2019
"0695573",548,10,76,634,86.44,1.58,11.99,2019
"0691316",11356,188,865,12409,91.51,1.52,6.97,2019
"0691504",8266,342,779,9387,88.06,3.64,8.3,2019
"0691724",6962,238,894,8094,86.01,2.94,11.05,2019
"0691103",6946,167,1402,8515,81.57,1.96,16.47,2019
"0691008",321,38,67,426,75.35,8.92,15.73,2019
"0691046",51,0,44,95,53.68,0,46.32,2019
"0691210",210,18,0,228,92.11,7.89,0,2019
"0691330",0,0,0,0,NA,NA,NA,2019
"0691371",0,0,0,0,NA,NA,NA,2019
"0691387",12138,96,581,12815,94.72,0.75,4.53,2019
"0691390",5512,124,364,6000,91.87,2.07,6.07,2019
"0691708",727,0,0,727,100,0,0,2019
"0691915",8622,36,73,8731,98.75,0.41,0.84,2019
"0692335",19117,3179,2802,25098,76.17,12.67,11.16,2019
"0692371",4358,208,702,5268,82.73,3.95,13.33,2019
"0692372",1710,93,274,2077,82.33,4.48,13.19,2019
"0692392",14357,263,1260,15880,90.41,1.66,7.93,2019
"0692505",12227,273,1200,13700,89.25,1.99,8.76,2019
"0692401",431,61,270,762,56.56,8.01,35.43,2019
"0692408",2483,403,754,3640,68.21,11.07,20.71,2019
"0692504",14401,198,1970,16569,86.92,1.2,11.89,2019
"0692506",13365,302,1025,14692,90.97,2.06,6.98,2019
"0692509",16411,439,1885,18735,87.6,2.34,10.06,2019
"0692539",1231,81,317,1629,75.57,4.97,19.46,2019
"0692543",9526,348,2901,12775,74.57,2.72,22.71,2019
"0692586",7053,179,1817,9049,77.94,1.98,20.08,2019
"0692592",23209,350,985,24544,94.56,1.43,4.01,2019
"0692618",18650,203,394,19247,96.9,1.05,2.05,2019
"0692625",5413,39,307,5759,93.99,0.68,5.33,2019
"0692679",10779,33,51,10863,99.23,0.3,0.47,2019
"0692688",15003,234,747,15984,93.86,1.46,4.67,2019
"0692708",17178,373,1205,18756,91.59,1.99,6.42,2019
"0692806",11077,265,997,12339,89.77,2.15,8.08,2019
"0692843",10161,246,1426,11833,85.87,2.08,12.05,2019
"0692870",15984,209,984,17177,93.05,1.22,5.73,2019
"0692004",826,0,310,1136,72.71,0,27.29,2019
"0692007",4222,108,289,4619,91.41,2.34,6.26,2019
"0692037",15591,331,744,16666,93.55,1.99,4.46,2019
"0692020",17243,322,1691,19256,89.55,1.67,8.78,2019
"0692025",13872,511,1574,15957,86.93,3.2,9.86,2019
"0692027",14402,478,1709,16589,86.82,2.88,10.3,2019
"0692065",10962,211,710,11883,92.25,1.78,5.97,2019
"0880451",286,0,23,309,92.56,0,7.44,2019
"0880461",2651,62,570,3283,80.75,1.89,17.36,2019
"0880504",18171,406,902,19479,93.29,2.08,4.63,2019
"0880517",4736,97,352,5185,91.34,1.87,6.79,2019
"0880520",483,33,0,516,93.6,6.4,0,2019
"0880528",7484,156,263,7903,94.7,1.97,3.33,2019
"0692256",1235,31,190,1456,84.82,2.13,13.05,2019
"0692283",261,19,232,512,50.98,3.71,45.31,2019
"0692328",77,82,71,230,33.48,35.65,30.87,2019
"0692363",1743,24,421,2188,79.66,1.1,19.24,2019
"0692008",10260,248,799,11307,90.74,2.19,7.07,2019
"0692036",847,8,348,1203,70.41,0.67,28.93,2019
"0692106",7084,292,335,7711,91.87,3.79,4.34,2019
"0692108",10467,267,338,11072,94.54,2.41,3.05,2019
"0692109",20719,559,695,21973,94.29,2.54,3.16,2019
"0692121",1804,45,9,1858,97.09,2.42,0.48,2019
"0692128",19638,246,926,20810,94.37,1.18,4.45,2019
"0692227",5544,132,1552,7228,76.7,1.83,21.47,2019
"0692249",1581,112,243,1936,81.66,5.79,12.55,2019
"0692257",291,37,163,491,59.27,7.54,33.2,2019
"0692264",9474,252,1332,11058,85.68,2.28,12.05,2019
"0692277",7469,450,992,8911,83.82,5.05,11.13,2019
"0692301",6515,478,963,7956,81.89,6.01,12.1,2019
"0692315",1969,38,236,2243,87.78,1.69,10.52,2019
"0692105",17547,551,3860,21958,79.91,2.51,17.58,2019
"0692107",12785,422,536,13743,93.03,3.07,3.9,2019
"0572012",4192,80,710,4982,84.14,1.61,14.25,2019
"0572016",789,38,253,1080,73.06,3.52,23.43,2019
"0572017",139,16,145,300,46.33,5.33,48.33,2019
"0572027",273,48,201,522,52.3,9.2,38.51,2019
"0572029",389,13,381,783,49.68,1.66,48.66,2019
"0572065",1382,101,322,1805,76.57,5.6,17.84,2019
"0572073",251,19,176,446,56.28,4.26,39.46,2019
"0572080",138,16,35,189,73.02,8.47,18.52,2019
"0572084",310,5,117,432,71.76,1.16,27.08,2019
"0572135",847,29,208,1084,78.14,2.68,19.19,2019
"0572157",338,74,95,507,66.67,14.6,18.74,2019
"0572170",95,14,30,139,68.35,10.07,21.58,2019
"0572179",90,10,53,153,58.82,6.54,34.64,2019
"0572209",7623,668,2974,11265,67.67,5.93,26.4,2019
"0572311",37,0,5,42,88.1,0,11.9,2019
"0572554",578,229,258,1065,54.27,21.5,24.23,2019
"0572560",1834,764,1007,3605,50.87,21.19,27.93,2019
"0572578",49,0,0,49,100,0,0,2019
"0572584",68,49,16,133,51.13,36.84,12.03,2019
"0572616",2918,130,1040,4088,71.38,3.18,25.44,2019
"0572628",176,14,160,350,50.29,4,45.71,2019
"0572629",123,0,49,172,71.51,0,28.49,2019
"0572630",89,2,26,117,76.07,1.71,22.22,2019
"0572634",1402,40,352,1794,78.15,2.23,19.62,2019
"0572639",111,33,86,230,48.26,14.35,37.39,2019
"0572653",9807,563,2327,12697,77.24,4.43,18.33,2019
"0572661",201,14,56,271,74.17,5.17,20.66,2019
"0572679",0,0,7,7,0,0,100,2019
"0572683",77,8,9,94,81.91,8.51,9.57,2019
"0572704",9410,282,924,10616,88.64,2.66,8.7,2019
"0572721",85,0,67,152,55.92,0,44.08,2019
"0572744",1515,135,283,1933,78.38,6.98,14.64,2019
"0572747",33,0,92,125,26.4,0,73.6,2019
"0486438",276,0,95,371,74.39,0,25.61,2019
"0486507",157,12,409,578,27.16,2.08,70.76,2019
"0486545",42,5,360,407,10.32,1.23,88.45,2019
"0486333",2131,139,425,2695,79.07,5.16,15.77,2019
"0486334",1424,142,337,1903,74.83,7.46,17.71,2019
"0486426",5474,169,558,6201,88.28,2.73,9,2019
"5554560",239,18,27,284,84.15,6.34,9.51,2019
"5554531",478,7,95,580,82.41,1.21,16.38,2019
"5554550",251,9,46,306,82.03,2.94,15.03,2019
"5554557",422,0,36,458,92.14,0,7.86,2019
"5554559",255,5,81,341,74.78,1.47,23.75,2019
"5554561",0,0,0,0,NA,NA,NA,2019
"5554659",365,14,158,537,67.97,2.61,29.42,2019
"5554646",1271,72,337,1680,75.65,4.29,20.06,2019
"5554654",47,0,0,47,100,0,0,2019
"5554722",1032,33,325,1390,74.24,2.37,23.38,2019
"5554724",2585,25,451,3061,84.45,0.82,14.73,2019
"5554726",512,28,156,696,73.56,4.02,22.41,2019
"5554730",1729,38,205,1972,87.68,1.93,10.4,2019
"5554756",314,11,92,417,75.3,2.64,22.06,2019
"5554767",1061,65,221,1347,78.77,4.83,16.41,2019
"5554770",703,12,136,851,82.61,1.41,15.98,2019
"5554773",1006,33,294,1333,75.47,2.48,22.06,2019
"5554810",763,29,209,1001,76.22,2.9,20.88,2019
"5554952",9702,414,1374,11490,84.44,3.6,11.96,2019
"5554956",16280,272,1986,18538,87.82,1.47,10.71,2019
"5554970",951,42,261,1254,75.84,3.35,20.81,2019
"5554840",1572,55,355,1982,79.31,2.77,17.91,2019
"5554842",54,3,8,65,83.08,4.62,12.31,2019
"5554847",838,39,140,1017,82.4,3.83,13.77,2019
"5554848",2010,60,511,2581,77.88,2.32,19.8,2019
"5554921",352,15,80,447,78.75,3.36,17.9,2019
"5554935",14164,503,2900,17567,80.63,2.86,16.51,2019
"5554123",94,10,19,123,76.42,8.13,15.45,2019
"5554124",1180,19,318,1517,77.79,1.25,20.96,2019
"5554127",27,0,4,31,87.1,0,12.9,2019
"5554130",9071,159,1049,10279,88.25,1.55,10.21,2019
"5554156",553,14,189,756,73.15,1.85,25,2019
"5554204",623,17,69,709,87.87,2.4,9.73,2019
"5554241",5138,153,1186,6477,79.33,2.36,18.31,2019
"5554245",723,14,151,888,81.42,1.58,17,2019
"5554247",740,18,132,890,83.15,2.02,14.83,2019
"5554413",46,0,22,68,67.65,0,32.35,2019
"5554449",9714,197,1713,11624,83.57,1.69,14.74,2019
"5554452",6544,222,1534,8300,78.84,2.67,18.48,2019
"5554456",1962,66,523,2551,76.91,2.59,20.5,2019
"5554463",240,10,41,291,82.47,3.44,14.09,2019
"5554467",5158,96,539,5793,89.04,1.66,9.3,2019
"5554469",610,24,96,730,83.56,3.29,13.15,2019
"5554474",1537,12,220,1769,86.89,0.68,12.44,2019
"5554475",502,25,153,680,73.82,3.68,22.5,2019
"5554489",591,24,107,722,81.86,3.32,14.82,2019
"5554519",484,13,118,615,78.7,2.11,19.19,2019
"5554525",100,0,27,127,78.74,0,21.26,2019
"5554529",433,6,90,529,81.85,1.13,17.01,2019
"5554530",244,26,109,379,64.38,6.86,28.76,2019
"5554849",667,15,120,802,83.17,1.87,14.96,2019
"5554858",509,25,208,742,68.6,3.37,28.03,2019
"5554859",696,32,178,906,76.82,3.53,19.65,2019
"2756211",157,1,40,198,79.29,0.51,20.2,2019
"2756220",859,25,269,1153,74.5,2.17,23.33,2019
"2756224",97,3,34,134,72.39,2.24,25.37,2019
"2756239",206,5,23,234,88.03,2.14,9.83,2019
"2756264",718,17,127,862,83.29,1.97,14.73,2019
"2756281",196,2,40,238,82.35,0.84,16.81,2019
"0692624",2523,100,176,2799,90.14,3.57,6.29,2019
"0692629",11190,194,459,11843,94.49,1.64,3.88,2019
"0692649",13064,350,925,14339,91.11,2.44,6.45,2019
"0692701",10414,93,2702,13209,78.84,0.7,20.46,2019
"0692675",12016,134,1005,13155,91.34,1.02,7.64,2019
"0692683",24047,552,3035,27634,87.02,2,10.98,2019
"0692691",16099,188,763,17050,94.42,1.1,4.48,2019
"0692706",8081,122,1152,9355,86.38,1.3,12.31,2019
"0692808",7162,79,194,7435,96.33,1.06,2.61,2019
"0692882",18901,461,1948,21310,88.7,2.16,9.14,2019
"0692887",6667,47,133,6847,97.37,0.69,1.94,2019
"0692327",185,0,103,288,64.24,0,35.76,2019
"0692307",11300,317,1155,12772,88.47,2.48,9.04,2019
"0692003",1691,17,107,1815,93.17,0.94,5.9,2019
"0692021",19702,461,2355,22518,87.49,2.05,10.46,2019
"0692059",407,2,96,505,80.59,0.4,19.01,2019
"0692024",18398,394,1029,19821,92.82,1.99,5.19,2019
"0692028",14210,361,1726,16297,87.19,2.22,10.59,2019
"0692070",240,2,86,328,73.17,0.61,26.22,2019
"0692071",17527,411,1230,19168,91.44,2.14,6.42,2019
"0692101",20806,759,2790,24355,85.43,3.12,11.46,2019
"0692110",10092,246,1050,11388,88.62,2.16,9.22,2019
"0692111",15392,240,1488,17120,89.91,1.4,8.69,2019
"0692119",8744,114,680,9538,91.68,1.2,7.13,2019
"0692127",15387,72,350,15809,97.33,0.46,2.21,2019
"0692129",17388,106,549,18043,96.37,0.59,3.04,2019
"0692201",18428,536,4643,23607,78.06,2.27,19.67,2019
"0692210",2347,62,248,2657,88.33,2.33,9.33,2019
"0692211",11265,442,1010,12717,88.58,3.48,7.94,2019
"0692241",2714,32,827,3573,75.96,0.9,23.15,2019
"0692242",524,0,86,610,85.9,0,14.1,2019
"0692243",10565,360,2076,13001,81.26,2.77,15.97,2019
"0692251",4929,14,409,5352,92.1,0.26,7.64,2019
"0692252",3195,141,596,3932,81.26,3.59,15.16,2019
"0692260",13408,550,1879,15837,84.66,3.47,11.86,2019
"0692266",53,0,22,75,70.67,0,29.33,2019
"0692267",0,0,6,6,0,0,100,2019
"0692270",8359,290,641,9290,89.98,3.12,6.9,2019
"0692276",1962,89,533,2584,75.93,3.44,20.63,2019
"0692278",341,0,29,370,92.16,0,7.84,2019
"0692282",377,11,66,454,83.04,2.42,14.54,2019
"0692304",0,0,13,13,0,0,100,2019
"0692305",224,0,27,251,89.24,0,10.76,2019
"0692320",2616,85,504,3205,81.62,2.65,15.73,2019
"0692338",0,0,0,0,NA,NA,NA,2019
"0692356",1693,28,622,2343,72.26,1.2,26.55,2019
"0692382",1516,46,154,1716,88.34,2.68,8.97,2019
"0692384",10,0,3,13,76.92,0,23.08,2019
"0692411",4048,1011,1369,6428,62.97,15.73,21.3,2019
"0692530",13152,280,2034,15466,85.04,1.81,13.15,2019
"0692583",7504,328,1517,9349,80.27,3.51,16.23,2019
"0692585",5651,109,355,6115,92.41,1.78,5.81,2019
"0692595",8469,124,909,9502,89.13,1.3,9.57,2019
"0880436",213,0,33,246,86.59,0,13.41,2019
"0880439",9499,181,409,10089,94.15,1.79,4.05,2019
"0880470",1276,90,71,1437,88.8,6.26,4.94,2019
"0880473",3,0,0,3,100,0,0,2019
"0880478",521,0,50,571,91.24,0,8.76,2019
"0880503",12341,265,1075,13681,90.21,1.94,7.86,2019
"4984711",244,3,22,269,90.71,1.12,8.18,2019
"4984731",38,0,0,38,100,0,0,2019
"4984738",3372,16,157,3545,95.12,0.45,4.43,2019
"4984740",58,1,10,69,84.06,1.45,14.49,2019
"4984743",2,0,0,2,100,0,0,2019
"4984759",534,15,88,637,83.83,2.35,13.81,2019
"4984760",151,2,37,190,79.47,1.05,19.47,2019
"4984052",412,10,37,459,89.76,2.18,8.06,2019
"4984082",205,0,41,246,83.33,0,16.67,2019
"4984530",64,0,14,78,82.05,0,17.95,2019
"4984637",186,17,73,276,67.39,6.16,26.45,2019
"4984741",1640,206,304,2150,76.28,9.58,14.14,2019
"4984715",121,0,22,143,84.62,0,15.38,2019
"4984790",13657,652,1557,15866,86.08,4.11,9.81,2019
"4984116",8946,932,1184,11062,80.87,8.43,10.7,2019
"4984005",6803,286,167,7256,93.76,3.94,2.3,2019
"4984045",6730,246,35,7011,95.99,3.51,0.5,2019
"4984081",12963,171,264,13398,96.75,1.28,1.97,2019
"4984096",12176,752,212,13140,92.66,5.72,1.61,2019
"4984144",133,98,0,231,57.58,42.42,0,2019
"4984308",89,3,2,94,94.68,3.19,2.13,2019
"4984515",0,0,0,0,NA,NA,NA,2019
"4984665",133,2,15,150,88.67,1.33,10,2019
"4984721",6200,305,866,7371,84.11,4.14,11.75,2019
"4984742",95,0,4,99,95.96,0,4.04,2019
"4984746",365,45,49,459,79.52,9.8,10.68,2019
"4984756",108,0,12,120,90,0,10,2019
"4984763",87,5,18,110,79.09,4.55,16.36,2019
"4984767",133,11,32,176,75.57,6.25,18.18,2019
"4984784",226,0,180,406,55.67,0,44.33,2019
"4984626",88,0,0,88,100,0,0,2019
"4984664",2349,51,118,2518,93.29,2.03,4.69,2019
"4984749",65,0,21,86,75.58,0,24.42,2019
"4984037",10293,189,428,10910,94.34,1.73,3.92,2019
"4984095",18640,1747,581,20968,88.9,8.33,2.77,2019
"4984318",1305,20,18,1343,97.17,1.49,1.34,2019
"4984542",497,30,108,635,78.27,4.72,17.01,2019
"4984750",149,6,18,173,86.13,3.47,10.4,2019
"4984035",66,0,42,108,61.11,0,38.89,2019
"4984305",192,2,39,233,82.4,0.86,16.74,2019
"4984341",6794,662,575,8031,84.6,8.24,7.16,2019
"4984535",845,55,185,1085,77.88,5.07,17.05,2019
"4984724",364,18,62,444,81.98,4.05,13.96,2019
"0881328",1334,60,394,1788,74.61,3.36,22.04,2019
"0881415",428,4,108,540,79.26,0.74,20,2019
"0881418",598,0,70,668,89.52,0,10.48,2019
"0881425",1530,35,509,2074,73.77,1.69,24.54,2019
"0881431",111,0,47,158,70.25,0,29.75,2019
"0881504",10313,255,1175,11743,87.82,2.17,10.01,2019
"0881521",5533,168,721,6422,86.16,2.62,11.23,2019
"0881128",52,0,0,52,100,0,0,2019
"0881130",291,15,48,354,82.2,4.24,13.56,2019
"0881330",0,0,24,24,0,0,100,2019
"3588424",8,0,6,14,57.14,0,42.86,2019
"3588427",48,0,18,66,72.73,0,27.27,2019
"3588435",455,40,553,1048,43.42,3.82,52.77,2019
"3588004",0,0,0,0,NA,NA,NA,2019
"3588421",0,0,0,0,NA,NA,NA,2019
"3588426",254,27,45,326,77.91,8.28,13.8,2019
"0486404",6855,94,980,7929,86.45,1.19,12.36,2019
"0486406",9085,223,1232,10540,86.2,2.12,11.69,2019
"0486429",2835,83,597,3515,80.65,2.36,16.98,2019
"0486433",25,0,0,25,100,0,0,2019
"0486437",34,0,8,42,80.95,0,19.05,2019
"0486444",509,0,195,704,72.3,0,27.7,2019
"0486508",34,3,162,199,17.09,1.51,81.41,2019
"0486510",513,17,828,1358,37.78,1.25,60.97,2019
"0486512",157,30,498,685,22.92,4.38,72.7,2019
"0486520",60,13,367,440,13.64,2.95,83.41,2019
"0486535",56,0,295,351,15.95,0,84.05,2019
"0486544",66,4,257,327,20.18,1.22,78.59,2019
"0486042",241,0,278,519,46.44,0,53.56,2019
"0486053",274,14,314,602,45.51,2.33,52.16,2019
"0486305",7705,80,633,8418,91.53,0.95,7.52,2019
"0486442",11094,589,2496,14179,78.24,4.15,17.6,2019
"0486434",275,24,172,471,58.39,5.1,36.52,2019
"0486436",342,0,291,633,54.03,0,45.97,2019
"0486441",855,16,319,1190,71.85,1.34,26.81,2019
"0486505",578,38,1450,2066,27.98,1.84,70.18,2019
"0486514",178,7,697,882,20.18,0.79,79.02,2019
"0486515",477,111,702,1290,36.98,8.6,54.42,2019
"0486538",87,8,562,657,13.24,1.22,85.54,2019
"0486314",13044,295,2428,15767,82.73,1.87,15.4,2019
"0486324",1544,83,455,2082,74.16,3.99,21.85,2019
"0486351",2781,9,370,3160,88.01,0.28,11.71,2019
"0486403",6170,102,1377,7649,80.66,1.33,18,2019
"0486431",172,0,97,269,63.94,0,36.06,2019
"0486018",302,19,104,425,71.06,4.47,24.47,2019
"0486440",2429,69,579,3077,78.94,2.24,18.82,2019
"0486502",67,10,280,357,18.77,2.8,78.43,2019
"0486503",517,120,2629,3266,15.83,3.67,80.5,2019
"0486504",520,68,1192,1780,29.21,3.82,66.97,2019
"0486025",1356,9,368,1733,78.25,0.52,21.23,2019
"0486301",8699,444,978,10121,85.95,4.39,9.66,2019
"0486321",618,23,129,770,80.26,2.99,16.75,2019
"0486335",1729,66,286,2081,83.09,3.17,13.74,2019
"0486401",8700,138,1465,10303,84.44,1.34,14.22,2019
"0486413",3788,146,1318,5252,72.12,2.78,25.1,2019
"0486435",0,0,0,0,NA,NA,NA,2019
"0486004",11441,435,1422,13298,86.04,3.27,10.69,2019
"0486022",511,41,152,704,72.59,5.82,21.59,2019
"0486039",149,18,228,395,37.72,4.56,57.72,2019
"0486320",593,36,251,880,67.39,4.09,28.52,2019
"0486326",8216,328,2098,10642,77.2,3.08,19.71,2019
"0486001",15253,845,1378,17476,87.28,4.84,7.89,2019
"0486016",0,0,17,17,0,0,100,2019
"0486032",454,12,68,534,85.02,2.25,12.73,2019
"0486033",615,11,1633,2259,27.22,0.49,72.29,2019
"0486045",976,30,1992,2998,32.56,1,66.44,2019
"0486054",148,10,352,510,29.02,1.96,69.02,2019
"0486323",5802,289,944,7035,82.47,4.11,13.42,2019
"0486332",629,27,228,884,71.15,3.05,25.79,2019
"0485653",5589,81,454,6124,91.26,1.32,7.41,2019
"0485701",2339,99,286,2724,85.87,3.63,10.5,2019
"0485706",14954,294,2145,17393,85.98,1.69,12.33,2019
"0485040",7080,342,2901,10323,68.58,3.31,28.1,2019
"0485208",12015,504,2067,14586,82.37,3.46,14.17,2019
"0485249",13124,325,428,13877,94.57,2.34,3.08,2019
"2756289",193,13,77,283,68.2,4.59,27.21,2019
"2756307",1433,103,361,1897,75.54,5.43,19.03,2019
"2756308",9126,506,1781,11413,79.96,4.43,15.61,2019
"2756310",1781,49,265,2095,85.01,2.34,12.65,2019
"2756312",773,34,173,980,78.88,3.47,17.65,2019
"2756313",28,1,8,37,75.68,2.7,21.62,2019
"2756327",281,6,35,322,87.27,1.86,10.87,2019
"2756328",58,5,12,75,77.33,6.67,16,2019
"2756329",2083,90,444,2617,79.59,3.44,16.97,2019
"2756352",1723,48,523,2294,75.11,2.09,22.8,2019
"2756356",87,0,27,114,76.32,0,23.68,2019
"2756357",321,17,71,409,78.48,4.16,17.36,2019
"2756358",969,72,229,1270,76.3,5.67,18.03,2019
"2756360",1286,46,373,1705,75.43,2.7,21.88,2019
"2756171",599,20,163,782,76.6,2.56,20.84,2019
"2756060",133,2,38,173,76.88,1.16,21.97,2019
"2756048",1360,12,215,1587,85.7,0.76,13.55,2019
"2756057",1185,54,251,1490,79.53,3.62,16.85,2019
"2756058",1835,44,447,2326,78.89,1.89,19.22,2019
"2756073",5911,120,977,7008,84.35,1.71,13.94,2019
"2756082",4203,165,479,4847,86.71,3.4,9.88,2019
"2756083",271,12,108,391,69.31,3.07,27.62,2019
"2756085",1730,80,428,2238,77.3,3.57,19.12,2019
"2756114",103,12,22,137,75.18,8.76,16.06,2019
"2756207",62,10,25,97,63.92,10.31,25.77,2019
"2756469",390,10,132,532,73.31,1.88,24.81,2019
"2756474",1455,76,364,1895,76.78,4.01,19.21,2019
"2756501",6162,285,901,7348,83.86,3.88,12.26,2019
"2756510",677,65,191,933,72.56,6.97,20.47,2019
"2756514",1150,37,225,1412,81.44,2.62,15.93,2019
"2756519",74,3,42,119,62.18,2.52,35.29,2019
"2756523",173,9,27,209,82.78,4.31,12.92,2019
"2756552",154,11,38,203,75.86,5.42,18.72,2019
"2756568",51,0,19,70,72.86,0,27.14,2019
"2756574",76,4,22,102,74.51,3.92,21.57,2019
"2756578",269,7,22,298,90.27,2.35,7.38,2019
"2756579",393,23,69,485,81.03,4.74,14.23,2019
"2756580",445,14,59,518,85.91,2.7,11.39,2019
"2756584",375,12,181,568,66.02,2.11,31.87,2019
"2756594",176,5,17,198,88.89,2.53,8.59,2019
"2756639",176,9,40,225,78.22,4,17.78,2019
"2756646",140,6,38,184,76.09,3.26,20.65,2019
"2756653",482,4,118,604,79.8,0.66,19.54,2019
"2756673",85,130,75,290,29.31,44.83,25.86,2019
"2756681",88,6,24,118,74.58,5.08,20.34,2019
"2756683",254,6,72,332,76.51,1.81,21.69,2019
"2756685",27,1,19,47,57.45,2.13,40.43,2019
"2756686",157,98,62,317,49.53,30.91,19.56,2019
"2756063",1071,40,92,1203,89.03,3.33,7.65,2019
"2756134",153,8,32,193,79.27,4.15,16.58,2019
"2756176",378,13,66,457,82.71,2.84,14.44,2019
"2756742",304,14,63,381,79.79,3.67,16.54,2019
"2756661",265,3,101,369,71.82,0.81,27.37,2019
"1950434",136,7,29,172,79.07,4.07,16.86,2019
"1950439",84,1,7,92,91.3,1.09,7.61,2019
"1950440",164,6,19,189,86.77,3.17,10.05,2019
"1950441",1528,99,585,2212,69.08,4.48,26.45,2019
"1950451",201,5,45,251,80.08,1.99,17.93,2019
"1950461",1920,50,373,2343,81.95,2.13,15.92,2019
"0880521",11624,1107,564,13295,87.43,8.33,4.24,2019
"0880545",382,0,123,505,75.64,0,24.36,2019
"0880610",1004,4,230,1238,81.1,0.32,18.58,2019
"0880612",97,36,11,144,67.36,25,7.64,2019
"0880645",1239,47,306,1592,77.83,2.95,19.22,2019
"0880654",818,10,165,993,82.38,1.01,16.62,2019
"0880720",870,25,190,1085,80.18,2.3,17.51,2019
"0880721",76,0,20,96,79.17,0,20.83,2019
"0880722",157,0,17,174,90.23,0,9.77,2019
"0880731",456,12,66,534,85.39,2.25,12.36,2019
"0880733",206,0,21,227,90.75,0,9.25,2019
"0880919",10892,145,235,11272,96.63,1.29,2.08,2019
"0880103",793,90,120,1003,79.06,8.97,11.96,2019
"0880449",320,11,66,397,80.6,2.77,16.62,2019
"0880649",125,8,22,155,80.65,5.16,14.19,2019
"0880827",270,22,15,307,87.95,7.17,4.89,2019
"0880918",17447,351,927,18725,93.17,1.87,4.95,2019
"0880023",8098,37,230,8365,96.81,0.44,2.75,2019
"0880045",486,39,39,564,86.17,6.91,6.91,2019
"0880108",9373,66,125,9564,98,0.69,1.31,2019
"0880109",7396,144,295,7835,94.4,1.84,3.77,2019
"0880113",9253,180,1141,10574,87.51,1.7,10.79,2019
"0880129",11445,142,286,11873,96.4,1.2,2.41,2019
"0880130",9684,52,246,9982,97.01,0.52,2.46,2019
"0880131",133,0,8,141,94.33,0,5.67,2019
"0880238",7406,132,108,7646,96.86,1.73,1.41,2019
"0880247",12205,303,2009,14517,84.07,2.09,13.84,2019
"0880305",6447,175,371,6993,92.19,2.5,5.31,2019
"0880310",0,0,0,0,NA,NA,NA,2019
"0880419",0,0,0,0,NA,NA,NA,2019
"0880453",41,0,0,41,100,0,0,2019
"0880471",0,0,0,0,NA,NA,NA,2019
"0880475",0,0,0,0,NA,NA,NA,2019
"0880477",34,9,0,43,79.07,20.93,0,2019
"0880488",60,0,0,60,100,0,0,2019
"0880497",89,39,0,128,69.53,30.47,0,2019
"0880511",0,0,0,0,NA,NA,NA,2019
"0880544",54,0,0,54,100,0,0,2019
"0880438",156,6,107,269,57.99,2.23,39.78,2019
"0880468",140,12,29,181,77.35,6.63,16.02,2019
"0880549",3864,76,367,4307,89.71,1.76,8.52,2019
"0880808",1837,24,304,2165,84.85,1.11,14.04,2019
"0880546",80,0,19,99,80.81,0,19.19,2019
"0880602",11151,113,364,11628,95.9,0.97,3.13,2019
"0880603",3910,108,435,4453,87.81,2.43,9.77,2019
"0880622",45,0,11,56,80.36,0,19.64,2019
"0880746",8,1,15,24,33.33,4.17,62.5,2019
"0880902",2772,41,46,2859,96.96,1.43,1.61,2019
"0880914",41,0,0,41,100,0,0,2019
"0880923",10404,106,134,10644,97.75,1,1.26,2019
"0880924",3047,27,113,3187,95.61,0.85,3.55,2019
"0880927",1345,23,0,1368,98.32,1.68,0,2019
"0880938",25,0,0,25,100,0,0,2019
"4984536",73,0,358,431,16.94,0,83.06,2019
"4984606",7327,2941,294,10562,69.37,27.85,2.78,2019
"4984624",1552,85,274,1911,81.21,4.45,14.34,2019
"4984309",107,1,22,130,82.31,0.77,16.92,2019
"4984316",59,4,26,89,66.29,4.49,29.21,2019
"4984317",683,8,77,768,88.93,1.04,10.03,2019
"3588232",451,42,142,635,71.02,6.61,22.36,2019
"3588256",421,30,212,663,63.5,4.52,31.98,2019
"3588262",0,0,4,4,0,0,100,2019
"3588264",0,0,17,17,0,0,100,2019
"3588316",669,38,163,870,76.9,4.37,18.74,2019
"3588325",343,9,30,382,89.79,2.36,7.85,2019
"3588337",670,29,63,762,87.93,3.81,8.27,2019
"3588346",431,19,386,836,51.56,2.27,46.17,2019
"3588347",30,0,0,30,100,0,0,2019
"3588353",57,8,79,144,39.58,5.56,54.86,2019
"3588354",0,0,16,16,0,0,100,2019
"3588430",37,0,19,56,66.07,0,33.93,2019
"3588340",775,27,311,1113,69.63,2.43,27.94,2019
"3588352",1405,0,501,1906,73.71,0,26.29,2019
"3588401",1211,79,1059,2349,51.55,3.36,45.08,2019
"3588411",19,0,5,24,79.17,0,20.83,2019
"3588431",9,0,0,9,100,0,0,2019
"3588436",31,0,18,49,63.27,0,36.73,2019
"3588021",3517,282,2176,5975,58.86,4.72,36.42,2019
"3588003",0,0,0,0,NA,NA,NA,2019
"3588008",2596,100,284,2980,87.11,3.36,9.53,2019
"3588040",33,12,11,56,58.93,21.43,19.64,2019
"3588041",421,0,148,569,73.99,0,26.01,2019
"3588043",402,8,156,566,71.02,1.41,27.56,2019
"3588052",49,0,45,94,52.13,0,47.87,2019
"3588061",5735,337,1779,7851,73.05,4.29,22.66,2019
"3588065",155,11,91,257,60.31,4.28,35.41,2019
"3588101",14160,347,2913,17420,81.29,1.99,16.72,2019
"3588039",149,41,41,231,64.5,17.75,17.75,2019
"3588027",41,10,77,128,32.03,7.81,60.16,2019
"3588119",430,23,183,636,67.61,3.62,28.77,2019
"3588314",17,0,0,17,100,0,0,2019
"3588317",560,8,108,676,82.84,1.18,15.98,2019
"3588330",1096,0,0,1096,100,0,0,2019
"3588341",245,18,55,318,77.04,5.66,17.3,2019
"3588343",0,0,4,4,0,0,100,2019
"3588351",51,5,24,80,63.75,6.25,30,2019
"3588414",5,0,2,7,71.43,0,28.57,2019
"3588434",92,13,53,158,58.23,8.23,33.54,2019
"3588001",9389,654,3704,13747,68.3,4.76,26.94,2019
"3588022",238,26,81,345,68.99,7.54,23.48,2019
"3588023",628,33,290,951,66.04,3.47,30.49,2019
"3588025",70,0,16,86,81.4,0,18.6,2019
"3588242",2146,67,348,2561,83.8,2.62,13.59,2019
"3588115",20,0,19,39,51.28,0,48.72,2019
"3588220",11198,285,2134,13617,82.24,2.09,15.67,2019
"3588231",877,33,238,1148,76.39,2.87,20.73,2019
"3588002",243,21,28,292,83.22,7.19,9.59,2019
"3588009",2,0,0,2,100,0,0,2019
"3588026",272,32,252,556,48.92,5.76,45.32,2019
"3588045",902,69,331,1302,69.28,5.3,25.42,2019
"3588049",138,9,41,188,73.4,4.79,21.81,2019
"3588056",82,7,22,111,73.87,6.31,19.82,2019
"0693635",9264,414,1795,11473,80.75,3.61,15.65,2019
"0693640",1591,83,1292,2966,53.64,2.8,43.56,2019
"0693646",1932,241,875,3048,63.39,7.91,28.71,2019
"0693647",2090,137,705,2932,71.28,4.67,24.05,2019
"0693653",406,50,86,542,74.91,9.23,15.87,2019
"0693657",8248,259,2213,10720,76.94,2.42,20.64,2019
"0485253",7214,169,230,7613,94.76,2.22,3.02,2019
"0485254",17497,556,523,18576,94.19,2.99,2.82,2019
"0485258",12314,200,623,13137,93.74,1.52,4.74,2019
"0485281",21149,971,2724,24844,85.13,3.91,10.96,2019
"0485283",17204,498,2107,19809,86.85,2.51,10.64,2019
"0485324",980,38,361,1379,71.07,2.76,26.18,2019
"0485331",11534,155,353,12042,95.78,1.29,2.93,2019
"0485345",16844,552,2446,19842,84.89,2.78,12.33,2019
"0485347",154,0,27,181,85.08,0,14.92,2019
"0485350",3949,332,1602,5883,67.13,5.64,27.23,2019
"0485351",13561,562,3166,17289,78.44,3.25,18.31,2019
"0485501",3224,397,1645,5266,61.22,7.54,31.24,2019
"0485015",10957,1026,3198,15181,72.18,6.76,21.07,2019
"0485044",15924,261,921,17106,93.09,1.53,5.38,2019
"0485053",9897,269,1123,11289,87.67,2.38,9.95,2019
"0485201",15766,783,3481,20030,78.71,3.91,17.38,2019
"0485205",14523,531,2583,17637,82.34,3.01,14.65,2019
"0485206",13288,391,1966,15645,84.93,2.5,12.57,2019
"0485213",11375,410,960,12745,89.25,3.22,7.53,2019
"0485224",15590,270,1199,17059,91.39,1.58,7.03,2019
"1683669",3331,104,579,4014,82.98,2.59,14.42,2019
"1683849",639,33,177,849,75.27,3.89,20.85,2019
"1683654",537,49,94,680,78.97,7.21,13.82,2019
"1683808",29,5,27,61,47.54,8.2,44.26,2019
"1683629",629,26,193,848,74.17,3.07,22.76,2019
"1683645",269,10,36,315,85.4,3.17,11.43,2019
"1683648",875,12,15,902,97.01,1.33,1.66,2019
"1683660",1691,33,398,2122,79.69,1.56,18.76,2019
"1683677",32,27,0,59,54.24,45.76,0,2019
"1683686",14255,450,2519,17224,82.76,2.61,14.62,2019
"1683801",2410,118,308,2836,84.98,4.16,10.86,2019
"1683810",370,0,155,525,70.48,0,29.52,2019
"1683827",64,0,22,86,74.42,0,25.58,2019
"1683830",118,0,42,160,73.75,0,26.25,2019
"1683832",507,35,79,621,81.64,5.64,12.72,2019
"1683836",379,41,39,459,82.57,8.93,8.5,2019
"1683841",107,0,68,175,61.14,0,38.86,2019
"1683843",9898,684,629,11211,88.29,6.1,5.61,2019
"1683846",250,0,96,346,72.25,0,27.75,2019
"1683239",190,4,22,216,87.96,1.85,10.19,2019
"1683241",748,8,78,834,89.69,0.96,9.35,2019
"1683252",1427,17,162,1606,88.85,1.06,10.09,2019
"1683255",438,6,84,528,82.95,1.14,15.91,2019
"1683287",114,0,9,123,92.68,0,7.32,2019
"1683318",4995,74,615,5684,87.88,1.3,10.82,2019
"1683320",257,10,49,316,81.33,3.16,15.51,2019
"1683333",3106,54,400,3560,87.25,1.52,11.24,2019
"1683334",618,6,140,764,80.89,0.79,18.32,2019
"1683446",16,0,0,16,100,0,0,2019
"1683451",176,10,68,254,69.29,3.94,26.77,2019
"1683854",13642,722,1760,16124,84.61,4.48,10.92,2019
"5683001",6174,221,459,6854,90.08,3.22,6.7,2019
"5683114",235,23,28,286,82.17,8.04,9.79,2019
"0690504",10539,147,999,11685,90.19,1.26,8.55,2019
"0690602",5730,365,1548,7643,74.97,4.78,20.25,2019
"0690631",19164,441,1624,21229,90.27,2.08,7.65,2019
"0690814",8536,161,468,9165,93.14,1.76,5.11,2019
"0690815",13303,313,940,14556,91.39,2.15,6.46,2019
"0690071",114,0,5,119,95.8,0,4.2,2019
"1950468",555,17,92,664,83.58,2.56,13.86,2019
"1950472",814,28,118,960,84.79,2.92,12.29,2019
"1950483",217,4,52,273,79.49,1.47,19.05,2019
"1950516",205,28,20,253,81.03,11.07,7.91,2019
"1950518",116,3,41,160,72.5,1.88,25.62,2019
"1950522",275,0,70,345,79.71,0,20.29,2019
"1950525",1062,48,443,1553,68.38,3.09,28.53,2019
"1950535",359,2,82,443,81.04,0.45,18.51,2019
"1950546",89,5,51,145,61.38,3.45,35.17,2019
"1950558",201,4,42,247,81.38,1.62,17,2019
"1950559",107,6,37,150,71.33,4,24.67,2019
"1950562",131,3,39,173,75.72,1.73,22.54,2019
"1950565",163,6,17,186,87.63,3.23,9.14,2019
"1950571",123,7,25,155,79.35,4.52,16.13,2019
"1950590",282,20,107,409,68.95,4.89,26.16,2019
"1950602",509,25,146,680,74.85,3.68,21.47,2019
"1950603",131,0,65,196,66.84,0,33.16,2019
"1950625",309,20,126,455,67.91,4.4,27.69,2019
"1950644",2853,42,696,3591,79.45,1.17,19.38,2019
"1950075",284,11,56,351,80.91,3.13,15.95,2019
"1950002",454,17,134,605,75.04,2.81,22.15,2019
"1950005",272,36,65,373,72.92,9.65,17.43,2019
"1950006",563,28,120,711,79.18,3.94,16.88,2019
"1950038",44,0,0,44,100,0,0,2019
"1950042",101,3,16,120,84.17,2.5,13.33,2019
"1950103",120,10,28,158,75.95,6.33,17.72,2019
"1950105",319,9,22,350,91.14,2.57,6.29,2019
"1950109",1063,27,71,1161,91.56,2.33,6.12,2019
"1950131",7729,281,554,8564,90.25,3.28,6.47,2019
"1950134",226,2,54,282,80.14,0.71,19.15,2019
"1950138",3788,242,1040,5070,74.71,4.77,20.51,2019
"1950149",284,7,88,379,74.93,1.85,23.22,2019
"1950156",1557,95,281,1933,80.55,4.91,14.54,2019
"1950158",9151,362,2295,11808,77.5,3.07,19.44,2019
"1950217",255,11,37,303,84.16,3.63,12.21,2019
"1950230",343,35,60,438,78.31,7.99,13.7,2019
"1950231",62,2,9,73,84.93,2.74,12.33,2019
"1950261",811,9,110,930,87.2,0.97,11.83,2019
"1950271",181,12,51,244,74.18,4.92,20.9,2019
"1950310",11075,434,1747,13256,83.55,3.27,13.18,2019
"1950312",6392,493,766,7651,83.54,6.44,10.01,2019
"1950320",6714,233,1086,8033,83.58,2.9,13.52,2019
"1950321",2935,75,280,3290,89.21,2.28,8.51,2019
"1950322",11439,222,1101,12762,89.63,1.74,8.63,2019
"1950432",95,1,25,121,78.51,0.83,20.66,2019
"1950169",736,41,109,886,83.07,4.63,12.3,2019
"1950170",992,23,179,1194,83.08,1.93,14.99,2019
"1950173",226,40,62,328,68.9,12.2,18.9,2019
"1950210",480,30,136,646,74.3,4.64,21.05,2019
"1950213",2355,114,440,2909,80.96,3.92,15.13,2019
"1950223",258,5,25,288,89.58,1.74,8.68,2019
"1950225",945,22,176,1143,82.68,1.92,15.4,2019
"1950226",1847,54,109,2010,91.89,2.69,5.42,2019
"1951053",353,21,94,468,75.43,4.49,20.09,2019
"1951111",23,0,13,36,63.89,0,36.11,2019
"1951201",2051,37,508,2596,79.01,1.43,19.57,2019
"1951242",66,3,11,80,82.5,3.75,13.75,2019
"1951334",2254,60,522,2836,79.48,2.12,18.41,2019
"1951347",537,10,132,679,79.09,1.47,19.44,2019
"4984324",211,0,34,245,86.12,0,13.88,2019
"4984022",266,0,36,302,88.08,0,11.92,2019
"4984043",15826,477,395,16698,94.78,2.86,2.37,2019
"4984054",6226,101,256,6583,94.58,1.53,3.89,2019
"4984055",433,6,34,473,91.54,1.27,7.19,2019
"4984065",10894,596,314,11804,92.29,5.05,2.66,2019
"4984118",17819,511,1354,19684,90.53,2.6,6.88,2019
"4984119",14615,897,1621,17133,85.3,5.24,9.46,2019
"4984310",1455,0,30,1485,97.98,0,2.02,2019
"4984311",147,3,24,174,84.48,1.72,13.79,2019
"4984326",529,15,41,585,90.43,2.56,7.01,2019
"4984331",88,1,11,100,88,1,11,2019
"4984333",755,25,90,870,86.78,2.87,10.34,2019
"4984414",8760,175,348,9283,94.37,1.89,3.75,2019
"4984521",231,3,33,267,86.52,1.12,12.36,2019
"4984528",705,25,183,913,77.22,2.74,20.04,2019
"4984631",941,16,145,1102,85.39,1.45,13.16,2019
"4984635",219,12,31,262,83.59,4.58,11.83,2019
"4984643",158,1,28,187,84.49,0.53,14.97,2019
"4984648",1684,36,343,2063,81.63,1.75,16.63,2019
"4984723",182,18,50,250,72.8,7.2,20,2019
"4984726",302,8,62,372,81.18,2.15,16.67,2019
"4984728",15,0,0,15,100,0,0,2019
"4984329",30,0,16,46,65.22,0,34.78,2019
"4984534",162,23,448,633,25.59,3.63,70.77,2019
"4984537",383,3,93,479,79.96,0.63,19.42,2019
"4984622",520,3,62,585,88.89,0.51,10.6,2019
"4984627",1582,285,192,2059,76.83,13.84,9.32,2019
"4984632",270,15,54,339,79.65,4.42,15.93,2019
"4984653",2253,23,107,2383,94.54,0.97,4.49,2019
"4984654",777,24,192,993,78.25,2.42,19.34,2019
"4984657",144,2,46,192,75,1.04,23.96,2019
"3587575",161,0,140,301,53.49,0,46.51,2019
"3587583",45,0,53,98,45.92,0,54.08,2019
"3587731",82,0,35,117,70.09,0,29.91,2019
"3587735",38,0,39,77,49.35,0,50.65,2019
"3587740",2359,58,1111,3528,66.87,1.64,31.49,2019
"3587747",436,6,184,626,69.65,0.96,29.39,2019
"3587750",0,0,0,0,NA,NA,NA,2019
"3587820",8,0,25,33,24.24,0,75.76,2019
"3587823",161,14,120,295,54.58,4.75,40.68,2019
"3587831",35,7,11,53,66.04,13.21,20.75,2019
"3587931",261,0,204,465,56.13,0,43.87,2019
"3587121",19481,1272,3603,24356,79.98,5.22,14.79,2019
"3587123",12940,798,3482,17220,75.15,4.63,20.22,2019
"3587310",77,6,187,270,28.52,2.22,69.26,2019
"3587311",226,45,835,1106,20.43,4.07,75.5,2019
"3587347",45,0,51,96,46.88,0,53.12,2019
"3587552",809,109,560,1478,54.74,7.37,37.89,2019
"3587553",233,19,209,461,50.54,4.12,45.34,2019
"3587557",1395,56,720,2171,64.26,2.58,33.16,2019
"3587562",89,0,73,162,54.94,0,45.06,2019
"3587578",90,13,9,112,80.36,11.61,8.04,2019
"0694702",6480,221,798,7499,86.41,2.95,10.64,2019
"0694704",7250,567,434,8251,87.87,6.87,5.26,2019
"0694707",4653,11,174,4838,96.18,0.23,3.6,2019
"0694904",4867,96,339,5302,91.8,1.81,6.39,2019
"0694014",12353,214,1477,14044,87.96,1.52,10.52,2019
"0694020",615,13,33,661,93.04,1.97,4.99,2019
"0693703",7632,185,2084,9901,77.08,1.87,21.05,2019
"0693725",4879,191,1765,6835,71.38,2.79,25.82,2019
"0693436",14818,387,2305,17510,84.63,2.21,13.16,2019
"0693441",353,0,51,404,87.38,0,12.62,2019
"0693452",126,0,196,322,39.13,0,60.87,2019
"0693518",274,12,86,372,73.66,3.23,23.12,2019
"0693522",23,0,36,59,38.98,0,61.02,2019
"0693528",32,0,26,58,55.17,0,44.83,2019
"0693606",174,0,64,238,73.11,0,26.89,2019
"0693624",81,21,75,177,45.76,11.86,42.37,2019
"0693648",2288,352,1509,4149,55.15,8.48,36.37,2019
"0693654",6109,336,2127,8572,71.27,3.92,24.81,2019
"0693656",1110,49,531,1690,65.68,2.9,31.42,2019
"0693010",14657,108,1277,16042,91.37,0.67,7.96,2019
"0693015",4127,39,1022,5188,79.55,0.75,19.7,2019
"0693117",14048,1120,891,16059,87.48,6.97,5.55,2019
"0693202",836,13,313,1162,71.94,1.12,26.94,2019
"0693223",2178,72,662,2912,74.79,2.47,22.73,2019
"0693244",103,4,10,117,88.03,3.42,8.55,2019
"0693277",15325,342,2474,18141,84.48,1.89,13.64,2019
"0693292",11499,169,1926,13594,84.59,1.24,14.17,2019
"0693305",8057,512,2132,10701,75.29,4.78,19.92,2019
"0693313",13086,379,1016,14481,90.37,2.62,7.02,2019
"0693405",8051,253,347,8651,93.06,2.92,4.01,2019
"0693424",422,45,40,507,83.23,8.88,7.89,2019
"0693432",517,65,23,605,85.45,10.74,3.8,2019
"0693433",4868,16,423,5307,91.73,0.3,7.97,2019
"0693450",109,0,95,204,53.43,0,46.57,2019
"0693460",1899,15,109,2023,93.87,0.74,5.39,2019
"0693465",3056,28,273,3357,91.03,0.83,8.13,2019
"0693532",904,51,21,976,92.62,5.23,2.15,2019
"0693550",17869,716,2963,21548,82.93,3.32,13.75,2019
"0693551",14424,364,983,15771,91.46,2.31,6.23,2019
"0693561",9483,536,1660,11679,81.2,4.59,14.21,2019
"0693563",96,0,0,96,100,0,0,2019
"0693602",1053,20,327,1400,75.21,1.43,23.36,2019
"0693605",52,0,5,57,91.23,0,8.77,2019
"0693610",3727,127,856,4710,79.13,2.7,18.17,2019
"0693644",2867,120,572,3559,80.56,3.37,16.07,2019
"0693662",6610,292,1905,8807,75.05,3.32,21.63,2019
"0693668",177,0,176,353,50.14,0,49.86,2019
"0693704",9571,377,1386,11334,84.45,3.33,12.23,2019
"0693726",11625,264,2246,14135,82.24,1.87,15.89,2019
"0693906",14800,180,1820,16800,88.1,1.07,10.83,2019
"0693908",4140,24,271,4435,93.35,0.54,6.11,2019
"0693923",4945,97,529,5571,88.76,1.74,9.5,2019
"0693665",61,0,173,234,26.07,0,73.93,2019
"0693702",8014,356,3591,11961,67,2.98,30.02,2019
"0693705",9099,486,2518,12103,75.18,4.02,20.8,2019
"0693706",7325,524,3177,11026,66.43,4.75,28.81,2019
"0693710",9530,468,1240,11238,84.8,4.16,11.03,2019
"0693905",9607,200,3208,13015,73.81,1.54,24.65,2019
"0693940",11985,149,1224,13358,89.72,1.12,9.16,2019
"0695623",1364,24,117,1505,90.63,1.59,7.77,2019
"0695140",49,4,18,71,69.01,5.63,25.35,2019
"0695937",461,0,75,536,86.01,0,13.99,2019
"0695939",103,11,78,192,53.65,5.73,40.62,2019
"0695951",483,0,371,854,56.56,0,43.44,2019
"0695960",261,16,71,348,75,4.6,20.4,2019
"0695634",1069,87,230,1386,77.13,6.28,16.59,2019
"0695646",34,0,0,34,100,0,0,2019
"0695650",4842,199,349,5390,89.83,3.69,6.47,2019
"0695664",528,0,50,578,91.35,0,8.65,2019
"0695673",4451,93,414,4958,89.77,1.88,8.35,2019
"0695684",940,41,324,1305,72.03,3.14,24.83,2019
"0695689",609,19,98,726,83.88,2.62,13.5,2019
"0695694",3101,87,289,3477,89.19,2.5,8.31,2019
"0695703",340,0,41,381,89.24,0,10.76,2019
"0695714",170,19,35,224,75.89,8.48,15.62,2019
"0695762",14134,194,249,14577,96.96,1.33,1.71,2019
"0695817",5129,77,942,6148,83.43,1.25,15.32,2019
"0695819",7286,133,482,7901,92.22,1.68,6.1,2019
"0695824",6883,351,1869,9103,75.61,3.86,20.53,2019
"0695843",13352,166,757,14275,93.53,1.16,5.3,2019
"0695917",1002,13,89,1104,90.76,1.18,8.06,2019
"0695918",1133,0,157,1290,87.83,0,12.17,2019
"0695922",270,2,49,321,84.11,0.62,15.26,2019
"0695926",13383,249,1310,14942,89.57,1.67,8.77,2019
"0695932",2320,56,498,2874,80.72,1.95,17.33,2019
"0695935",95,0,35,130,73.08,0,26.92,2019
"0695938",1313,51,158,1522,86.27,3.35,10.38,2019
"0695946",3391,90,318,3799,89.26,2.37,8.37,2019
"0695955",367,5,141,513,71.54,0.97,27.49,2019
"0695959",6478,167,893,7538,85.94,2.22,11.85,2019
"0695965",5240,208,1535,6983,75.04,2.98,21.98,2019
"0695966",9268,360,1638,11266,82.27,3.2,14.54,2019
"0695970",194,4,56,254,76.38,1.57,22.05,2019
"0695993",10667,206,1412,12285,86.83,1.68,11.49,2019
"0695204",8882,357,1837,11076,80.19,3.22,16.59,2019
"0695230",231,3,35,269,85.87,1.12,13.01,2019
"0695231",518,34,225,777,66.67,4.38,28.96,2019
"0695246",416,0,129,545,76.33,0,23.67,2019
"0695247",1324,51,255,1630,81.23,3.13,15.64,2019
"0695315",3221,88,313,3622,88.93,2.43,8.64,2019
"0695325",40,0,0,40,100,0,0,2019
"0695326",3025,48,392,3465,87.3,1.39,11.31,2019
"0695328",879,21,205,1105,79.55,1.9,18.55,2019
"0695841",7208,133,850,8191,88,1.62,10.38,2019
"0695912",1315,10,251,1576,83.44,0.63,15.93,2019
"0695942",463,23,78,564,82.09,4.08,13.83,2019
"0695944",0,0,14,14,0,0,100,2019
"0695948",3125,78,515,3718,84.05,2.1,13.85,2019
"0695950",121,0,30,151,80.13,0,19.87,2019
"0695953",2687,111,464,3262,82.37,3.4,14.22,2019
"0695956",118,8,41,167,70.66,4.79,24.55,2019
"0695983",132,0,17,149,88.59,0,11.41,2019
"0695987",1503,18,245,1766,85.11,1.02,13.87,2019
"0695334",3781,64,640,4485,84.3,1.43,14.27,2019
"0695337",10731,173,1144,12048,89.07,1.44,9.5,2019
"0695356",10527,81,869,11477,91.72,0.71,7.57,2019
"0695363",6666,43,897,7606,87.64,0.57,11.79,2019
"0695383",1670,25,83,1778,93.93,1.41,4.67,2019
"0486337",400,21,231,652,61.35,3.22,35.43,2019
"0486338",154,5,19,178,86.52,2.81,10.67,2019
"0486432",921,0,632,1553,59.3,0,40.7,2019
"0486024",335,4,39,378,88.62,1.06,10.32,2019
"0486035",211,48,302,561,37.61,8.56,53.83,2019
"0486040",2465,92,648,3205,76.91,2.87,20.22,2019
"1951019",238,19,93,350,68,5.43,26.57,2019
"1951101",239,15,167,421,56.77,3.56,39.67,2019
"1951240",607,5,162,774,78.42,0.65,20.93,2019
"1951248",711,16,118,845,84.14,1.89,13.96,2019
"1951343",112,1,22,135,82.96,0.74,16.3,2019
"1951363",61,2,17,80,76.25,2.5,21.25,2019
"1951447",92,6,24,122,75.41,4.92,19.67,2019
"1951448",164,3,73,240,68.33,1.25,30.42,2019
"1951461",392,5,93,490,80,1.02,18.98,2019
"1951536",97,26,40,163,59.51,15.95,24.54,2019
"1951541",138,7,43,188,73.4,3.72,22.87,2019
"1951546",836,65,222,1123,74.44,5.79,19.77,2019
"1951562",143,8,25,176,81.25,4.55,14.2,2019
"1951571",178,6,17,201,88.56,2.99,8.46,2019
"1951645",101,3,16,120,84.17,2.5,13.33,2019
"1951105",2621,191,1149,3961,66.17,4.82,29.01,2019
"1951235",470,0,32,502,93.63,0,6.37,2019
"1951244",35,0,5,40,87.5,0,12.5,2019
"1951341",10,0,12,22,45.45,0,54.55,2019
"1951346",768,55,180,1003,76.57,5.48,17.95,2019
"1951351",1581,82,301,1964,80.5,4.18,15.33,2019
"1951431",157,1,32,190,82.63,0.53,16.84,2019
"1951440",106,13,10,129,82.17,10.08,7.75,2019
"1951445",955,21,239,1215,78.6,1.73,19.67,2019
"1951449",698,6,176,880,79.32,0.68,20,2019
"1951501",10188,773,2953,13914,73.22,5.56,21.22,2019
"1951531",266,10,33,309,86.08,3.24,10.68,2019
"1951578",26,0,1,27,96.3,0,3.7,2019
"1951003",586,30,65,681,86.05,4.41,9.54,2019
"1951007",179,9,19,207,86.47,4.35,9.18,2019
"1951028",792,34,98,924,85.71,3.68,10.61,2019
"1951029",124,0,20,144,86.11,0,13.89,2019
"1951047",233,12,35,280,83.21,4.29,12.5,2019
"1951061",176,4,26,206,85.44,1.94,12.62,2019
"1951062",132,1,29,162,81.48,0.62,17.9,2019
"1951063",360,15,74,449,80.18,3.34,16.48,2019
"1951650",79,7,45,131,60.31,5.34,34.35,2019
"1951561",353,9,71,433,81.52,2.08,16.4,2019
"1951530",195,21,82,298,65.44,7.05,27.52,2019
"1951055",496,25,106,627,79.11,3.99,16.91,2019
"1951550",55,2,13,70,78.57,2.86,18.57,2019
"1951005",538,8,90,636,84.59,1.26,14.15,2019
"1951009",69,4,14,87,79.31,4.6,16.09,2019
"1951656",11,0,4,15,73.33,0,26.67,2019
"1951446",154,21,55,230,66.96,9.13,23.91,2019
"1952566",60,10,7,77,77.92,12.99,9.09,2019
"1952570",201,2,126,329,61.09,0.61,38.3,2019
"1952572",274,9,144,427,64.17,2.11,33.72,2019
"1952594",99,3,10,112,88.39,2.68,8.93,2019
"1952237",453,19,123,595,76.13,3.19,20.67,2019
"1952322",788,29,152,969,81.32,2.99,15.69,2019
"1952305",206,1,23,230,89.57,0.43,10,2019
"1952308",36,4,25,65,55.38,6.15,38.46,2019
"5554871",1000,54,227,1281,78.06,4.22,17.72,2019
"5554876",469,29,125,623,75.28,4.65,20.06,2019
"5554027",311,9,72,392,79.34,2.3,18.37,2019
"5554102",311,10,121,442,70.36,2.26,27.38,2019
"5554107",1107,40,234,1381,80.16,2.9,16.94,2019
"5554150",194,0,121,315,61.59,0,38.41,2019
"0694028",2406,15,87,2508,95.93,0.6,3.47,2019
"0694040",13378,248,941,14567,91.84,1.7,6.46,2019
"0694102",12889,1277,3870,18036,71.46,7.08,21.46,2019
"0694111",1942,40,229,2211,87.83,1.81,10.36,2019
"0694010",15303,126,633,16062,95.27,0.78,3.94,2019
"0694044",12771,203,776,13750,92.88,1.48,5.64,2019
"0694070",10815,108,614,11537,93.74,0.94,5.32,2019
"0694105",5167,283,37,5487,94.17,5.16,0.67,2019
"0694121",15496,344,1608,17448,88.81,1.97,9.22,2019
"0694301",6252,344,446,7042,88.78,4.88,6.33,2019
"0694303",12455,508,1347,14310,87.04,3.55,9.41,2019
"0694305",2120,1409,49,3578,59.25,39.38,1.37,2019
"0694403",15517,145,867,16529,93.88,0.88,5.25,2019
"0694572",3029,117,227,3373,89.8,3.47,6.73,2019
"0694579",6000,121,679,6800,88.24,1.78,9.99,2019
"0694589",8457,196,1132,9785,86.43,2,11.57,2019
"0694603",7408,286,2312,10006,74.04,2.86,23.11,2019
"0694605",13667,513,2266,16446,83.1,3.12,13.78,2019
"0694612",6742,289,1719,8750,77.05,3.3,19.65,2019
"0694706",6750,890,341,7981,84.58,11.15,4.27,2019
"0694923",411,18,77,506,81.23,3.56,15.22,2019
"0694928",14899,384,1110,16393,90.89,2.34,6.77,2019
"0694938",307,24,43,374,82.09,6.42,11.5,2019
"0694939",2947,40,140,3127,94.24,1.28,4.48,2019
"0694945",6835,133,432,7400,92.36,1.8,5.84,2019
"0694964",70,0,0,70,100,0,0,2019
"0694512",16,0,0,16,100,0,0,2019
"0694569",83,0,0,83,100,0,0,2019
"0694517",4562,40,195,4797,95.1,0.83,4.07,2019
"0694545",8452,157,805,9414,89.78,1.67,8.55,2019
"0694556",5590,50,241,5881,95.05,0.85,4.1,2019
"0694574",3446,62,288,3796,90.78,1.63,7.59,2019
"0694583",11536,192,368,12096,95.37,1.59,3.04,2019
"0694586",273,0,32,305,89.51,0,10.49,2019
"0694601",11594,841,3101,15536,74.63,5.41,19.96,2019
"0694621",6243,463,2979,9685,64.46,4.78,30.76,2019
"0694708",4577,85,87,4749,96.38,1.79,1.83,2019
"0694710",2856,124,123,3103,92.04,4,3.96,2019
"0694117",17278,194,772,18244,94.71,1.06,4.23,2019
"0694134",10624,198,1350,12172,87.28,1.63,11.09,2019
"0694404",13768,126,447,14341,96,0.88,3.12,2019
"0694506",8073,24,180,8277,97.54,0.29,2.17,2019
"0694509",18741,325,2471,21537,87.02,1.51,11.47,2019
"0694510",10557,150,632,11339,93.1,1.32,5.57,2019
"0694801",8045,141,1149,9335,86.18,1.51,12.31,2019
"0694803",8500,112,502,9114,93.26,1.23,5.51,2019
"0694901",14269,550,1171,15990,89.24,3.44,7.32,2019
"0694947",9383,147,656,10186,92.12,1.44,6.44,2019
"0694952",12374,299,1113,13786,89.76,2.17,8.07,2019
"0694960",6061,54,168,6283,96.47,0.86,2.67,2019
"0694970",343,25,10,378,90.74,6.61,2.65,2019
"0694542",4207,81,104,4392,95.79,1.84,2.37,2019
"0694550",16744,294,1079,18117,92.42,1.62,5.96,2019
"0692602",7736,58,268,8062,95.96,0.72,3.32,2019
"0692661",1448,0,53,1501,96.47,0,3.53,2019
"0692672",12800,322,991,14113,90.7,2.28,7.02,2019
"0692673",9903,112,304,10319,95.97,1.09,2.95,2019
"0692823",1458,0,0,1458,100,0,0,2019
"0692835",7783,136,594,8513,91.42,1.6,6.98,2019
"0695979",158,0,45,203,77.83,0,22.17,2019
"0695981",13,0,0,13,100,0,0,2019
"0695991",11574,325,2533,14432,80.2,2.25,17.55,2019
"0695003",9312,126,825,10263,90.73,1.23,8.04,2019
"0695012",1954,9,471,2434,80.28,0.37,19.35,2019
"0695017",214,0,45,259,82.63,0,17.37,2019
"0695030",4804,109,175,5088,94.42,2.14,3.44,2019
"0695037",15763,340,1194,17297,91.13,1.97,6.9,2019
"0695043",236,4,44,284,83.1,1.41,15.49,2019
"0695045",1211,18,205,1434,84.45,1.26,14.3,2019
"0695050",12727,321,1064,14112,90.19,2.27,7.54,2019
"0695066",5207,67,324,5598,93.02,1.2,5.79,2019
"0695120",12078,94,350,12522,96.45,0.75,2.8,2019
"0695123",21660,536,1005,23201,93.36,2.31,4.33,2019
"0695225",100,0,60,160,62.5,0,37.5,2019
"0695228",1494,52,182,1728,86.46,3.01,10.53,2019
"0695242",8828,185,1008,10021,88.1,1.85,10.06,2019
"0695250",0,0,0,0,NA,NA,NA,2019
"0695258",1166,49,226,1441,80.92,3.4,15.68,2019
"0695301",10539,252,1208,11999,87.83,2.1,10.07,2019
"0695324",2356,75,447,2878,81.86,2.61,15.53,2019
"0695330",5116,123,403,5642,90.68,2.18,7.14,2019
"0695346",520,0,21,541,96.12,0,3.88,2019
"0695365",846,127,380,1353,62.53,9.39,28.09,2019
"0695380",11330,328,2812,14470,78.3,2.27,19.43,2019
"0695385",140,0,8,148,94.59,0,5.41,2019
"0695389",215,9,59,283,75.97,3.18,20.85,2019
"0695405",7551,107,516,8174,92.38,1.31,6.31,2019
"0695412",124,0,29,153,81.05,0,18.95,2019
"0695431",0,0,0,0,NA,NA,NA,2019
"0695436",2466,89,268,2823,87.35,3.15,9.49,2019
"0695441",534,21,69,624,85.58,3.37,11.06,2019
"0695451",3682,19,920,4621,79.68,0.41,19.91,2019
"0695462",536,7,40,583,91.94,1.2,6.86,2019
"0695470",1878,26,212,2116,88.75,1.23,10.02,2019
"0695472",11592,279,622,12493,92.79,2.23,4.98,2019
"0695482",9607,327,1517,11451,83.9,2.86,13.25,2019
"0695497",557,0,47,604,92.22,0,7.78,2019
"0695503",8826,197,1203,10226,86.31,1.93,11.76,2019
"0695519",6731,54,767,7552,89.13,0.72,10.16,2019
"0695531",6870,443,1184,8497,80.85,5.21,13.93,2019
"0695536",931,14,179,1124,82.83,1.25,15.93,2019
"0695537",114,0,0,114,100,0,0,2019
"0695559",14,0,35,49,28.57,0,71.43,2019
"0695564",128,12,18,158,81.01,7.59,11.39,2019
"0695607",145,6,16,167,86.83,3.59,9.58,2019
"0695608",22574,520,2346,25440,88.73,2.04,9.22,2019
"0695619",1760,119,280,2159,81.52,5.51,12.97,2019
"0695624",18619,423,906,19948,93.34,2.12,4.54,2019
"0695004",1167,52,33,1252,93.21,4.15,2.64,2019
"0695032",9172,108,560,9840,93.21,1.1,5.69,2019
"0695060",17197,446,1270,18913,90.93,2.36,6.71,2019
"0692040",13624,485,1136,15245,89.37,3.18,7.45,2019
"0881021",12,0,0,12,100,0,0,2019
"0881059",15,5,26,46,32.61,10.87,56.52,2019
"0881155",61,8,53,122,50,6.56,43.44,2019
"0881222",119,10,32,161,73.91,6.21,19.88,2019
"0881233",384,13,52,449,85.52,2.9,11.58,2019
"0881244",144,2,42,188,76.6,1.06,22.34,2019
"1683283",56,0,4,60,93.33,0,6.67,2019
"1683325",253,0,43,296,85.47,0,14.53,2019
"1683539",615,24,237,876,70.21,2.74,27.05,2019
"3588312",1148,37,104,1289,89.06,2.87,8.07,2019
"3588336",49,0,48,97,50.52,0,49.48,2019
"3588338",35,0,0,35,100,0,0,2019
"3588410",20,0,29,49,40.82,0,59.18,2019
"3588419",36,2,2,40,90,5,5,2019
"3588042",113,0,48,161,70.19,0,29.81,2019
"3588072",373,0,223,596,62.58,0,37.42,2019
"3588113",30,0,7,37,81.08,0,18.92,2019
"1683327",248,16,74,338,73.37,4.73,21.89,2019
"1683340",1766,5,164,1935,91.27,0.26,8.48,2019
"1683301",17954,752,2641,21347,84.11,3.52,12.37,2019
"1683336",1541,45,265,1851,83.25,2.43,14.32,2019
"1683346",441,17,77,535,82.43,3.18,14.39,2019
"1683421",114,0,7,121,94.21,0,5.79,2019
"1683422",973,26,104,1103,88.21,2.36,9.43,2019
"1683428",175,0,21,196,89.29,0,10.71,2019
"1683434",521,3,57,581,89.67,0.52,9.81,2019
"1683448",531,27,75,633,83.89,4.27,11.85,2019
"1683464",84,2,41,127,66.14,1.57,32.28,2019
"1683466",108,0,29,137,78.83,0,21.17,2019
"1683501",11696,451,2313,14460,80.89,3.12,16,2019
"1683670",139,26,8,173,80.35,15.03,4.62,2019
"1683804",513,11,184,708,72.46,1.55,25.99,2019
"1683834",43,0,23,66,65.15,0,34.85,2019
"1683705",9394,389,2248,12031,78.08,3.23,18.69,2019
"1683812",9,0,15,24,37.5,0,62.5,2019
"1683813",445,0,0,445,100,0,0,2019
"1683815",12222,556,1565,14343,85.21,3.88,10.91,2019
"1683833",482,38,129,649,74.27,5.86,19.88,2019
"1683842",53,0,10,63,84.13,0,15.87,2019
"1683847",499,20,169,688,72.53,2.91,24.56,2019
"1683861",1864,150,510,2524,73.85,5.94,20.21,2019
"1683868",255,20,84,359,71.03,5.57,23.4,2019
"1683870",69,4,34,107,64.49,3.74,31.78,2019
"1683872",252,9,0,261,96.55,3.45,0,2019
"1683806",52,11,39,102,50.98,10.78,38.24,2019
"1683809",139,0,0,139,100,0,0,2019
"1683811",412,22,222,656,62.8,3.35,33.84,2019
"1683826",0,0,0,0,NA,NA,NA,2019
"1683850",600,32,177,809,74.17,3.96,21.88,2019
"1683867",178,29,0,207,85.99,14.01,0,2019
"1683873",494,40,270,804,61.44,4.98,33.58,2019
"1683821",98,0,17,115,85.22,0,14.78,2019
"1683823",460,5,151,616,74.68,0.81,24.51,2019
"1683535",317,6,118,441,71.88,1.36,26.76,2019
"1683552",341,11,106,458,74.45,2.4,23.14,2019
"1683553",361,25,103,489,73.82,5.11,21.06,2019
"1683601",12,0,0,12,100,0,0,2019
"1683607",7071,259,1124,8454,83.64,3.06,13.3,2019
"1683623",380,29,159,568,66.9,5.11,27.99,2019
"0690006",13215,1137,4985,19337,68.34,5.88,25.78,2019
"0690032",11265,210,2018,13493,83.49,1.56,14.96,2019
"0690042",18383,359,2275,21017,87.47,1.71,10.82,2019
"0690043",12807,881,3688,17376,73.71,5.07,21.22,2019
"0690047",13115,928,3850,17893,73.3,5.19,21.52,2019
"0690049",15845,188,687,16720,94.77,1.12,4.11,2019
"5554211",107,4,27,138,77.54,2.9,19.57,2019
"5554216",2235,92,406,2733,81.78,3.37,14.86,2019
"5554229",1806,6,146,1958,92.24,0.31,7.46,2019
"5554230",1441,72,320,1833,78.61,3.93,17.46,2019
"5554232",284,9,55,348,81.61,2.59,15.8,2019
"5554304",10013,373,1918,12304,81.38,3.03,15.59,2019
"5554407",528,8,61,597,88.44,1.34,10.22,2019
"5554414",1059,28,230,1317,80.41,2.13,17.46,2019
"5554417",20,0,0,20,100,0,0,2019
"5554422",223,8,164,395,56.46,2.03,41.52,2019
"5554448",1374,56,296,1726,79.61,3.24,17.15,2019
"5554459",412,16,118,546,75.46,2.93,21.61,2019
"5554484",1626,53,307,1986,81.87,2.67,15.46,2019
"5554538",1096,53,373,1522,72.01,3.48,24.51,2019
"5554539",525,21,58,604,86.92,3.48,9.6,2019
"5554541",378,19,92,489,77.3,3.89,18.81,2019
"5554603",5606,189,654,6449,86.93,2.93,10.14,2019
"5554625",87,0,32,119,73.11,0,26.89,2019
"5554914",11596,236,1264,13096,88.55,1.8,9.65,2019
"5554922",377,23,165,565,66.73,4.07,29.2,2019
"5554932",373,3,75,451,82.71,0.67,16.63,2019
"5554941",931,45,154,1130,82.39,3.98,13.63,2019
"5554942",3562,15,172,3749,95.01,0.4,4.59,2019
"5554944",2946,77,364,3387,86.98,2.27,10.75,2019
"5554948",80,0,37,117,68.38,0,31.62,2019
"5554963",2367,22,477,2866,82.59,0.77,16.64,2019
"5554968",976,30,241,1247,78.27,2.41,19.33,2019
"5554971",3556,107,837,4500,79.02,2.38,18.6,2019
"5554985",0,0,0,0,NA,NA,NA,2019
"5554909",703,22,118,843,83.39,2.61,14,2019
"5554915",15025,264,1741,17030,88.23,1.55,10.22,2019
"5554947",872,9,155,1036,84.17,0.87,14.96,2019
"5554822",1526,79,272,1877,81.3,4.21,14.49,2019
"5554159",475,8,80,563,84.37,1.42,14.21,2019
"5554165",2502,133,421,3056,81.87,4.35,13.78,2019
"5554170",1108,43,237,1388,79.83,3.1,17.07,2019
"5554632",386,11,72,469,82.3,2.35,15.35,2019
"5554635",588,16,156,760,77.37,2.11,20.53,2019
"5554636",4666,84,421,5171,90.23,1.62,8.14,2019
"5554644",506,0,78,584,86.64,0,13.36,2019
"5554950",780,43,323,1146,68.06,3.75,28.18,2019
"5554653",260,4,68,332,78.31,1.2,20.48,2019
"5554563",248,4,65,317,78.23,1.26,20.5,2019
"5554623",677,14,137,828,81.76,1.69,16.55,2019
"5554628",346,16,82,444,77.93,3.6,18.47,2019
"5554650",8675,222,1252,10149,85.48,2.19,12.34,2019
"5554657",114,4,29,147,77.55,2.72,19.73,2019
"5554670",373,16,141,530,70.38,3.02,26.6,2019
"5554720",2777,30,470,3277,84.74,0.92,14.34,2019
"5554723",381,8,111,500,76.2,1.6,22.2,2019
"5554745",704,29,176,909,77.45,3.19,19.36,2019
"5554748",370,29,113,512,72.27,5.66,22.07,2019
"5554749",404,21,99,524,77.1,4.01,18.89,2019
"2756723",271,14,52,337,80.42,4.15,15.43,2019
"2756020",46,0,4,50,92,0,8,2019
"2756021",380,7,45,432,87.96,1.62,10.42,2019
"2756023",180,2,54,236,76.27,0.85,22.88,2019
"2756034",163,0,33,196,83.16,0,16.84,2019
"2756039",261,2,75,338,77.22,0.59,22.19,2019
"0692840",13041,354,1670,15065,86.56,2.35,11.09,2019
"0692881",8894,119,553,9566,92.98,1.24,5.78,2019
"0692310",2506,33,169,2708,92.54,1.22,6.24,2019
"0692314",4058,67,293,4418,91.85,1.52,6.63,2019
"0692321",366,28,20,414,88.41,6.76,4.83,2019
"0692054",13556,363,1462,15381,88.13,2.36,9.51,2019
"0692056",17215,225,1555,18995,90.63,1.18,8.19,2019
"0695129",13164,90,656,13910,94.64,0.65,4.72,2019
"0695203",3888,173,1411,5472,71.05,3.16,25.79,2019
"0695205",6118,382,4202,10702,57.17,3.57,39.26,2019
"0695641",454,48,217,719,63.14,6.68,30.18,2019
"0695642",2822,61,264,3147,89.67,1.94,8.39,2019
"0695648",17273,744,1570,19587,88.19,3.8,8.02,2019
"0695661",10763,223,1045,12031,89.46,1.85,8.69,2019
"0695670",18446,521,1769,20736,88.96,2.51,8.53,2019
"0695683",2487,16,72,2575,96.58,0.62,2.8,2019
"0695688",12435,142,654,13231,93.98,1.07,4.94,2019
"0695701",292,4,51,347,84.15,1.15,14.7,2019
"0695715",18,7,11,36,50,19.44,30.56,2019
"0695721",0,0,0,0,NA,NA,NA,2019
"0695736",64,0,0,64,100,0,0,2019
"0695776",6873,60,662,7595,90.49,0.79,8.72,2019
"0695814",5254,277,1178,6709,78.31,4.13,17.56,2019
"0695832",2562,152,433,3147,81.41,4.83,13.76,2019
"0695837",117,0,2,119,98.32,0,1.68,2019
"0695612",368,22,34,424,86.79,5.19,8.02,2019
"0695614",1562,16,112,1690,92.43,0.95,6.63,2019
"0695636",508,0,37,545,93.21,0,6.79,2019
"0695675",127,0,90,217,58.53,0,41.47,2019
"0695685",1569,69,315,1953,80.34,3.53,16.13,2019
"0695687",20486,265,1469,22220,92.2,1.19,6.61,2019
"0695722",1852,72,124,2048,90.43,3.52,6.05,2019
"0695735",2,0,5,7,28.57,0,71.43,2019
"0695747",21750,375,1055,23180,93.83,1.62,4.55,2019
"0695820",10379,319,2266,12964,80.06,2.46,17.48,2019
"0695827",6090,239,963,7292,83.52,3.28,13.21,2019
"0695903",341,0,0,341,100,0,0,2019
"0695916",365,32,171,568,64.26,5.63,30.11,2019
"0695941",263,80,18,361,72.85,22.16,4.99,2019
"0695945",9174,322,1666,11162,82.19,2.88,14.93,2019
"0695954",4487,63,384,4934,90.94,1.28,7.78,2019
"0695962",494,0,132,626,78.91,0,21.09,2019
"0695969",8560,213,1188,9961,85.94,2.14,11.93,2019
"0695971",1903,71,454,2428,78.38,2.92,18.7,2019
"0695975",494,76,226,796,62.06,9.55,28.39,2019
"0695977",562,20,132,714,78.71,2.8,18.49,2019
"0695986",11,0,21,32,34.38,0,65.62,2019
"0695002",582,0,43,625,93.12,0,6.88,2019
"0695006",3747,60,185,3992,93.86,1.5,4.63,2019
"0695019",1420,91,578,2089,67.98,4.36,27.67,2019
"0695119",3150,21,38,3209,98.16,0.65,1.18,2019
"0695127",15028,275,1227,16530,90.91,1.66,7.42,2019
"0695128",12178,181,1419,13778,88.39,1.31,10.3,2019
"0880939",0,0,0,0,NA,NA,NA,2019
"0880951",1504,0,30,1534,98.04,0,1.96,2019
"0880443",1511,186,159,1856,81.41,10.02,8.57,2019
"0880515",313,30,31,374,83.69,8.02,8.29,2019
"0880290",0,0,0,0,NA,NA,NA,2019
"0880428",214,0,42,256,83.59,0,16.41,2019
"0881324",350,19,151,520,67.31,3.65,29.04,2019
"0881325",52,0,26,78,66.67,0,33.33,2019
"0881334",177,32,387,596,29.7,5.37,64.93,2019
"0881401",7377,273,1885,9535,77.37,2.86,19.77,2019
"0881527",671,10,83,764,87.83,1.31,10.86,2019
"0881632",2813,104,195,3112,90.39,3.34,6.27,2019
"0881653",0,0,9,9,0,0,100,2019
"0881655",11,0,0,11,100,0,0,2019
"0881001",8627,520,2768,11915,72.4,4.36,23.23,2019
"0881050",3069,140,1021,4230,72.55,3.31,24.14,2019
"0881062",267,1,47,315,84.76,0.32,14.92,2019
"0881063",511,38,142,691,73.95,5.5,20.55,2019
"0881040",75,47,71,193,38.86,24.35,36.79,2019
"0881003",4196,197,1369,5762,72.82,3.42,23.76,2019
"0881030",53,2,12,67,79.1,2.99,17.91,2019
"0881069",683,47,158,888,76.91,5.29,17.79,2019
"0881081",32,2,3,37,86.49,5.41,8.11,2019
"0881124",9,34,25,68,13.24,50,36.76,2019
"0881526",1886,68,229,2183,86.39,3.11,10.49,2019
"0881620",3000,195,251,3446,87.06,5.66,7.28,2019
"0881624",320,22,102,444,72.07,4.95,22.97,2019
"0881635",2242,41,296,2579,86.93,1.59,11.48,2019
"0881642",10,0,0,10,100,0,0,2019
"0881647",2190,50,246,2486,88.09,2.01,9.9,2019
"0881650",3974,72,765,4811,82.6,1.5,15.9,2019
"0881652",1568,26,154,1748,89.7,1.49,8.81,2019
"0881657",2163,78,141,2382,90.81,3.27,5.92,2019
"0881320",54,0,57,111,48.65,0,51.35,2019
"0881223",488,42,160,690,70.72,6.09,23.19,2019
"0881224",1166,14,70,1250,93.28,1.12,5.6,2019
"0881248",26,0,28,54,48.15,0,51.85,2019
"0881331",99,0,40,139,71.22,0,28.78,2019
"0881332",76,3,32,111,68.47,2.7,28.83,2019
"0881411",11,0,15,26,42.31,0,57.69,2019
"0881416",3719,152,1245,5116,72.69,2.97,24.34,2019
"0881419",1143,34,362,1539,74.27,2.21,23.52,2019
"0881423",596,0,97,693,86,0,14,2019
"0881601",4973,121,759,5853,84.96,2.07,12.97,2019
"0881610",61,13,42,116,52.59,11.21,36.21,2019
"0881637",2316,206,280,2802,82.66,7.35,9.99,2019
"0881638",28,0,5,33,84.85,0,15.15,2019
"0881641",1114,46,244,1404,79.34,3.28,17.38,2019
"0881646",77,5,9,91,84.62,5.49,9.89,2019
"0881649",75,3,23,101,74.26,2.97,22.77,2019
"0881006",3567,219,797,4583,77.83,4.78,17.39,2019
"0881036",408,3,67,478,85.36,0.63,14.02,2019
"0881058",284,3,123,410,69.27,0.73,30,2019
"0881073",628,18,204,850,73.88,2.12,24,2019
"0881084",21,1,44,66,31.82,1.52,66.67,2019
"0881090",312,16,102,430,72.56,3.72,23.72,2019
"0881123",333,0,66,399,83.46,0,16.54,2019
"0881126",75,0,29,104,72.12,0,27.88,2019
"0881132",858,74,481,1413,60.72,5.24,34.04,2019
"3588121",43,0,9,52,82.69,0,17.31,2019
"3588125",14,0,5,19,73.68,0,26.32,2019
"3588136",14,0,8,22,63.64,0,36.36,2019
"3588230",1072,86,478,1636,65.53,5.26,29.22,2019
"3588252",474,48,242,764,62.04,6.28,31.68,2019
"3588348",71,6,48,125,56.8,4.8,38.4,2019
"0690230",11140,706,1481,13327,83.59,5.3,11.11,2019
"0690249",7311,164,1351,8826,82.83,1.86,15.31,2019
"0690272",8364,97,263,8724,95.87,1.11,3.01,2019
"0690291",12702,403,587,13692,92.77,2.94,4.29,2019
"0690303",5637,210,1201,7048,79.98,2.98,17.04,2019
"0690403",11736,184,819,12739,92.13,1.44,6.43,2019
"0690502",5267,53,655,5975,88.15,0.89,10.96,2019
"0690603",5791,131,739,6661,86.94,1.97,11.09,2019
"0690604",10467,237,1728,12432,84.19,1.91,13.9,2019
"0690007",9031,619,2269,11919,75.77,5.19,19.04,2019
"0690015",7930,342,1998,10270,77.22,3.33,19.45,2019
"0690003",13179,692,3613,17484,75.38,3.96,20.66,2019
"0690020",13975,983,1438,16396,85.23,6,8.77,2019
"0690023",7727,620,3344,11691,66.09,5.3,28.6,2019
"0690027",19168,478,2022,21668,88.46,2.21,9.33,2019
"0690039",10504,235,946,11685,89.89,2.01,8.1,2019
"0690045",14224,150,1248,15622,91.05,0.96,7.99,2019
"0690046",26307,848,1870,29025,90.64,2.92,6.44,2019
"0690077",3057,67,49,3173,96.34,2.11,1.54,2019
"0690260",9199,309,1024,10532,87.34,2.93,9.72,2019
"0690262",11002,1683,2689,15374,71.56,10.95,17.49,2019
"0690263",0,0,0,0,NA,NA,NA,2019
"0690278",14162,194,956,15312,92.49,1.27,6.24,2019
"0690211",3336,50,275,3661,91.12,1.37,7.51,2019
"0690056",2799,207,406,3412,82.03,6.07,11.9,2019
"0690058",471,36,199,706,66.71,5.1,28.19,2019
"0690062",7854,235,1974,10063,78.05,2.34,19.62,2019
"0690220",9818,1269,2119,13206,74.34,9.61,16.05,2019
"0690222",5278,1130,1571,7979,66.15,14.16,19.69,2019
"0690255",14349,620,3608,18577,77.24,3.34,19.42,2019
"0690265",7067,65,259,7391,95.62,0.88,3.5,2019
"0690266",12647,215,565,13427,94.19,1.6,4.21,2019
"0690292",11796,393,417,12606,93.57,3.12,3.31,2019
"0690304",5477,189,917,6583,83.2,2.87,13.93,2019
"0690505",12823,240,929,13992,91.65,1.72,6.64,2019
"0690621",9271,306,789,10366,89.44,2.95,7.61,2019
"0690640",14615,339,3944,18898,77.34,1.79,20.87,2019
"0690650",22671,672,3621,26964,84.08,2.49,13.43,2019
"0690002",8828,351,3738,12917,68.34,2.72,28.94,2019
"0690005",12437,1014,3330,16781,74.11,6.04,19.84,2019
"0690011",16963,845,6625,24433,69.43,3.46,27.11,2019
"0690014",4184,88,1372,5644,74.13,1.56,24.31,2019
"0690026",22312,632,3101,26045,85.67,2.43,11.91,2019
"0690033",8964,394,3945,13303,67.38,2.96,29.65,2019
"0690038",9566,1033,1630,12229,78.22,8.45,13.33,2019
"0690040",2406,196,859,3461,69.52,5.66,24.82,2019
"0690044",21307,788,6934,29029,73.4,2.71,23.89,2019
"0690808",12825,263,828,13916,92.16,1.89,5.95,2019
"0690680",7806,178,1053,9037,86.38,1.97,11.65,2019
"0690701",3613,129,726,4468,80.86,2.89,16.25,2019
"0690802",17717,647,2392,20756,85.36,3.12,11.52,2019
"0690805",21898,824,4632,27354,80.05,3.01,16.93,2019
"0690004",17979,1949,2076,22004,81.71,8.86,9.43,2019
"0695514",13,36,11,60,21.67,60,18.33,2019
"0695550",30,0,10,40,75,0,25,2019
"0695567",619,18,105,742,83.42,2.43,14.15,2019
"0695602",6049,126,835,7010,86.29,1.8,11.91,2019
"0695603",10333,324,1415,12072,85.59,2.68,11.72,2019
"0695628",14653,230,1207,16090,91.07,1.43,7.5,2019
"2756042",263,10,41,314,83.76,3.18,13.06,2019
"2756362",1839,60,440,2339,78.62,2.57,18.81,2019
"2756364",1608,57,470,2135,75.32,2.67,22.01,2019
"2756377",6411,495,653,7559,84.81,6.55,8.64,2019
"2756436",27,2,4,33,81.82,6.06,12.12,2019
"2756441",1215,43,319,1577,77.05,2.73,20.23,2019
"2756442",1024,13,127,1164,87.97,1.12,10.91,2019
"2756450",355,17,87,459,77.34,3.7,18.95,2019
"2756453",292,13,59,364,80.22,3.57,16.21,2019
"2756456",16,0,7,23,69.57,0,30.43,2019
"2756464",1376,60,312,1748,78.72,3.43,17.85,2019
"2756525",29,0,8,37,78.38,0,21.62,2019
"2756533",99,15,17,131,75.57,11.45,12.98,2019
"2756547",745,28,186,959,77.69,2.92,19.4,2019
"2756566",127,10,57,194,65.46,5.15,29.38,2019
"2756571",625,42,135,802,77.93,5.24,16.83,2019
"2756586",670,30,110,810,82.72,3.7,13.58,2019
"2756589",567,33,172,772,73.45,4.27,22.28,2019
"2756590",105,3,20,128,82.03,2.34,15.62,2019
"2756592",150,2,29,181,82.87,1.1,16.02,2019
"2756162",79,2,22,103,76.7,1.94,21.36,2019
"2756212",181,12,38,231,78.35,5.19,16.45,2019
"2756270",343,15,98,456,75.22,3.29,21.49,2019
"2756339",356,12,93,461,77.22,2.6,20.17,2019
"2756024",1125,51,34,1210,92.98,4.21,2.81,2019
"2756071",3940,46,494,4480,87.95,1.03,11.03,2019
"2756113",69,2,11,82,84.15,2.44,13.41,2019
"2756147",72,0,11,83,86.75,0,13.25,2019
"2756230",232,9,53,294,78.91,3.06,18.03,2019
"2756001",16051,895,1808,18754,85.59,4.77,9.64,2019
"2756560",13848,743,2405,16996,81.48,4.37,14.15,2019
"2756636",1583,60,382,2025,78.17,2.96,18.86,2019
"2756724",27,12,23,62,43.55,19.35,37.1,2019
"2756741",0,0,0,0,NA,NA,NA,2019
"2756173",104,13,38,155,67.1,8.39,24.52,2019
"2756431",3193,130,873,4196,76.1,3.1,20.81,2019
"2756046",33,0,3,36,91.67,0,8.33,2019
"2756047",47,0,2,49,95.92,0,4.08,2019
"2756125",22,0,7,29,75.86,0,24.14,2019
"2756146",37,0,0,37,100,0,0,2019
"2756210",1,0,0,1,100,0,0,2019
"2756321",0,0,0,0,NA,NA,NA,2019
"2756363",42,6,9,57,73.68,10.53,15.79,2019
"2756389",31,0,9,40,77.5,0,22.5,2019
"2756541",8,0,0,8,100,0,0,2019
"2756577",3,0,0,3,100,0,0,2019
"2756591",41,2,9,52,78.85,3.85,17.31,2019
"2756593",0,0,0,0,NA,NA,NA,2019
"2756658",0,0,0,0,NA,NA,NA,2019
"2756668",35,3,3,41,85.37,7.32,7.32,2019
"2756141",101,7,21,129,78.29,5.43,16.28,2019
"2756160",82,1,13,96,85.42,1.04,13.54,2019
"2756303",8947,394,1511,10852,82.45,3.63,13.92,2019
"1950240",954,40,114,1108,86.1,3.61,10.29,2019
"1950249",387,6,136,529,73.16,1.13,25.71,2019
"1950256",129,0,52,181,71.27,0,28.73,2019
"1950258",311,41,71,423,73.52,9.69,16.78,2019
"1950268",310,14,113,437,70.94,3.2,25.86,2019
"1950278",268,8,45,321,83.49,2.49,14.02,2019
"0880824",81,3,14,98,82.65,3.06,14.29,2019
"0880118",2436,37,30,2503,97.32,1.48,1.2,2019
"0880007",4695,11,143,4849,96.82,0.23,2.95,2019
"0880013",23191,490,1301,24982,92.83,1.96,5.21,2019
"0880102",1623,77,315,2015,80.55,3.82,15.63,2019
"0880644",931,8,96,1035,89.95,0.77,9.28,2019
"0880726",172,7,18,197,87.31,3.55,9.14,2019
"0880421",3147,44,418,3609,87.2,1.22,11.58,2019
"0880423",37,6,12,55,67.27,10.91,21.82,2019
"0880011",13326,560,2857,16743,79.59,3.34,17.06,2019
"0880027",12153,251,551,12955,93.81,1.94,4.25,2019
"0880017",11770,297,900,12967,90.77,2.29,6.94,2019
"0880121",6613,311,406,7330,90.22,4.24,5.54,2019
"0880137",449,7,18,474,94.73,1.48,3.8,2019
"0880206",12257,484,790,13531,90.58,3.58,5.84,2019
"5682081",55,0,0,55,100,0,0,2019
"5682224",6,0,0,6,100,0,0,2019
"5682331",917,5,165,1087,84.36,0.46,15.18,2019
"5682421",107,0,23,130,82.31,0,17.69,2019
"5682223",280,18,80,378,74.07,4.76,21.16,2019
"5682053",408,2,43,453,90.07,0.44,9.49,2019
"5682082",500,56,66,622,80.39,9,10.61,2019
"5682243",20,0,26,46,43.48,0,56.52,2019
"5682321",245,9,69,323,75.85,2.79,21.36,2019
"5682325",382,7,89,478,79.92,1.46,18.62,2019
"5682401",2357,140,547,3044,77.43,4.6,17.97,2019
"5682422",8,0,0,8,100,0,0,2019
"5682001",13206,364,2061,15631,84.49,2.33,13.19,2019
"5682052",0,0,0,0,NA,NA,NA,2019
"5682084",0,0,7,7,0,0,100,2019
"5682212",232,5,36,273,84.98,1.83,13.19,2019
"5682213",106,3,98,207,51.21,1.45,47.34,2019
"5682336",73,0,15,88,82.95,0,17.05,2019
"5682411",151,21,6,178,84.83,11.8,3.37,2019
"5682412",153,8,17,178,85.96,4.49,9.55,2019
"5682523",313,13,39,365,85.75,3.56,10.68,2019
"5682601",9424,430,1562,11416,82.55,3.77,13.68,2019
"5682639",228,14,25,267,85.39,5.24,9.36,2019
"5682701",1640,153,337,2130,77,7.18,15.82,2019
"5682721",804,74,208,1086,74.03,6.81,19.15,2019
"5682801",9417,184,1704,11305,83.3,1.63,15.07,2019
"5682933",191,19,0,210,90.95,9.05,0,2019
"5682935",3977,235,398,4610,86.27,5.1,8.63,2019
"5682936",0,0,0,0,NA,NA,NA,2019
"5682834",2692,137,581,3410,78.94,4.02,17.04,2019
"5682845",13,0,0,13,100,0,0,2019
"5682901",8818,254,1112,10184,86.59,2.49,10.92,2019
"5682941",1454,53,154,1661,87.54,3.19,9.27,2019
"5682440",68,0,0,68,100,0,0,2019
"5682423",49,0,26,75,65.33,0,34.67,2019
"5682434",52,0,6,58,89.66,0,10.34,2019
"5682435",4333,139,463,4935,87.8,2.82,9.38,2019
"5682716",5980,98,775,6853,87.26,1.43,11.31,2019
"3587723",21,0,84,105,20,0,80,2019
"3587742",188,0,80,268,70.15,0,29.85,2019
"3587827",43,0,35,78,55.13,0,44.87,2019
"3587936",97,0,46,143,67.83,0,32.17,2019
"3587752",79,0,68,147,53.74,0,46.26,2019
"3587801",1740,196,876,2812,61.88,6.97,31.15,2019
"3588350",114,0,83,197,57.87,0,42.13,2019
"3588417",0,0,0,0,NA,NA,NA,2019
"3588055",22,0,6,28,78.57,0,21.43,2019
"3588318",138,3,27,168,82.14,1.79,16.07,2019
"3588415",679,21,422,1122,60.52,1.87,37.61,2019
"3588260",3670,121,822,4613,79.56,2.62,17.82,2019
"3588345",2571,260,431,3262,78.82,7.97,13.21,2019
"3588007",6661,357,1606,8624,77.24,4.14,18.62,2019
"3588028",89,11,5,105,84.76,10.48,4.76,2019
"3588032",21,16,98,135,15.56,11.85,72.59,2019
"3588034",0,0,17,17,0,0,100,2019
"3588046",288,0,144,432,66.67,0,33.33,2019
"3588081",2668,177,1486,4331,61.6,4.09,34.31,2019
"3588103",0,0,0,0,NA,NA,NA,2019
"3588203",7026,649,2966,10641,66.03,6.1,27.87,2019
"3588311",289,7,161,457,63.24,1.53,35.23,2019
"3588342",0,0,24,24,0,0,100,2019
"3588349",12,0,0,12,100,0,0,2019
"3588355",0,0,0,0,NA,NA,NA,2019
"3588130",4938,232,1101,6271,78.74,3.7,17.56,2019
"3588250",63,0,36,99,63.64,0,36.36,2019
"3588339",232,0,21,253,91.7,0,8.3,2019
"3588038",109,0,0,109,100,0,0,2019
"3588048",341,52,456,849,40.16,6.12,53.71,2019
"3588124",409,9,76,494,82.79,1.82,15.38,2019
"3588005",8169,270,2041,10480,77.95,2.58,19.48,2019
"3588118",83,0,40,123,67.48,0,32.52,2019
"3588263",39,0,14,53,73.58,0,26.42,2019
"1683709",18498,492,1775,20765,89.08,2.37,8.55,2019
"1683713",8983,395,1078,10456,85.91,3.78,10.31,2019
"1683714",8097,413,1814,10324,78.43,4,17.57,2019
"1683716",6028,185,412,6625,90.99,2.79,6.22,2019
"1683802",23,0,10,33,69.7,0,30.3,2019
"1683803",373,49,0,422,88.39,11.61,0,2019
"1683822",559,72,227,858,65.15,8.39,26.46,2019
"1683864",5813,262,1283,7358,79,3.56,17.44,2019
"1683824",76,3,19,98,77.55,3.06,19.39,2019
"1683839",480,0,166,646,74.3,0,25.7,2019
"1683851",458,53,146,657,69.71,8.07,22.22,2019
"1683452",644,1,39,684,94.15,0.15,5.7,2019
"1683522",513,31,161,705,72.77,4.4,22.84,2019
"1683541",358,6,83,447,80.09,1.34,18.57,2019
"1683549",132,70,130,332,39.76,21.08,39.16,2019
"1683617",4899,229,990,6118,80.08,3.74,16.18,2019
"1683622",859,46,101,1006,85.39,4.57,10.04,2019
"1683631",254,12,146,412,61.65,2.91,35.44,2019
"1683641",927,43,206,1176,78.83,3.66,17.52,2019
"1683651",9901,366,1628,11895,83.24,3.08,13.69,2019
"1683655",1358,21,190,1569,86.55,1.34,12.11,2019
"1683703",6265,156,927,7348,85.26,2.12,12.62,2019
"1683350",3733,66,712,4511,82.75,1.46,15.78,2019
"1683433",6,0,0,6,100,0,0,2019
"1683442",5991,209,530,6730,89.02,3.11,7.88,2019
"0693927",2871,65,1135,4071,70.52,1.6,27.88,2019
"0693035",8869,246,814,9929,89.32,2.48,8.2,2019
"0693067",260,0,0,260,100,0,0,2019
"0693203",3291,304,1685,5280,62.33,5.76,31.91,2019
"0693060",7440,149,2033,9622,77.32,1.55,21.13,2019
"0693065",21828,290,1763,23881,91.4,1.21,7.38,2019
"0486322",3345,120,722,4187,79.89,2.87,17.24,2019
"0486343",18,0,12,30,60,0,40,2019
"0486547",76,8,188,272,27.94,2.94,69.12,2019
"0486556",132,14,367,513,25.73,2.73,71.54,2019
"0486047",2503,170,1516,4189,59.75,4.06,36.19,2019
"0486003",0,0,15,15,0,0,100,2019
"0486011",58,43,0,101,57.43,42.57,0,2019
"0486028",0,0,0,0,NA,NA,NA,2019
"0486029",21,0,0,21,100,0,0,2019
"0486038",24,0,0,24,100,0,0,2019
"0486313",0,0,0,0,NA,NA,NA,2019
"0486315",2898,108,85,3091,93.76,3.49,2.75,2019
"0486329",334,0,89,423,78.96,0,21.04,2019
"0486409",9323,352,2029,11704,79.66,3.01,17.34,2019
"0486411",74,0,31,105,70.48,0,29.52,2019
"0486443",0,0,0,0,NA,NA,NA,2019
"0486445",128,0,19,147,87.07,0,12.93,2019
"0486020",65,2,484,551,11.8,0.36,87.84,2019
"0486015",121,0,0,121,100,0,0,2019
"0486331",170,3,59,232,73.28,1.29,25.43,2019
"0485256",1171,131,340,1642,71.32,7.98,20.71,2019
"0485282",20203,429,2202,22834,88.48,1.88,9.64,2019
"0485746",12668,164,1988,14820,85.48,1.11,13.41,2019
"0485750",10312,204,876,11392,90.52,1.79,7.69,2019
"0485920",175,13,58,246,71.14,5.28,23.58,2019
"0485923",188,19,42,249,75.5,7.63,16.87,2019
"0485924",954,16,232,1202,79.37,1.33,19.3,2019
"0485927",66,0,0,66,100,0,0,2019
"0485934",133,0,23,156,85.26,0,14.74,2019
"0485714",4014,186,1107,5307,75.64,3.5,20.86,2019
"0485911",131,11,270,412,31.8,2.67,65.53,2019
"0485928",326,0,81,407,80.1,0,19.9,2019
"0485930",107,4,155,266,40.23,1.5,58.27,2019
"0485937",1900,17,532,2449,77.58,0.69,21.72,2019
"0485940",454,0,68,522,86.97,0,13.03,2019
"0485941",851,36,1662,2549,33.39,1.41,65.2,2019
"0485338",14550,252,844,15646,93,1.61,5.39,2019
"0485339",12406,198,728,13332,93.05,1.49,5.46,2019
"0485348",744,102,480,1326,56.11,7.69,36.2,2019
"0485357",85,17,137,239,35.56,7.11,57.32,2019
"0485360",35,8,21,64,54.69,12.5,32.81,2019
"0485362",338,0,65,403,83.87,0,16.13,2019
"0485374",18765,522,2282,21569,87,2.42,10.58,2019
"0485379",13614,136,433,14183,95.99,0.96,3.05,2019
"0485382",13848,371,1221,15440,89.69,2.4,7.91,2019
"0485539",896,149,717,1762,50.85,8.46,40.69,2019
"0485543",876,3,247,1126,77.8,0.27,21.94,2019
"0485546",4665,114,1317,6096,76.53,1.87,21.6,2019
"0485553",486,23,416,925,52.54,2.49,44.97,2019
"0485602",3327,94,726,4147,80.23,2.27,17.51,2019
"0485007",3579,136,1572,5287,67.69,2.57,29.73,2019
"0485013",8523,123,1483,10129,84.14,1.21,14.64,2019
"0485027",13899,482,1405,15786,88.05,3.05,8.9,2019
"5683118",340,0,0,340,100,0,0,2019
"5683123",137,2,30,169,81.07,1.18,17.75,2019
"1683226",764,40,213,1017,75.12,3.93,20.94,2019
"1683639",1015,31,246,1292,78.56,2.4,19.04,2019
"5683011",64,0,0,64,100,0,0,2019
"1683211",1591,45,355,1991,79.91,2.26,17.83,2019
"1950453",238,8,29,275,86.55,2.91,10.55,2019
"1950476",244,4,52,300,81.33,1.33,17.33,2019
"1950840",158,5,46,209,75.6,2.39,22.01,2019
"1950845",212,4,74,290,73.1,1.38,25.52,2019
"1950846",315,0,128,443,71.11,0,28.89,2019
"1950146",150,0,46,196,76.53,0,23.47,2019
"1950107",337,34,78,449,75.06,7.57,17.37,2019
"1950124",1309,43,178,1530,85.56,2.81,11.63,2019
"1950140",796,64,188,1048,75.95,6.11,17.94,2019
"1950153",283,10,54,347,81.56,2.88,15.56,2019
"1950208",6443,140,1558,8141,79.14,1.72,19.14,2019
"1950229",280,0,33,313,89.46,0,10.54,2019
"1950234",143,4,45,192,74.48,2.08,23.44,2019
"1950482",328,3,32,363,90.36,0.83,8.82,2019
"1950532",283,16,28,327,86.54,4.89,8.56,2019
"1950533",1229,86,370,1685,72.94,5.1,21.96,2019
"1950538",183,3,37,223,82.06,1.35,16.59,2019
"1950540",360,7,75,442,81.45,1.58,16.97,2019
"1950843",167,0,40,207,80.68,0,19.32,2019
"1950830",498,33,151,682,73.02,4.84,22.14,2019
"1950853",250,9,40,299,83.61,3.01,13.38,2019
"1950854",840,18,214,1072,78.36,1.68,19.96,2019
"1950135",483,29,89,601,80.37,4.83,14.81,2019
"1950147",133,5,44,182,73.08,2.75,24.18,2019
"1950148",128,2,45,175,73.14,1.14,25.71,2019
"1950162",438,11,81,530,82.64,2.08,15.28,2019
"1950168",259,0,56,315,82.22,0,17.78,2019
"1950171",885,9,186,1080,81.94,0.83,17.22,2019
"1950252",53,0,36,89,59.55,0,40.45,2019
"1950273",2830,107,620,3557,79.56,3.01,17.43,2019
"1950276",643,42,132,817,78.7,5.14,16.16,2019
"1950277",118,6,19,143,82.52,4.2,13.29,2019
"1950421",1018,77,262,1357,75.02,5.67,19.31,2019
"1950423",857,19,330,1206,71.06,1.58,27.36,2019
"1950001",298,2,41,341,87.39,0.59,12.02,2019
"1950007",138,12,17,167,82.63,7.19,10.18,2019
"1950010",11630,2052,906,14588,79.72,14.07,6.21,2019
"1950014",8905,2985,553,12443,71.57,23.99,4.44,2019
"1950039",138,25,10,173,79.77,14.45,5.78,2019
"1950047",1819,91,357,2267,80.24,4.01,15.75,2019
"1950048",281,7,87,375,74.93,1.87,23.2,2019
"1950062",232,10,32,274,84.67,3.65,11.68,2019
"1950073",366,18,38,422,86.73,4.27,9,2019
"1950076",524,50,98,672,77.98,7.44,14.58,2019
"1950115",822,122,190,1134,72.49,10.76,16.75,2019
"1950120",145,0,17,162,89.51,0,10.49,2019
"1950123",235,13,96,344,68.31,3.78,27.91,2019
"1950125",6632,246,1042,7920,83.74,3.11,13.16,2019
"1950132",73,0,29,102,71.57,0,28.43,2019
"1950435",239,18,50,307,77.85,5.86,16.29,2019
"1950426",23,1,1,25,92,4,4,2019
"1950430",155,5,57,217,71.43,2.3,26.27,2019
"1950431",61,1,29,91,67.03,1.1,31.87,2019
"1952310",2149,67,344,2560,83.95,2.62,13.44,2019
"1952326",165,23,32,220,75,10.45,14.55,2019
"1952348",25,1,9,35,71.43,2.86,25.71,2019
"1952534",96,0,54,150,64,0,36,2019
"1952536",315,11,124,450,70,2.44,27.56,2019
"1952544",2309,133,868,3310,69.76,4.02,26.22,2019
"3587544",7177,167,587,7931,90.49,2.11,7.4,2019
"3587551",73,0,88,161,45.34,0,54.66,2019
"3587565",83,77,19,179,46.37,43.02,10.61,2019
"3587571",3339,147,1092,4578,72.94,3.21,23.85,2019
"3587577",93,0,56,149,62.42,0,37.58,2019
"3587582",151,0,175,326,46.32,0,53.68,2019
"3587701",4382,280,2982,7644,57.33,3.66,39.01,2019
"3587713",113,0,45,158,71.52,0,28.48,2019
"3587715",93,0,115,208,44.71,0,55.29,2019
"3587718",152,3,42,197,77.16,1.52,21.32,2019
"3587736",0,0,34,34,0,0,100,2019
"3587824",0,9,23,32,0,28.12,71.88,2019
"3587313",641,138,948,1727,37.12,7.99,54.89,2019
"3587326",101,2,396,499,20.24,0.4,79.36,2019
"3587328",185,27,505,717,25.8,3.77,70.43,2019
"3587402",3460,56,352,3868,89.45,1.45,9.1,2019
"3587511",509,0,188,697,73.03,0,26.97,2019
"3587543",55,0,0,55,100,0,0,2019
"3587558",147,5,35,187,78.61,2.67,18.72,2019
"3587573",32,0,0,32,100,0,0,2019
"3587579",181,5,68,254,71.26,1.97,26.77,2019
"3587580",138,0,87,225,61.33,0,38.67,2019
"3587711",103,0,163,266,38.72,0,61.28,2019
"3587728",108,12,38,158,68.35,7.59,24.05,2019
"3587732",229,0,214,443,51.69,0,48.31,2019
"3587734",71,0,39,110,64.55,0,35.45,2019
"3587753",16,0,19,35,45.71,0,54.29,2019
"3587933",38,0,0,38,100,0,0,2019
"3587828",62,3,24,89,69.66,3.37,26.97,2019
"3587829",220,43,49,312,70.51,13.78,15.71,2019
"3587930",171,0,135,306,55.88,0,44.12,2019
"3587940",107,38,58,203,52.71,18.72,28.57,2019
"3587010",425,4,92,521,81.57,0.77,17.66,2019
"3587029",79,0,58,137,57.66,0,42.34,2019
"3587035",1665,76,910,2651,62.81,2.87,34.33,2019
"3587047",1701,24,150,1875,90.72,1.28,8,2019
"3587052",136,14,415,565,24.07,2.48,73.45,2019
"3587064",15,0,34,49,30.61,0,69.39,2019
"3587070",25,0,0,25,100,0,0,2019
"3587072",74,2,102,178,41.57,1.12,57.3,2019
"3587111",21134,1080,2135,24349,86.8,4.44,8.77,2019
"3587122",6713,188,197,7098,94.58,2.65,2.78,2019
"3587301",5066,341,2450,7857,64.48,4.34,31.18,2019
"3587312",51,2,119,172,29.65,1.16,69.19,2019
"3587316",82,10,206,298,27.52,3.36,69.13,2019
"3587319",146,33,390,569,25.66,5.8,68.54,2019
"3587323",403,49,872,1324,30.44,3.7,65.86,2019
"3587327",925,70,903,1898,48.74,3.69,47.58,2019
"3587415",501,7,205,713,70.27,0.98,28.75,2019
"3587418",309,0,65,374,82.62,0,17.38,2019
"3587505",11540,243,2220,14003,82.41,1.74,15.85,2019
"3587516",37,3,5,45,82.22,6.67,11.11,2019
"3587517",221,0,11,232,95.26,0,4.74,2019
"0694553",17632,190,1139,18961,92.99,1,6.01,2019
"0694602",10554,258,1001,11813,89.34,2.18,8.47,2019
"0694608",12695,353,1320,14368,88.36,2.46,9.19,2019
"0694609",8872,172,871,9915,89.48,1.73,8.78,2019
"0694922",228,0,37,265,86.04,0,13.96,2019
"0694931",3054,78,131,3263,93.59,2.39,4.01,2019
"0693066",942,20,58,1020,92.35,1.96,5.69,2019
"0693105",10483,257,915,11655,89.94,2.21,7.85,2019
"0693208",82,0,3,85,96.47,0,3.53,2019
"0693215",7843,162,4331,12336,63.58,1.31,35.11,2019
"0693219",1625,3,909,2537,64.05,0.12,35.83,2019
"0693225",1633,25,284,1942,84.09,1.29,14.62,2019
"0693210",3900,178,621,4699,83,3.79,13.22,2019
"0693243",418,0,258,676,61.83,0,38.17,2019
"0693250",2238,46,1394,3678,60.85,1.25,37.9,2019
"0693257",16945,806,4513,22264,76.11,3.62,20.27,2019
"0693262",0,0,0,0,NA,NA,NA,2019
"0693615",990,111,448,1549,63.91,7.17,28.92,2019
"0693620",2146,66,545,2757,77.84,2.39,19.77,2019
"0693622",1831,191,726,2748,66.63,6.95,26.42,2019
"0693645",50,0,0,50,100,0,0,2019
"0693650",897,27,289,1213,73.95,2.23,23.83,2019
"0693512",101,4,25,130,77.69,3.08,19.23,2019
"0693516",650,123,193,966,67.29,12.73,19.98,2019
"0693523",1073,25,63,1161,92.42,2.15,5.43,2019
"0693527",523,27,130,680,76.91,3.97,19.12,2019
"0693531",122,0,10,132,92.42,0,7.58,2019
"0693534",9939,692,3530,14161,70.19,4.89,24.93,2019
"0693553",567,37,66,670,84.63,5.52,9.85,2019
"0693554",76,0,6,82,92.68,0,7.32,2019
"0693666",120,0,97,217,55.3,0,44.7,2019
"0693675",935,20,344,1299,71.98,1.54,26.48,2019
"0693721",1309,103,620,2032,64.42,5.07,30.51,2019
"0693722",21825,492,2971,25288,86.31,1.95,11.75,2019
"0693901",8232,188,1433,9853,83.55,1.91,14.54,2019
"0693920",416,19,111,546,76.19,3.48,20.33,2019
"0693950",6170,193,486,6849,90.09,2.82,7.1,2019
"0693239",144,40,145,329,43.77,12.16,44.07,2019
"0693241",2568,232,1222,4022,63.85,5.77,30.38,2019
"0693255",220,16,167,403,54.59,3.97,41.44,2019
"0693256",929,8,572,1509,61.56,0.53,37.91,2019
"0693280",3564,116,2575,6255,56.98,1.85,41.17,2019
"0693301",3871,112,715,4698,82.4,2.38,15.22,2019
"0693437",1014,8,0,1022,99.22,0.78,0,2019
"0693445",2164,54,244,2462,87.9,2.19,9.91,2019
"0693442",4222,179,655,5056,83.5,3.54,12.95,2019
"0693444",6646,92,508,7246,91.72,1.27,7.01,2019
"0693453",839,71,263,1173,71.53,6.05,22.42,2019
"0693463",3037,10,183,3230,94.02,0.31,5.67,2019
"0693514",5145,129,694,5968,86.21,2.16,11.63,2019
"0693529",138,49,0,187,73.8,26.2,0,2019
"0693541",139,0,27,166,83.73,0,16.27,2019
"0693549",97,0,37,134,72.39,0,27.61,2019
"0693562",611,33,131,775,78.84,4.26,16.9,2019
"0693268",4577,275,1568,6420,71.29,4.28,24.42,2019
"0693271",946,38,142,1126,84.01,3.37,12.61,2019
"0693954",84,1,31,116,72.41,0.86,26.72,2019
"0693955",9386,167,1270,10823,86.72,1.54,11.73,2019
"0693960",3227,22,849,4098,78.75,0.54,20.72,2019
"0691354",10093,73,278,10444,96.64,0.7,2.66,2019
"0691010",6580,128,1352,8060,81.64,1.59,16.77,2019
"0691203",5109,39,962,6110,83.62,0.64,15.74,2019
"0691340",7039,83,1764,8886,79.21,0.93,19.85,2019
"0691362",12549,258,712,13519,92.82,1.91,5.27,2019
"0691364",9910,203,535,10648,93.07,1.91,5.02,2019
"2649346",1740,22,382,2144,81.16,1.03,17.82,2019
"2649449",996,40,153,1189,83.77,3.36,12.87,2019
"2649454",1386,51,343,1780,77.87,2.87,19.27,2019
"2649461",2954,71,505,3530,83.68,2.01,14.31,2019
"2649618",224,6,61,291,76.98,2.06,20.96,2019
"2649633",1156,70,344,1570,73.63,4.46,21.91,2019
"2649639",632,21,223,876,72.15,2.4,25.46,2019
"2649665",1111,42,549,1702,65.28,2.47,32.26,2019
"2649644",638,20,295,953,66.95,2.1,30.95,2019
"2649660",4396,160,982,5538,79.38,2.89,17.73,2019
"2649668",992,37,287,1316,75.38,2.81,21.81,2019
"2649670",744,6,153,903,82.39,0.66,16.94,2019
"2649677",1950,166,710,2826,69,5.87,25.12,2019
"2649657",1066,51,219,1336,79.79,3.82,16.39,2019
"2649664",689,5,118,812,84.85,0.62,14.53,2019
"2649676",1300,36,190,1526,85.19,2.36,12.45,2019
"2649682",1430,24,222,1676,85.32,1.43,13.25,2019
"2649683",639,19,152,810,78.89,2.35,18.77,2019
"2649690",2328,78,406,2812,82.79,2.77,14.44,2019
"2649743",222,13,100,335,66.27,3.88,29.85,2019
"2649745",369,3,78,450,82,0.67,17.33,2019
"2649748",66,0,20,86,76.74,0,23.26,2019
"2649756",1367,37,400,1804,75.78,2.05,22.17,2019
"2649777",653,53,125,831,78.58,6.38,15.04,2019
"2649795",617,25,182,824,74.88,3.03,22.09,2019
"1951241",621,14,52,687,90.39,2.04,7.57,2019
"1951357",208,2,35,245,84.9,0.82,14.29,2019
"1951358",403,27,120,550,73.27,4.91,21.82,2019
"1951439",332,20,87,439,75.63,4.56,19.82,2019
"1951451",30,4,24,58,51.72,6.9,41.38,2019
"1951454",479,1,113,593,80.78,0.17,19.06,2019
"1951020",256,10,49,315,81.27,3.17,15.56,2019
"1951036",302,4,27,333,90.69,1.2,8.11,2019
"1951051",19,0,14,33,57.58,0,42.42,2019
"1951054",1773,37,163,1973,89.86,1.88,8.26,2019
"1951106",8460,417,1499,10376,81.53,4.02,14.45,2019
"1951237",553,39,115,707,78.22,5.52,16.27,2019
"1951250",2602,31,227,2860,90.98,1.08,7.94,2019
"1951008",62,2,3,67,92.54,2.99,4.48,2019
"1951014",148,0,32,180,82.22,0,17.78,2019
"1951027",372,6,86,464,80.17,1.29,18.53,2019
"1951031",4392,104,559,5055,86.88,2.06,11.06,2019
"1951034",598,32,151,781,76.57,4.1,19.33,2019
"1951039",945,48,96,1089,86.78,4.41,8.82,2019
"1951052",260,1,89,350,74.29,0.29,25.43,2019
"1951056",133,1,36,170,78.24,0.59,21.18,2019
"1951104",6877,430,1192,8499,80.92,5.06,14.03,2019
"1951109",993,34,226,1253,79.25,2.71,18.04,2019
"1951230",105,2,8,115,91.3,1.74,6.96,2019
"1951239",1021,35,51,1107,92.23,3.16,4.61,2019
"1951243",230,12,58,300,76.67,4,19.33,2019
"1951245",464,22,52,538,86.25,4.09,9.67,2019
"1951301",4508,162,838,5508,81.84,2.94,15.21,2019
"5554010",0,0,0,0,NA,NA,NA,2019
"5554307",0,0,0,0,NA,NA,NA,2019
"5554450",118,0,43,161,73.29,0,26.71,2019
"5554458",31,1,3,35,88.57,2.86,8.57,2019
"5554482",3379,124,737,4240,79.69,2.92,17.38,2019
"5554641",0,0,2,2,0,0,100,2019
"1952584",84,13,86,183,45.9,7.1,46.99,2019
"1952586",179,0,40,219,81.74,0,18.26,2019
"1952728",304,20,94,418,72.73,4.78,22.49,2019
"1952060",2811,89,792,3692,76.14,2.41,21.45,2019
"1952064",276,17,53,346,79.77,4.91,15.32,2019
"1952077",131,3,24,158,82.91,1.9,15.19,2019
"1952144",357,26,121,504,70.83,5.16,24.01,2019
"1952159",804,21,211,1036,77.61,2.03,20.37,2019
"1952160",257,0,128,385,66.75,0,33.25,2019
"1952041",509,46,100,655,77.71,7.02,15.27,2019
"1952163",120,7,31,158,75.95,4.43,19.62,2019
"1952172",1957,76,632,2665,73.43,2.85,23.71,2019
"1952201",520,8,21,549,94.72,1.46,3.83,2019
"1952206",823,17,78,918,89.65,1.85,8.5,2019
"1952222",179,19,57,255,70.2,7.45,22.35,2019
"1952241",7598,183,627,8408,90.37,2.18,7.46,2019
"1952246",8941,658,720,10319,86.65,6.38,6.98,2019
"1952253",1067,63,152,1282,83.23,4.91,11.86,2019
"1952301",1196,31,291,1518,78.79,2.04,19.17,2019
"1952307",24,0,55,79,30.38,0,69.62,2019
"1952316",501,6,175,682,73.46,0.88,25.66,2019
"1952066",22,2,8,32,68.75,6.25,25,2019
"1952166",35,0,19,54,64.81,0,35.19,2019
"1952211",946,50,182,1178,80.31,4.24,15.45,2019
"1952219",60,0,18,78,76.92,0,23.08,2019
"1952314",1728,51,65,1844,93.71,2.77,3.52,2019
"1952359",85,0,9,94,90.43,0,9.57,2019
"1952560",83,2,18,103,80.58,1.94,17.48,2019
"1952318",311,12,50,373,83.38,3.22,13.4,2019
"1952338",1159,40,61,1260,91.98,3.17,4.84,2019
"1952342",1059,43,305,1407,75.27,3.06,21.68,2019
"1952354",155,0,30,185,83.78,0,16.22,2019
"1952401",690,73,197,960,71.88,7.6,20.52,2019
"1952501",9167,348,2620,12135,75.54,2.87,21.59,2019
"1952306",505,8,96,609,82.92,1.31,15.76,2019
"1952356",809,31,148,988,81.88,3.14,14.98,2019
"1952655",1413,31,344,1788,79.03,1.73,19.24,2019
"1952212",99,0,29,128,77.34,0,22.66,2019
"1952313",108,3,14,125,86.4,2.4,11.2,2019
"1952355",112,0,16,128,87.5,0,12.5,2019
"1952158",113,2,28,143,79.02,1.4,19.58,2019
"1952345",492,14,40,546,90.11,2.56,7.33,2019
"1952349",2257,112,716,3085,73.16,3.63,23.21,2019
"1952353",3009,192,581,3782,79.56,5.08,15.36,2019
"1952361",1544,39,288,1871,82.52,2.08,15.39,2019
"1952405",9221,222,1202,10645,86.62,2.09,11.29,2019
"1952530",377,6,88,471,80.04,1.27,18.68,2019
"1952533",393,4,87,484,81.2,0.83,17.98,2019
"1952327",1045,14,203,1262,82.81,1.11,16.09,2019
"1952551",129,0,76,205,62.93,0,37.07,2019
"1952739",176,12,54,242,72.73,4.96,22.31,2019
"1952233",2583,32,419,3034,85.14,1.05,13.81,2019
"1952043",678,78,263,1019,66.54,7.65,25.81,2019
"5554421",940,15,351,1306,71.98,1.15,26.88,2019
"5554202",516,13,128,657,78.54,1.98,19.48,2019
"5554246",330,19,58,407,81.08,4.67,14.25,2019
"5554428",434,7,72,513,84.6,1.36,14.04,2019
"5554435",622,17,220,859,72.41,1.98,25.61,2019
"5554436",527,16,240,783,67.31,2.04,30.65,2019
"0694946",238,24,29,291,81.79,8.25,9.97,2019
"0694950",51,0,0,51,100,0,0,2019
"0694973",554,0,98,652,84.97,0,15.03,2019
"0694555",11152,114,417,11683,95.45,0.98,3.57,2019
"0694571",4565,89,557,5211,87.6,1.71,10.69,2019
"0694576",47,0,0,47,100,0,0,2019
"0694591",17193,268,1096,18557,92.65,1.44,5.91,2019
"0694595",8411,558,792,9761,86.17,5.72,8.11,2019
"0694596",9095,103,724,9922,91.66,1.04,7.3,2019
"0694598",9967,162,229,10358,96.23,1.56,2.21,2019
"0694606",12378,499,2383,15260,81.11,3.27,15.62,2019
"0694610",14139,336,736,15211,92.95,2.21,4.84,2019
"0694618",6817,183,156,7156,95.26,2.56,2.18,2019
"0694703",8142,142,390,8674,93.87,1.64,4.5,2019
"0694705",5385,147,255,5787,93.05,2.54,4.41,2019
"0694937",338,0,64,402,84.08,0,15.92,2019
"0694940",77,10,26,113,68.14,8.85,23.01,2019
"0694965",5409,211,330,5950,90.91,3.55,5.55,2019
"0694558",21419,471,2034,23924,89.53,1.97,8.5,2019
"0694564",6168,72,517,6757,91.28,1.07,7.65,2019
"0694015",18243,383,1669,20295,89.89,1.89,8.22,2019
"0694027",2223,33,62,2318,95.9,1.42,2.67,2019
"0694038",1055,0,102,1157,91.18,0,8.82,2019
"0694041",5799,181,258,6238,92.96,2.9,4.14,2019
"0692066",176,5,39,220,80,2.27,17.73,2019
"0692091",622,16,0,638,97.49,2.51,0,2019
"0692103",16712,243,1318,18273,91.46,1.33,7.21,2019
"0692113",10033,255,3293,13581,73.88,1.88,24.25,2019
"0692116",15261,143,913,16317,93.53,0.88,5.6,2019
"0692118",7665,166,604,8435,90.87,1.97,7.16,2019
"0692060",69,20,0,89,77.53,22.47,0,2019
"0692075",5007,46,246,5299,94.49,0.87,4.64,2019
"0692083",9989,244,1041,11274,88.6,2.16,9.23,2019
"0692084",13341,193,1343,14877,89.68,1.3,9.03,2019
"0692104",19258,433,1386,21077,91.37,2.05,6.58,2019
"0692325",2755,168,231,3154,87.35,5.33,7.32,2019
"0692333",176,19,16,211,83.41,9,7.58,2019
"0692336",23102,696,1281,25079,92.12,2.78,5.11,2019
"0692365",768,8,306,1082,70.98,0.74,28.28,2019
"0692389",43,7,52,102,42.16,6.86,50.98,2019
"0692398",530,32,114,676,78.4,4.73,16.86,2019
"0692606",8793,195,220,9208,95.49,2.12,2.39,2019
"0692802",9826,246,1455,11527,85.24,2.13,12.62,2019
"0692501",5848,176,675,6699,87.3,2.63,10.08,2019
"0692508",9520,58,432,10010,95.1,0.58,4.32,2019
"0692518",393,16,74,483,81.37,3.31,15.32,2019
"0692705",13491,187,1060,14738,91.54,1.27,7.19,2019
"0692883",9862,106,565,10533,93.63,1.01,5.36,2019
"0692536",886,48,153,1087,81.51,4.42,14.08,2019
"0692557",12751,223,927,13901,91.73,1.6,6.67,2019
"0692571",11283,361,1202,12846,87.83,2.81,9.36,2019
"0692582",3516,108,395,4019,87.48,2.69,9.83,2019
"0692584",14159,147,668,14974,94.56,0.98,4.46,2019
"0695130",4587,124,424,5135,89.33,2.41,8.26,2019
"0695138",6001,53,91,6145,97.66,0.86,1.48,2019
"0695210",9814,331,1784,11929,82.27,2.77,14.96,2019
"0695233",155,0,30,185,83.78,0,16.22,2019
"0695237",1057,42,170,1269,83.29,3.31,13.4,2019
"0695255",380,0,223,603,63.02,0,36.98,2019
"0691202",7558,86,1259,8903,84.89,0.97,14.14,2019
"0691207",3583,40,458,4081,87.8,0.98,11.22,2019
"0691208",5444,44,367,5855,92.98,0.75,6.27,2019
"0691214",9718,169,470,10357,93.83,1.63,4.54,2019
"0691307",8023,111,516,8650,92.75,1.28,5.97,2019
"0691311",13352,197,734,14283,93.48,1.38,5.14,2019
"0691344",15595,284,1158,17037,91.54,1.67,6.8,2019
"0691730",21864,545,1606,24015,91.04,2.27,6.69,2019
"0691764",13789,439,2254,16482,83.66,2.66,13.68,2019
"0691775",7333,191,589,8113,90.39,2.35,7.26,2019
"0691790",10920,188,1146,12254,89.11,1.53,9.35,2019
"0691977",17277,324,1553,19154,90.2,1.69,8.11,2019
"0691020",3019,125,380,3524,85.67,3.55,10.78,2019
"0691030",9147,90,578,9815,93.19,0.92,5.89,2019
"0691104",10844,326,1994,13164,82.38,2.48,15.15,2019
"0691205",10995,242,3145,14382,76.45,1.68,21.87,2019
"0691007",10375,118,1164,11657,89,1.01,9.99,2019
"0691042",7789,678,1494,9961,78.19,6.81,15,2019
"0691206",11209,110,2053,13372,83.82,0.82,15.35,2019
"0691301",8765,107,423,9295,94.3,1.15,4.55,2019
"0691320",14250,74,647,14971,95.18,0.49,4.32,2019
"0691321",9205,206,1370,10781,85.38,1.91,12.71,2019
"0691350",10835,164,403,11402,95.03,1.44,3.53,2019
"0691351",9284,152,640,10076,92.14,1.51,6.35,2019
"0691361",8054,133,369,8556,94.13,1.55,4.31,2019
"0691601",11727,1881,3102,16710,70.18,11.26,18.56,2019
"0691606",11286,1011,3104,15401,73.28,6.56,20.15,2019
"0691732",12724,282,3060,16066,79.2,1.76,19.05,2019
"0691755",7285,95,1285,8665,84.07,1.1,14.83,2019
"0691801",17512,270,2283,20065,87.28,1.35,11.38,2019
"0691803",8396,91,1157,9644,87.06,0.94,12,2019
"0691786",15967,437,2703,19107,83.57,2.29,14.15,2019
"0691789",12682,120,546,13348,95.01,0.9,4.09,2019
"0691791",8657,91,1332,10080,85.88,0.9,13.21,2019
"0691360",13494,335,1126,14955,90.23,2.24,7.53,2019
"0691040",6312,242,785,7339,86.01,3.3,10.7,2019
"0691352",9921,430,2085,12436,79.78,3.46,16.77,2019
"0691101",8765,467,1507,10739,81.62,4.35,14.03,2019
"3289506",13018,223,1443,14684,88.65,1.52,9.83,2019
"3289511",10069,302,770,11141,90.38,2.71,6.91,2019
"3289828",181,0,0,181,100,0,0,2019
"3289832",267,61,160,488,54.71,12.5,32.79,2019
"3289001",487,0,57,544,89.52,0,10.48,2019
"3289011",9157,194,1101,10452,87.61,1.86,10.53,2019
"3289018",177,4,140,321,55.14,1.25,43.61,2019
"3289043",303,22,191,516,58.72,4.26,37.02,2019
"3289052",20192,559,1230,21981,91.86,2.54,5.6,2019
"3289108",20964,1369,4707,27040,77.53,5.06,17.41,2019
"0695476",13828,149,1355,15332,90.19,0.97,8.84,2019
"0695485",861,24,194,1079,79.8,2.22,17.98,2019
"0695524",611,10,117,738,82.79,1.36,15.85,2019
"0695492",8918,176,663,9757,91.4,1.8,6.8,2019
"0695501",8315,304,1516,10135,82.04,3,14.96,2019
"0881143",199,0,129,328,60.67,0,39.33,2019
"0881147",4664,123,754,5541,84.17,2.22,13.61,2019
"0881211",2522,70,545,3137,80.4,2.23,17.37,2019
"0881008",3783,151,607,4541,83.31,3.33,13.37,2019
"0881024",61,36,42,139,43.88,25.9,30.22,2019
"0881025",222,5,63,290,76.55,1.72,21.72,2019
"5554643",1,0,2,3,33.33,0,66.67,2019
"5554765",6,0,0,6,100,0,0,2019
"5554931",95,0,4,99,95.96,0,4.04,2019
"5554220",13768,513,3011,17292,79.62,2.97,17.41,2019
"5554408",331,14,93,438,75.57,3.2,21.23,2019
"5554471",563,7,108,678,83.04,1.03,15.93,2019
"5554610",628,8,110,746,84.18,1.07,14.75,2019
"5554986",1863,89,329,2281,81.67,3.9,14.42,2019
"5554946",0,0,0,0,NA,NA,NA,2019
"5554913",7805,139,534,8478,92.06,1.64,6.3,2019
"5554928",110,0,34,144,76.39,0,23.61,2019
"5554933",130,6,23,159,81.76,3.77,14.47,2019
"5554949",1115,38,259,1412,78.97,2.69,18.34,2019
"5554961",4727,204,914,5845,80.87,3.49,15.64,2019
"5554979",487,7,70,564,86.35,1.24,12.41,2019
"5554661",1390,10,197,1597,87.04,0.63,12.34,2019
"5554664",472,9,154,635,74.33,1.42,24.25,2019
"5554703",15227,544,1714,17485,87.09,3.11,9.8,2019
"5554721",443,4,116,563,78.69,0.71,20.6,2019
"5554729",11805,277,1475,13557,87.08,2.04,10.88,2019
"5554746",231,3,45,279,82.8,1.08,16.13,2019
"5554751",7761,461,1310,9532,81.42,4.84,13.74,2019
"5554755",2453,57,486,2996,81.88,1.9,16.22,2019
"5554759",541,8,110,659,82.09,1.21,16.69,2019
"5554801",2303,149,589,3041,75.73,4.9,19.37,2019
"5554829",1649,161,398,2208,74.68,7.29,18.03,2019
"5554836",344,16,48,408,84.31,3.92,11.76,2019
"5554462",135,0,58,193,69.95,0,30.05,2019
"5554465",202,12,78,292,69.18,4.11,26.71,2019
"5554470",645,22,179,846,76.24,2.6,21.16,2019
"5554473",827,18,212,1057,78.24,1.7,20.06,2019
"5554480",446,8,118,572,77.97,1.4,20.63,2019
"5554481",10036,236,1270,11542,86.95,2.04,11,2019
"5554490",231,14,102,347,66.57,4.03,29.39,2019
"5554498",573,17,271,861,66.55,1.97,31.48,2019
"5554512",390,10,54,454,85.9,2.2,11.89,2019
"5554521",3001,140,676,3817,78.62,3.67,17.71,2019
"5554545",357,21,53,431,82.83,4.87,12.3,2019
"5554547",512,29,140,681,75.18,4.26,20.56,2019
"5554565",13,0,9,22,59.09,0,40.91,2019
"5554566",406,66,168,640,63.44,10.31,26.25,2019
"5554614",855,19,213,1087,78.66,1.75,19.6,2019
"5554618",732,15,112,859,85.22,1.75,13.04,2019
"5554619",841,21,372,1234,68.15,1.7,30.15,2019
"5554624",503,14,122,639,78.72,2.19,19.09,2019
"5554630",1425,42,277,1744,81.71,2.41,15.88,2019
"5554638",446,8,136,590,75.59,1.36,23.05,2019
"5554645",31,4,9,44,70.45,9.09,20.45,2019
"5554652",243,9,136,388,62.63,2.32,35.05,2019
"5554658",933,23,169,1125,82.93,2.04,15.02,2019
"5554665",2703,99,802,3604,75,2.75,22.25,2019
"5554728",1922,133,528,2583,74.41,5.15,20.44,2019
"5554733",348,31,77,456,76.32,6.8,16.89,2019
"2756545",208,23,76,307,67.75,7.49,24.76,2019
"2756554",907,21,160,1088,83.36,1.93,14.71,2019
"2756569",350,7,125,482,72.61,1.45,25.93,2019
"2756628",588,20,168,776,75.77,2.58,21.65,2019
"2756659",25,1,1,27,92.59,3.7,3.7,2019
"2756669",111,7,25,143,77.62,4.9,17.48,2019
"5554441",310,7,29,346,89.6,2.02,8.38,2019
"5554488",351,13,103,467,75.16,2.78,22.06,2019
"5554494",9749,304,1714,11767,82.85,2.58,14.57,2019
"5554537",152,13,34,199,76.38,6.53,17.09,2019
"5554548",1936,41,187,2164,89.46,1.89,8.64,2019
"5554552",1596,120,440,2156,74.03,5.57,20.41,2019
"5554555",1803,106,487,2396,75.25,4.42,20.33,2019
"5554556",444,13,130,587,75.64,2.21,22.15,2019
"5554568",1765,251,400,2416,73.05,10.39,16.56,2019
"5554601",16693,804,2746,20243,82.46,3.97,13.57,2019
"5554613",600,23,241,864,69.44,2.66,27.89,2019
"5554667",1428,42,340,1810,78.9,2.32,18.78,2019
"5554725",991,24,173,1188,83.42,2.02,14.56,2019
"5554732",885,33,291,1209,73.2,2.73,24.07,2019
"5554734",249,21,58,328,75.91,6.4,17.68,2019
"5554736",1391,37,272,1700,81.82,2.18,16,2019
"5554738",1018,33,184,1235,82.43,2.67,14.9,2019
"5554739",1708,49,133,1890,90.37,2.59,7.04,2019
"5554741",440,31,202,673,65.38,4.61,30.01,2019
"5554762",379,42,79,500,75.8,8.4,15.8,2019
"5554821",490,18,113,621,78.9,2.9,18.2,2019
"5554437",781,26,309,1116,69.98,2.33,27.69,2019
"5554451",3860,71,1048,4979,77.53,1.43,21.05,2019
"5554454",407,21,111,539,75.51,3.9,20.59,2019
"5554466",962,27,202,1191,80.77,2.27,16.96,2019
"5554479",1163,39,299,1501,77.48,2.6,19.92,2019
"5554501",6905,123,1415,8443,81.78,1.46,16.76,2019
"5554520",1366,134,357,1857,73.56,7.22,19.22,2019
"5554524",225,14,41,280,80.36,5,14.64,2019
"5554542",132,20,77,229,57.64,8.73,33.62,2019
"5554546",366,12,148,526,69.58,2.28,28.14,2019
"5554002",1952,127,568,2647,73.74,4.8,21.46,2019
"5554005",989,52,211,1252,78.99,4.15,16.85,2019
"5554009",876,23,142,1041,84.15,2.21,13.64,2019
"5554827",139,4,23,166,83.73,2.41,13.86,2019
"5554845",30,0,10,40,75,0,25,2019
"5554850",104,1,10,115,90.43,0.87,8.7,2019
"5554857",19,3,0,22,86.36,13.64,0,2019
"5554861",32,8,28,68,47.06,11.76,41.18,2019
"5554867",183,6,52,241,75.93,2.49,21.58,2019
"5554868",5372,375,1083,6830,78.65,5.49,15.86,2019
"5554895",325,28,122,475,68.42,5.89,25.68,2019
"5554930",545,9,158,712,76.54,1.26,22.19,2019
"5554960",917,33,254,1204,76.16,2.74,21.1,2019
"5554965",447,16,91,554,80.69,2.89,16.43,2019
"5554980",37,0,13,50,74,0,26,2019
"5554983",1478,60,308,1846,80.07,3.25,16.68,2019
"5554101",932,30,135,1097,84.96,2.73,12.31,2019
"5554103",144,2,56,202,71.29,0.99,27.72,2019
"5554120",66,5,46,117,56.41,4.27,39.32,2019
"5554121",996,78,268,1342,74.22,5.81,19.97,2019
"5554128",546,13,122,681,80.18,1.91,17.91,2019
"5554136",2188,33,422,2643,82.78,1.25,15.97,2019
"0881091",247,0,90,337,73.29,0,26.71,2019
"0881151",554,18,85,657,84.32,2.74,12.94,2019
"0881120",603,27,400,1030,58.54,2.62,38.83,2019
"0881121",116,5,36,157,73.89,3.18,22.93,2019
"0881122",2627,371,555,3553,73.94,10.44,15.62,2019
"0881201",3420,177,563,4160,82.21,4.25,13.53,2019
"0695257",129,0,26,155,83.23,0,16.77,2019
"0695306",276,0,82,358,77.09,0,22.91,2019
"0695307",10698,262,1629,12589,84.98,2.08,12.94,2019
"0695316",1967,52,218,2237,87.93,2.32,9.75,2019
"0695335",0,71,27,98,0,72.45,27.55,2019
"0695336",13480,311,1686,15477,87.1,2.01,10.89,2019
"0695350",16548,365,2919,19832,83.44,1.84,14.72,2019
"0695430",7,0,0,7,100,0,0,2019
"0695452",397,30,56,483,82.19,6.21,11.59,2019
"0695521",7440,144,747,8331,89.31,1.73,8.97,2019
"0695528",428,5,66,499,85.77,1,13.23,2019
"0695540",4302,185,915,5402,79.64,3.42,16.94,2019
"0695552",247,17,120,384,64.32,4.43,31.25,2019
"0695560",508,47,96,651,78.03,7.22,14.75,2019
"0695606",43,2,53,98,43.88,2.04,54.08,2019
"0695629",184,18,148,350,52.57,5.14,42.29,2019
"0695633",1171,15,190,1376,85.1,1.09,13.81,2019
"0695637",76,0,21,97,78.35,0,21.65,2019
"0695662",11125,271,851,12247,90.84,2.21,6.95,2019
"0695667",11995,289,2051,14335,83.68,2.02,14.31,2019
"0695678",14475,320,1359,16154,89.61,1.98,8.41,2019
"0695682",10158,110,1041,11309,89.82,0.97,9.21,2019
"0695823",19713,581,3416,23710,83.14,2.45,14.41,2019
"0695825",14416,329,1659,16404,87.88,2.01,10.11,2019
"0695826",13524,485,1205,15214,88.89,3.19,7.92,2019
"0695920",87,0,44,131,66.41,0,33.59,2019
"0695925",129,0,13,142,90.85,0,9.15,2019
"0695674",204,3,47,254,80.31,1.18,18.5,2019
"0695659",312,13,66,391,79.8,3.32,16.88,2019
"0695668",182,11,42,235,77.45,4.68,17.87,2019
"0695669",773,33,78,884,87.44,3.73,8.82,2019
"0695717",49,20,18,87,56.32,22.99,20.69,2019
"0695720",39,0,9,48,81.25,0,18.75,2019
"0695828",15173,477,2202,17852,84.99,2.67,12.33,2019
"0695830",185,7,66,258,71.71,2.71,25.58,2019
"0695842",9852,238,1359,11449,86.05,2.08,11.87,2019
"0695901",9575,330,1829,11734,81.6,2.81,15.59,2019
"0695919",384,9,91,484,79.34,1.86,18.8,2019
"0695928",12653,439,1381,14473,87.42,3.03,9.54,2019
"0695943",276,0,49,325,84.92,0,15.08,2019
"0695957",244,17,52,313,77.96,5.43,16.61,2019
"0695973",12564,286,1369,14219,88.36,2.01,9.63,2019
"0695630",26357,377,1102,27836,94.69,1.35,3.96,2019
"0695639",114,0,0,114,100,0,0,2019
"0691766",15487,272,2228,17987,86.1,1.51,12.39,2019
"0691767",11886,248,1931,14065,84.51,1.76,13.73,2019
"0691770",13907,296,2445,16648,83.54,1.78,14.69,2019
"0691776",10248,75,1390,11713,87.49,0.64,11.87,2019
"0691911",20706,473,3505,24684,83.88,1.92,14.2,2019
"0691941",10587,154,833,11574,91.47,1.33,7.2,2019
"0691963",182,0,78,260,70,0,30,2019
"0691980",0,0,0,0,NA,NA,NA,2019
"0691367",17180,292,961,18433,93.2,1.58,5.21,2019
"5682725",202,0,0,202,100,0,0,2019
"5682838",95,0,38,133,71.43,0,28.57,2019
"5682922",75,0,90,165,45.45,0,54.55,2019
"5682942",35,0,0,35,100,0,0,2019
"5682050",64,0,12,76,84.21,0,15.79,2019
"5682944",34,0,0,34,100,0,0,2019
"0881027",53,0,22,75,70.67,0,29.33,2019
"0881033",36,0,17,53,67.92,0,32.08,2019
"0881044",111,2,33,146,76.03,1.37,22.6,2019
"0881049",92,6,16,114,80.7,5.26,14.04,2019
"0881005",10000,299,2306,12605,79.33,2.37,18.29,2019
"0881023",342,17,143,502,68.13,3.39,28.49,2019
"0881524",630,0,72,702,89.74,0,10.26,2019
"0881640",49,0,34,83,59.04,0,40.96,2019
"0881643",195,11,42,248,78.63,4.44,16.94,2019
"0881082",3921,289,1274,5484,71.5,5.27,23.23,2019
"0881226",2159,54,321,2534,85.2,2.13,12.67,2019
"0881327",125,39,49,213,58.69,18.31,23,2019
"0881432",1218,55,100,1373,88.71,4.01,7.28,2019
"0881077",264,11,22,297,88.89,3.7,7.41,2019
"0881241",41,0,5,46,89.13,0,10.87,2019
"0881043",19,0,3,22,86.36,0,13.64,2019
"0881064",95,6,22,123,77.24,4.88,17.89,2019
"0881133",362,18,75,455,79.56,3.96,16.48,2019
"0881140",625,27,182,834,74.94,3.24,21.82,2019
"0881144",1934,106,818,2858,67.67,3.71,28.62,2019
"0881221",85,2,31,118,72.03,1.69,26.27,2019
"0881326",584,37,216,837,69.77,4.42,25.81,2019
"0881410",510,10,165,685,74.45,1.46,24.09,2019
"0881413",1656,102,377,2135,77.56,4.78,17.66,2019
"0881427",400,31,78,509,78.59,6.09,15.32,2019
"0881523",389,0,0,389,100,0,0,2019
"0881525",366,0,75,441,82.99,0,17.01,2019
"0881004",7311,664,2925,10900,67.07,6.09,26.83,2019
"0881041",208,0,116,324,64.2,0,35.8,2019
"0881087",41,0,18,59,69.49,0,30.51,2019
"0881125",795,112,426,1333,59.64,8.4,31.96,2019
"0881141",349,13,121,483,72.26,2.69,25.05,2019
"0881212",9580,367,1456,11403,84.01,3.22,12.77,2019
"0881230",3517,240,387,4144,84.87,5.79,9.34,2019
"0881235",262,6,77,345,75.94,1.74,22.32,2019
"0881236",620,21,57,698,88.83,3.01,8.17,2019
"0881240",1287,97,121,1505,85.51,6.45,8.04,2019
"0881243",35,0,5,40,87.5,0,12.5,2019
"0881301",10173,518,1505,12196,83.41,4.25,12.34,2019
"0881321",4289,321,1389,5999,71.5,5.35,23.15,2019
"0881435",2022,171,178,2371,85.28,7.21,7.51,2019
"0881501",8147,299,1487,9933,82.02,3.01,14.97,2019
"0881506",4339,222,956,5517,78.65,4.02,17.33,2019
"0881654",486,19,38,543,89.5,3.5,7,2019
"0881019",370,26,125,521,71.02,4.99,23.99,2019
"0485132",7075,223,791,8089,87.46,2.76,9.78,2019
"0485135",68,10,96,174,39.08,5.75,55.17,2019
"0485137",527,98,323,948,55.59,10.34,34.07,2019
"0485138",11062,339,495,11896,92.99,2.85,4.16,2019
"0485139",4722,225,681,5628,83.9,4,12.1,2019
"0485140",13543,296,593,14432,93.84,2.05,4.11,2019
"0485141",66,4,58,128,51.56,3.12,45.31,2019
"0485142",20060,668,709,21437,93.58,3.12,3.31,2019
"1683445",2073,72,370,2515,82.43,2.86,14.71,2019
"1683450",256,7,31,294,87.07,2.38,10.54,2019
"1683462",180,13,27,220,81.82,5.91,12.27,2019
"1683530",1540,50,446,2036,75.64,2.46,21.91,2019
"1683542",39,0,25,64,60.94,0,39.06,2019
"1683545",155,3,43,201,77.11,1.49,21.39,2019
"2756670",180,0,105,285,63.16,0,36.84,2019
"2756684",79,2,28,109,72.48,1.83,25.69,2019
"2756714",312,118,77,507,61.54,23.27,15.19,2019
"2756467",905,37,115,1057,85.62,3.5,10.88,2019
"2756470",3452,224,756,4432,77.89,5.05,17.06,2019
"2756472",2706,76,401,3183,85.01,2.39,12.6,2019
"2756473",1163,42,254,1459,79.71,2.88,17.41,2019
"2756479",1768,59,351,2178,81.18,2.71,16.12,2019
"2756044",677,29,124,830,81.57,3.49,14.94,2019
"2756056",27,8,9,44,61.36,18.18,20.45,2019
"2756115",460,13,73,546,84.25,2.38,13.37,2019
"2756118",136,1,24,161,84.47,0.62,14.91,2019
"2756120",255,11,82,348,73.28,3.16,23.56,2019
"2756143",1573,66,312,1951,80.63,3.38,15.99,2019
"2756144",367,34,108,509,72.1,6.68,21.22,2019
"2756145",151,8,97,256,58.98,3.12,37.89,2019
"2756149",387,43,91,521,74.28,8.25,17.47,2019
"2756156",1926,55,411,2392,80.52,2.3,17.18,2019
"2756165",134,1,21,156,85.9,0.64,13.46,2019
"2756172",1030,58,287,1375,74.91,4.22,20.87,2019
"2756511",670,40,102,812,82.51,4.93,12.56,2019
"2756515",1115,71,163,1349,82.65,5.26,12.08,2019
"2756516",71,3,35,109,65.14,2.75,32.11,2019
"2756518",101,13,42,156,64.74,8.33,26.92,2019
"2756520",1388,58,335,1781,77.93,3.26,18.81,2019
"2756535",371,35,110,516,71.9,6.78,21.32,2019
"2756729",28,0,18,46,60.87,0,39.13,2019
"2756731",17,6,11,34,50,17.65,32.35,2019
"2756744",168,12,34,214,78.5,5.61,15.89,2019
"2756754",195,4,31,230,84.78,1.74,13.48,2019
"2756758",115,7,17,139,82.73,5.04,12.23,2019
"2756763",1227,403,259,1889,64.96,21.33,13.71,2019
"2756153",78,2,27,107,72.9,1.87,25.23,2019
"2756078",143,0,34,177,80.79,0,19.21,2019
"2756080",241,4,25,270,89.26,1.48,9.26,2019
"2756088",617,12,179,808,76.36,1.49,22.15,2019
"2756177",11,2,4,17,64.71,11.76,23.53,2019
"2756219",316,22,97,435,72.64,5.06,22.3,2019
"2756228",316,8,93,417,75.78,1.92,22.3,2019
"2756231",125,7,22,154,81.17,4.55,14.29,2019
"2756237",168,6,48,222,75.68,2.7,21.62,2019
"2756240",273,9,133,415,65.78,2.17,32.05,2019
"2756245",223,4,34,261,85.44,1.53,13.03,2019
"2756253",343,21,115,479,71.61,4.38,24.01,2019
"2756271",376,16,80,472,79.66,3.39,16.95,2019
"2756280",173,9,28,210,82.38,4.29,13.33,2019
"2756316",414,22,142,578,71.63,3.81,24.57,2019
"2756319",460,10,84,554,83.03,1.81,15.16,2019
"2756324",335,14,75,424,79.01,3.3,17.69,2019
"2756325",69,1,29,99,69.7,1.01,29.29,2019
"2756334",2002,127,561,2690,74.42,4.72,20.86,2019
"2756335",63,2,22,87,72.41,2.3,25.29,2019
"2756338",502,12,137,651,77.11,1.84,21.04,2019
"1950133",129,0,54,183,70.49,0,29.51,2019
"1950139",394,2,82,478,82.43,0.42,17.15,2019
"1950154",165,0,36,201,82.09,0,17.91,2019
"1950164",157,3,49,209,75.12,1.44,23.44,2019
"1950248",1551,50,314,1915,80.99,2.61,16.4,2019
"1950251",416,5,90,511,81.41,0.98,17.61,2019
"0881210",178,13,0,191,93.19,6.81,0,2019
"0881225",493,15,12,520,94.81,2.88,2.31,2019
"0881251",93,16,0,109,85.32,14.68,0,2019
"0881253",261,0,17,278,93.88,0,6.12,2019
"0881131",525,137,90,752,69.81,18.22,11.97,2019
"0881146",200,3,67,270,74.07,1.11,24.81,2019
"0881422",157,19,138,314,50,6.05,43.95,2019
"0881424",344,9,99,452,76.11,1.99,21.9,2019
"0881426",48,0,14,62,77.42,0,22.58,2019
"0881505",4176,54,330,4560,91.58,1.18,7.24,2019
"0881522",61,0,0,61,100,0,0,2019
"0881335",11,12,0,23,47.83,52.17,0,2019
"0881430",361,13,27,401,90.02,3.24,6.73,2019
"0881434",58,0,56,114,50.88,0,49.12,2019
"0881615",1189,38,0,1227,96.9,3.1,0,2019
"0881623",5419,65,367,5851,92.62,1.11,6.27,2019
"0881625",4132,147,814,5093,81.13,2.89,15.98,2019
"0881630",333,9,45,387,86.05,2.33,11.63,2019
"0881631",2506,0,141,2647,94.67,0,5.33,2019
"0881645",366,12,17,395,92.66,3.04,4.3,2019
"0881648",771,35,84,890,86.63,3.93,9.44,2019
"0881656",124,0,0,124,100,0,0,2019
"0880928",362,4,44,410,88.29,0.98,10.73,2019
"0880749",97,3,19,119,81.51,2.52,15.97,2019
"0880754",59,3,9,71,83.1,4.23,12.68,2019
"0880757",91,0,16,107,85.05,0,14.95,2019
"0880758",1089,63,328,1480,73.58,4.26,22.16,2019
"0880804",72,14,37,123,58.54,11.38,30.08,2019
"0880815",287,6,71,364,78.85,1.65,19.51,2019
"0880816",2425,65,113,2603,93.16,2.5,4.34,2019
"0880817",9463,166,661,10290,91.96,1.61,6.42,2019
"0880835",278,6,82,366,75.96,1.64,22.4,2019
"0880862",21,0,0,21,100,0,0,2019
"0880863",4748,163,261,5172,91.8,3.15,5.05,2019
"0880547",752,7,24,783,96.04,0.89,3.07,2019
"0880425",81,0,0,81,100,0,0,2019
"0880466",1357,19,157,1533,88.52,1.24,10.24,2019
"0880524",12800,767,1244,14811,86.42,5.18,8.4,2019
"0880615",2531,111,413,3055,82.85,3.63,13.52,2019
"0880621",3332,100,848,4280,77.85,2.34,19.81,2019
"0880623",202,28,65,295,68.47,9.49,22.03,2019
"0880729",206,3,41,250,82.4,1.2,16.4,2019
"0880740",49,0,8,57,85.96,0,14.04,2019
"0880906",13587,454,1207,15248,89.11,2.98,7.92,2019
"0880921",8129,146,280,8555,95.02,1.71,3.27,2019
"0880930",601,6,67,674,89.17,0.89,9.94,2019
"0880021",13560,564,847,14971,90.58,3.77,5.66,2019
"0880031",12177,289,975,13441,90.6,2.15,7.25,2019
"0880101",177,4,14,195,90.77,2.05,7.18,2019
"0880110",8135,232,1087,9454,86.05,2.45,11.5,2019
"0880117",949,13,150,1112,85.34,1.17,13.49,2019
"0880128",13660,186,389,14235,95.96,1.31,2.73,2019
"0880204",10583,399,2522,13504,78.37,2.95,18.68,2019
"3587935",477,30,318,825,57.82,3.64,38.55,2019
"3587942",332,6,107,445,74.61,1.35,24.04,2019
"3587043",2159,62,84,2305,93.67,2.69,3.64,2019
"3587045",95,6,407,508,18.7,1.18,80.12,2019
"3587062",106,0,224,330,32.12,0,67.88,2019
"3587109",14815,532,2377,17724,83.59,3,13.41,2019
"5682945",70,0,33,103,67.96,0,32.04,2019
"5682060",138,0,0,138,100,0,0,2019
"5682210",145,6,29,180,80.56,3.33,16.11,2019
"5682217",9,0,0,9,100,0,0,2019
"5682227",98,0,20,118,83.05,0,16.95,2019
"5682240",3121,167,820,4108,75.97,4.07,19.96,2019
"5682301",2723,109,456,3288,82.82,3.32,13.87,2019
"5682323",19,6,47,72,26.39,8.33,65.28,2019
"5682332",48,0,21,69,69.57,0,30.43,2019
"5682414",5663,165,751,6579,86.08,2.51,11.42,2019
"5682441",46,0,33,79,58.23,0,41.77,2019
"5682514",251,30,143,424,59.2,7.08,33.73,2019
"5682516",111,0,45,156,71.15,0,28.85,2019
"5682637",1189,86,272,1547,76.86,5.56,17.58,2019
"5682642",29,0,20,49,59.18,0,40.82,2019
"5682644",520,50,211,781,66.58,6.4,27.02,2019
"5682710",57,0,54,111,51.35,0,48.65,2019
"5682731",65,0,20,85,76.47,0,23.53,2019
"5682835",123,2,19,144,85.42,1.39,13.19,2019
"5682943",37,0,86,123,30.08,0,69.92,2019
"5682059",66,0,32,98,67.35,0,32.65,2019
"5682061",0,0,0,0,NA,NA,NA,2019
"5682063",97,0,6,103,94.17,0,5.83,2019
"5682190",148,0,52,200,74,0,26,2019
"5682222",13,0,6,19,68.42,0,31.58,2019
"5682225",514,35,194,743,69.18,4.71,26.11,2019
"5682335",20,0,10,30,66.67,0,33.33,2019
"5682420",258,8,26,292,88.36,2.74,8.9,2019
"5682432",107,2,18,127,84.25,1.57,14.17,2019
"5682442",314,21,24,359,87.47,5.85,6.69,2019
"5682513",755,51,92,898,84.08,5.68,10.24,2019
"5682723",119,0,31,150,79.33,0,20.67,2019
"5682730",572,15,129,716,79.89,2.09,18.02,2019
"5682833",45,0,0,45,100,0,0,2019
"5682839",406,7,69,482,84.23,1.45,14.32,2019
"5682938",49,0,30,79,62.03,0,37.97,2019
"5682219",8,0,0,8,100,0,0,2019
"5682221",97,8,41,146,66.44,5.48,28.08,2019
"5682244",156,25,25,206,75.73,12.14,12.14,2019
"5682327",220,0,80,300,73.33,0,26.67,2019
"5682433",383,22,76,481,79.63,4.57,15.8,2019
"5682512",64,0,21,85,75.29,0,24.71,2019
"5682620",80,6,8,94,85.11,6.38,8.51,2019
"5682636",1377,25,222,1624,84.79,1.54,13.67,2019
"5682649",353,30,85,468,75.43,6.41,18.16,2019
"5682714",22,0,0,22,100,0,0,2019
"5682729",884,83,125,1092,80.95,7.6,11.45,2019
"5682842",347,0,49,396,87.63,0,12.37,2019
"5682051",8,0,17,25,32,0,68,2019
"5682054",318,0,41,359,88.58,0,11.42,2019
"5682055",171,0,0,171,100,0,0,2019
"5682072",6065,532,365,6962,87.12,7.64,5.24,2019
"5682083",88,0,29,117,75.21,0,24.79,2019
"3587525",24,0,0,24,100,0,0,2019
"3587533",36,0,17,53,67.92,0,32.08,2019
"3587539",0,0,25,25,0,0,100,2019
"3587004",3189,206,859,4254,74.96,4.84,20.19,2019
"3587007",129,24,140,293,44.03,8.19,47.78,2019
"3587015",4254,77,808,5139,82.78,1.5,15.72,2019
"1683548",33,0,21,54,61.11,0,38.89,2019
"1683554",171,2,36,209,81.82,0.96,17.22,2019
"1683602",0,6,0,6,0,100,0,2019
"1683605",11622,631,2175,14428,80.55,4.37,15.07,2019
"5683116",236,18,47,301,78.41,5.98,15.61,2019
"5683122",201,0,0,201,100,0,0,2019
"5683127",1155,203,75,1433,80.6,14.17,5.23,2019
"5683128",422,7,44,473,89.22,1.48,9.3,2019
"1683218",97,0,13,110,88.18,0,11.82,2019
"1683235",54,0,0,54,100,0,0,2019
"1683246",374,7,30,411,91,1.7,7.3,2019
"1683263",2854,24,344,3222,88.58,0.74,10.68,2019
"1683281",18,0,0,18,100,0,0,2019
"1683285",27,0,0,27,100,0,0,2019
"1683286",375,23,20,418,89.71,5.5,4.78,2019
"1683323",404,24,150,578,69.9,4.15,25.95,2019
"1683328",1694,68,314,2076,81.6,3.28,15.13,2019
"1683349",294,3,98,395,74.43,0.76,24.81,2019
"1683354",0,0,0,0,NA,NA,NA,2019
"1683423",169,0,88,257,65.76,0,34.24,2019
"1683401",12706,309,1128,14143,89.84,2.18,7.98,2019
"1683402",8269,215,909,9393,88.03,2.29,9.68,2019
"1683420",655,4,150,809,80.96,0.49,18.54,2019
"1683431",183,4,52,239,76.57,1.67,21.76,2019
"1683465",51,0,0,51,100,0,0,2019
"1683523",243,12,88,343,70.85,3.5,25.66,2019
"1683555",156,11,69,236,66.1,4.66,29.24,2019
"1683628",1236,19,341,1596,77.44,1.19,21.37,2019
"1683637",66,0,6,72,91.67,0,8.33,2019
"1683657",92,0,13,105,87.62,0,12.38,2019
"1683672",2448,87,777,3312,73.91,2.63,23.46,2019
"1683805",2513,134,729,3376,74.44,3.97,21.59,2019
"1683202",6545,141,1015,7701,84.99,1.83,13.18,2019
"1683204",6190,184,1005,7379,83.89,2.49,13.62,2019
"1683214",214,1,18,233,91.85,0.43,7.73,2019
"1683223",47,0,0,47,100,0,0,2019
"1683261",193,9,47,249,77.51,3.61,18.88,2019
"1683271",172,1,6,179,96.09,0.56,3.35,2019
"5683014",1182,40,13,1235,95.71,3.24,1.05,2019
"5683101",1098,58,179,1335,82.25,4.34,13.41,2019
"5683115",311,43,24,378,82.28,11.38,6.35,2019
"5683121",0,0,0,0,NA,NA,NA,2019
"5683126",111,0,0,111,100,0,0,2019
"1683210",966,9,169,1144,84.44,0.79,14.77,2019
"1683212",66,0,4,70,94.29,0,5.71,2019
"1683227",0,0,7,7,0,0,100,2019
"1683251",338,16,84,438,77.17,3.65,19.18,2019
"1683253",26,0,17,43,60.47,0,39.53,2019
"1683276",1167,41,172,1380,84.57,2.97,12.46,2019
"1683302",54,13,32,99,54.55,13.13,32.32,2019
"1683312",33,0,22,55,60,0,40,2019
"1683314",229,5,137,371,61.73,1.35,36.93,2019
"1683324",183,4,21,208,87.98,1.92,10.1,2019
"0693962",148,0,0,148,100,0,0,2019
"0693272",748,30,359,1137,65.79,2.64,31.57,2019
"0693308",16122,591,2775,19488,82.73,3.03,14.24,2019
"0693402",5859,75,467,6401,91.53,1.17,7.3,2019
"0693429",47,0,22,69,68.12,0,31.88,2019
"0693430",1266,28,111,1405,90.11,1.99,7.9,2019
"1950264",134,16,42,192,69.79,8.33,21.88,2019
"1950265",12212,285,1261,13758,88.76,2.07,9.17,2019
"1950309",4301,217,500,5018,85.71,4.32,9.96,2019
"1950311",4823,239,782,5844,82.53,4.09,13.38,2019
"1950428",3322,84,687,4093,81.16,2.05,16.78,2019
"1950438",1396,76,230,1702,82.02,4.47,13.51,2019
"1950447",447,6,77,530,84.34,1.13,14.53,2019
"1950449",271,21,107,399,67.92,5.26,26.82,2019
"1950457",130,7,20,157,82.8,4.46,12.74,2019
"1950477",89,2,28,119,74.79,1.68,23.53,2019
"1950478",238,11,100,349,68.19,3.15,28.65,2019
"1950484",145,2,22,169,85.8,1.18,13.02,2019
"1950517",357,9,100,466,76.61,1.93,21.46,2019
"1950519",207,12,35,254,81.5,4.72,13.78,2019
"1950529",287,16,64,367,78.2,4.36,17.44,2019
"1950545",55,0,24,79,69.62,0,30.38,2019
"1950578",233,14,73,320,72.81,4.38,22.81,2019
"1950579",822,40,197,1059,77.62,3.78,18.6,2019
"1950003",2615,50,314,2979,87.78,1.68,10.54,2019
"1950009",6478,287,502,7267,89.14,3.95,6.91,2019
"1950025",1099,68,281,1448,75.9,4.7,19.41,2019
"1950032",146,0,0,146,100,0,0,2019
"1950034",153,11,31,195,78.46,5.64,15.9,2019
"1950035",2452,87,156,2695,90.98,3.23,5.79,2019
"1950044",269,6,73,348,77.3,1.72,20.98,2019
"1950050",244,21,35,300,81.33,7,11.67,2019
"1950063",794,35,122,951,83.49,3.68,12.83,2019
"1950068",131,0,16,147,89.12,0,10.88,2019
"1950582",120,11,12,143,83.92,7.69,8.39,2019
"1950597",369,4,86,459,80.39,0.87,18.74,2019
"1950612",140,16,0,156,89.74,10.26,0,2019
"1950626",569,14,95,678,83.92,2.06,14.01,2019
"1950629",780,22,127,929,83.96,2.37,13.67,2019
"1950633",108,0,44,152,71.05,0,28.95,2019
"1950638",1205,42,190,1437,83.86,2.92,13.22,2019
"1950642",177,10,27,214,82.71,4.67,12.62,2019
"1950666",305,5,61,371,82.21,1.35,16.44,2019
"1950681",141,7,36,184,76.63,3.8,19.57,2019
"1950701",10644,472,1747,12863,82.75,3.67,13.58,2019
"1950849",813,69,295,1177,69.07,5.86,25.06,2019
"1950851",657,48,131,836,78.59,5.74,15.67,2019
"1950857",79,0,22,101,78.22,0,21.78,2019
"1950861",75,12,18,105,71.43,11.43,17.14,2019
"1950864",690,34,117,841,82.05,4.04,13.91,2019
"1950238",349,9,74,432,80.79,2.08,17.13,2019
"1950243",75,1,21,97,77.32,1.03,21.65,2019
"1950262",91,7,52,150,60.67,4.67,34.67,2019
"1950266",12449,611,717,13777,90.36,4.43,5.2,2019
"1950314",2927,192,868,3987,73.41,4.82,21.77,2019
"1950424",516,22,92,630,81.9,3.49,14.6,2019
"1950448",248,6,64,318,77.99,1.89,20.13,2019
"1950470",87,2,27,116,75,1.72,23.28,2019
"1950501",8813,446,2463,11722,75.18,3.8,21.01,2019
"1951338",377,26,48,451,83.59,5.76,10.64,2019
"1951463",198,10,14,222,89.19,4.5,6.31,2019
"1951345",142,6,14,162,87.65,3.7,8.64,2019
"1951350",197,5,23,225,87.56,2.22,10.22,2019
"1951366",85,19,45,149,57.05,12.75,30.2,2019
"1951444",90,1,9,100,90,1,9,2019
"3587317",383,0,136,519,73.8,0,26.2,2019
"3587322",57,0,15,72,79.17,0,20.83,2019
"3587325",272,23,572,867,31.37,2.65,65.97,2019
"3587357",82,6,131,219,37.44,2.74,59.82,2019
"3587364",48,7,260,315,15.24,2.22,82.54,2019
"3587417",1231,81,698,2010,61.24,4.03,34.73,2019
"3587512",31,0,0,31,100,0,0,2019
"3587513",217,42,73,332,65.36,12.65,21.99,2019
"3587515",59,0,54,113,52.21,0,47.79,2019
"3587531",65,0,131,196,33.16,0,66.84,2019
"3587556",592,24,357,973,60.84,2.47,36.69,2019
"3587560",356,19,231,606,58.75,3.14,38.12,2019
"3587566",347,20,449,816,42.52,2.45,55.02,2019
"3587714",367,22,134,523,70.17,4.21,25.62,2019
"3587825",237,26,325,588,40.31,4.42,55.27,2019
"3587006",201,23,52,276,72.83,8.33,18.84,2019
"3587014",154,15,149,318,48.43,4.72,46.86,2019
"3587026",470,46,596,1112,42.27,4.14,53.6,2019
"3587036",387,35,203,625,61.92,5.6,32.48,2019
"3587037",38,18,126,182,20.88,9.89,69.23,2019
"3587042",913,181,167,1261,72.4,14.35,13.24,2019
"3587008",1029,54,17,1100,93.55,4.91,1.55,2019
"3587020",2608,120,1108,3836,67.99,3.13,28.88,2019
"3587031",10589,814,3724,15127,70,5.38,24.62,2019
"3587034",192,1,290,483,39.75,0.21,60.04,2019
"3587053",194,4,213,411,47.2,0.97,51.82,2019
"3587110",14184,490,2564,17238,82.28,2.84,14.87,2019
"3587535",366,40,223,629,58.19,6.36,35.45,2019
"3587518",0,0,0,0,NA,NA,NA,2019
"3587522",586,0,517,1103,53.13,0,46.87,2019
"3587524",0,0,35,35,0,0,100,2019
"3587537",680,7,238,925,73.51,0.76,25.73,2019
"3587540",334,0,50,384,86.98,0,13.02,2019
"3587001",442,18,414,874,50.57,2.06,47.37,2019
"3587011",19,0,8,27,70.37,0,29.63,2019
"3587018",43,0,116,159,27.04,0,72.96,2019
"3587023",105,0,75,180,58.33,0,41.67,2019
"3587027",77,0,82,159,48.43,0,51.57,2019
"3587044",83,0,14,97,85.57,0,14.43,2019
"3587049",230,0,156,386,59.59,0,40.41,2019
"3587061",87,25,78,190,45.79,13.16,41.05,2019
"3587102",6208,423,2497,9128,68.01,4.63,27.36,2019
"3587106",9434,356,1620,11410,82.68,3.12,14.2,2019
"3587113",4855,314,630,5799,83.72,5.41,10.86,2019
"3587124",18078,518,2286,20882,86.57,2.48,10.95,2019
"3587320",42,2,125,169,24.85,1.18,73.96,2019
"3587321",392,75,393,860,45.58,8.72,45.7,2019
"3587401",11857,697,3338,15892,74.61,4.39,21,2019
"3587419",93,0,80,173,53.76,0,46.24,2019
"3587461",67,18,338,423,15.84,4.26,79.91,2019
"3587510",229,10,154,393,58.27,2.54,39.19,2019
"3587519",71,0,122,193,36.79,0,63.21,2019
"3587528",396,47,332,775,51.1,6.06,42.84,2019
"3289161",29,0,64,93,31.18,0,68.82,2019
"3289166",7159,469,232,7860,91.08,5.97,2.95,2019
"3289169",5971,794,2713,9478,63,8.38,28.62,2019
"3289178",12859,217,490,13566,94.79,1.6,3.61,2019
"3289179",2169,97,98,2364,91.75,4.1,4.15,2019
"3289183",12957,404,1102,14463,89.59,2.79,7.62,2019
"3587017",29,0,60,89,32.58,0,67.42,2019
"3587041",144,14,120,278,51.8,5.04,43.17,2019
"3587056",312,25,85,422,73.93,5.92,20.14,2019
"3587832",48,0,43,91,52.75,0,47.25,2019
"3587937",639,47,382,1068,59.83,4.4,35.77,2019
"3587943",42,0,54,96,43.75,0,56.25,2019
"3587059",3885,88,510,4483,86.66,1.96,11.38,2019
"3587083",210,6,47,263,79.85,2.28,17.87,2019
"3587104",4442,124,1256,5822,76.3,2.13,21.57,2019
"3587105",14127,1028,4988,20143,70.13,5.1,24.76,2019
"3587112",14608,649,2824,18081,80.79,3.59,15.62,2019
"3587116",1249,0,15,1264,98.81,0,1.19,2019
"3587120",21134,561,2476,24171,87.44,2.32,10.24,2019
"3587013",552,47,970,1569,35.18,3,61.82,2019
"3587016",708,9,408,1125,62.93,0.8,36.27,2019
"3587022",154,6,134,294,52.38,2.04,45.58,2019
"3587024",215,0,296,511,42.07,0,57.93,2019
"3587025",475,17,127,619,76.74,2.75,20.52,2019
"3587038",57,9,100,166,34.34,5.42,60.24,2019
"3587048",3605,43,252,3900,92.44,1.1,6.46,2019
"3587107",9093,589,2932,12614,72.09,4.67,23.24,2019
"3587108",11276,790,4573,16639,67.77,4.75,27.48,2019
"3587114",21968,928,2696,25592,85.84,3.63,10.53,2019
"3587315",15,0,62,77,19.48,0,80.52,2019
"3587410",4949,359,1160,6468,76.52,5.55,17.93,2019
"3587416",587,81,837,1505,39,5.38,55.61,2019
"3587521",122,4,206,332,36.75,1.2,62.05,2019
"3587529",1165,46,323,1534,75.95,3,21.06,2019
"3587569",122,20,101,243,50.21,8.23,41.56,2019
"3587581",19,0,0,19,100,0,0,2019
"3588254",45,0,0,45,100,0,0,2019
"3588267",347,22,50,419,82.82,5.25,11.93,2019
"3588321",30,0,43,73,41.1,0,58.9,2019
"3588011",10948,644,1177,12769,85.74,5.04,9.22,2019
"3588020",199,23,32,254,78.35,9.06,12.6,2019
"3588030",5397,234,2804,8435,63.98,2.77,33.24,2019
"3588047",483,0,273,756,63.89,0,36.11,2019
"3588012",8458,354,1421,10233,82.65,3.46,13.89,2019
"3588029",235,8,226,469,50.11,1.71,48.19,2019
"3588033",0,0,0,0,NA,NA,NA,2019
"3588044",659,56,475,1190,55.38,4.71,39.92,2019
"3588112",63,0,18,81,77.78,0,22.22,2019
"0485004",2145,179,693,3017,71.1,5.93,22.97,2019
"0485006",6700,362,2293,9355,71.62,3.87,24.51,2019
"0485020",12948,545,2353,15846,81.71,3.44,14.85,2019
"0485033",13440,418,2237,16095,83.5,2.6,13.9,2019
"0485304",8576,251,704,9531,89.98,2.63,7.39,2019
"0485356",1584,89,347,2020,78.42,4.41,17.18,2019
"0485363",2007,41,443,2491,80.57,1.65,17.78,2019
"0485373",7646,249,1015,8910,85.81,2.79,11.39,2019
"0485381",8089,131,862,9082,89.07,1.44,9.49,2019
"0485605",145,3,98,246,58.94,1.22,39.84,2019
"0485606",370,2,128,500,74,0.4,25.6,2019
"0692587",5377,112,351,5840,92.07,1.92,6.01,2019
"0692590",1362,174,126,1662,81.95,10.47,7.58,2019
"0692620",18092,80,805,18977,95.34,0.42,4.24,2019
"0692630",19224,248,1334,20806,92.4,1.19,6.41,2019
"0692657",3905,0,0,3905,100,0,0,2019
"0692660",14186,129,747,15062,94.18,0.86,4.96,2019
"0693063",17262,284,1434,18980,90.95,1.5,7.56,2019
"0693205",603,19,280,902,66.85,2.11,31.04,2019
"0693224",91,3,62,156,58.33,1.92,39.74,2019
"0693226",31,3,39,73,42.47,4.11,53.42,2019
"0693240",2042,82,552,2676,76.31,3.06,20.63,2019
"0693251",25,0,43,68,36.76,0,63.24,2019
"0693265",1255,225,256,1736,72.29,12.96,14.75,2019
"0693287",27,0,1,28,96.43,0,3.57,2019
"0693309",18262,746,2423,21431,85.21,3.48,11.31,2019
"0693311",13156,334,1034,14524,90.58,2.3,7.12,2019
"0693427",2071,58,151,2280,90.83,2.54,6.62,2019
"0693446",14994,398,2108,17500,85.68,2.27,12.05,2019
"0693451",1176,45,191,1412,83.29,3.19,13.53,2019
"0693254",243,9,54,306,79.41,2.94,17.65,2019
"0693285",978,0,263,1241,78.81,0,21.19,2019
"0693286",2077,120,664,2861,72.6,4.19,23.21,2019
"0693312",18449,248,919,19616,94.05,1.26,4.68,2019
"0693109",4212,62,269,4543,92.71,1.36,5.92,2019
"0693111",5680,164,322,6166,92.12,2.66,5.22,2019
"0693201",178,0,232,410,43.41,0,56.59,2019
"0693221",3756,103,966,4825,77.84,2.13,20.02,2019
"0693230",18307,615,3282,22204,82.45,2.77,14.78,2019
"0693401",11015,375,871,12261,89.84,3.06,7.1,2019
"0693207",83,2,29,114,72.81,1.75,25.44,2019
"0693544",366,43,145,554,66.06,7.76,26.17,2019
"0693727",20683,624,3438,24745,83.58,2.52,13.89,2019
"0693204",1819,67,603,2489,73.08,2.69,24.23,2019
"0693238",243,53,96,392,61.99,13.52,24.49,2019
"0693266",232,0,75,307,75.57,0,24.43,2019
"0693428",2586,50,204,2840,91.06,1.76,7.18,2019
"0693434",1731,31,268,2030,85.27,1.53,13.2,2019
"0693440",445,0,122,567,78.48,0,21.52,2019
"0693535",16314,844,4176,21334,76.47,3.96,19.57,2019
"0693510",2392,33,183,2608,91.72,1.27,7.02,2019
"0693513",619,35,82,736,84.1,4.76,11.14,2019
"0693517",213,0,54,267,79.78,0,20.22,2019
"0693543",3060,132,506,3698,82.75,3.57,13.68,2019
"0693555",10755,380,1851,12986,82.82,2.93,14.25,2019
"0693604",224,0,45,269,83.27,0,16.73,2019
"0693614",4060,277,410,4747,85.53,5.84,8.64,2019
"0693625",1939,125,443,2507,77.34,4.99,17.67,2019
"0693630",4266,108,999,5373,79.4,2.01,18.59,2019
"0693631",4612,95,680,5387,85.61,1.76,12.62,2019
"0693637",10157,155,2048,12360,82.18,1.25,16.57,2019
"0693641",44,0,84,128,34.38,0,65.62,2019
"0693643",1064,11,168,1243,85.6,0.88,13.52,2019
"0693926",1740,66,471,2277,76.42,2.9,20.69,2019
"0690242",10907,367,1051,12325,88.49,2.98,8.53,2019
"0690620",11996,238,908,13142,91.28,1.81,6.91,2019
"0690623",4515,15,315,4845,93.19,0.31,6.5,2019
"0690630",14556,420,828,15804,92.1,2.66,5.24,2019
"0690713",8309,66,736,9111,91.2,0.72,8.08,2019
"0690715",5280,174,564,6018,87.74,2.89,9.37,2019
"0692078",16217,289,1026,17532,92.5,1.65,5.85,2019
"0692117",19063,346,1637,21046,90.58,1.64,7.78,2019
"0692123",11751,109,578,12438,94.48,0.88,4.65,2019
"0692139",9241,111,998,10350,89.29,1.07,9.64,2019
"0692173",6214,333,1400,7947,78.19,4.19,17.62,2019
"0692223",14865,628,1375,16868,88.13,3.72,8.15,2019
"1951466",343,3,67,413,83.05,0.73,16.22,2019
"1951510",1135,92,186,1413,80.33,6.51,13.16,2019
"1951521",637,15,125,777,81.98,1.93,16.09,2019
"1951525",384,17,76,477,80.5,3.56,15.93,2019
"1951527",145,7,46,198,73.23,3.54,23.23,2019
"1951532",253,20,38,311,81.35,6.43,12.22,2019
"1951542",351,22,40,413,84.99,5.33,9.69,2019
"1951548",151,5,38,194,77.84,2.58,19.59,2019
"1951552",83,15,31,129,64.34,11.63,24.03,2019
"1951559",527,21,110,658,80.09,3.19,16.72,2019
"1951560",671,13,98,782,85.81,1.66,12.53,2019
"1951601",1973,55,399,2427,81.29,2.27,16.44,2019
"1951646",285,10,79,374,76.2,2.67,21.12,2019
"1951010",134,2,42,178,75.28,1.12,23.6,2019
"1951534",2968,65,366,3399,87.32,1.91,10.77,2019
"1951558",149,1,53,203,73.4,0.49,26.11,2019
"1951544",225,31,33,289,77.85,10.73,11.42,2019
"1951554",77,0,11,88,87.5,0,12.5,2019
"1951556",137,18,40,195,70.26,9.23,20.51,2019
"1951566",2273,106,565,2944,77.21,3.6,19.19,2019
"1951570",364,20,60,444,81.98,4.5,13.51,2019
"1951004",325,5,93,423,76.83,1.18,21.99,2019
"1951526",546,9,70,625,87.36,1.44,11.2,2019
"1951549",208,4,23,235,88.51,1.7,9.79,2019
"1951563",230,8,36,274,83.94,2.92,13.14,2019
"1951575",509,16,58,583,87.31,2.74,9.95,2019
"1951576",627,35,80,742,84.5,4.72,10.78,2019
"1951246",1260,23,125,1408,89.49,1.63,8.88,2019
"1951247",1548,23,193,1764,87.76,1.3,10.94,2019
"1951433",165,3,29,197,83.76,1.52,14.72,2019
"1951436",285,19,33,337,84.57,5.64,9.79,2019
"1951441",105,4,61,170,61.76,2.35,35.88,2019
"1951450",588,6,129,723,81.33,0.83,17.84,2019
"1951453",247,4,50,301,82.06,1.33,16.61,2019
"1951455",711,61,219,991,71.75,6.16,22.1,2019
"1951462",404,22,61,487,82.96,4.52,12.53,2019
"1951503",11893,672,2069,14634,81.27,4.59,14.14,2019
"1951523",153,0,12,165,92.73,0,7.27,2019
"1951528",266,5,64,335,79.4,1.49,19.1,2019
"1951529",552,32,189,773,71.41,4.14,24.45,2019
"1951535",606,23,154,783,77.39,2.94,19.67,2019
"1951551",594,39,51,684,86.84,5.7,7.46,2019
"1951238",417,12,72,501,83.23,2.4,14.37,2019
"1951012",2265,35,567,2867,79,1.22,19.78,2019
"1951024",693,27,63,783,88.51,3.45,8.05,2019
"1951025",700,35,106,841,83.23,4.16,12.6,2019
"1951035",644,20,143,807,79.8,2.48,17.72,2019
"1951058",319,16,60,395,80.76,4.05,15.19,2019
"1951103",4516,329,1035,5880,76.8,5.6,17.6,2019
"1951108",1628,67,288,1983,82.1,3.38,14.52,2019
"1951231",124,4,18,146,84.93,2.74,12.33,2019
"1951232",283,6,41,330,85.76,1.82,12.42,2019
"1951234",468,8,37,513,91.23,1.56,7.21,2019
"5554747",726,23,287,1036,70.08,2.22,27.7,2019
"5554757",1074,24,282,1380,77.83,1.74,20.43,2019
"5554771",1033,52,425,1510,68.41,3.44,28.15,2019
"5554813",194,20,46,260,74.62,7.69,17.69,2019
"5554011",2323,39,337,2699,86.07,1.44,12.49,2019
"5554013",998,75,255,1328,75.15,5.65,19.2,2019
"3289319",69,0,11,80,86.25,0,13.75,2019
"3289402",8,0,0,8,100,0,0,2019
"3289412",0,17,27,44,0,38.64,61.36,2019
"3289438",10,0,33,43,23.26,0,76.74,2019
"3289441",4157,171,223,4551,91.34,3.76,4.9,2019
"3289446",0,0,0,0,NA,NA,NA,2019
"3289450",24,0,0,24,100,0,0,2019
"3289460",4760,96,604,5460,87.18,1.76,11.06,2019
"3289508",4294,92,330,4716,91.05,1.95,7,2019
"3289519",3485,107,132,3724,93.58,2.87,3.54,2019
"3289521",11723,266,672,12661,92.59,2.1,5.31,2019
"3289702",0,0,0,0,NA,NA,NA,2019
"3289003",259,0,212,471,54.99,0,45.01,2019
"3289042",371,25,47,443,83.75,5.64,10.61,2019
"0694933",227,48,64,339,66.96,14.16,18.88,2019
"0694941",12515,243,532,13290,94.17,1.83,4,2019
"0694971",116,0,0,116,100,0,0,2019
"0694972",0,0,13,13,0,0,100,2019
"0694924",501,14,20,535,93.64,2.62,3.74,2019
"0694920",5026,129,204,5359,93.79,2.41,3.81,2019
"0694949",6897,165,471,7533,91.56,2.19,6.25,2019
"0694956",449,25,169,643,69.83,3.89,26.28,2019
"0694002",9560,104,659,10323,92.61,1.01,6.38,2019
"0694107",13372,352,668,14392,92.91,2.45,4.64,2019
"0694109",28218,989,4325,33532,84.15,2.95,12.9,2019
"0694115",15045,352,1665,17062,88.18,2.06,9.76,2019
"0694124",9543,199,1477,11219,85.06,1.77,13.17,2019
"0694130",501,37,68,606,82.67,6.11,11.22,2019
"0694133",9636,456,2889,12981,74.23,3.51,22.26,2019
"0694502",4657,113,196,4966,93.78,2.28,3.95,2019
"0694507",4966,18,257,5241,94.75,0.34,4.9,2019
"0694514",390,17,44,451,86.47,3.77,9.76,2019
"0694523",13126,147,687,13960,94.03,1.05,4.92,2019
"0694539",16198,156,468,16822,96.29,0.93,2.78,2019
"0694544",20040,340,2540,22920,87.43,1.48,11.08,2019
"0694005",1621,0,271,1892,85.68,0,14.32,2019
"0694019",6893,99,460,7452,92.5,1.33,6.17,2019
"0694024",7498,57,260,7815,95.94,0.73,3.33,2019
"0694030",7170,152,654,7976,89.89,1.91,8.2,2019
"0694037",860,0,168,1028,83.66,0,16.34,2019
"0694103",12229,868,2617,15714,77.82,5.52,16.65,2019
"0694104",104,43,73,220,47.27,19.55,33.18,2019
"0694127",7194,93,316,7603,94.62,1.22,4.16,2019
"0694128",0,0,0,0,NA,NA,NA,2019
"0694129",1248,15,30,1293,96.52,1.16,2.32,2019
"0694501",22918,561,1973,25452,90.04,2.2,7.75,2019
"0694525",1294,90,75,1459,88.69,6.17,5.14,2019
"0694549",10359,17,476,10852,95.46,0.16,4.39,2019
"0694560",13069,104,874,14047,93.04,0.74,6.22,2019
"0694568",17811,163,686,18660,95.45,0.87,3.68,2019
"0694619",8017,260,818,9095,88.15,2.86,8.99,2019
"0694804",12245,420,1727,14392,85.08,2.92,12,2019
"0694925",3671,37,222,3930,93.41,0.94,5.65,2019
"3289146",5655,174,1090,6919,81.73,2.51,15.75,2019
"3289404",0,0,0,0,NA,NA,NA,2019
"3289405",44,0,0,44,100,0,0,2019
"3289411",278,0,7,285,97.54,0,2.46,2019
"3289414",77,0,0,77,100,0,0,2019
"3289422",61,14,50,125,48.8,11.2,40,2019
"0692694",8270,705,73,9048,91.4,7.79,0.81,2019
"0692704",17237,411,2370,20018,86.11,2.05,11.84,2019
"0692867",12172,93,679,12944,94.04,0.72,5.25,2019
"0692880",16822,30,532,17384,96.77,0.17,3.06,2019
"0692886",15941,248,627,16816,94.8,1.47,3.73,2019
"0692562",18074,443,1097,19614,92.15,2.26,5.59,2019
"0692019",13303,246,963,14512,91.67,1.7,6.64,2019
"0692805",17269,284,2058,19611,88.06,1.45,10.49,2019
"0692596",7876,49,253,8178,96.31,0.6,3.09,2019
"0692780",16537,575,1435,18547,89.16,3.1,7.74,2019
"0692010",5977,35,223,6235,95.86,0.56,3.58,2019
"0692011",9042,100,283,9425,95.94,1.06,3,2019
"0692055",292,0,0,292,100,0,0,2019
"0692058",12927,307,803,14037,92.09,2.19,5.72,2019
"0692081",9775,32,473,10280,95.09,0.31,4.6,2019
"0692132",0,0,0,0,NA,NA,NA,2019
"0692134",0,0,0,0,NA,NA,NA,2019
"0692135",0,0,0,0,NA,NA,NA,2019
"0692140",0,0,0,0,NA,NA,NA,2019
"0692145",563,0,0,563,100,0,0,2019
"0692147",0,0,0,0,NA,NA,NA,2019
"0692155",0,0,0,0,NA,NA,NA,2019
"0692222",0,0,0,0,NA,NA,NA,2019
"0692322",316,0,15,331,95.47,0,4.53,2019
"0692344",5198,176,629,6003,86.59,2.93,10.48,2019
"0692378",94,0,0,94,100,0,0,2019
"0692385",71,17,0,88,80.68,19.32,0,2019
"0692391",671,76,62,809,82.94,9.39,7.66,2019
"0692395",11446,517,1483,13446,85.13,3.85,11.03,2019
"0692603",7086,72,43,7201,98.4,1,0.6,2019
"0692617",2400,1482,89,3971,60.44,37.32,2.24,2019
"0692637",8803,338,1862,11003,80.01,3.07,16.92,2019
"0692678",192,0,15,207,92.75,0,7.25,2019
"0692394",7431,159,530,8120,91.51,1.96,6.53,2019
"0692544",12392,501,2515,15408,80.43,3.25,16.32,2019
"0692067",2629,31,23,2683,97.99,1.16,0.86,2019
"0692250",1808,147,394,2349,76.97,6.26,16.77,2019
"0692364",0,0,6,6,0,0,100,2019
"0692545",11761,486,2395,14642,80.32,3.32,16.36,2019
"0692626",17766,283,898,18947,93.77,1.49,4.74,2019
"0693001",10894,221,1579,12694,85.82,1.74,12.44,2019
"0693013",5701,60,452,6213,91.76,0.97,7.28,2019
"0693041",6283,144,684,7111,88.36,2.03,9.62,2019
"0693101",11161,418,1521,13100,85.2,3.19,11.61,2019
"0693206",237,18,230,485,48.87,3.71,47.42,2019
"0693004",9834,140,1056,11030,89.16,1.27,9.57,2019
"0693021",11206,116,819,12141,92.3,0.96,6.75,2019
"0693022",2149,108,231,2488,86.37,4.34,9.28,2019
"0693222",702,25,107,834,84.17,3,12.83,2019
"0693234",941,119,740,1800,52.28,6.61,41.11,2019
"0693242",707,4,307,1018,69.45,0.39,30.16,2019
"0693247",3668,285,1460,5413,67.76,5.27,26.97,2019
"0693249",154,0,360,514,29.96,0,70.04,2019
"0691006",9824,134,617,10575,92.9,1.27,5.83,2019
"0691011",6139,34,261,6434,95.41,0.53,4.06,2019
"0691201",6644,57,1608,8309,79.96,0.69,19.35,2019
"0691302",9030,172,286,9488,95.17,1.81,3.01,2019
"0691901",5863,67,390,6320,92.77,1.06,6.17,2019
"0691902",5599,70,339,6008,93.19,1.17,5.64,2019
"0692230",598,0,234,832,71.88,0,28.12,2019
"0692240",9697,353,2684,12734,76.15,2.77,21.08,2019
"0692254",1904,10,983,2897,65.72,0.35,33.93,2019
"0692280",0,0,0,0,NA,NA,NA,2019
"0692313",3947,66,364,4377,90.18,1.51,8.32,2019
"0692316",5784,288,1433,7505,77.07,3.84,19.09,2019
"0692324",15169,456,2700,18325,82.78,2.49,14.73,2019
"0692354",6743,341,953,8037,83.9,4.24,11.86,2019
"0692377",4918,300,312,5530,88.93,5.42,5.64,2019
"0692507",14714,551,1781,17046,86.32,3.23,10.45,2019
"0692548",1816,40,400,2256,80.5,1.77,17.73,2019
"0692551",7056,159,722,7937,88.9,2,9.1,2019
"0692553",16163,339,1883,18385,87.91,1.84,10.24,2019
"0692567",2252,24,360,2636,85.43,0.91,13.66,2019
"0692570",11416,264,2103,13783,82.83,1.92,15.26,2019
"0692604",8916,252,517,9685,92.06,2.6,5.34,2019
"0692646",19586,371,1248,21205,92.37,1.75,5.89,2019
"0692662",1235,20,40,1295,95.37,1.54,3.09,2019
"0692677",24123,339,1088,25550,94.41,1.33,4.26,2019
"0692804",21880,432,2642,24954,87.68,1.73,10.59,2019
"0692821",12828,111,811,13750,93.29,0.81,5.9,2019
"0692860",6472,133,515,7120,90.9,1.87,7.23,2019
"0692866",4715,63,640,5418,87.02,1.16,11.81,2019
"0692879",12253,327,1675,14255,85.96,2.29,11.75,2019
"0692337",9062,497,463,10022,90.42,4.96,4.62,2019
"0692342",2410,4,184,2598,92.76,0.15,7.08,2019
"0692345",21332,502,2112,23946,89.08,2.1,8.82,2019
"0692346",14497,1085,2165,17747,81.69,6.11,12.2,2019
"0692347",188,0,100,288,65.28,0,34.72,2019
"0692359",2639,156,302,3097,85.21,5.04,9.75,2019
"0692376",15958,3092,2365,21415,74.52,14.44,11.04,2019
"0692399",15640,494,2313,18447,84.78,2.68,12.54,2019
"0692405",6445,1094,1200,8739,73.75,12.52,13.73,2019
"0692410",8292,1450,2917,12659,65.5,11.45,23.04,2019
"0692503",21758,385,2913,25056,86.84,1.54,11.63,2019
"0692532",6644,155,342,7141,93.04,2.17,4.79,2019
"0692555",10256,135,482,10873,94.33,1.24,4.43,2019
"0692869",10610,85,813,11508,92.2,0.74,7.06,2019
"0692124",10722,228,198,11148,96.18,2.05,1.78,2019
"0692225",4288,128,1534,5950,72.07,2.15,25.78,2019
"0692231",6798,239,1996,9033,75.26,2.65,22.1,2019
"0692234",15592,408,2816,18816,82.87,2.17,14.97,2019
"0692253",14399,303,1113,15815,91.05,1.92,7.04,2019
"0692259",50,0,21,71,70.42,0,29.58,2019
"0692262",11672,351,1435,13458,86.73,2.61,10.66,2019
"0692273",332,50,122,504,65.87,9.92,24.21,2019
"0692275",618,34,293,945,65.4,3.6,31.01,2019
"0692284",9018,165,1390,10573,85.29,1.56,13.15,2019
"0692285",869,24,185,1078,80.61,2.23,17.16,2019
"0692332",44,0,0,44,100,0,0,2019
"0692026",14944,372,1632,16948,88.18,2.19,9.63,2019
"0695595",43,0,17,60,71.67,0,28.33,2019
"0695621",14224,330,1831,16385,86.81,2.01,11.17,2019
"0485143",11543,369,600,12512,92.26,2.95,4.8,2019
"0485145",1100,76,23,1199,91.74,6.34,1.92,2019
"0485147",389,47,734,1170,33.25,4.02,62.74,2019
"0485172",370,42,75,487,75.98,8.62,15.4,2019
"0485173",760,55,481,1296,58.64,4.24,37.11,2019
"0485192",466,96,254,816,57.11,11.76,31.13,2019
"5554082",535,32,34,601,89.02,5.32,5.66,2019
"5554126",1062,26,306,1394,76.18,1.87,21.95,2019
"5554137",371,4,112,487,76.18,0.82,23,2019
"5554139",990,54,220,1264,78.32,4.27,17.41,2019
"5554149",422,14,149,585,72.14,2.39,25.47,2019
"5554171",1297,21,51,1369,94.74,1.53,3.73,2019
"5554173",1712,0,19,1731,98.9,0,1.1,2019
"5554177",969,61,319,1349,71.83,4.52,23.65,2019
"5554227",531,6,119,656,80.95,0.91,18.14,2019
"5554228",889,40,232,1161,76.57,3.45,19.98,2019
"5554234",711,37,116,864,82.29,4.28,13.43,2019
"5554426",1327,21,294,1642,80.82,1.28,17.9,2019
"5554433",505,27,209,741,68.15,3.64,28.21,2019
"5554446",873,30,202,1105,79,2.71,18.28,2019
"5554447",146,2,67,215,67.91,0.93,31.16,2019
"5554648",409,36,155,600,68.17,6,25.83,2019
"5554004",666,32,232,930,71.61,3.44,24.95,2019
"5554025",2241,43,314,2598,86.26,1.66,12.09,2019
"5554026",737,14,68,819,89.99,1.71,8.3,2019
"5554814",984,65,165,1214,81.05,5.35,13.59,2019
"5554820",351,20,64,435,80.69,4.6,14.71,2019
"5554830",1211,58,278,1547,78.28,3.75,17.97,2019
"5554843",4276,185,957,5418,78.92,3.41,17.66,2019
"5554854",317,11,39,367,86.38,3,10.63,2019
"5554872",934,52,258,1244,75.08,4.18,20.74,2019
"5554888",522,23,89,634,82.33,3.63,14.04,2019
"5554889",805,67,262,1134,70.99,5.91,23.1,2019
"5554891",1280,45,187,1512,84.66,2.98,12.37,2019
"5554896",545,39,204,788,69.16,4.95,25.89,2019
"5554135",795,11,241,1047,75.93,1.05,23.02,2019
"5554140",3552,67,484,4103,86.57,1.63,11.8,2019
"5554143",5622,250,1050,6922,81.22,3.61,15.17,2019
"5554151",1154,60,258,1472,78.4,4.08,17.53,2019
"5554155",2758,82,230,3070,89.84,2.67,7.49,2019
"5554162",2970,41,460,3471,85.57,1.18,13.25,2019
"5554208",2017,39,375,2431,82.97,1.6,15.43,2019
"5554209",540,18,73,631,85.58,2.85,11.57,2019
"5554214",94,7,23,124,75.81,5.65,18.55,2019
"5554302",10325,278,2056,12659,81.56,2.2,16.24,2019
"5554311",12307,578,1245,14130,87.1,4.09,8.81,2019
"5554403",8592,237,1581,10410,82.54,2.28,15.19,2019
"5554406",1200,32,181,1413,84.93,2.26,12.81,2019
"5554411",1338,49,565,1952,68.55,2.51,28.94,2019
"5554416",508,21,146,675,75.26,3.11,21.63,2019
"5554420",356,10,108,474,75.11,2.11,22.78,2019
"5554442",341,9,86,436,78.21,2.06,19.72,2019
"5554455",6201,223,849,7273,85.26,3.07,11.67,2019
"5554460",628,17,326,971,64.68,1.75,33.57,2019
"5554485",135,8,22,165,81.82,4.85,13.33,2019
"5554491",580,17,181,778,74.55,2.19,23.26,2019
"5554511",416,28,92,536,77.61,5.22,17.16,2019
"5554513",159,5,31,195,81.54,2.56,15.9,2019
"5554515",170,4,55,229,74.24,1.75,24.02,2019
"2756345",4656,134,1292,6082,76.55,2.2,21.24,2019
"2756347",1889,83,785,2757,68.52,3.01,28.47,2019
"2756350",161,5,45,211,76.3,2.37,21.33,2019
"2756641",86,8,50,144,59.72,5.56,34.72,2019
"2756654",53,5,9,67,79.1,7.46,13.43,2019
"2756657",122,0,32,154,79.22,0,20.78,2019
"3289429",2328,82,533,2943,79.1,2.79,18.11,2019
"3289501",1747,307,364,2418,72.25,12.7,15.05,2019
"0692309",130,28,43,201,64.68,13.93,21.39,2019
"0692311",8072,822,2535,11429,70.63,7.19,22.18,2019
"0692339",335,6,72,413,81.11,1.45,17.43,2019
"0692341",95,10,11,116,81.9,8.62,9.48,2019
"0692358",281,7,96,384,73.18,1.82,25,2019
"0692404",13638,1303,2907,17848,76.41,7.3,16.29,2019
"0692407",14566,1566,1276,17408,83.67,9,7.33,2019
"0692561",558,2,68,628,88.85,0.32,10.83,2019
"0692651",10089,250,565,10904,92.53,2.29,5.18,2019
"0692653",9532,130,646,10308,92.47,1.26,6.27,2019
"0692656",18485,149,610,19244,96.06,0.77,3.17,2019
"0692692",16400,191,830,17421,94.14,1.1,4.76,2019
"0692703",11198,291,2086,13575,82.49,2.14,15.37,2019
"0692782",7793,77,110,7980,97.66,0.96,1.38,2019
"0692801",16017,306,1598,17921,89.38,1.71,8.92,2019
"0692807",11730,178,529,12437,94.32,1.43,4.25,2019
"0692831",11668,133,637,12438,93.81,1.07,5.12,2019
"0692832",7329,184,809,8322,88.07,2.21,9.72,2019
"0692833",14911,335,1064,16310,91.42,2.05,6.52,2019
"0692845",5075,94,395,5564,91.21,1.69,7.1,2019
"0692612",12073,167,759,12999,92.88,1.28,5.84,2019
"0692614",9735,152,210,10097,96.41,1.51,2.08,2019
"0692627",19891,460,1908,22259,89.36,2.07,8.57,2019
"0692647",18599,476,2377,21452,86.7,2.22,11.08,2019
"0692648",17452,349,1739,19540,89.31,1.79,8.9,2019
"0692655",1950,46,426,2422,80.51,1.9,17.59,2019
"0692663",9160,230,682,10072,90.95,2.28,6.77,2019
"0692676",786,11,30,827,95.04,1.33,3.63,2019
"0692707",11904,377,1520,13801,86.25,2.73,11.01,2019
"0692841",8139,131,1114,9384,86.73,1.4,11.87,2019
"0692844",5955,101,657,6713,88.71,1.5,9.79,2019
"0692861",1928,0,47,1975,97.62,0,2.38,2019
"0692865",5887,206,313,6406,91.9,3.22,4.89,2019
"0692868",7230,125,706,8061,89.69,1.55,8.76,2019
"0692009",15944,216,404,16564,96.26,1.3,2.44,2019
"0692014",5572,80,99,5751,96.89,1.39,1.72,2019
"0692029",6605,150,251,7006,94.28,2.14,3.58,2019
"0692057",18155,275,1130,19560,92.82,1.41,5.78,2019
"0692061",562,2,208,772,72.8,0.26,26.94,2019
"0692082",5278,162,552,5992,88.08,2.7,9.21,2019
"0692102",12261,476,2020,14757,83.09,3.23,13.69,2019
"0692131",11747,93,140,11980,98.06,0.78,1.17,2019
"0692203",11121,213,568,11902,93.44,1.79,4.77,2019
"0692239",94,0,0,94,100,0,0,2019
"0692258",116,0,100,216,53.7,0,46.3,2019
"0692268",165,19,73,257,64.2,7.39,28.4,2019
"0692281",516,7,169,692,74.57,1.01,24.42,2019
"0692352",1975,99,107,2181,90.55,4.54,4.91,2019
"0692368",173,8,109,290,59.66,2.76,37.59,2019
"0692373",11017,421,1274,12712,86.67,3.31,10.02,2019
"0692374",11735,306,1880,13921,84.3,2.2,13.5,2019
"0880401",15060,398,1198,16656,90.42,2.39,7.19,2019
"0880459",782,0,232,1014,77.12,0,22.88,2019
"0880501",14079,521,2312,16912,83.25,3.08,13.67,2019
"0880514",1726,54,148,1928,89.52,2.8,7.68,2019
"0880530",1535,34,105,1674,91.7,2.03,6.27,2019
"0880634",20004,490,2138,22632,88.39,2.17,9.45,2019
"0691934",176,0,33,209,84.21,0,15.79,2019
"0691914",4423,25,173,4621,95.72,0.54,3.74,2019
"0691916",538,49,79,666,80.78,7.36,11.86,2019
"0691932",8188,242,1117,9547,85.77,2.53,11.7,2019
"0691935",2652,101,195,2948,89.96,3.43,6.61,2019
"0691950",12919,299,3745,16963,76.16,1.76,22.08,2019
"0691381",6287,45,222,6554,95.93,0.69,3.39,2019
"0691384",6805,67,219,7091,95.97,0.94,3.09,2019
"0691405",15245,874,2127,18246,83.55,4.79,11.66,2019
"0691505",11193,695,1014,12902,86.75,5.39,7.86,2019
"0691607",12016,427,1164,13607,88.31,3.14,8.55,2019
"0691701",12028,161,871,13060,92.1,1.23,6.67,2019
"0691722",8577,155,1109,9841,87.16,1.58,11.27,2019
"0691748",12383,179,996,13558,91.33,1.32,7.35,2019
"0691761",14993,634,1708,17335,86.49,3.66,9.85,2019
"0691773",9660,134,1593,11387,84.83,1.18,13.99,2019
"0691784",8562,137,324,9023,94.89,1.52,3.59,2019
"0691905",364,87,134,585,62.22,14.87,22.91,2019
"0691910",20903,552,3487,24942,83.81,2.21,13.98,2019
"0691304",15736,442,1330,17508,89.88,2.52,7.6,2019
"0691324",8902,208,902,10012,88.91,2.08,9.01,2019
"0691335",21280,686,2425,24391,87.25,2.81,9.94,2019
"0691342",21580,301,3240,25121,85.9,1.2,12.9,2019
"0691343",15577,214,2244,18035,86.37,1.19,12.44,2019
"0691105",5197,96,212,5505,94.41,1.74,3.85,2019
"0691016",12320,248,1750,14318,86.05,1.73,12.22,2019
"0691108",4310,32,240,4582,94.06,0.7,5.24,2019
"0691204",5073,39,1373,6485,78.23,0.6,21.17,2019
"0691303",8705,436,956,10097,86.21,4.32,9.47,2019
"0691306",13190,300,1164,14654,90.01,2.05,7.94,2019
"0691331",18722,545,4180,23447,79.85,2.32,17.83,2019
"0691604",13849,191,601,14641,94.59,1.3,4.1,2019
"0691608",10,0,0,10,100,0,0,2019
"0691702",12595,412,2495,15502,81.25,2.66,16.09,2019
"0691024",4070,219,375,4664,87.26,4.7,8.04,2019
"0691106",9237,435,993,10665,86.61,4.08,9.31,2019
"0691107",11345,230,891,12466,91.01,1.85,7.15,2019
"0691355",10884,161,664,11709,92.95,1.38,5.67,2019
"0691401",12701,258,1974,14933,85.05,1.73,13.22,2019
"0691406",15653,774,1971,18398,85.08,4.21,10.71,2019
"0691423",14244,188,653,15085,94.42,1.25,4.33,2019
"0691502",3606,265,1200,5071,71.11,5.23,23.66,2019
"0691602",9078,259,476,9813,92.51,2.64,4.85,2019
"0691706",15608,270,2450,18328,85.16,1.47,13.37,2019
"0691710",20387,397,1974,22758,89.58,1.74,8.67,2019
"0691711",11065,176,756,11997,92.23,1.47,6.3,2019
"0691906",973,25,313,1311,74.22,1.91,23.87,2019
"0691913",14600,118,470,15188,96.13,0.78,3.09,2019
"0691942",14752,171,1382,16305,90.48,1.05,8.48,2019
"0691948",37,0,0,37,100,0,0,2019
"0691962",575,72,50,697,82.5,10.33,7.17,2019
"0691978",3188,20,161,3369,94.63,0.59,4.78,2019
"0691001",11156,285,1228,12669,88.06,2.25,9.69,2019
"5682201",2257,43,833,3133,72.04,1.37,26.59,2019
"5682214",377,15,129,521,72.36,2.88,24.76,2019
"5682324",56,1,59,116,48.28,0.86,50.86,2019
"5682443",1631,78,372,2081,78.38,3.75,17.88,2019
"5682925",158,0,0,158,100,0,0,2019
"5682604",9007,447,1462,10916,82.51,4.09,13.39,2019
"0694951",1685,77,93,1855,90.84,4.15,5.01,2019
"0694806",17857,322,1764,19943,89.54,1.61,8.85,2019
"0694903",11013,312,1023,12348,89.19,2.53,8.28,2019
"0694930",3425,21,320,3766,90.95,0.56,8.5,2019
"0694954",12498,266,1017,13781,90.69,1.93,7.38,2019
"0693932",175,15,82,272,64.34,5.51,30.15,2019
"0693953",1582,62,98,1742,90.82,3.56,5.63,2019
"0693003",17270,406,1571,19247,89.73,2.11,8.16,2019
"0693023",6745,259,761,7765,86.86,3.34,9.8,2019
"0693103",6828,172,749,7749,88.11,2.22,9.67,2019
"0693108",3652,210,190,4052,90.13,5.18,4.69,2019
"0693601",509,16,71,596,85.4,2.68,11.91,2019
"0693603",69,0,16,85,81.18,0,18.82,2019
"0693928",16,0,0,16,100,0,0,2019
"0693245",10761,229,1223,12213,88.11,1.88,10.01,2019
"0693449",3876,66,271,4213,92,1.57,6.43,2019
"0693628",69,0,0,69,100,0,0,2019
"0693652",68,0,74,142,47.89,0,52.11,2019
"0693033",13220,225,3772,17217,76.78,1.31,21.91,2019
"0693036",11237,174,1663,13074,85.95,1.33,12.72,2019
"0693042",0,0,0,0,NA,NA,NA,2019
"0693043",12,0,0,12,100,0,0,2019
"0693064",0,0,0,0,NA,NA,NA,2019
"0693220",0,0,65,65,0,0,100,2019
"0693258",393,15,142,550,71.45,2.73,25.82,2019
"0693314",8538,239,440,9217,92.63,2.59,4.77,2019
"0693410",0,0,0,0,NA,NA,NA,2019
"0693519",0,0,0,0,NA,NA,NA,2019
"0693524",0,0,0,0,NA,NA,NA,2019
"0693558",0,0,16,16,0,0,100,2019
"0693592",37,0,34,71,52.11,0,47.89,2019
"0693619",12080,167,784,13031,92.7,1.28,6.02,2019
"0693633",0,0,0,0,NA,NA,NA,2019
"0693636",3747,83,455,4285,87.44,1.94,10.62,2019
"0693723",3172,78,656,3906,81.21,2,16.79,2019
"0693730",4055,92,307,4454,91.04,2.07,6.89,2019
"0693943",0,0,0,0,NA,NA,NA,2019
"0693235",882,14,292,1188,74.24,1.18,24.58,2019
"0693283",629,66,291,986,63.79,6.69,29.51,2019
"0693426",405,17,57,479,84.55,3.55,11.9,2019
"0693545",529,0,243,772,68.52,0,31.48,2019
"0693623",52,0,0,52,100,0,0,2019
"0693611",14480,257,1086,15823,91.51,1.62,6.86,2019
"0692114",15568,218,2295,18081,86.1,1.21,12.69,2019
"0692115",18444,568,2191,21203,86.99,2.68,10.33,2019
"0692120",11021,193,541,11755,93.76,1.64,4.6,2019
"0692122",19077,187,693,19957,95.59,0.94,3.47,2019
"0692154",19542,410,2497,22449,87.05,1.83,11.12,2019
"0692220",9158,640,2121,11919,76.84,5.37,17.8,2019
"0692233",606,48,273,927,65.37,5.18,29.45,2019
"0692274",2684,73,2279,5036,53.3,1.45,45.25,2019
"0692308",12265,319,1541,14125,86.83,2.26,10.91,2019
"0694063",9247,207,1193,10647,86.85,1.94,11.21,2019
"0880653",296,7,26,329,89.97,2.13,7.9,2019
"0880734",936,31,207,1174,79.73,2.64,17.63,2019
"0880742",79,2,14,95,83.16,2.11,14.74,2019
"0880825",131,1,29,161,81.37,0.62,18.01,2019
"0880744",128,2,47,177,72.32,1.13,26.55,2019
"0880755",19,0,14,33,57.58,0,42.42,2019
"4073761",80,8,44,132,60.61,6.06,33.33,2019
"4073771",106,8,38,152,69.74,5.26,25,2019
"4073832",310,12,101,423,73.29,2.84,23.88,2019
"4073843",222,20,96,338,65.68,5.92,28.4,2019
"4073852",621,8,143,772,80.44,1.04,18.52,2019
"4073853",146,4,31,181,80.66,2.21,17.13,2019
"4073858",443,36,157,636,69.65,5.66,24.69,2019
"4073860",367,21,123,511,71.82,4.11,24.07,2019
"4877831",929,36,201,1166,79.67,3.09,17.24,2019
"4877837",507,3,234,744,68.15,0.4,31.45,2019
"4877840",15252,3755,1402,20409,74.73,18.4,6.87,2019
"4877969",56,9,8,73,76.71,12.33,10.96,2019
"4877990",222,9,80,311,71.38,2.89,25.72,2019
"4877016",6950,303,2426,9679,71.8,3.13,25.06,2019
"4877018",9074,141,1719,10934,82.99,1.29,15.72,2019
"4877029",3916,149,1582,5647,69.35,2.64,28.01,2019
"4877044",13007,316,971,14294,91,2.21,6.79,2019
"4877048",4588,166,1287,6041,75.95,2.75,21.3,2019
"4877051",4111,262,2006,6379,64.45,4.11,31.45,2019
"4877054",11941,344,812,13097,91.17,2.63,6.2,2019
"4877059",5711,46,142,5899,96.81,0.78,2.41,2019
"4877062",8763,217,565,9545,91.81,2.27,5.92,2019
"4877066",9491,237,1076,10804,87.85,2.19,9.96,2019
"4877075",10567,257,2129,12953,81.58,1.98,16.44,2019
"4877078",3674,77,889,4640,79.18,1.66,19.16,2019
"4877085",4136,82,1056,5274,78.42,1.55,20.02,2019
"4877950",54,0,28,82,65.85,0,34.15,2019
"4877957",2127,33,787,2947,72.18,1.12,26.71,2019
"4877975",474,11,158,643,73.72,1.71,24.57,2019
"4877979",4905,101,1214,6220,78.86,1.62,19.52,2019
"4877988",104,14,38,156,66.67,8.97,24.36,2019
"4877482",440,64,331,835,52.69,7.66,39.64,2019
"4877484",2655,56,870,3581,74.14,1.56,24.29,2019
"4877486",2204,37,395,2636,83.61,1.4,14.98,2019
"4877506",8541,265,1892,10698,79.84,2.48,17.69,2019
"4877518",3082,33,431,3546,86.91,0.93,12.15,2019
"4877520",8839,717,2613,12169,72.64,5.89,21.47,2019
"4877532",8648,213,1785,10646,81.23,2,16.77,2019
"4877533",286,0,61,347,82.42,0,17.58,2019
"4877541",4933,331,1188,6452,76.46,5.13,18.41,2019
"4877561",41,0,2,43,95.35,0,4.65,2019
"4877565",3354,101,341,3796,88.36,2.66,8.98,2019
"4877577",408,2,128,538,75.84,0.37,23.79,2019
"4877586",8403,87,262,8752,96.01,0.99,2.99,2019
"4877598",9637,529,1078,11244,85.71,4.7,9.59,2019
"4877612",2367,192,808,3367,70.3,5.7,24,2019
"4877619",4739,76,886,5701,83.13,1.33,15.54,2019
"4877002",4038,192,448,4678,86.32,4.1,9.58,2019
"4877091",7260,112,2539,9911,73.25,1.13,25.62,2019
"4877024",14313,314,591,15218,94.05,2.06,3.88,2019
"4877036",17326,757,8417,26500,65.38,2.86,31.76,2019
"4877046",689,55,65,809,85.17,6.8,8.03,2019
"4877049",9620,143,1046,10809,89,1.32,9.68,2019
"4877061",6784,90,1826,8700,77.98,1.03,20.99,2019
"4877073",11489,383,1873,13745,83.59,2.79,13.63,2019
"4877076",6021,277,4084,10382,57.99,2.67,39.34,2019
"4877079",11503,126,646,12275,93.71,1.03,5.26,2019
"4877080",12899,240,2086,15225,84.72,1.58,13.7,2019
"4877087",8646,450,2013,11109,77.83,4.05,18.12,2019
"1762610",33,0,29,62,53.23,0,46.77,2019
"1762928",72,0,23,95,75.79,0,24.21,2019
"1762914",545,8,367,920,59.24,0.87,39.89,2019
"1762917",612,43,239,894,68.46,4.81,26.73,2019
"1762924",995,25,139,1159,85.85,2.16,11.99,2019
"1762931",377,20,179,576,65.45,3.47,31.08,2019
"1762034",4837,189,388,5414,89.34,3.49,7.17,2019
"1762049",1942,125,526,2593,74.89,4.82,20.29,2019
"1762056",2811,123,825,3759,74.78,3.27,21.95,2019
"1762065",32,0,13,45,71.11,0,28.89,2019
"1762080",647,12,262,921,70.25,1.3,28.45,2019
"1762083",56,0,9,65,86.15,0,13.85,2019
"1762090",286,27,247,560,51.07,4.82,44.11,2019
"1762203",1548,285,1141,2974,52.05,9.58,38.37,2019
"1762217",253,23,55,331,76.44,6.95,16.62,2019
"1762218",478,8,93,579,82.56,1.38,16.06,2019
"4875421",113,22,57,192,58.85,11.46,29.69,2019
"4875453",743,31,352,1126,65.99,2.75,31.26,2019
"4875474",3871,208,1313,5392,71.79,3.86,24.35,2019
"4875477",233,34,119,386,60.36,8.81,30.83,2019
"4875492",120,11,64,195,61.54,5.64,32.82,2019
"4875561",1332,92,542,1966,67.75,4.68,27.57,2019
"4875565",60,0,25,85,70.59,0,29.41,2019
"4875572",1158,48,448,1654,70.01,2.9,27.09,2019
"4875605",10607,173,1616,12396,85.57,1.4,13.04,2019
"4875639",630,15,449,1094,57.59,1.37,41.04,2019
"4875670",3318,192,2271,5781,57.39,3.32,39.28,2019
"4875684",1578,82,875,2535,62.25,3.23,34.52,2019
"4875692",1032,88,343,1463,70.54,6.02,23.44,2019
"4875708",1667,24,539,2230,74.75,1.08,24.17,2019
"4875750",844,163,348,1355,62.29,12.03,25.68,2019
"4875759",4,0,19,23,17.39,0,82.61,2019
"4875778",897,87,230,1214,73.89,7.17,18.95,2019
"4875035",23286,450,484,24220,96.14,1.86,2,2019
"4875038",10414,418,1549,12381,84.11,3.38,12.51,2019
"4875051",8643,356,3755,12754,67.77,2.79,29.44,2019
"4875060",11071,260,2487,13818,80.12,1.88,18,2019
"4875856",78,0,0,78,100,0,0,2019
"4875024",17287,176,328,17791,97.17,0.99,1.84,2019
"4875028",15763,163,336,16262,96.93,1,2.07,2019
"4875039",9640,92,428,10160,94.88,0.91,4.21,2019
"4875041",7639,274,1286,9199,83.04,2.98,13.98,2019
"4875043",18989,457,1642,21088,90.05,2.17,7.79,2019
"4875056",21165,414,958,22537,93.91,1.84,4.25,2019
"4875076",2839,181,302,3322,85.46,5.45,9.09,2019
"4875102",339,6,163,508,66.73,1.18,32.09,2019
"4875082",8207,56,147,8410,97.59,0.67,1.75,2019
"4875093",17930,172,700,18802,95.36,0.91,3.72,2019
"4875103",3933,331,1200,5464,71.98,6.06,21.96,2019
"4875116",5155,225,1194,6574,78.41,3.42,18.16,2019
"4875117",1153,26,308,1487,77.54,1.75,20.71,2019
"4875126",13466,290,524,14280,94.3,2.03,3.67,2019
"4879765",5467,145,347,5959,91.74,2.43,5.82,2019
"4879109",15702,312,2221,18235,86.11,1.71,12.18,2019
"4879225",286,10,80,376,76.06,2.66,21.28,2019
"4879226",712,35,374,1121,63.51,3.12,33.36,2019
"4879227",390,20,139,549,71.04,3.64,25.32,2019
"4879234",14,0,0,14,100,0,0,2019
"4879248",450,13,224,687,65.5,1.89,32.61,2019
"4879251",2,1,5,8,25,12.5,62.5,2019
"4879256",84,0,62,146,57.53,0,42.47,2019
"4879257",242,13,88,343,70.55,3.79,25.66,2019
"4879261",112,9,42,163,68.71,5.52,25.77,2019
"4879336",4658,169,1223,6050,76.99,2.79,20.21,2019
"4879339",1601,91,606,2298,69.67,3.96,26.37,2019
"4879344",22,0,10,32,68.75,0,31.25,2019
"4879781",60,13,19,92,65.22,14.13,20.65,2019
"4879785",20,0,15,35,57.14,0,42.86,2019
"4879831",4,0,0,4,100,0,0,2019
"4879843",694,27,233,954,72.75,2.83,24.42,2019
"4879124",3170,134,140,3444,92.04,3.89,4.07,2019
"4879062",44,0,14,58,75.86,0,24.14,2019
"4879091",21,0,0,21,100,0,0,2019
"4879237",128,4,71,203,63.05,1.97,34.98,2019
"4879244",220,26,57,303,72.61,8.58,18.81,2019
"4879346",523,35,252,810,64.57,4.32,31.11,2019
"4879351",425,23,94,542,78.41,4.24,17.34,2019
"4879749",76,10,14,100,76,10,14,2019
"4879755",38,0,23,61,62.3,0,37.7,2019
"4879764",5541,113,1360,7014,79,1.61,19.39,2019
"4879788",122,14,104,240,50.83,5.83,43.33,2019
"4879789",207,8,39,254,81.5,3.15,15.35,2019
"4879849",2666,37,660,3363,79.27,1.1,19.63,2019
"4879782",820,114,413,1347,60.88,8.46,30.66,2019
"4879851",164,4,49,217,75.58,1.84,22.58,2019
"4879010",118,11,41,170,69.41,6.47,24.12,2019
"4879036",1437,48,242,1727,83.21,2.78,14.01,2019
"4879355",494,7,119,620,79.68,1.13,19.19,2019
"4879356",1180,9,309,1498,78.77,0.6,20.63,2019
"4879363",1559,83,346,1988,78.42,4.18,17.4,2019
"4879376",5,0,9,14,35.71,0,64.29,2019
"4879414",6567,129,1006,7702,85.26,1.67,13.06,2019
"1762288",952,31,200,1183,80.47,2.62,16.91,2019
"1762293",1371,46,319,1736,78.97,2.65,18.38,2019
"1762312",606,4,202,812,74.63,0.49,24.88,2019
"1762319",70,1,34,105,66.67,0.95,32.38,2019
"1762691",714,26,154,894,79.87,2.91,17.23,2019
"1762803",351,12,62,425,82.59,2.82,14.59,2019
"1762814",639,13,116,768,83.2,1.69,15.1,2019
"1762824",629,22,177,828,75.97,2.66,21.38,2019
"1762825",54,2,29,85,63.53,2.35,34.12,2019
"1762839",2219,89,401,2709,81.91,3.29,14.8,2019
"1762848",218,19,51,288,75.69,6.6,17.71,2019
"1762854",487,25,132,644,75.62,3.88,20.5,2019
"1762860",150,5,71,226,66.37,2.21,31.42,2019
"1762871",186,36,54,276,67.39,13.04,19.57,2019
"1762882",799,23,184,1006,79.42,2.29,18.29,2019
"1762549",1983,56,184,2223,89.2,2.52,8.28,2019
"1762536",197,69,22,288,68.4,23.96,7.64,2019
"1762543",177,5,50,232,76.29,2.16,21.55,2019
"1762545",367,29,103,499,73.55,5.81,20.64,2019
"0880821",320,0,59,379,84.43,0,15.57,2019
"0880861",87,0,15,102,85.29,0,14.71,2019
"0880905",6101,230,1140,7471,81.66,3.08,15.26,2019
"0880916",12604,193,1235,14032,89.82,1.38,8.8,2019
"0880736",157,7,30,194,80.93,3.61,15.46,2019
"0880807",1472,18,286,1776,82.88,1.01,16.1,2019
"0880819",318,13,56,387,82.17,3.36,14.47,2019
"0880832",201,7,89,297,67.68,2.36,29.97,2019
"0880907",11394,266,1174,12834,88.78,2.07,9.15,2019
"0880911",10877,99,935,11911,91.32,0.83,7.85,2019
"0880926",426,34,94,554,76.9,6.14,16.97,2019
"0880303",10281,397,439,11117,92.48,3.57,3.95,2019
"0880427",342,8,92,442,77.38,1.81,20.81,2019
"0880432",71,0,29,100,71,0,29,2019
"0880442",664,3,44,711,93.39,0.42,6.19,2019
"0880444",488,25,58,571,85.46,4.38,10.16,2019
"0880454",510,26,0,536,95.15,4.85,0,2019
"0880455",163,18,55,236,69.07,7.63,23.31,2019
"0880456",223,0,79,302,73.84,0,26.16,2019
"0880457",83,0,11,94,88.3,0,11.7,2019
"0880476",71,3,10,84,84.52,3.57,11.9,2019
"0880479",4,0,0,4,100,0,0,2019
"0880482",430,0,12,442,97.29,0,2.71,2019
"0880483",222,0,31,253,87.75,0,12.25,2019
"0880487",6341,69,350,6760,93.8,1.02,5.18,2019
"0880498",2401,132,329,2862,83.89,4.61,11.5,2019
"0880512",693,9,88,790,87.72,1.14,11.14,2019
"0880525",20524,762,1335,22621,90.73,3.37,5.9,2019
"0880526",17101,512,1032,18645,91.72,2.75,5.53,2019
"0880535",910,30,218,1158,78.58,2.59,18.83,2019
"0880537",16151,443,1736,18330,88.11,2.42,9.47,2019
"0880538",17523,669,1518,19710,88.9,3.39,7.7,2019
"0880601",10807,368,1621,12796,84.46,2.88,12.67,2019
"0880611",291,13,29,333,87.39,3.9,8.71,2019
"0880642",1536,44,216,1796,85.52,2.45,12.03,2019
"0880652",202,0,73,275,73.45,0,26.55,2019
"0880727",110,84,77,271,40.59,31,28.41,2019
"0880728",305,14,78,397,76.83,3.53,19.65,2019
"0880743",402,6,80,488,82.38,1.23,16.39,2019
"0880801",78,0,11,89,87.64,0,12.36,2019
"0880802",77,0,10,87,88.51,0,11.49,2019
"0880809",528,0,27,555,95.14,0,4.86,2019
"0880812",87,4,16,107,81.31,3.74,14.95,2019
"0880814",1446,32,85,1563,92.51,2.05,5.44,2019
"0880822",87,4,26,117,74.36,3.42,22.22,2019
"0880829",2522,75,161,2758,91.44,2.72,5.84,2019
"0880830",50,9,20,79,63.29,11.39,25.32,2019
"0880910",10204,283,1546,12033,84.8,2.35,12.85,2019
"0880005",10420,149,509,11078,94.06,1.35,4.59,2019
"0880014",15663,602,1730,17995,87.04,3.35,9.61,2019
"0880019",898,54,0,952,94.33,5.67,0,2019
"0880020",18504,408,855,19767,93.61,2.06,4.33,2019
"0880112",13207,146,498,13851,95.35,1.05,3.6,2019
"0485708",1182,24,0,1206,98.01,1.99,0,2019
"0485617",375,10,233,618,60.68,1.62,37.7,2019
"0485627",412,3,82,497,82.9,0.6,16.5,2019
"0485654",0,0,0,0,NA,NA,NA,2019
"0485736",1339,24,392,1755,76.3,1.37,22.34,2019
"0485932",126,0,21,147,85.71,0,14.29,2019
"4877092",11300,370,2284,13954,80.98,2.65,16.37,2019
"4877095",22752,267,1095,24114,94.35,1.11,4.54,2019
"4877448",16,0,47,63,25.4,0,74.6,2019
"4877455",605,8,115,728,83.1,1.1,15.8,2019
"4877470",118,0,35,153,77.12,0,22.88,2019
"4877477",11712,163,1059,12934,90.55,1.26,8.19,2019
"4877478",8977,156,470,9603,93.48,1.62,4.89,2019
"4877564",548,0,166,714,76.75,0,23.25,2019
"4875702",5419,297,2220,7936,68.28,3.74,27.97,2019
"4875754",1717,186,625,2528,67.92,7.36,24.72,2019
"4875763",1738,59,544,2341,74.24,2.52,23.24,2019
"4875006",15265,253,3062,18580,82.16,1.36,16.48,2019
"4875019",15487,167,558,16212,95.53,1.03,3.44,2019
"4875021",2350,139,823,3312,70.95,4.2,24.85,2019
"4875025",17924,293,445,18662,96.05,1.57,2.38,2019
"4875160",6403,547,1363,8313,77.02,6.58,16.4,2019
"4875201",9879,235,221,10335,95.59,2.27,2.14,2019
"4875210",1484,190,1194,2868,51.74,6.62,41.63,2019
"4875212",5113,259,2551,7923,64.53,3.27,32.2,2019
"4875240",7956,216,1943,10115,78.66,2.14,19.21,2019
"4875243",23061,765,4481,28307,81.47,2.7,15.83,2019
"4875246",744,120,479,1343,55.4,8.94,35.67,2019
"4875249",4675,86,625,5386,86.8,1.6,11.6,2019
"4875413",77,19,18,114,67.54,16.67,15.79,2019
"4875417",595,89,310,994,59.86,8.95,31.19,2019
"4875423",874,8,247,1129,77.41,0.71,21.88,2019
"4875426",1203,174,548,1925,62.49,9.04,28.47,2019
"4875436",630,11,237,878,71.75,1.25,26.99,2019
"4875439",299,6,93,398,75.13,1.51,23.37,2019
"4875457",1870,59,386,2315,80.78,2.55,16.67,2019
"4875002",21394,238,782,22414,95.45,1.06,3.49,2019
"4875010",11272,149,413,11834,95.25,1.26,3.49,2019
"4875023",17296,141,759,18196,95.05,0.77,4.17,2019
"4875042",9373,453,1486,11312,82.86,4,13.14,2019
"4875075",13354,215,852,14421,92.6,1.49,5.91,2019
"4875114",1644,170,199,2013,81.67,8.45,9.89,2019
"4875135",1971,57,330,2358,83.59,2.42,13.99,2019
"4875143",3941,162,1236,5339,73.82,3.03,23.15,2019
"4875144",969,70,322,1361,71.2,5.14,23.66,2019
"4875152",1444,46,146,1636,88.26,2.81,8.92,2019
"4875163",822,65,277,1164,70.62,5.58,23.8,2019
"4875165",13535,446,1478,15459,87.55,2.89,9.56,2019
"4875173",1228,23,170,1421,86.42,1.62,11.96,2019
"4875182",1727,14,119,1860,92.85,0.75,6.4,2019
"4875204",16121,255,1252,17628,91.45,1.45,7.1,2019
"4875216",8396,895,9191,18482,45.43,4.84,49.73,2019
"4875217",14029,507,9839,24375,57.55,2.08,40.37,2019
"4875220",9945,1534,2923,14402,69.05,10.65,20.3,2019
"4875224",8379,275,2620,11274,74.32,2.44,23.24,2019
"4875238",10364,301,2090,12755,81.25,2.36,16.39,2019
"4875422",958,17,188,1163,82.37,1.46,16.17,2019
"4875428",2665,158,812,3635,73.31,4.35,22.34,2019
"4875433",806,37,208,1051,76.69,3.52,19.79,2019
"4875134",5652,502,1120,7274,77.7,6.9,15.4,2019
"4875226",1391,213,329,1933,71.96,11.02,17.02,2019
"4875969",1050,0,353,1403,74.84,0,25.16,2019
"4875125",1642,65,356,2063,79.59,3.15,17.26,2019
"4875094",5906,115,112,6133,96.3,1.88,1.83,2019
"4875227",11617,553,5727,17897,64.91,3.09,32,2019
"4875132",602,0,0,602,100,0,0,2019
"4875137",6173,160,599,6932,89.05,2.31,8.64,2019
"4875149",15838,467,1833,18138,87.32,2.57,10.11,2019
"4875150",17358,650,3078,21086,82.32,3.08,14.6,2019
"4875202",1372,67,58,1497,91.65,4.48,3.87,2019
"4875205",8785,134,397,9316,94.3,1.44,4.26,2019
"4875214",14375,438,1430,16243,88.5,2.7,8.8,2019
"4875251",1366,196,178,1740,78.51,11.26,10.23,2019
"4875562",63,0,0,63,100,0,0,2019
"4875570",2166,97,1035,3298,65.68,2.94,31.38,2019
"4875601",4397,77,1183,5657,77.73,1.36,20.91,2019
"4875638",1815,11,477,2303,78.81,0.48,20.71,2019
"4875651",596,52,195,843,70.7,6.17,23.13,2019
"4875654",2957,477,1280,4714,62.73,10.12,27.15,2019
"4875704",2195,27,812,3034,72.35,0.89,26.76,2019
"4875756",1228,74,228,1530,80.26,4.84,14.9,2019
"4875757",3805,53,513,4371,87.05,1.21,11.74,2019
"4875760",671,20,241,932,72,2.15,25.86,2019
"4875765",2279,150,541,2970,76.73,5.05,18.22,2019
"4875771",6277,168,1016,7461,84.13,2.25,13.62,2019
"4875773",3845,166,942,4953,77.63,3.35,19.02,2019
"4875790",1008,96,354,1458,69.14,6.58,24.28,2019
"4875831",1343,101,529,1973,68.07,5.12,26.81,2019
"4877904",9091,249,1264,10604,85.73,2.35,11.92,2019
"4877951",141,111,331,583,24.19,19.04,56.78,2019
"4877954",2286,107,1223,3616,63.22,2.96,33.82,2019
"4877973",8,0,0,8,100,0,0,2019
"4877983",529,31,155,715,73.99,4.34,21.68,2019
"4877083",19388,699,2251,22338,86.79,3.13,10.08,2019
"4877367",14,0,32,46,30.43,0,69.57,2019
"4877354",11607,158,562,12327,94.16,1.28,4.56,2019
"4877358",1431,15,497,1943,73.65,0.77,25.58,2019
"4877363",771,2,509,1282,60.14,0.16,39.7,2019
"4877369",94,15,123,232,40.52,6.47,53.02,2019
"4877380",11168,280,538,11986,93.18,2.34,4.49,2019
"4877401",6735,51,283,7069,95.28,0.72,4,2019
"4877412",7,0,0,7,100,0,0,2019
"4877430",678,3,71,752,90.16,0.4,9.44,2019
"4877433",24812,1014,1396,27222,91.15,3.72,5.13,2019
"4877442",240,22,61,323,74.3,6.81,18.89,2019
"4877457",91,31,113,235,38.72,13.19,48.09,2019
"4877458",50,24,56,130,38.46,18.46,43.08,2019
"4877461",3223,195,471,3889,82.87,5.01,12.11,2019
"4877467",0,17,0,17,0,100,0,2019
"4877471",9644,259,3196,13099,73.62,1.98,24.4,2019
"4877483",92,0,15,107,85.98,0,14.02,2019
"4877504",7861,69,948,8878,88.54,0.78,10.68,2019
"4877545",6411,83,619,7113,90.13,1.17,8.7,2019
"4877566",9859,373,1006,11238,87.73,3.32,8.95,2019
"4877575",4965,55,1153,6173,80.43,0.89,18.68,2019
"4877578",6425,83,632,7140,89.99,1.16,8.85,2019
"4877611",2615,52,388,3055,85.6,1.7,12.7,2019
"1762553",116,11,55,182,63.74,6.04,30.22,2019
"1762555",148,8,19,175,84.57,4.57,10.86,2019
"1762557",2399,40,683,3122,76.84,1.28,21.88,2019
"1762565",2343,69,795,3207,73.06,2.15,24.79,2019
"1762601",94,0,36,130,72.31,0,27.69,2019
"1762438",97,0,18,115,84.35,0,15.65,2019
"1762360",539,12,66,617,87.36,1.94,10.7,2019
"1762410",360,17,55,432,83.33,3.94,12.73,2019
"1761375",411,13,102,526,78.14,2.47,19.39,2019
"1761431",84,2,25,111,75.68,1.8,22.52,2019
"1761337",143,8,28,179,79.89,4.47,15.64,2019
"1761488",390,38,66,494,78.95,7.69,13.36,2019
"1761443",3763,210,1557,5530,68.05,3.8,28.16,2019
"1761465",447,5,57,509,87.82,0.98,11.2,2019
"1761476",170,2,8,180,94.44,1.11,4.44,2019
"1761483",606,8,222,836,72.49,0.96,26.56,2019
"1761516",237,3,58,298,79.53,1.01,19.46,2019
"1761523",3532,90,689,4311,81.93,2.09,15.98,2019
"1761524",84,0,37,121,69.42,0,30.58,2019
"1761534",539,6,122,667,80.81,0.9,18.29,2019
"1761559",976,21,151,1148,85.02,1.83,13.15,2019
"1761603",4374,220,1649,6243,70.06,3.52,26.41,2019
"1761013",170,2,21,193,88.08,1.04,10.88,2019
"1761822",9062,321,539,9922,91.33,3.24,5.43,2019
"1761831",49,0,13,62,79.03,0,20.97,2019
"1761870",435,9,97,541,80.41,1.66,17.93,2019
"1761840",180,0,59,239,75.31,0,24.69,2019
"2963073",303,0,0,303,100,0,0,2019
"2963079",27,0,0,27,100,0,0,2019
"2963155",0,0,0,0,NA,NA,NA,2019
"2963368",14250,296,1232,15778,90.32,1.88,7.81,2019
"2963467",5,0,8,13,38.46,0,61.54,2019
"2963666",5,0,22,27,18.52,0,81.48,2019
"2963744",23,0,14,37,62.16,0,37.84,2019
"2963745",4,0,0,4,100,0,0,2019
"2963746",11,0,4,15,73.33,0,26.67,2019
"2963902",0,0,0,0,NA,NA,NA,2019
"2963962",35,0,16,51,68.63,0,31.37,2019
"2963104",8181,170,1171,9522,85.92,1.79,12.3,2019
"2963020",6352,153,1419,7924,80.16,1.93,17.91,2019
"4876685",17,0,15,32,53.12,0,46.88,2019
"4876701",495,65,146,706,70.11,9.21,20.68,2019
"4876712",8909,355,743,10007,89.03,3.55,7.42,2019
"4876823",840,69,256,1165,72.1,5.92,21.97,2019
"4876859",638,48,264,950,67.16,5.05,27.79,2019
"4876861",485,11,121,617,78.61,1.78,19.61,2019
"4876864",189,3,109,301,62.79,1,36.21,2019
"4876884",38,0,3,41,92.68,0,7.32,2019
"4876888",71,0,15,86,82.56,0,17.44,2019
"4876936",720,28,327,1075,66.98,2.6,30.42,2019
"4876065",11483,212,473,12168,94.37,1.74,3.89,2019
"4876067",5233,193,1477,6903,75.81,2.8,21.4,2019
"4876660",132,1,36,169,78.11,0.59,21.3,2019
"4876667",2474,157,1183,3814,64.87,4.12,31.02,2019
"4876708",7324,420,1996,9740,75.2,4.31,20.49,2019
"4876848",23,0,8,31,74.19,0,25.81,2019
"4876854",125,0,38,163,76.69,0,23.31,2019
"4876869",43,0,0,43,100,0,0,2019
"4876870",61,0,34,95,64.21,0,35.79,2019
"0485939",1284,17,249,1550,82.84,1.1,16.06,2019
"0485346",1173,133,1079,2385,49.18,5.58,45.24,2019
"0485364",20369,693,5234,26296,77.46,2.64,19.9,2019
"0485534",784,15,208,1007,77.86,1.49,20.66,2019
"0485542",323,81,301,705,45.82,11.49,42.7,2019
"0485935",1644,99,233,1976,83.2,5.01,11.79,2019
"1683524",276,12,105,393,70.23,3.05,26.72,2019
"1683533",93,13,7,113,82.3,11.5,6.19,2019
"1683536",1190,82,565,1837,64.78,4.46,30.76,2019
"1683537",371,8,81,460,80.65,1.74,17.61,2019
"1683546",198,13,46,257,77.04,5.06,17.9,2019
"1683547",87,6,86,179,48.6,3.35,48.04,2019
"1683619",2501,179,414,3094,80.83,5.79,13.38,2019
"1683626",366,16,62,444,82.43,3.6,13.96,2019
"1683633",174,0,80,254,68.5,0,31.5,2019
"1683634",6625,112,642,7379,89.78,1.52,8.7,2019
"1683612",580,54,196,830,69.88,6.51,23.61,2019
"5683012",18,68,0,86,20.93,79.07,0,2019
"5683111",250,0,12,262,95.42,0,4.58,2019
"5683124",61,0,10,71,85.92,0,14.08,2019
"1683215",27,0,0,27,100,0,0,2019
"1683220",72,4,0,76,94.74,5.26,0,2019
"1683835",7591,140,942,8673,87.52,1.61,10.86,2019
"1683837",1007,82,205,1294,77.82,6.34,15.84,2019
"1683845",511,0,78,589,86.76,0,13.24,2019
"1683848",65,0,26,91,71.43,0,28.57,2019
"1683858",4954,349,526,5829,84.99,5.99,9.02,2019
"1683860",1940,65,362,2367,81.96,2.75,15.29,2019
"1683869",1568,95,285,1948,80.49,4.88,14.63,2019
"1683676",1149,98,397,1644,69.89,5.96,24.15,2019
"1683704",12689,363,2920,15972,79.45,2.27,18.28,2019
"1683404",7742,365,892,8999,86.03,4.06,9.91,2019
"1683424",156,0,0,156,100,0,0,2019
"1683435",173,10,8,191,90.58,5.24,4.19,2019
"1683443",262,18,62,342,76.61,5.26,18.13,2019
"1683449",69,0,21,90,76.67,0,23.33,2019
"1683469",13,0,0,13,100,0,0,2019
"1683525",111,0,37,148,75,0,25,2019
"1683526",80,3,36,119,67.23,2.52,30.25,2019
"1683543",235,8,53,296,79.39,2.7,17.91,2019
"1683615",339,31,56,426,79.58,7.28,13.15,2019
"1683627",136,11,111,258,52.71,4.26,43.02,2019
"1683656",183,0,32,215,85.12,0,14.88,2019
"1683661",3057,218,587,3862,79.16,5.64,15.2,2019
"4984025",6425,164,169,6758,95.07,2.43,2.5,2019
"4984028",160,34,0,194,82.47,17.53,0,2019
"4984044",7127,35,739,7901,90.2,0.44,9.35,2019
"4984056",994,8,0,1002,99.2,0.8,0,2019
"4984328",451,8,47,506,89.13,1.58,9.29,2019
"4984314",291,3,33,327,88.99,0.92,10.09,2019
"4984319",2219,12,120,2351,94.39,0.51,5.1,2019
"4984321",12792,950,1208,14950,85.57,6.35,8.08,2019
"4984332",2223,65,99,2387,93.13,2.72,4.15,2019
"1683311",278,8,20,306,90.85,2.61,6.54,2019
"1683332",765,25,275,1065,71.83,2.35,25.82,2019
"1683335",449,6,139,594,75.59,1.01,23.4,2019
"1683341",2240,24,119,2383,94,1.01,4.99,2019
"1683342",327,0,69,396,82.58,0,17.42,2019
"1683347",882,31,213,1126,78.33,2.75,18.92,2019
"4875414",872,62,234,1168,74.66,5.31,20.03,2019
"4875440",1750,189,550,2489,70.31,7.59,22.1,2019
"4875558",338,0,163,501,67.47,0,32.53,2019
"4875751",4131,113,1231,5475,75.45,2.06,22.48,2019
"4875929",590,0,114,704,83.81,0,16.19,2019
"4875148",1620,11,596,2227,72.74,0.49,26.76,2019
"4875231",13273,732,3121,17126,77.5,4.27,18.22,2019
"4875448",199,0,29,228,87.28,0,12.72,2019
"2963443",51,0,76,127,40.16,0,59.84,2019
"2963458",28,6,15,49,57.14,12.24,30.61,2019
"2963303",17824,335,1887,20046,88.92,1.67,9.41,2019
"2963332",406,30,82,518,78.38,5.79,15.83,2019
"2963339",257,9,74,340,75.59,2.65,21.76,2019
"2963385",13847,145,1152,15144,91.44,0.96,7.61,2019
"2963386",145,4,44,193,75.13,2.07,22.8,2019
"2963390",3112,110,866,4088,76.13,2.69,21.18,2019
"2963447",359,12,82,453,79.25,2.65,18.1,2019
"2963448",449,31,124,604,74.34,5.13,20.53,2019
"2963454",298,27,40,365,81.64,7.4,10.96,2019
"2963456",1313,34,488,1835,71.55,1.85,26.59,2019
"2963457",80,0,19,99,80.81,0,19.19,2019
"2963459",1161,19,275,1455,79.79,1.31,18.9,2019
"2963464",5,0,0,5,100,0,0,2019
"2963544",206,13,52,271,76.01,4.8,19.19,2019
"2963545",231,16,119,366,63.11,4.37,32.51,2019
"2963631",327,9,79,415,78.8,2.17,19.04,2019
"2963638",731,11,293,1035,70.63,1.06,28.31,2019
"2963640",9266,216,1592,11074,83.67,1.95,14.38,2019
"2963648",355,10,102,467,76.02,2.14,21.84,2019
"2963674",0,0,0,0,NA,NA,NA,2019
"2963703",2625,50,913,3588,73.16,1.39,25.45,2019
"2963732",309,7,40,356,86.8,1.97,11.24,2019
"2963735",233,11,52,296,78.72,3.72,17.57,2019
"2963747",99,8,44,151,65.56,5.3,29.14,2019
"2963760",156,6,77,239,65.27,2.51,32.22,2019
"2963775",5359,93,1224,6676,80.27,1.39,18.33,2019
"2963827",241,8,87,336,71.73,2.38,25.89,2019
"2963837",511,4,161,676,75.59,0.59,23.82,2019
"2963841",4138,104,1076,5318,77.81,1.96,20.23,2019
"2963866",124,0,50,174,71.26,0,28.74,2019
"2963017",15330,249,978,16557,92.59,1.5,5.91,2019
"2963028",8166,174,1710,10050,81.25,1.73,17.01,2019
"2963056",604,23,190,817,73.93,2.82,23.26,2019
"2963040",3093,8,122,3223,95.97,0.25,3.79,2019
"2963042",7551,215,938,8704,86.75,2.47,10.78,2019
"2963055",874,19,43,936,93.38,2.03,4.59,2019
"2963336",380,6,141,527,72.11,1.14,26.76,2019
"2963344",463,13,65,541,85.58,2.4,12.01,2019
"2963349",559,56,112,727,76.89,7.7,15.41,2019
"2963351",616,24,163,803,76.71,2.99,20.3,2019
"2963361",1411,78,507,1996,70.69,3.91,25.4,2019
"2963366",16606,490,1402,18498,89.77,2.65,7.58,2019
"2963437",391,18,156,565,69.2,3.19,27.61,2019
"2963446",171,5,52,228,75,2.19,22.81,2019
"2963453",164,7,31,202,81.19,3.47,15.35,2019
"2963463",229,24,34,287,79.79,8.36,11.85,2019
"2963465",91,0,32,123,73.98,0,26.02,2019
"2963548",236,13,117,366,64.48,3.55,31.97,2019
"2963621",353,20,214,587,60.14,3.41,36.46,2019
"4877617",49,0,0,49,100,0,0,2019
"4877622",352,13,106,471,74.73,2.76,22.51,2019
"4877655",70,0,44,114,61.4,0,38.6,2019
"4877338",13040,310,1712,15062,86.58,2.06,11.37,2019
"4877339",14665,569,501,15735,93.2,3.62,3.18,2019
"4877362",1670,19,184,1873,89.16,1.01,9.82,2019
"4877364",700,60,209,969,72.24,6.19,21.57,2019
"4877365",10205,127,1123,11455,89.09,1.11,9.8,2019
"4877371",1830,164,538,2532,72.27,6.48,21.25,2019
"4877429",25836,1730,1125,28691,90.05,6.03,3.92,2019
"4877444",132,13,62,207,63.77,6.28,29.95,2019
"4877454",0,0,0,0,NA,NA,NA,2019
"4877468",20,0,0,20,100,0,0,2019
"4877473",0,12,33,45,0,26.67,73.33,2019
"4877475",178,26,83,287,62.02,9.06,28.92,2019
"4877489",11672,196,520,12388,94.22,1.58,4.2,2019
"4877507",182,0,0,182,100,0,0,2019
"4877511",13323,537,2343,16203,82.23,3.31,14.46,2019
"4877517",1596,50,261,1907,83.69,2.62,13.69,2019
"4877535",8065,145,1667,9877,81.65,1.47,16.88,2019
"4877539",13558,1010,2108,16676,81.3,6.06,12.64,2019
"4877551",6857,187,1312,8356,82.06,2.24,15.7,2019
"4877554",3424,91,229,3744,91.45,2.43,6.12,2019
"4877560",171,0,0,171,100,0,0,2019
"4877562",3171,107,485,3763,84.27,2.84,12.89,2019
"4877590",9062,226,2078,11366,79.73,1.99,18.28,2019
"4877660",227,7,88,322,70.5,2.17,27.33,2019
"4877713",5225,95,853,6173,84.64,1.54,13.82,2019
"4877807",2964,151,403,3518,84.25,4.29,11.46,2019
"4877835",749,3,391,1143,65.53,0.26,34.21,2019
"0881633",0,0,0,0,NA,NA,NA,2019
"0881054",967,6,384,1357,71.26,0.44,28.3,2019
"4879001",62,0,7,69,89.86,0,10.14,2019
"4879005",518,13,66,597,86.77,2.18,11.06,2019
"4879013",634,0,319,953,66.53,0,33.47,2019
"4879014",1002,55,228,1285,77.98,4.28,17.74,2019
"4879029",4439,118,449,5006,88.67,2.36,8.97,2019
"4879046",188,16,39,243,77.37,6.58,16.05,2019
"4879057",375,18,100,493,76.06,3.65,20.28,2019
"4879059",209,10,44,263,79.47,3.8,16.73,2019
"4879501",678,88,315,1081,62.72,8.14,29.14,2019
"4879503",36,4,18,58,62.07,6.9,31.03,2019
"4879510",2108,89,699,2896,72.79,3.07,24.14,2019
"4879526",288,11,73,372,77.42,2.96,19.62,2019
"4879546",559,26,211,796,70.23,3.27,26.51,2019
"4879548",61,5,18,84,72.62,5.95,21.43,2019
"4879605",8588,157,2430,11175,76.85,1.4,21.74,2019
"4879606",8766,241,1216,10223,85.75,2.36,11.89,2019
"4879703",6891,169,827,7887,87.37,2.14,10.49,2019
"4879720",7863,301,2373,10537,74.62,2.86,22.52,2019
"4879731",928,10,477,1415,65.58,0.71,33.71,2019
"4879742",111,0,68,179,62.01,0,37.99,2019
"4876872",236,32,68,336,70.24,9.52,20.24,2019
"4876933",388,45,123,556,69.78,8.09,22.12,2019
"4876949",0,0,5,5,0,0,100,2019
"4876040",9641,237,1430,11308,85.26,2.1,12.65,2019
"4876048",7793,385,1309,9487,82.14,4.06,13.8,2019
"4876077",76,0,22,98,77.55,0,22.45,2019
"4876093",584,34,68,686,85.13,4.96,9.91,2019
"4876104",3723,312,2235,6270,59.38,4.98,35.65,2019
"4876109",8542,382,764,9688,88.17,3.94,7.89,2019
"4876117",8180,445,1253,9878,82.81,4.5,12.68,2019
"4876134",6811,389,1170,8370,81.37,4.65,13.98,2019
"4876137",18510,372,944,19826,93.36,1.88,4.76,2019
"4876179",19698,223,946,20867,94.4,1.07,4.53,2019
"4876180",12928,461,1440,14829,87.18,3.11,9.71,2019
"4876240",7991,509,2329,10829,73.79,4.7,21.51,2019
"4876272",1279,79,271,1629,78.51,4.85,16.64,2019
"4876443",624,12,222,858,72.73,1.4,25.87,2019
"4876446",1918,43,563,2524,75.99,1.7,22.31,2019
"4876454",370,19,281,670,55.22,2.84,41.94,2019
"4876459",76,12,22,110,69.09,10.91,20,2019
"4876463",102,5,69,176,57.95,2.84,39.2,2019
"4876466",106,0,0,106,100,0,0,2019
"4876475",227,6,115,348,65.23,1.72,33.05,2019
"4876486",334,10,112,456,73.25,2.19,24.56,2019
"4876513",11663,373,1633,13669,85.32,2.73,11.95,2019
"4876518",341,0,220,561,60.78,0,39.22,2019
"4876519",93,31,21,145,64.14,21.38,14.48,2019
"4876570",476,106,286,868,54.84,12.21,32.95,2019
"4876571",2645,47,241,2933,90.18,1.6,8.22,2019
"4876640",937,17,268,1222,76.68,1.39,21.93,2019
"4876642",1532,212,784,2528,60.6,8.39,31.01,2019
"4876671",502,41,168,711,70.6,5.77,23.63,2019
"4876801",7192,286,1846,9324,77.13,3.07,19.8,2019
"4876689",1026,59,245,1330,77.14,4.44,18.42,2019
"4876691",1772,60,528,2360,75.08,2.54,22.37,2019
"4073021",76,7,17,100,76,7,17,2019
"4073011",59,20,52,131,45.04,15.27,39.69,2019
"4073020",7533,209,858,8600,87.59,2.43,9.98,2019
"4073045",3554,142,848,4544,78.21,3.12,18.66,2019
"4073047",1055,33,312,1400,75.36,2.36,22.29,2019
"4878730",4037,22,0,4059,99.46,0.54,0,2019
"4878733",2910,0,22,2932,99.25,0,0.75,2019
"4878751",7199,311,401,7911,91,3.93,5.07,2019
"4878828",24,9,50,83,28.92,10.84,60.24,2019
"4878572",17607,595,6328,24530,71.78,2.43,25.8,2019
"4878582",6123,525,3988,10636,57.57,4.94,37.5,2019
"4878592",71,9,129,209,33.97,4.31,61.72,2019
"4878597",1314,222,109,1645,79.88,13.5,6.63,2019
"4878609",637,20,168,825,77.21,2.42,20.36,2019
"4878610",11497,127,960,12584,91.36,1.01,7.63,2019
"4878612",3537,0,356,3893,90.86,0,9.14,2019
"4878616",1721,57,855,2633,65.36,2.16,32.47,2019
"4878879",40,0,0,40,100,0,0,2019
"4878886",150,0,39,189,79.37,0,20.63,2019
"4878940",652,11,221,884,73.76,1.24,25,2019
"4878669",4462,51,154,4667,95.61,1.09,3.3,2019
"4878701",6065,127,203,6395,94.84,1.99,3.17,2019
"4878735",7183,70,356,7609,94.4,0.92,4.68,2019
"4878752",6893,281,1310,8484,81.25,3.31,15.44,2019
"1683348",118,0,0,118,100,0,0,2019
"1683353",473,7,53,533,88.74,1.31,9.94,2019
"1683425",127,0,36,163,77.91,0,22.09,2019
"1683427",548,26,34,608,90.13,4.28,5.59,2019
"1683444",283,18,108,409,69.19,4.4,26.41,2019
"1683455",1577,35,152,1764,89.4,1.98,8.62,2019
"1683463",43,0,12,55,78.18,0,21.82,2019
"4984021",1059,32,241,1332,79.5,2.4,18.09,2019
"4984039",231,10,6,247,93.52,4.05,2.43,2019
"4984041",14714,446,1421,16581,88.74,2.69,8.57,2019
"4984092",8573,253,339,9165,93.54,2.76,3.7,2019
"4984093",7090,194,211,7495,94.6,2.59,2.82,2019
"4984101",2392,133,436,2961,80.78,4.49,14.72,2019
"4984103",9631,477,673,10781,89.33,4.42,6.24,2019
"4984104",6281,524,933,7738,81.17,6.77,12.06,2019
"4984111",4905,378,1476,6759,72.57,5.59,21.84,2019
"4984320",641,38,69,748,85.7,5.08,9.22,2019
"4984325",590,13,47,650,90.77,2,7.23,2019
"4984327",229,6,11,246,93.09,2.44,4.47,2019
"4984330",94,1,32,127,74.02,0.79,25.2,2019
"4984340",990,31,136,1157,85.57,2.68,11.75,2019
"4984403",11260,435,1231,12926,87.11,3.37,9.52,2019
"4984518",267,0,35,302,88.41,0,11.59,2019
"4984520",326,3,135,464,70.26,0.65,29.09,2019
"4984623",61,0,50,111,54.95,0,45.05,2019
"4984646",442,9,75,526,84.03,1.71,14.26,2019
"4984649",218,12,13,243,89.71,4.94,5.35,2019
"4984701",2611,89,321,3021,86.43,2.95,10.63,2019
"4984752",274,6,66,346,79.19,1.73,19.08,2019
"4984753",0,0,8,8,0,0,100,2019
"4984013",262,4,20,286,91.61,1.4,6.99,2019
"4984018",78,0,0,78,100,0,0,2019
"4984113",38,0,0,38,100,0,0,2019
"4984121",14393,623,946,15962,90.17,3.9,5.93,2019
"4984301",228,2,37,267,85.39,0.75,13.86,2019
"4984307",305,11,53,369,82.66,2.98,14.36,2019
"4984312",1345,7,178,1530,87.91,0.46,11.63,2019
"4984335",3459,75,201,3735,92.61,2.01,5.38,2019
"4984404",17248,450,2760,20458,84.31,2.2,13.49,2019
"4984405",9922,185,1120,11227,88.38,1.65,9.98,2019
"4984525",228,6,104,338,67.46,1.78,30.77,2019
"4984533",98,0,0,98,100,0,0,2019
"4984651",6317,266,635,7218,87.52,3.69,8.8,2019
"4984652",231,12,57,300,77,4,19,2019
"4984660",10208,250,653,11111,91.87,2.25,5.88,2019
"4984716",132,11,9,152,86.84,7.24,5.92,2019
"4984719",8,7,19,34,23.53,20.59,55.88,2019
"4984722",316,30,98,444,71.17,6.76,22.07,2019
"4984733",56,0,0,56,100,0,0,2019
"4984735",75,8,11,94,79.79,8.51,11.7,2019
"4984739",156,3,14,173,90.17,1.73,8.09,2019
"4984754",1158,99,120,1377,84.1,7.19,8.71,2019
"4984757",419,59,120,598,70.07,9.87,20.07,2019
"0694535",1030,0,5,1035,99.52,0,0.48,2019
"0694561",10976,314,900,12190,90.04,2.58,7.38,2019
"0694567",184,11,36,231,79.65,4.76,15.58,2019
"0694585",8174,251,875,9300,87.89,2.7,9.41,2019
"0694588",12500,206,326,13032,95.92,1.58,2.5,2019
"0694592",291,0,0,291,100,0,0,2019
"2963628",4041,162,786,4989,81,3.25,15.75,2019
"2963535",20,0,5,25,80,0,20,2019
"2963537",477,14,254,745,64.03,1.88,34.09,2019
"2963546",414,19,171,604,68.54,3.15,28.31,2019
"2963561",217,16,151,384,56.51,4.17,39.32,2019
"2963565",875,82,357,1314,66.59,6.24,27.17,2019
"2963623",197,10,107,314,62.74,3.18,34.08,2019
"2963630",1062,33,296,1391,76.35,2.37,21.28,2019
"4073005",2304,99,1062,3465,66.49,2.86,30.65,2019
"4073008",5957,177,1737,7871,75.68,2.25,22.07,2019
"4073014",410,6,147,563,72.82,1.07,26.11,2019
"4073016",552,0,84,636,86.79,0,13.21,2019
"4073018",5471,762,1534,7767,70.44,9.81,19.75,2019
"4073032",57,8,32,97,58.76,8.25,32.99,2019
"4073040",546,28,168,742,73.58,3.77,22.64,2019
"4073057",673,42,188,903,74.53,4.65,20.82,2019
"4073622",70,2,35,107,65.42,1.87,32.71,2019
"4073626",289,4,100,393,73.54,1.02,25.45,2019
"4073638",50,0,36,86,58.14,0,41.86,2019
"4073642",50,0,32,82,60.98,0,39.02,2019
"4073660",87,4,64,155,56.13,2.58,41.29,2019
"4073661",116,4,39,159,72.96,2.52,24.53,2019
"4073663",339,1,80,420,80.71,0.24,19.05,2019
"4073673",90,0,29,119,75.63,0,24.37,2019
"4073728",593,6,172,771,76.91,0.78,22.31,2019
"4073735",205,0,61,266,77.07,0,22.93,2019
"4073743",31,2,4,37,83.78,5.41,10.81,2019
"4073746",10,0,4,14,71.43,0,28.57,2019
"4073750",1959,167,488,2614,74.94,6.39,18.67,2019
"4073507",7405,382,1158,8945,82.78,4.27,12.95,2019
"4073528",170,5,33,208,81.73,2.4,15.87,2019
"4073532",186,1,23,210,88.57,0.48,10.95,2019
"4073533",8307,333,1990,10630,78.15,3.13,18.72,2019
"4073543",549,19,101,669,82.06,2.84,15.1,2019
"4073567",201,17,39,257,78.21,6.61,15.18,2019
"4073570",276,31,123,430,64.19,7.21,28.6,2019
"4073573",658,29,254,941,69.93,3.08,26.99,2019
"4073627",191,0,59,250,76.4,0,23.6,2019
"4073644",4068,161,875,5104,79.7,3.15,17.14,2019
"4073659",51,2,10,63,80.95,3.17,15.87,2019
"4073729",167,5,60,232,71.98,2.16,25.86,2019
"4073731",52,0,12,64,81.25,0,18.75,2019
"4073737",1099,21,280,1400,78.5,1.5,20,2019
"4073757",101,8,10,119,84.87,6.72,8.4,2019
"4073758",49,0,6,55,89.09,0,10.91,2019
"4073801",4525,285,1077,5887,76.86,4.84,18.29,2019
"4073838",117,2,47,166,70.48,1.2,28.31,2019
"4073842",194,3,31,228,85.09,1.32,13.6,2019
"4073937",49,4,23,76,64.47,5.26,30.26,2019
"4073074",332,16,73,421,78.86,3.8,17.34,2019
"4073077",1979,105,657,2741,72.2,3.83,23.97,2019
"4073089",3477,430,563,4470,77.79,9.62,12.6,2019
"4073096",4304,135,618,5057,85.11,2.67,12.22,2019
"4073102",942,19,180,1141,82.56,1.67,15.78,2019
"4073110",10692,280,2832,13804,77.46,2.03,20.52,2019
"4073121",887,75,306,1268,69.95,5.91,24.13,2019
"4073122",4186,110,804,5100,82.08,2.16,15.76,2019
"4073439",1898,207,964,3069,61.84,6.74,31.41,2019
"4073443",1031,118,313,1462,70.52,8.07,21.41,2019
"4879745",1713,186,440,2339,73.24,7.95,18.81,2019
"4879068",1013,69,209,1291,78.47,5.34,16.19,2019
"4879080",130,20,47,197,65.99,10.15,23.86,2019
"4879082",69,0,28,97,71.13,0,28.87,2019
"4879087",189,13,40,242,78.1,5.37,16.53,2019
"4879096",574,34,174,782,73.4,4.35,22.25,2019
"4879236",65,2,7,74,87.84,2.7,9.46,2019
"4879240",14,0,8,22,63.64,0,36.36,2019
"4879259",0,0,15,15,0,0,100,2019
"4879312",240,16,98,354,67.8,4.52,27.68,2019
"4879324",10,0,4,14,71.43,0,28.57,2019
"4879329",900,30,187,1117,80.57,2.69,16.74,2019
"4879342",130,0,17,147,88.44,0,11.56,2019
"4879367",193,12,47,252,76.59,4.76,18.65,2019
"4879370",483,16,127,626,77.16,2.56,20.29,2019
"4879371",341,21,186,548,62.23,3.83,33.94,2019
"4879752",411,80,379,870,47.24,9.2,43.56,2019
"4879758",667,52,119,838,79.59,6.21,14.2,2019
"4879772",1913,91,1054,3058,62.56,2.98,34.47,2019
"4879110",5748,220,724,6692,85.89,3.29,10.82,2019
"4879111",441,24,44,509,86.64,4.72,8.64,2019
"4879119",6417,134,259,6810,94.23,1.97,3.8,2019
"4879201",1779,16,635,2430,73.21,0.66,26.13,2019
"4879220",52,8,15,75,69.33,10.67,20,2019
"4879247",23,0,5,28,82.14,0,17.86,2019
"4879311",925,60,251,1236,74.84,4.85,20.31,2019
"4879323",1586,0,566,2152,73.7,0,26.3,2019
"4879326",13,0,10,23,56.52,0,43.48,2019
"4879359",559,24,224,807,69.27,2.97,27.76,2019
"4879380",27,0,7,34,79.41,0,20.59,2019
"4879778",215,26,148,389,55.27,6.68,38.05,2019
"4879347",1521,70,534,2125,71.58,3.29,25.13,2019
"4879379",125,10,35,170,73.53,5.88,20.59,2019
"4879360",3678,80,931,4689,78.44,1.71,19.85,2019
"4879366",373,28,31,432,86.34,6.48,7.18,2019
"4879377",71,2,12,85,83.53,2.35,14.12,2019
"4879381",393,9,117,519,75.72,1.73,22.54,2019
"1762221",10645,371,1311,12327,86.36,3.01,10.64,2019
"1762232",2026,155,336,2517,80.49,6.16,13.35,2019
"1762233",1906,121,625,2652,71.87,4.56,23.57,2019
"1762240",444,47,80,571,77.76,8.23,14.01,2019
"1762244",358,13,72,443,80.81,2.93,16.25,2019
"1762245",595,13,154,762,78.08,1.71,20.21,2019
"1762254",1962,101,430,2493,78.7,4.05,17.25,2019
"1762279",0,0,0,0,NA,NA,NA,2019
"1762298",5511,266,1060,6837,80.61,3.89,15.5,2019
"1762301",10417,472,3018,13907,74.9,3.39,21.7,2019
"1762313",90,21,59,170,52.94,12.35,34.71,2019
"1762346",64,0,28,92,69.57,0,30.43,2019
"1762355",225,0,65,290,77.59,0,22.41,2019
"1762363",1731,123,468,2322,74.55,5.3,20.16,2019
"1762365",119,2,72,193,61.66,1.04,37.31,2019
"1762376",340,13,86,439,77.45,2.96,19.59,2019
"1762411",1349,49,307,1705,79.12,2.87,18.01,2019
"1762418",601,23,207,831,72.32,2.77,24.91,2019
"1762424",718,31,104,853,84.17,3.63,12.19,2019
"4878758",17240,402,3202,20844,82.71,1.93,15.36,2019
"4878801",4890,410,1923,7223,67.7,5.68,26.62,2019
"4878850",221,26,131,378,58.47,6.88,34.66,2019
"4878873",450,44,158,652,69.02,6.75,24.23,2019
"4878942",2263,54,648,2965,76.32,1.82,21.85,2019
"4878956",1248,54,626,1928,64.73,2.8,32.47,2019
"4878005",211,0,156,367,57.49,0,42.51,2019
"4878013",1810,26,321,2157,83.91,1.21,14.88,2019
"4878201",10517,1126,4664,16307,64.49,6.91,28.6,2019
"4878202",2255,326,1231,3812,59.16,8.55,32.29,2019
"4878211",5963,596,2397,8956,66.58,6.65,26.76,2019
"4878230",16411,248,1564,18223,90.06,1.36,8.58,2019
"4878520",9406,2958,5709,18073,52.04,16.37,31.59,2019
"4878401",1058,18,740,1816,58.26,0.99,40.75,2019
"4878407",668,12,141,821,81.36,1.46,17.17,2019
"4878516",4404,957,4091,9452,46.59,10.12,43.28,2019
"4878549",122,0,166,288,42.36,0,57.64,2019
"4878552",8916,522,3089,12527,71.17,4.17,24.66,2019
"4878558",141,0,78,219,64.38,0,35.62,2019
"4878559",2245,94,1609,3948,56.86,2.38,40.75,2019
"4878161",171,16,93,280,61.07,5.71,33.21,2019
"4878203",1193,195,596,1984,60.13,9.83,30.04,2019
"4878210",8511,805,3112,12428,68.48,6.48,25.04,2019
"4878213",12083,812,3381,16276,74.24,4.99,20.77,2019
"4878222",5502,545,1344,7391,74.44,7.37,18.18,2019
"4878234",932,16,0,948,98.31,1.69,0,2019
"4878250",16802,504,1597,18903,88.89,2.67,8.45,2019
"4878257",3200,46,370,3616,88.5,1.27,10.23,2019
"4878338",7,0,6,13,53.85,0,46.15,2019
"4878343",1208,141,245,1594,75.78,8.85,15.37,2019
"4878355",1285,121,668,2074,61.96,5.83,32.21,2019
"4878380",5277,409,2204,7890,66.88,5.18,27.93,2019
"4878390",968,53,789,1810,53.48,2.93,43.59,2019
"4878402",124,25,7,156,79.49,16.03,4.49,2019
"4878405",3037,27,2179,5243,57.92,0.51,41.56,2019
"4878411",7798,207,1944,9949,78.38,2.08,19.54,2019
"4878418",10585,239,1298,12122,87.32,1.97,10.71,2019
"4878576",992,10,1506,2508,39.55,0.4,60.05,2019
"4878578",2907,412,1065,4384,66.31,9.4,24.29,2019
"4878586",7972,1299,6409,15680,50.84,8.28,40.87,2019
"4879835",2100,80,1135,3315,63.35,2.41,34.24,2019
"4879848",233,23,126,382,60.99,6.02,32.98,2019
"4879902",6040,433,1594,8067,74.87,5.37,19.76,2019
"4879904",8171,359,2428,10958,74.57,3.28,22.16,2019
"4879847",57,0,4,61,93.44,0,6.56,2019
"4879853",522,19,176,717,72.8,2.65,24.55,2019
"4879908",972,16,0,988,98.38,1.62,0,2019
"4879930",6911,782,2521,10214,67.66,7.66,24.68,2019
"4879003",57,0,17,74,77.03,0,22.97,2019
"4879009",334,57,192,583,57.29,9.78,32.93,2019
"4879015",6737,199,538,7474,90.14,2.66,7.2,2019
"4879019",537,10,99,646,83.13,1.55,15.33,2019
"4879024",124,0,22,146,84.93,0,15.07,2019
"4879034",154,9,32,195,78.97,4.62,16.41,2019
"4879035",1177,110,442,1729,68.07,6.36,25.56,2019
"4879056",17,0,3,20,85,0,15,2019
"4879064",555,38,310,903,61.46,4.21,34.33,2019
"4879070",2515,223,590,3328,75.57,6.7,17.73,2019
"4879078",64,0,22,86,74.42,0,25.58,2019
"0694607",8836,309,2358,11503,76.81,2.69,20.5,2019
"0694611",15769,313,1175,17257,91.38,1.81,6.81,2019
"0694709",4590,125,269,4984,92.09,2.51,5.4,2019
"0694805",4800,87,367,5254,91.36,1.66,6.99,2019
"0694021",91,0,0,91,100,0,0,2019
"0694022",6970,89,143,7202,96.78,1.24,1.99,2019
"0694123",12963,191,615,13769,94.15,1.39,4.47,2019
"0694521",14705,220,1007,15932,92.3,1.38,6.32,2019
"0694587",20160,323,1369,21852,92.26,1.48,6.26,2019
"0694060",238,12,50,300,79.33,4,16.67,2019
"0694025",13785,412,909,15106,91.26,2.73,6.02,2019
"0694963",122,7,0,129,94.57,5.43,0,2019
"0694085",7398,342,678,8418,87.88,4.06,8.05,2019
"0694158",3603,301,557,4461,80.77,6.75,12.49,2019
"0694503",4851,125,327,5303,91.48,2.36,6.17,2019
"0694505",5367,28,128,5523,97.18,0.51,2.32,2019
"0694516",38,5,5,48,79.17,10.42,10.42,2019
"0694528",145,0,56,201,72.14,0,27.86,2019
"0694531",11531,180,768,12479,92.4,1.44,6.15,2019
"0694534",12478,137,482,13097,95.27,1.05,3.68,2019
"0694548",134,0,16,150,89.33,0,10.67,2019
"0694551",15009,248,731,15988,93.88,1.55,4.57,2019
"0694573",14,0,0,14,100,0,0,2019
"0694575",0,0,0,0,NA,NA,NA,2019
"0694582",13736,100,200,14036,97.86,0.71,1.42,2019
"0694597",9864,43,590,10497,93.97,0.41,5.62,2019
"0694613",4,0,0,4,100,0,0,2019
"0694720",26,0,0,26,100,0,0,2019
"0694850",0,0,0,0,NA,NA,NA,2019
"0694957",391,15,13,419,93.32,3.58,3.1,2019
"0695010",3543,112,287,3942,89.88,2.84,7.28,2019
"0695046",1496,0,202,1698,88.1,0,11.9,2019
"0695076",19051,465,4340,23856,79.86,1.95,18.19,2019
"0695117",9465,372,984,10821,87.47,3.44,9.09,2019
"0695118",10152,229,766,11147,91.07,2.05,6.87,2019
"0695122",11234,150,1280,12664,88.71,1.18,10.11,2019
"0690010",1861,10,158,2029,91.72,0.49,7.79,2019
"0690024",14228,1226,1061,16515,86.15,7.42,6.42,2019
"0690025",20313,413,1289,22015,92.27,1.88,5.86,2019
"0690029",10994,364,2639,13997,78.55,2.6,18.85,2019
"0690201",18215,1449,4800,24464,74.46,5.92,19.62,2019
"0690031",9507,246,1986,11739,80.99,2.1,16.92,2019
"0690035",10815,138,863,11816,91.53,1.17,7.3,2019
"0690063",9561,912,3213,13686,69.86,6.66,23.48,2019
"3289010",133,5,72,210,63.33,2.38,34.29,2019
"3289020",268,25,119,412,65.05,6.07,28.88,2019
"3289025",303,11,53,367,82.56,3,14.44,2019
"3289124",444,0,70,514,86.38,0,13.62,2019
"3289128",11678,1162,1969,14809,78.86,7.85,13.3,2019
"3289131",15902,281,609,16792,94.7,1.67,3.63,2019
"3289143",3789,299,125,4213,89.94,7.1,2.97,2019
"3289148",17175,358,1181,18714,91.78,1.91,6.31,2019
"3289149",13038,1128,659,14825,87.95,7.61,4.45,2019
"0880127",16266,252,346,16864,96.45,1.49,2.05,2019
"0880132",6893,142,175,7210,95.6,1.97,2.43,2019
"0880202",8530,513,726,9769,87.32,5.25,7.43,2019
"0880003",12376,332,1593,14301,86.54,2.32,11.14,2019
"0880012",15596,669,2479,18744,83.21,3.57,13.23,2019
"0880216",3413,151,772,4336,78.71,3.48,17.8,2019
"4073450",314,13,145,472,66.53,2.75,30.72,2019
"4073455",117,14,102,233,50.21,6.01,43.78,2019
"4073461",158,10,101,269,58.74,3.72,37.55,2019
"4073481",236,33,85,354,66.67,9.32,24.01,2019
"4073520",41,1,28,70,58.57,1.43,40,2019
"4073531",102,11,14,127,80.31,8.66,11.02,2019
"4073559",182,4,26,212,85.85,1.89,12.26,2019
"4073564",156,2,53,211,73.93,0.95,25.12,2019
"4877485",1055,50,455,1560,67.63,3.21,29.17,2019
"4877502",9177,240,1392,10809,84.9,2.22,12.88,2019
"4877547",2039,152,389,2580,79.03,5.89,15.08,2019
"4877597",173,0,95,268,64.55,0,35.45,2019
"4877629",212,3,129,344,61.63,0.87,37.5,2019
"4877632",7149,270,1172,8591,83.21,3.14,13.64,2019
"4877642",8553,139,5034,13726,62.31,1.01,36.67,2019
"4877664",794,31,195,1020,77.84,3.04,19.12,2019
"4877701",2384,81,2252,4717,50.54,1.72,47.74,2019
"4877010",590,10,0,600,98.33,1.67,0,2019
"4877020",6121,201,2348,8670,70.6,2.32,27.08,2019
"4877021",7659,492,2569,10720,71.45,4.59,23.96,2019
"4877030",4636,169,253,5058,91.66,3.34,5,2019
"4877037",2807,94,2235,5136,54.65,1.83,43.52,2019
"4877045",7990,173,2228,10391,76.89,1.66,21.44,2019
"4877082",19572,416,2320,22308,87.74,1.86,10.4,2019
"4877084",30346,749,3987,35082,86.5,2.13,11.36,2019
"4877301",8359,193,1951,10503,79.59,1.84,18.58,2019
"4877316",7677,272,479,8428,91.09,3.23,5.68,2019
"4877318",5404,122,750,6276,86.11,1.94,11.95,2019
"4877340",9358,453,1457,11268,83.05,4.02,12.93,2019
"4877346",20344,299,801,21444,94.87,1.39,3.74,2019
"4877355",8908,251,475,9634,92.46,2.61,4.93,2019
"4877373",18237,730,1621,20588,88.58,3.55,7.87,2019
"4877434",1200,10,392,1602,74.91,0.62,24.47,2019
"4877446",466,41,303,810,57.53,5.06,37.41,2019
"4877466",141,0,88,229,61.57,0,38.43,2019
"4877469",15251,169,1796,17216,88.59,0.98,10.43,2019
"4877336",3906,13,650,4569,85.49,0.28,14.23,2019
"4877094",3317,6,47,3370,98.43,0.18,1.39,2019
"4877096",10494,509,1992,12995,80.75,3.92,15.33,2019
"4877379",26108,394,1151,27653,94.41,1.42,4.16,2019
"4877386",17274,210,697,18181,95.01,1.16,3.83,2019
"4877389",11575,68,391,12034,96.19,0.57,3.25,2019
"4877437",4490,175,1502,6167,72.81,2.84,24.36,2019
"4877451",14,0,6,20,70,0,30,2019
"4877465",2032,40,560,2632,77.2,1.52,21.28,2019
"4877479",28579,228,668,29475,96.96,0.77,2.27,2019
"4877481",5,0,25,30,16.67,0,83.33,2019
"4877853",257,17,165,439,58.54,3.87,37.59,2019
"4877651",4362,44,530,4936,88.37,0.89,10.74,2019
"4877803",6877,391,2422,9690,70.97,4.04,24.99,2019
"4877830",908,12,266,1186,76.56,1.01,22.43,2019
"4877859",1780,61,630,2471,72.04,2.47,25.5,2019
"4877864",1893,156,720,2769,68.36,5.63,26,2019
"4877867",26,0,21,47,55.32,0,44.68,2019
"4877474",3616,78,854,4548,79.51,1.72,18.78,2019
"4877488",3459,180,1726,5365,64.47,3.36,32.17,2019
"4877503",6662,116,974,7752,85.94,1.5,12.56,2019
"4877510",4541,54,642,5237,86.71,1.03,12.26,2019
"4877521",17178,418,2419,20015,85.83,2.09,12.09,2019
"1762444",94,10,70,174,54.02,5.75,40.23,2019
"1762454",3240,79,759,4078,79.45,1.94,18.61,2019
"1762459",95,0,15,110,86.36,0,13.64,2019
"1762461",270,4,43,317,85.17,1.26,13.56,2019
"1762463",407,19,85,511,79.65,3.72,16.63,2019
"1762522",4822,206,1158,6186,77.95,3.33,18.72,2019
"1762523",234,0,152,386,60.62,0,39.38,2019
"1762526",10596,440,3230,14266,74.27,3.08,22.64,2019
"1762556",116,1,43,160,72.5,0.62,26.88,2019
"1762612",648,39,118,805,80.5,4.84,14.66,2019
"1762644",1725,65,360,2150,80.23,3.02,16.74,2019
"1762650",7987,449,2050,10486,76.17,4.28,19.55,2019
"1762682",326,7,55,388,84.02,1.8,14.18,2019
"1762684",1922,86,101,2109,91.13,4.08,4.79,2019
"1762688",254,9,42,305,83.28,2.95,13.77,2019
"1762808",490,15,129,634,77.29,2.37,20.35,2019
"1762820",51,3,8,62,82.26,4.84,12.9,2019
"1762837",2820,105,1079,4004,70.43,2.62,26.95,2019
"1762850",99,8,28,135,73.33,5.93,20.74,2019
"1762863",3226,181,761,4168,77.4,4.34,18.26,2019
"1762874",144,2,58,204,70.59,0.98,28.43,2019
"1762954",132,3,102,237,55.7,1.27,43.04,2019
"1762894",360,2,34,396,90.91,0.51,8.59,2019
"1762918",3541,91,662,4294,82.46,2.12,15.42,2019
"1762943",121,0,52,173,69.94,0,30.06,2019
"1762974",523,21,109,653,80.09,3.22,16.69,2019
"1762987",338,1,208,547,61.79,0.18,38.03,2019
"1762830",449,0,137,586,76.62,0,23.38,2019
"1762833",155,8,22,185,83.78,4.32,11.89,2019
"1762849",598,20,240,858,69.7,2.33,27.97,2019
"1762939",980,36,230,1246,78.65,2.89,18.46,2019
"1762910",652,29,323,1004,64.94,2.89,32.17,2019
"1762926",523,7,339,869,60.18,0.81,39.01,2019
"1762938",711,19,381,1111,64,1.71,34.29,2019
"1762941",134,33,77,244,54.92,13.52,31.56,2019
"1762996",140,13,25,178,78.65,7.3,14.04,2019
"1762208",5953,211,907,7071,84.19,2.98,12.83,2019
"1762214",427,1,111,539,79.22,0.19,20.59,2019
"1762002",10744,495,2329,13568,79.19,3.65,17.17,2019
"1762009",496,26,161,683,72.62,3.81,23.57,2019
"4875839",1473,79,704,2256,65.29,3.5,31.21,2019
"4875848",40,0,15,55,72.73,0,27.27,2019
"4875849",14,0,13,27,51.85,0,48.15,2019
"4875858",0,0,0,0,NA,NA,NA,2019
"4875904",10686,203,1641,12530,85.28,1.62,13.1,2019
"4875932",471,26,155,652,72.24,3.99,23.77,2019
"4875937",240,18,81,339,70.8,5.31,23.89,2019
"4875956",1921,175,1098,3194,60.14,5.48,34.38,2019
"4875973",694,60,329,1083,64.08,5.54,30.38,2019
"4875211",14636,466,6618,21720,67.38,2.15,30.47,2019
"4875449",368,28,147,543,67.77,5.16,27.07,2019
"4875480",493,46,85,624,79.01,7.37,13.62,2019
"4875459",1615,50,238,1903,84.87,2.63,12.51,2019
"4875468",180,38,117,335,53.73,11.34,34.93,2019
"4875475",29,5,26,60,48.33,8.33,43.33,2019
"4875487",560,44,122,726,77.13,6.06,16.8,2019
"4875490",762,23,170,955,79.79,2.41,17.8,2019
"4875503",7915,257,1393,9565,82.75,2.69,14.56,2019
"4875555",499,23,200,722,69.11,3.19,27.7,2019
"4879088",1357,40,414,1811,74.93,2.21,22.86,2019
"4879093",68,0,0,68,100,0,0,2019
"4879097",268,12,31,311,86.17,3.86,9.97,2019
"4879007",3566,110,853,4529,78.74,2.43,18.83,2019
"4879025",4,0,10,14,28.57,0,71.43,2019
"4879027",1108,39,410,1557,71.16,2.5,26.33,2019
"4879039",263,13,102,378,69.58,3.44,26.98,2019
"4879044",195,3,71,269,72.49,1.12,26.39,2019
"4879053",20,0,7,27,74.07,0,25.93,2019
"4879084",589,12,141,742,79.38,1.62,19,2019
"4879101",536,113,441,1090,49.17,10.37,40.46,2019
"4879107",8086,770,2705,11561,69.94,6.66,23.4,2019
"4879118",6849,337,807,7993,85.69,4.22,10.1,2019
"4879121",2288,16,234,2538,90.15,0.63,9.22,2019
"4879229",130,6,24,160,81.25,3.75,15,2019
"4879231",0,0,28,28,0,0,100,2019
"4879250",400,5,131,536,74.63,0.93,24.44,2019
"4879106",8674,516,2466,11656,74.42,4.43,21.16,2019
"4879230",29,0,14,43,67.44,0,32.56,2019
"4879233",39,3,25,67,58.21,4.48,37.31,2019
"4879235",915,24,382,1321,69.27,1.82,28.92,2019
"4879243",18,0,0,18,100,0,0,2019
"4879245",592,40,311,943,62.78,4.24,32.98,2019
"4879255",204,15,41,260,78.46,5.77,15.77,2019
"4879313",372,19,143,534,69.66,3.56,26.78,2019
"4879314",12,0,6,18,66.67,0,33.33,2019
"4879343",398,51,105,554,71.84,9.21,18.95,2019
"4879364",2537,117,351,3005,84.43,3.89,11.68,2019
"4879372",335,8,97,440,76.14,1.82,22.05,2019
"4879373",753,4,339,1096,68.7,0.36,30.93,2019
"4879401",1799,1176,327,3302,54.48,35.61,9.9,2019
"4879406",0,0,0,0,NA,NA,NA,2019
"4879535",71,2,15,88,80.68,2.27,17.05,2019
"4879537",18,0,4,22,81.82,0,18.18,2019
"4879544",159,3,85,247,64.37,1.21,34.41,2019
"4879602",6879,118,1352,8349,82.39,1.41,16.19,2019
"4879713",142,0,42,184,77.17,0,22.83,2019
"4879733",45,17,6,68,66.18,25,8.82,2019
"4879738",63,0,15,78,80.77,0,19.23,2019
"4879855",313,0,244,557,56.19,0,43.81,2019
"1761849",651,38,104,793,82.09,4.79,13.11,2019
"1761865",504,12,81,597,84.42,2.01,13.57,2019
"1761878",482,25,66,573,84.12,4.36,11.52,2019
"1761882",217,15,71,303,71.62,4.95,23.43,2019
"1761883",1371,48,272,1691,81.08,2.84,16.09,2019
"1761932",165,1,45,211,78.2,0.47,21.33,2019
"1761957",559,17,176,752,74.34,2.26,23.4,2019
"1761525",2931,12,129,3072,95.41,0.39,4.2,2019
"1761528",938,52,51,1041,90.11,5,4.9,2019
"1761540",781,25,240,1046,74.67,2.39,22.94,2019
"1761543",47,1,15,63,74.6,1.59,23.81,2019
"1761547",1275,31,170,1476,86.38,2.1,11.52,2019
"1761564",327,7,44,378,86.51,1.85,11.64,2019
"0880222",9414,292,1156,10862,86.67,2.69,10.64,2019
"0880223",6622,254,1184,8060,82.16,3.15,14.69,2019
"0880234",9403,199,904,10506,89.5,1.89,8.6,2019
"0880235",3442,47,253,3742,91.98,1.26,6.76,2019
"0880239",10229,204,2068,12501,81.83,1.63,16.54,2019
"0880294",0,0,0,0,NA,NA,NA,2019
"0880435",2080,84,166,2330,89.27,3.61,7.12,2019
"0880467",873,13,93,979,89.17,1.33,9.5,2019
"0880469",191,0,21,212,90.09,0,9.91,2019
"0880510",113,0,13,126,89.68,0,10.32,2019
"0880516",9277,108,256,9641,96.22,1.12,2.66,2019
"0880929",26,0,36,62,41.94,0,58.06,2019
"0880643",1141,20,86,1247,91.5,1.6,6.9,2019
"0880532",40,0,30,70,57.14,0,42.86,2019
"0880631",13182,880,3347,17409,75.72,5.05,19.23,2019
"0880640",3293,38,241,3572,92.19,1.06,6.75,2019
"0880650",464,14,87,565,82.12,2.48,15.4,2019
"0880705",353,6,96,455,77.58,1.32,21.1,2019
"0880737",504,42,125,671,75.11,6.26,18.63,2019
"0880741",286,14,64,364,78.57,3.85,17.58,2019
"0880759",1476,40,285,1801,81.95,2.22,15.82,2019
"0880813",494,29,204,727,67.95,3.99,28.06,2019
"0880823",48,0,9,57,84.21,0,15.79,2019
"0880833",224,14,33,271,82.66,5.17,12.18,2019
"0880836",347,24,66,437,79.41,5.49,15.1,2019
"0880840",603,6,20,629,95.87,0.95,3.18,2019
"0880015",21744,348,587,22679,95.88,1.53,2.59,2019
"0880016",18496,313,394,19203,96.32,1.63,2.05,2019
"0880024",37,8,29,74,50,10.81,39.19,2019
"0880025",68,0,0,68,100,0,0,2019
"0880030",4710,132,1179,6021,78.23,2.19,19.58,2019
"0880104",10589,117,406,11112,95.29,1.05,3.65,2019
"0880136",1610,54,125,1789,89.99,3.02,6.99,2019
"0880105",390,27,77,494,78.95,5.47,15.59,2019
"0880111",12117,291,397,12805,94.63,2.27,3.1,2019
"0880123",18370,314,1071,19755,92.99,1.59,5.42,2019
"0880126",14786,198,408,15392,96.06,1.29,2.65,2019
"0880133",931,17,108,1056,88.16,1.61,10.23,2019
"0880215",7350,245,715,8310,88.45,2.95,8.6,2019
"0880116",1457,21,62,1540,94.61,1.36,4.03,2019
"0880120",12291,474,1171,13936,88.2,3.4,8.4,2019
"0880205",13407,242,1568,15217,88.11,1.59,10.3,2019
"0880219",18105,535,3261,21901,82.67,2.44,14.89,2019
"0880220",14228,494,1239,15961,89.14,3.1,7.76,2019
"0880228",13477,291,626,14394,93.63,2.02,4.35,2019
"0880230",3833,44,355,4232,90.57,1.04,8.39,2019
"0880236",5817,43,662,6522,89.19,0.66,10.15,2019
"0880237",9958,198,659,10815,92.08,1.83,6.09,2019
"0880241",10822,210,478,11510,94.02,1.82,4.15,2019
"0880249",9292,208,803,10303,90.19,2.02,7.79,2019
"0880260",9229,283,2325,11837,77.97,2.39,19.64,2019
"0880264",0,0,0,0,NA,NA,NA,2019
"0880293",0,0,0,0,NA,NA,NA,2019
"4984334",42,0,0,42,100,0,0,2019
"4984336",29,0,13,42,69.05,0,30.95,2019
"4984337",3568,115,324,4007,89.04,2.87,8.09,2019
"4984338",133,6,7,146,91.1,4.11,4.79,2019
"4984523",553,11,75,639,86.54,1.72,11.74,2019
"4984539",67,0,23,90,74.44,0,25.56,2019
"4876250",400,4,15,419,95.47,0.95,3.58,2019
"4876943",935,118,299,1352,69.16,8.73,22.12,2019
"4876108",13706,370,1305,15381,89.11,2.41,8.48,2019
"4876061",19,0,0,19,100,0,0,2019
"4876084",2046,124,299,2469,82.87,5.02,12.11,2019
"4876114",7877,281,949,9107,86.49,3.09,10.42,2019
"4876120",5643,244,1056,6943,81.28,3.51,15.21,2019
"4876549",16457,410,1028,17895,91.96,2.29,5.74,2019
"4875493",94,1,76,171,54.97,0.58,44.44,2019
"4875640",1434,27,375,1836,78.1,1.47,20.42,2019
"4875770",908,38,178,1124,80.78,3.38,15.84,2019
"4875762",3907,307,266,4480,87.21,6.85,5.94,2019
"4875844",1672,71,800,2543,65.75,2.79,31.46,2019
"4875959",293,18,72,383,76.5,4.7,18.8,2019
"4875801",3793,122,1939,5854,64.79,2.08,33.12,2019
"4875783",2320,89,558,2967,78.19,3,18.81,2019
"4875784",190,12,65,267,71.16,4.49,24.34,2019
"4875792",782,2,214,998,78.36,0.2,21.44,2019
"4875846",773,60,320,1153,67.04,5.2,27.75,2019
"4875860",1240,28,531,1799,68.93,1.56,29.52,2019
"4875931",678,25,247,950,71.37,2.63,26,2019
"4875935",3360,159,1180,4699,71.5,3.38,25.11,2019
"4875942",47,4,0,51,92.16,7.84,0,2019
"4875951",3865,282,1551,5698,67.83,4.95,27.22,2019
"4875978",42,0,6,48,87.5,0,12.5,2019
"4875979",2417,268,990,3675,65.77,7.29,26.94,2019
"4875938",728,26,243,997,73.02,2.61,24.37,2019
"4875851",649,31,243,923,70.31,3.36,26.33,2019
"4875949",2274,178,651,3103,73.28,5.74,20.98,2019
"4875054",3444,17,25,3486,98.8,0.49,0.72,2019
"4875071",16709,305,800,17814,93.8,1.71,4.49,2019
"4875109",1460,9,234,1703,85.73,0.53,13.74,2019
"4875156",4978,255,1497,6730,73.97,3.79,22.24,2019
"4875157",54,2,42,98,55.1,2.04,42.86,2019
"4875254",9922,234,1681,11837,83.82,1.98,14.2,2019
"4875390",0,0,0,0,NA,NA,NA,2019
"4875642",4,0,15,19,21.05,0,78.95,2019
"4875645",3113,87,501,3701,84.11,2.35,13.54,2019
"4875682",116,15,40,171,67.84,8.77,23.39,2019
"4875752",2261,147,399,2807,80.55,5.24,14.21,2019
"4875779",16,13,6,35,45.71,37.14,17.14,2019
"4875780",54,0,0,54,100,0,0,2019
"4875803",4371,96,1563,6030,72.49,1.59,25.92,2019
"4875832",0,0,9,9,0,0,100,2019
"4875962",0,0,0,0,NA,NA,NA,2019
"4875438",295,13,65,373,79.09,3.49,17.43,2019
"4875974",881,52,417,1350,65.26,3.85,30.89,2019
"4875976",202,0,65,267,75.66,0,24.34,2019
"4875965",6397,121,1086,7604,84.13,1.59,14.28,2019
"4877480",2403,36,536,2975,80.77,1.21,18.02,2019
"4877505",7710,57,410,8177,94.29,0.7,5.01,2019
"4877515",8841,596,1394,10831,81.63,5.5,12.87,2019
"4877519",247,19,138,404,61.14,4.7,34.16,2019
"4877531",4822,336,950,6108,78.95,5.5,15.55,2019
"4877534",748,5,63,816,91.67,0.61,7.72,2019
"4877536",9806,261,596,10663,91.96,2.45,5.59,2019
"4877538",235,4,107,346,67.92,1.16,30.92,2019
"4877546",16895,126,639,17660,95.67,0.71,3.62,2019
"4877563",3481,128,675,4284,81.26,2.99,15.76,2019
"4875568",725,9,295,1029,70.46,0.87,28.67,2019
"4875975",1033,41,415,1489,69.38,2.75,27.87,2019
"4875901",8908,230,1409,10547,84.46,2.18,13.36,2019
"4875928",311,24,35,370,84.05,6.49,9.46,2019
"4875948",1991,77,575,2643,75.33,2.91,21.76,2019
"4875954",737,2,225,964,76.45,0.21,23.34,2019
"4875960",142,0,115,257,55.25,0,44.75,2019
"4875001",7490,119,520,8129,92.14,1.46,6.4,2019
"4875013",14067,57,445,14569,96.55,0.39,3.05,2019
"4875022",8172,103,97,8372,97.61,1.23,1.16,2019
"4875034",36572,794,806,38172,95.81,2.08,2.11,2019
"4875040",16298,284,1713,18295,89.08,1.55,9.36,2019
"4875050",11624,432,2637,14693,79.11,2.94,17.95,2019
"4875052",26924,330,2421,29675,90.73,1.11,8.16,2019
"4875061",13328,347,3570,17245,77.29,2.01,20.7,2019
"4875063",15383,251,485,16119,95.43,1.56,3.01,2019
"4875078",8162,72,252,8486,96.18,0.85,2.97,2019
"4875081",14145,153,731,15029,94.12,1.02,4.86,2019
"4875119",7726,256,1527,9509,81.25,2.69,16.06,2019
"4875124",1198,24,495,1717,69.77,1.4,28.83,2019
"4875146",5739,230,904,6873,83.5,3.35,13.15,2019
"4875172",898,152,334,1384,64.88,10.98,24.13,2019
"4875181",7802,52,186,8040,97.04,0.65,2.31,2019
"4875206",19227,372,1320,20919,91.91,1.78,6.31,2019
"4875007",17765,233,1467,19465,91.27,1.2,7.54,2019
"4875009",3873,72,262,4207,92.06,1.71,6.23,2019
"4875020",6788,236,1871,8895,76.31,2.65,21.03,2019
"4875067",22545,579,1688,24812,90.86,2.33,6.8,2019
"4875080",16957,724,1175,18856,89.93,3.84,6.23,2019
"4875090",5934,551,1908,8393,70.7,6.56,22.73,2019
"4875104",14438,257,926,15621,92.43,1.65,5.93,2019
"4875110",7653,102,2180,9935,77.03,1.03,21.94,2019
"4875140",1674,138,525,2337,71.63,5.91,22.46,2019
"4875153",103,0,25,128,80.47,0,19.53,2019
"4875159",4123,340,896,5359,76.94,6.34,16.72,2019
"4875161",1479,112,515,2106,70.23,5.32,24.45,2019
"4875166",1231,48,110,1389,88.62,3.46,7.92,2019
"4875169",3922,202,1255,5379,72.91,3.76,23.33,2019
"4875189",8614,273,371,9258,93.04,2.95,4.01,2019
"4875207",1686,22,23,1731,97.4,1.27,1.33,2019
"4877857",163,57,111,331,49.24,17.22,33.53,2019
"4877861",716,21,111,848,84.43,2.48,13.09,2019
"4877868",3462,158,1039,4659,74.31,3.39,22.3,2019
"4877876",33,0,0,33,100,0,0,2019
"4877880",344,0,157,501,68.66,0,31.34,2019
"4877905",3858,280,1346,5484,70.35,5.11,24.54,2019
"4877960",37,0,28,65,56.92,0,43.08,2019
"4877963",1286,122,601,2009,64.01,6.07,29.92,2019
"4877978",208,7,53,268,77.61,2.61,19.78,2019
"4877657",6961,109,661,7731,90.04,1.41,8.55,2019
"4877708",3707,86,1159,4952,74.86,1.74,23.4,2019
"4877833",7578,260,2325,10163,74.56,2.56,22.88,2019
"4877845",22607,630,1106,24343,92.87,2.59,4.54,2019
"4877871",867,56,204,1127,76.93,4.97,18.1,2019
"4877878",135,0,35,170,79.41,0,20.59,2019
"4877995",2886,149,867,3902,73.96,3.82,22.22,2019
"4877004",10539,399,2480,13418,78.54,2.97,18.48,2019
"4877008",14436,323,1578,16337,88.36,1.98,9.66,2019
"4877006",11661,464,847,12972,89.89,3.58,6.53,2019
"4878722",2816,103,341,3260,86.38,3.16,10.46,2019
"4878664",19235,349,1022,20606,93.35,1.69,4.96,2019
"4878232",14942,226,610,15778,94.7,1.43,3.87,2019
"4878235",412,167,61,640,64.38,26.09,9.53,2019
"4878238",6805,786,1536,9127,74.56,8.61,16.83,2019
"4878245",19969,229,1507,21705,92,1.06,6.94,2019
"4878247",15767,909,747,17423,90.5,5.22,4.29,2019
"4878253",11735,219,398,12352,95,1.77,3.22,2019
"4878256",3980,181,110,4271,93.19,4.24,2.58,2019
"4878259",8898,243,308,9449,94.17,2.57,3.26,2019
"4878260",7878,107,355,8340,94.46,1.28,4.26,2019
"4878339",118,0,39,157,75.16,0,24.84,2019
"4878359",317,8,305,630,50.32,1.27,48.41,2019
"4878361",940,12,697,1649,57,0.73,42.27,2019
"4878369",37,12,79,128,28.91,9.38,61.72,2019
"4878370",1036,29,463,1528,67.8,1.9,30.3,2019
"4878373",1806,101,268,2175,83.03,4.64,12.32,2019
"4878377",891,18,312,1221,72.97,1.47,25.55,2019
"4878382",7047,182,1099,8328,84.62,2.19,13.2,2019
"4878385",77,0,96,173,44.51,0,55.49,2019
"4878002",1220,20,525,1765,69.12,1.13,29.75,2019
"4878017",665,0,355,1020,65.2,0,34.8,2019
"4878001",0,0,0,0,NA,NA,NA,2019
"4878007",37,5,18,60,61.67,8.33,30,2019
"4878011",379,0,199,578,65.57,0,34.43,2019
"4878016",2407,197,1002,3606,66.75,5.46,27.79,2019
"4878076",2488,113,1511,4112,60.51,2.75,36.75,2019
"4878947",1478,43,211,1732,85.33,2.48,12.18,2019
"4878948",198,0,70,268,73.88,0,26.12,2019
"4878957",2444,132,889,3465,70.53,3.81,25.66,2019
"4878962",1345,46,504,1895,70.98,2.43,26.6,2019
"4878075",23,0,63,86,26.74,0,73.26,2019
"4878117",143,6,58,207,69.08,2.9,28.02,2019
"4878121",3728,134,404,4266,87.39,3.14,9.47,2019
"4878155",13548,322,3489,17359,78.05,1.85,20.1,2019
"4878660",28940,563,1382,30885,93.7,1.82,4.47,2019
"4878703",8944,348,253,9545,93.7,3.65,2.65,2019
"4878721",3292,141,775,4208,78.23,3.35,18.42,2019
"4878726",5535,128,214,5877,94.18,2.18,3.64,2019
"4878704",21905,1193,1973,25071,87.37,4.76,7.87,2019
"4878725",2561,89,125,2775,92.29,3.21,4.5,2019
"4878739",6637,22,36,6695,99.13,0.33,0.54,2019
"4878742",149,7,115,271,54.98,2.58,42.44,2019
"4878834",1518,160,731,2409,63.01,6.64,30.34,2019
"4878006",10842,478,845,12165,89.12,3.93,6.95,2019
"4878008",96,0,156,252,38.1,0,61.9,2019
"4878375",610,17,306,933,65.38,1.82,32.8,2019
"4878340",108,2,39,149,72.48,1.34,26.17,2019
"4878371",48,0,27,75,64,0,36,2019
"4878372",689,14,846,1549,44.48,0.9,54.62,2019
"4878376",126,0,70,196,64.29,0,35.71,2019
"4878379",369,16,149,534,69.1,3,27.9,2019
"4878383",1168,27,409,1604,72.82,1.68,25.5,2019
"1762359",53,0,12,65,81.54,0,18.46,2019
"1762548",793,39,177,1009,78.59,3.87,17.54,2019
"1762567",387,9,80,476,81.3,1.89,16.81,2019
"1762568",4947,181,1435,6563,75.38,2.76,21.87,2019
"1762627",324,2,36,362,89.5,0.55,9.94,2019
"1762643",153,10,43,206,74.27,4.85,20.87,2019
"4984540",18,0,0,18,100,0,0,2019
"4984604",9012,2542,329,11883,75.84,21.39,2.77,2019
"4984621",54,0,0,54,100,0,0,2019
"4984057",11054,616,685,12355,89.47,4.99,5.54,2019
"4984063",48,0,5,53,90.57,0,9.43,2019
"4984066",3495,101,493,4089,85.47,2.47,12.06,2019
"4984071",456,8,24,488,93.44,1.64,4.92,2019
"4984073",82,0,6,88,93.18,0,6.82,2019
"4984074",14559,225,1128,15912,91.5,1.41,7.09,2019
"4984080",90,0,7,97,92.78,0,7.22,2019
"4984084",10992,396,665,12053,91.2,3.29,5.52,2019
"4984106",12512,743,1069,14324,87.35,5.19,7.46,2019
"4984302",7643,203,853,8699,87.86,2.33,9.81,2019
"4984734",89,1,21,111,80.18,0.9,18.92,2019
"4984713",955,55,235,1245,76.71,4.42,18.88,2019
"4984718",65,0,21,86,75.58,0,24.42,2019
"4984720",6573,398,569,7540,87.18,5.28,7.55,2019
"4984730",91,0,6,97,93.81,0,6.19,2019
"4984732",17,3,0,20,85,15,0,2019
"4984745",1205,23,109,1337,90.13,1.72,8.15,2019
"4984764",63,5,23,91,69.23,5.49,25.27,2019
"4984770",13105,492,1521,15118,86.68,3.25,10.06,2019
"4984636",185,11,9,205,90.24,5.37,4.39,2019
"4984638",114,0,6,120,95,0,5,2019
"4984639",215,8,77,300,71.67,2.67,25.67,2019
"4984642",1025,45,131,1201,85.35,3.75,10.91,2019
"4984645",619,32,105,756,81.88,4.23,13.89,2019
"4984655",3033,95,247,3375,89.87,2.81,7.32,2019
"4984656",93,1,33,127,73.23,0.79,25.98,2019
"4984662",483,2,39,524,92.18,0.38,7.44,2019
"4984714",246,0,95,341,72.14,0,27.86,2019
"4984736",70,0,15,85,82.35,0,17.65,2019
"4984747",260,12,109,381,68.24,3.15,28.61,2019
"4984765",2096,86,13,2195,95.49,3.92,0.59,2019
"4984774",445,4,21,470,94.68,0.85,4.47,2019
"4984780",7498,290,835,8623,86.95,3.36,9.68,2019
"4984783",310,8,28,346,89.6,2.31,8.09,2019
"4984001",183,2,29,214,85.51,0.93,13.55,2019
"4984003",12739,432,518,13689,93.06,3.16,3.78,2019
"4984014",5204,166,247,5617,92.65,2.96,4.4,2019
"4984026",238,15,88,341,69.79,4.4,25.81,2019
"4984027",168,5,42,215,78.14,2.33,19.53,2019
"4984031",58,5,22,85,68.24,5.88,25.88,2019
"4984038",101,6,7,114,88.6,5.26,6.14,2019
"4984049",2042,29,126,2197,92.94,1.32,5.74,2019
"4984060",2786,96,121,3003,92.77,3.2,4.03,2019
"4984061",189,15,0,204,92.65,7.35,0,2019
"4984076",80,0,0,80,100,0,0,2019
"4984078",7662,250,1091,9003,85.1,2.78,12.12,2019
"4984088",10393,298,677,11368,91.42,2.62,5.96,2019
"4984102",7580,560,1078,9218,82.23,6.08,11.69,2019
"4984115",8528,489,2284,11301,75.46,4.33,20.21,2019
"4984120",12170,410,1123,13703,88.81,2.99,8.2,2019
"4984758",175,5,9,189,92.59,2.65,4.76,2019
"4984761",917,52,220,1189,77.12,4.37,18.5,2019
"4984773",117,0,6,123,95.12,0,4.88,2019
"4984779",239,2,12,253,94.47,0.79,4.74,2019
"4984782",353,0,0,353,100,0,0,2019
"4984633",290,11,39,340,85.29,3.24,11.47,2019
"4877581",15718,192,1161,17071,92.07,1.12,6.8,2019
"4877583",8387,287,1246,9920,84.55,2.89,12.56,2019
"4877587",3088,426,1223,4737,65.19,8.99,25.82,2019
"4877616",166,0,91,257,64.59,0,35.41,2019
"4877624",130,9,143,282,46.1,3.19,50.71,2019
"4877640",3760,144,2276,6180,60.84,2.33,36.83,2019
"4877662",8002,317,1513,9832,81.39,3.22,15.39,2019
"4877665",1790,0,350,2140,83.64,0,16.36,2019
"2963655",443,6,120,569,77.86,1.05,21.09,2019
"2963670",3585,137,790,4512,79.45,3.04,17.51,2019
"2963701",12535,152,1668,14355,87.32,1.06,11.62,2019
"2963730",1092,6,386,1484,73.58,0.4,26.01,2019
"2963739",130,0,24,154,84.42,0,15.58,2019
"2963751",430,0,140,570,75.44,0,24.56,2019
"2963767",197,0,98,295,66.78,0,33.22,2019
"2963770",35,0,13,48,72.92,0,27.08,2019
"2963801",7124,215,2021,9360,76.11,2.3,21.59,2019
"2963822",745,30,222,997,74.72,3.01,22.27,2019
"2963823",338,40,117,495,68.28,8.08,23.64,2019
"2963743",21,0,4,25,84,0,16,2019
"2963748",336,4,106,446,75.34,0.9,23.77,2019
"2963769",398,1,69,468,85.04,0.21,14.74,2019
"2963787",205,4,86,295,69.49,1.36,29.15,2019
"2963820",34,2,27,63,53.97,3.17,42.86,2019
"2963821",202,5,147,354,57.06,1.41,41.53,2019
"2963833",56,0,36,92,60.87,0,39.13,2019
"2963839",115,0,37,152,75.66,0,24.34,2019
"2963860",74,0,19,93,79.57,0,20.43,2019
"2963870",274,13,87,374,73.26,3.48,23.26,2019
"2963878",21,3,5,29,72.41,10.34,17.24,2019
"2963935",2514,133,1019,3666,68.58,3.63,27.8,2019
"2963951",29,0,97,126,23.02,0,76.98,2019
"2963966",739,13,275,1027,71.96,1.27,26.78,2019
"2963026",14940,399,1364,16703,89.45,2.39,8.17,2019
"2963044",3337,104,504,3945,84.59,2.64,12.78,2019
"2963049",5981,58,525,6564,91.12,0.88,8,2019
"2963052",9158,97,593,9848,92.99,0.98,6.02,2019
"2963102",871,43,68,982,88.7,4.38,6.92,2019
"2963014",288,2,98,388,74.23,0.52,25.26,2019
"2963048",1133,13,211,1357,83.49,0.96,15.55,2019
"2963625",101,6,57,164,61.59,3.66,34.76,2019
"2963650",1122,58,502,1682,66.71,3.45,29.85,2019
"2963662",331,8,248,587,56.39,1.36,42.25,2019
"2963740",1517,22,341,1880,80.69,1.17,18.14,2019
"2963755",8009,162,1168,9339,85.76,1.73,12.51,2019
"2963758",71,0,14,85,83.53,0,16.47,2019
"2963780",1933,37,431,2401,80.51,1.54,17.95,2019
"2963830",1955,67,829,2851,68.57,2.35,29.08,2019
"2963845",1654,71,703,2428,68.12,2.92,28.95,2019
"2963846",493,15,125,633,77.88,2.37,19.75,2019
"2963855",292,10,103,405,72.1,2.47,25.43,2019
"2963784",42,0,37,79,53.16,0,46.84,2019
"2963824",37,0,5,42,88.1,0,11.9,2019
"2963015",758,53,101,912,83.11,5.81,11.07,2019
"2963016",2659,44,381,3084,86.22,1.43,12.35,2019
"4877009",11208,298,2617,14123,79.36,2.11,18.53,2019
"4877014",9478,558,1765,11801,80.32,4.73,14.96,2019
"4877031",4918,281,1097,6296,78.11,4.46,17.42,2019
"4877034",10610,467,1171,12248,86.63,3.81,9.56,2019
"4877055",13044,399,2015,15458,84.38,2.58,13.04,2019
"4877072",14214,558,3182,17954,79.17,3.11,17.72,2019
"4877035",9701,804,3259,13764,70.48,5.84,23.68,2019
"4877041",10030,219,1101,11350,88.37,1.93,9.7,2019
"4877050",1187,0,267,1454,81.64,0,18.36,2019
"4877063",15494,364,2895,18753,82.62,1.94,15.44,2019
"4877071",8477,357,1276,10110,83.85,3.53,12.62,2019
"4877074",8339,242,4259,12840,64.95,1.88,33.17,2019
"4074570",260,17,144,421,61.76,4.04,34.2,2019
"4074472",166,22,61,249,66.67,8.84,24.5,2019
"4074435",822,55,346,1223,67.21,4.5,28.29,2019
"4074436",1164,247,368,1779,65.43,13.88,20.69,2019
"4074459",27,0,23,50,54,0,46,2019
"4074521",59,0,28,87,67.82,0,32.18,2019
"4074522",109,0,21,130,83.85,0,16.15,2019
"4074528",63,0,18,81,77.78,0,22.22,2019
"4074531",196,4,144,344,56.98,1.16,41.86,2019
"4074533",224,20,96,340,65.88,5.88,28.24,2019
"4074536",444,15,194,653,67.99,2.3,29.71,2019
"4074546",218,11,63,292,74.66,3.77,21.58,2019
"4074571",904,50,464,1418,63.75,3.53,32.72,2019
"4074604",3871,320,804,4995,77.5,6.41,16.1,2019
"4074652",220,29,59,308,71.43,9.42,19.16,2019
"4074731",370,42,224,636,58.18,6.6,35.22,2019
"4074754",67,16,79,162,41.36,9.88,48.77,2019
"4074766",326,15,285,626,52.08,2.4,45.53,2019
"4074830",36,12,31,79,45.57,15.19,39.24,2019
"4074832",176,4,132,312,56.41,1.28,42.31,2019
"4074836",32,0,48,80,40,0,60,2019
"4074842",31,0,15,46,67.39,0,32.61,2019
"4074852",392,26,135,553,70.89,4.7,24.41,2019
"4074864",1299,63,429,1791,72.53,3.52,23.95,2019
"4074865",351,25,236,612,57.35,4.08,38.56,2019
"4074880",455,9,261,725,62.76,1.24,36,2019
"4074937",1058,81,750,1889,56.01,4.29,39.7,2019
"4074450",473,81,140,694,68.16,11.67,20.17,2019
"4879423",13422,461,1246,15129,88.72,3.05,8.24,2019
"4879424",17301,529,1026,18856,91.75,2.81,5.44,2019
"4879511",287,42,157,486,59.05,8.64,32.3,2019
"4879517",66,0,11,77,85.71,0,14.29,2019
"4879521",738,24,505,1267,58.25,1.89,39.86,2019
"4879530",137,6,71,214,64.02,2.8,33.18,2019
"4879536",1396,84,490,1970,70.86,4.26,24.87,2019
"4879561",146,12,83,241,60.58,4.98,34.44,2019
"4879043",360,31,126,517,69.63,6,24.37,2019
"4879032",26,0,7,33,78.79,0,21.21,2019
"4879033",12,0,17,29,41.38,0,58.62,2019
"4879042",349,16,84,449,77.73,3.56,18.71,2019
"4879011",79,0,26,105,75.24,0,24.76,2019
"4879012",443,0,76,519,85.36,0,14.64,2019
"4879022",2679,119,600,3398,78.84,3.5,17.66,2019
"4879031",348,13,121,482,72.2,2.7,25.1,2019
"4879083",517,45,148,710,72.82,6.34,20.85,2019
"4879239",48,0,47,95,50.53,0,49.47,2019
"4879241",751,28,101,880,85.34,3.18,11.48,2019
"1761748",897,6,72,975,92,0.62,7.38,2019
"1761756",672,25,166,863,77.87,2.9,19.24,2019
"1761801",9093,1532,992,11617,78.27,13.19,8.54,2019
"1761810",100,5,9,114,87.72,4.39,7.89,2019
"1761453",216,0,35,251,86.06,0,13.94,2019
"1761434",988,84,284,1356,72.86,6.19,20.94,2019
"1761450",500,25,210,735,68.03,3.4,28.57,2019
"1761452",86,0,25,111,77.48,0,22.52,2019
"1761738",1241,50,287,1578,78.64,3.17,18.19,2019
"1761740",456,23,104,583,78.22,3.95,17.84,2019
"1761753",955,41,180,1176,81.21,3.49,15.31,2019
"1761755",1655,15,195,1865,88.74,0.8,10.46,2019
"1761778",170,0,71,241,70.54,0,29.46,2019
"1761813",526,14,118,658,79.94,2.13,17.93,2019
"1761832",10573,264,3373,14210,74.41,1.86,23.74,2019
"1761833",663,56,284,1003,66.1,5.58,28.32,2019
"1761848",69,0,11,80,86.25,0,13.75,2019
"1761859",437,4,53,494,88.46,0.81,10.73,2019
"1761871",119,2,18,139,85.61,1.44,12.95,2019
"1761872",174,12,63,249,69.88,4.82,25.3,2019
"1761884",393,9,16,418,94.02,2.15,3.83,2019
"1761925",226,0,35,261,86.59,0,13.41,2019
"1761941",7,0,41,48,14.58,0,85.42,2019
"1761001",445,3,47,495,89.9,0.61,9.49,2019
"1761024",804,33,130,967,83.14,3.41,13.44,2019
"1761030",749,36,135,920,81.41,3.91,14.67,2019
"1761047",541,9,138,688,78.63,1.31,20.06,2019
"1761057",39,0,0,39,100,0,0,2019
"1761059",54,2,17,73,73.97,2.74,23.29,2019
"1761061",2310,97,588,2995,77.13,3.24,19.63,2019
"1761067",305,2,47,354,86.16,0.56,13.28,2019
"1761068",4533,250,955,5738,79,4.36,16.64,2019
"1761007",176,0,36,212,83.02,0,16.98,2019
"1761008",10099,237,1696,12032,83.93,1.97,14.1,2019
"1761010",2740,49,191,2980,91.95,1.64,6.41,2019
"1761015",292,0,49,341,85.63,0,14.37,2019
"1761036",2650,50,328,3028,87.52,1.65,10.83,2019
"1761039",305,11,35,351,86.89,3.13,9.97,2019
"1761044",90,0,27,117,76.92,0,23.08,2019
"1761046",857,14,162,1033,82.96,1.36,15.68,2019
"1761081",7009,194,1448,8651,81.02,2.24,16.74,2019
"1761087",522,47,137,706,73.94,6.66,19.41,2019
"1761091",31,0,0,31,100,0,0,2019
"1761114",5769,229,669,6667,86.53,3.43,10.03,2019
"1761231",1800,39,392,2231,80.68,1.75,17.57,2019
"1761238",979,75,181,1235,79.27,6.07,14.66,2019
"1761241",2312,110,427,2849,81.15,3.86,14.99,2019
"1761244",7236,257,1538,9031,80.12,2.85,17.03,2019
"1761251",122,0,25,147,82.99,0,17.01,2019
"1761265",15976,398,2800,19174,83.32,2.08,14.6,2019
"1761272",418,8,91,517,80.85,1.55,17.6,2019
"1761281",857,7,132,996,86.04,0.7,13.25,2019
"1761301",3342,93,624,4059,82.34,2.29,15.37,2019
"4984640",37,0,18,55,67.27,0,32.73,2019
"4984667",95,2,19,116,81.9,1.72,16.38,2019
"4984712",51,0,3,54,94.44,0,5.56,2019
"4984725",416,18,53,487,85.42,3.7,10.88,2019
"4984729",77,7,5,89,86.52,7.87,5.62,2019
"4984744",77,0,10,87,88.51,0,11.49,2019
"4984751",451,32,191,674,66.91,4.75,28.34,2019
"4984755",17,0,7,24,70.83,0,29.17,2019
"4984766",78,0,13,91,85.71,0,14.29,2019
"4984083",272,0,148,420,64.76,0,35.24,2019
"4984086",122,4,0,126,96.83,3.17,0,2019
"4984098",6631,111,246,6988,94.89,1.59,3.52,2019
"4984105",8506,247,645,9398,90.51,2.63,6.86,2019
"4984124",7175,146,549,7870,91.17,1.86,6.98,2019
"4984315",2425,53,76,2554,94.95,2.08,2.98,2019
"4984002",100,0,8,108,92.59,0,7.41,2019
"4984023",63,0,6,69,91.3,0,8.7,2019
"4984046",84,0,10,94,89.36,0,10.64,2019
"4984072",128,0,27,155,82.58,0,17.42,2019
"4984075",7288,277,266,7831,93.07,3.54,3.4,2019
"4984006",299,10,27,336,88.99,2.98,8.04,2019
"4984017",1175,11,154,1340,87.69,0.82,11.49,2019
"4984015",17519,486,1622,19627,89.26,2.48,8.26,2019
"0485530",215,33,203,451,47.67,7.32,45.01,2019
"0485735",3501,217,551,4269,82.01,5.08,12.91,2019
"0485018",14389,415,2333,17137,83.96,2.42,13.61,2019
"0485207",16258,413,1508,18179,89.43,2.27,8.3,2019
"0485043",7625,350,1821,9796,77.84,3.57,18.59,2019
"0485233",11909,231,560,12700,93.77,1.82,4.41,2019
"0485328",76,0,60,136,55.88,0,44.12,2019
"0485607",3803,45,1416,5264,72.25,0.85,26.9,2019
"0485929",2511,78,573,3162,79.41,2.47,18.12,2019
"0485042",12770,432,1569,14771,86.45,2.92,10.62,2019
"0485083",6297,88,82,6467,97.37,1.36,1.27,2019
"0485118",5862,156,387,6405,91.52,2.44,6.04,2019
"0485119",8480,434,1694,10608,79.94,4.09,15.97,2019
"0485120",10665,517,2959,14141,75.42,3.66,20.92,2019
"0485121",182,0,318,500,36.4,0,63.6,2019
"0485122",16175,576,2329,19080,84.77,3.02,12.21,2019
"0485123",3513,194,830,4537,77.43,4.28,18.29,2019
"0485128",3463,223,853,4539,76.29,4.91,18.79,2019
"0485131",2520,172,843,3535,71.29,4.87,23.85,2019
"0485028",7554,129,397,8080,93.49,1.6,4.91,2019
"3289115",14057,348,4018,18423,76.3,1.89,21.81,2019
"3289130",11117,384,988,12489,89.01,3.07,7.91,2019
"3289141",10901,207,495,11603,93.95,1.78,4.27,2019
"3289147",17720,404,2435,20559,86.19,1.97,11.84,2019
"3289419",1228,20,345,1593,77.09,1.26,21.66,2019
"3289421",133,4,93,230,57.83,1.74,40.43,2019
"3289425",29,0,67,96,30.21,0,69.79,2019
"3289431",11679,517,2741,14937,78.19,3.46,18.35,2019
"3289445",5170,172,910,6252,82.69,2.75,14.56,2019
"3289703",3901,47,651,4599,84.82,1.02,14.16,2019
"3289191",0,0,0,0,NA,NA,NA,2019
"3289410",4265,37,536,4838,88.16,0.76,11.08,2019
"3289420",0,0,7,7,0,0,100,2019
"3289428",51,0,37,88,57.95,0,42.05,2019
"3289439",546,13,73,632,86.39,2.06,11.55,2019
"3289449",1361,0,69,1430,95.17,0,4.83,2019
"2963023",1647,72,401,2120,77.69,3.4,18.92,2019
"2963037",1015,17,216,1248,81.33,1.36,17.31,2019
"2963039",203,0,81,284,71.48,0,28.52,2019
"2963041",117,0,19,136,86.03,0,13.97,2019
"2963069",4735,113,819,5667,83.55,1.99,14.45,2019
"2963080",4416,130,1163,5709,77.35,2.28,20.37,2019
"2963087",126,10,172,308,40.91,3.25,55.84,2019
"2963129",19609,451,1906,21966,89.27,2.05,8.68,2019
"2963133",1719,295,1149,3163,54.35,9.33,36.33,2019
"2963137",5832,204,1369,7405,78.76,2.75,18.49,2019
"2963301",16985,566,2310,19861,85.52,2.85,11.63,2019
"2963552",2056,106,826,2988,68.81,3.55,27.64,2019
"4073566",524,62,123,709,73.91,8.74,17.35,2019
"4073654",257,0,40,297,86.53,0,13.47,2019
"4073658",81,0,4,85,95.29,0,4.71,2019
"4073664",346,11,95,452,76.55,2.43,21.02,2019
"4073718",167,3,54,224,74.55,1.34,24.11,2019
"4073724",330,8,111,449,73.5,1.78,24.72,2019
"4073730",214,10,59,283,75.62,3.53,20.85,2019
"4073754",310,2,100,412,75.24,0.49,24.27,2019
"4073766",341,21,140,502,67.93,4.18,27.89,2019
"4073773",519,24,176,719,72.18,3.34,24.48,2019
"4073844",67,0,35,102,65.69,0,34.31,2019
"4073942",3077,187,821,4085,75.32,4.58,20.1,2019
"4073947",114,11,47,172,66.28,6.4,27.33,2019
"4073026",3529,42,533,4104,85.99,1.02,12.99,2019
"4073028",1038,54,318,1410,73.62,3.83,22.55,2019
"4073034",15415,282,940,16637,92.65,1.7,5.65,2019
"4073052",2050,43,391,2484,82.53,1.73,15.74,2019
"4073058",27,7,29,63,42.86,11.11,46.03,2019
"4073063",185,5,44,234,79.06,2.14,18.8,2019
"4073064",7097,152,849,8098,87.64,1.88,10.48,2019
"4073082",730,173,275,1178,61.97,14.69,23.34,2019
"4073104",1156,59,147,1362,84.88,4.33,10.79,2019
"4073118",5520,174,632,6326,87.26,2.75,9.99,2019
"4073128",1353,63,112,1528,88.55,4.12,7.33,2019
"4073134",2132,164,475,2771,76.94,5.92,17.14,2019
"4073135",7221,207,946,8374,86.23,2.47,11.3,2019
"4073141",937,18,117,1072,87.41,1.68,10.91,2019
"4073160",20758,379,1745,22882,90.72,1.66,7.63,2019
"4073434",176,16,39,231,76.19,6.93,16.88,2019
"4073440",118,17,40,175,67.43,9.71,22.86,2019
"4073442",109,6,37,152,71.71,3.95,24.34,2019
"4073447",282,31,160,473,59.62,6.55,33.83,2019
"4875230",11985,254,968,13207,90.75,1.92,7.33,2019
"4875236",4051,252,1843,6146,65.91,4.1,29.99,2019
"4875410",1581,73,291,1945,81.29,3.75,14.96,2019
"4875435",263,25,124,412,63.83,6.07,30.1,2019
"4875437",386,15,79,480,80.42,3.12,16.46,2019
"4875167",3316,87,253,3656,90.7,2.38,6.92,2019
"4875180",5335,214,823,6372,83.73,3.36,12.92,2019
"4875203",4756,250,1419,6425,74.02,3.89,22.09,2019
"4879316",2600,196,876,3672,70.81,5.34,23.86,2019
"4879331",2875,214,1102,4191,68.6,5.11,26.29,2019
"4879350",101,0,33,134,75.37,0,24.63,2019
"4879357",543,20,192,755,71.92,2.65,25.43,2019
"4879369",26,0,14,40,65,0,35,2019
"4879410",3410,106,413,3929,86.79,2.7,10.51,2019
"4879416",10199,1233,1507,12939,78.82,9.53,11.65,2019
"4879519",27,0,2,29,93.1,0,6.9,2019
"4879520",697,0,218,915,76.17,0,23.83,2019
"4879529",391,12,129,532,73.5,2.26,24.25,2019
"4879534",59,0,12,71,83.1,0,16.9,2019
"4879538",82,0,26,108,75.93,0,24.07,2019
"4879553",1099,14,317,1430,76.85,0.98,22.17,2019
"4879563",271,3,100,374,72.46,0.8,26.74,2019
"4879565",62,7,22,91,68.13,7.69,24.18,2019
"4879601",5639,301,1579,7519,75,4,21,2019
"4879603",5593,240,2656,8489,65.89,2.83,31.29,2019
"4879734",606,155,244,1005,60.3,15.42,24.28,2019
"4879743",78,7,21,106,73.58,6.6,19.81,2019
"4879761",9107,150,2171,11428,79.69,1.31,19,2019
"4879330",33,0,0,33,100,0,0,2019
"4879252",810,8,422,1240,65.32,0.65,34.03,2019
"4879322",498,30,220,748,66.58,4.01,29.41,2019
"4879325",506,46,203,755,67.02,6.09,26.89,2019
"4879353",4,0,2,6,66.67,0,33.33,2019
"4879358",291,15,104,410,70.98,3.66,25.37,2019
"4879378",57,3,8,68,83.82,4.41,11.76,2019
"4879403",3637,174,1902,5713,63.66,3.05,33.29,2019
"4879404",1932,55,1297,3284,58.83,1.67,39.49,2019
"4879407",7509,610,1356,9475,79.25,6.44,14.31,2019
"4879412",3717,157,1766,5640,65.9,2.78,31.31,2019
"4879413",7289,273,899,8461,86.15,3.23,10.63,2019
"4879502",396,14,110,520,76.15,2.69,21.15,2019
"4879504",839,22,346,1207,69.51,1.82,28.67,2019
"4879505",49,5,27,81,60.49,6.17,33.33,2019
"4879607",687,0,0,687,100,0,0,2019
"4879705",12955,217,1635,14807,87.49,1.47,11.04,2019
"4879706",5998,274,1322,7594,78.98,3.61,17.41,2019
"4879739",246,14,78,338,72.78,4.14,23.08,2019
"4879766",1455,94,485,2034,71.53,4.62,23.84,2019
"1762010",3933,58,585,4576,85.95,1.27,12.78,2019
"1762015",174,3,72,249,69.88,1.2,28.92,2019
"1762040",14409,393,2918,17720,81.31,2.22,16.47,2019
"1762050",91,1,30,122,74.59,0.82,24.59,2019
"1762067",807,30,42,879,91.81,3.41,4.78,2019
"1762074",366,10,50,426,85.92,2.35,11.74,2019
"1762079",89,0,29,118,75.42,0,24.58,2019
"1762089",164,2,41,207,79.23,0.97,19.81,2019
"1762094",335,4,102,441,75.96,0.91,23.13,2019
"1762242",359,16,154,529,67.86,3.02,29.11,2019
"1762260",2522,121,327,2970,84.92,4.07,11.01,2019
"1762263",1668,120,356,2144,77.8,5.6,16.6,2019
"1762265",1246,55,328,1629,76.49,3.38,20.14,2019
"1762278",2128,47,404,2579,82.51,1.82,15.66,2019
"1762284",193,0,53,246,78.46,0,21.54,2019
"1762285",1505,16,177,1698,88.63,0.94,10.42,2019
"1762289",85,17,20,122,69.67,13.93,16.39,2019
"1762295",492,10,44,546,90.11,1.83,8.06,2019
"1762311",229,11,94,334,68.56,3.29,28.14,2019
"1761565",487,8,147,642,75.86,1.25,22.9,2019
"1761610",1666,40,321,2027,82.19,1.97,15.84,2019
"1761812",130,9,22,161,80.75,5.59,13.66,2019
"1761815",88,0,31,119,73.95,0,26.05,2019
"1761820",11410,1530,1429,14369,79.41,10.65,9.95,2019
"1761843",740,6,156,902,82.04,0.67,17.29,2019
"1761844",277,6,42,325,85.23,1.85,12.92,2019
"1761850",148,4,34,186,79.57,2.15,18.28,2019
"1761857",64,0,7,71,90.14,0,9.86,2019
"1761858",968,17,177,1162,83.3,1.46,15.23,2019
"1761863",250,11,71,332,75.3,3.31,21.39,2019
"1761866",3845,175,1274,5294,72.63,3.31,24.06,2019
"1761910",1076,31,429,1536,70.05,2.02,27.93,2019
"1761913",450,4,138,592,76.01,0.68,23.31,2019
"1761741",500,17,95,612,81.7,2.78,15.52,2019
"1761742",409,14,62,485,84.33,2.89,12.78,2019
"1761750",50,0,7,57,87.72,0,12.28,2019
"1761759",505,4,103,612,82.52,0.65,16.83,2019
"1761814",349,30,55,434,80.41,6.91,12.67,2019
"1761834",2259,26,463,2748,82.21,0.95,16.85,2019
"1761845",129,0,19,148,87.16,0,12.84,2019
"1761846",1653,26,439,2118,78.05,1.23,20.73,2019
"1761851",134,1,28,163,82.21,0.61,17.18,2019
"1761873",2025,26,111,2162,93.66,1.2,5.13,2019
"1761874",2653,291,337,3281,80.86,8.87,10.27,2019
"1761875",349,0,0,349,100,0,0,2019
"1761924",740,63,175,978,75.66,6.44,17.89,2019
"1761930",248,5,50,303,81.85,1.65,16.5,2019
"1761931",324,2,109,435,74.48,0.46,25.06,2019
"1761936",106,0,9,115,92.17,0,7.83,2019
"1761942",343,3,71,417,82.25,0.72,17.03,2019
"1761364",6351,236,1780,8367,75.91,2.82,21.27,2019
"1761322",378,16,164,558,67.74,2.87,29.39,2019
"1761332",40,2,10,52,76.92,3.85,19.23,2019
"1761349",319,8,88,415,76.87,1.93,21.2,2019
"1761418",209,0,59,268,77.99,0,22.01,2019
"1761419",35,10,19,64,54.69,15.62,29.69,2019
"1761424",35,0,0,35,100,0,0,2019
"1761427",673,16,153,842,79.93,1.9,18.17,2019
"1761435",0,8,4,12,0,66.67,33.33,2019
"1761477",197,6,40,243,81.07,2.47,16.46,2019
"1761478",111,0,7,118,94.07,0,5.93,2019
"1761535",635,0,54,689,92.16,0,7.84,2019
"1761539",49,4,18,71,69.01,5.63,25.35,2019
"1761567",205,1,40,246,83.33,0.41,16.26,2019
"1761704",12937,623,1199,14759,87.65,4.22,8.12,2019
"4073056",112,16,19,147,76.19,10.88,12.93,2019
"4073067",506,90,189,785,64.46,11.46,24.08,2019
"4073651",982,29,462,1473,66.67,1.97,31.36,2019
"4073662",1300,69,430,1799,72.26,3.84,23.9,2019
"4073669",503,44,104,651,77.27,6.76,15.98,2019
"4073734",218,4,109,331,65.86,1.21,32.93,2019
"3289502",14586,780,3582,18948,76.98,4.12,18.9,2019
"3289512",7772,781,2017,10570,73.53,7.39,19.08,2019
"3289705",1927,24,231,2182,88.31,1.1,10.59,2019
"3289706",6672,418,1387,8477,78.71,4.93,16.36,2019
"3289830",85,0,18,103,82.52,0,17.48,2019
"3289821",230,0,14,244,94.26,0,5.74,2019
"3289823",61,0,8,69,88.41,0,11.59,2019
"3289825",264,22,170,456,57.89,4.82,37.28,2019
"3289314",51,5,115,171,29.82,2.92,67.25,2019
"3289408",6545,181,844,7570,86.46,2.39,11.15,2019
"3289424",39,5,60,104,37.5,4.81,57.69,2019
"3289426",52,0,20,72,72.22,0,27.78,2019
"3289523",13275,478,949,14702,90.29,3.25,6.45,2019
"3289820",1795,24,256,2075,86.51,1.16,12.34,2019
"3289826",0,0,0,0,NA,NA,NA,2019
"3289831",0,0,11,11,0,0,100,2019
"3289883",1085,43,137,1265,85.77,3.4,10.83,2019
"3289013",95,0,58,153,62.09,0,37.91,2019
"3289021",931,28,12,971,95.88,2.88,1.24,2019
"3289027",6616,245,1181,8042,82.27,3.05,14.69,2019
"3289030",9335,532,4306,14173,65.86,3.75,30.38,2019
"3289031",18546,584,1566,20696,89.61,2.82,7.57,2019
"3289120",7848,286,1225,9359,83.86,3.06,13.09,2019
"3289442",317,6,106,429,73.89,1.4,24.71,2019
"3289121",17033,905,5759,23697,71.88,3.82,24.3,2019
"3289317",62,0,49,111,55.86,0,44.14,2019
"3289427",235,13,138,386,60.88,3.37,35.75,2019
"3289444",1127,34,154,1315,85.7,2.59,11.71,2019
"3289448",757,0,71,828,91.43,0,8.57,2019
"3289503",9986,448,1476,11910,83.85,3.76,12.39,2019
"3289510",532,14,62,608,87.5,2.3,10.2,2019
"3289019",531,67,252,850,62.47,7.88,29.65,2019
"3289048",6684,314,1963,8961,74.59,3.5,21.91,2019
"3289049",789,30,421,1240,63.63,2.42,33.95,2019
"3289104",9973,326,3926,14225,70.11,2.29,27.6,2019
"3289117",19946,417,2526,22889,87.14,1.82,11.04,2019
"3289118",7090,211,915,8216,86.3,2.57,11.14,2019
"3289119",15712,1134,4969,21815,72.02,5.2,22.78,2019
"3289122",14169,748,3071,17988,78.77,4.16,17.07,2019
"3289123",21050,791,1881,23722,88.74,3.33,7.93,2019
"3289142",8777,189,1942,10908,80.46,1.73,17.8,2019
"3289701",8702,363,1273,10338,84.17,3.51,12.31,2019
"3289815",4393,170,192,4755,92.39,3.58,4.04,2019
"3289822",642,15,100,757,84.81,1.98,13.21,2019
"3289004",104,4,21,129,80.62,3.1,16.28,2019
"3289014",14234,351,1549,16134,88.22,2.18,9.6,2019
"3289029",3112,140,951,4203,74.04,3.33,22.63,2019
"3289040",1238,47,155,1440,85.97,3.26,10.76,2019
"3289103",16603,1025,4260,21888,75.85,4.68,19.46,2019
"3289135",10877,533,470,11880,91.56,4.49,3.96,2019
"3289139",12201,226,519,12946,94.25,1.75,4.01,2019
"4875209",6221,66,361,6648,93.58,0.99,5.43,2019
"4875215",3719,400,2690,6809,54.62,5.87,39.51,2019
"4875218",8881,231,1292,10404,85.36,2.22,12.42,2019
"4875228",17420,789,7461,25670,67.86,3.07,29.07,2019
"4875234",10445,273,2066,12784,81.7,2.14,16.16,2019
"4875237",4938,467,3754,9159,53.91,5.1,40.99,2019
"4875247",189,0,20,209,90.43,0,9.57,2019
"4875401",5303,221,1364,6888,76.99,3.21,19.8,2019
"4875402",5555,256,933,6744,82.37,3.8,13.83,2019
"4875407",4183,304,1245,5732,72.98,5.3,21.72,2019
"4875418",3477,261,1153,4891,71.09,5.34,23.57,2019
"4875431",546,10,146,702,77.78,1.42,20.8,2019
"4875450",24,21,10,55,43.64,38.18,18.18,2019
"4875451",346,11,179,536,64.55,2.05,33.4,2019
"4875452",1233,35,280,1548,79.65,2.26,18.09,2019
"4875471",319,32,45,396,80.56,8.08,11.36,2019
"4875489",264,51,73,388,68.04,13.14,18.81,2019
"4875495",2425,61,332,2818,86.05,2.16,11.78,2019
"4875551",3110,101,959,4170,74.58,2.42,23,2019
"4876630",376,17,79,472,79.66,3.6,16.74,2019
"4876177",4163,0,110,4273,97.43,0,2.57,2019
"4876208",7300,40,551,7891,92.51,0.51,6.98,2019
"4876041",131,0,9,140,93.57,0,6.43,2019
"4876082",5004,143,1095,6242,80.17,2.29,17.54,2019
"4876133",16044,651,1953,18648,86.04,3.49,10.47,2019
"4876258",2036,225,475,2736,74.42,8.22,17.36,2019
"4876008",5690,81,184,5955,95.55,1.36,3.09,2019
"4876006",10297,386,870,11553,89.13,3.34,7.53,2019
"4876011",7916,454,1332,9702,81.59,4.68,13.73,2019
"4876021",13847,269,813,14929,92.75,1.8,5.45,2019
"4876039",14222,201,659,15082,94.3,1.33,4.37,2019
"4876043",2055,202,373,2630,78.14,7.68,14.18,2019
"4876052",6854,82,121,7057,97.12,1.16,1.71,2019
"4876092",9242,75,136,9453,97.77,0.79,1.44,2019
"4876102",3090,110,471,3671,84.17,3,12.83,2019
"4876107",12452,347,1528,14327,86.91,2.42,10.67,2019
"4876131",12593,241,527,13361,94.25,1.8,3.94,2019
"4876140",8138,181,1283,9602,84.75,1.89,13.36,2019
"4876155",2735,54,234,3023,90.47,1.79,7.74,2019
"4876234",4850,161,935,5946,81.57,2.71,15.72,2019
"4876259",1644,38,245,1927,85.31,1.97,12.71,2019
"4876262",12238,228,453,12919,94.73,1.76,3.51,2019
"4876273",2711,190,643,3544,76.5,5.36,18.14,2019
"4876458",1385,83,543,2011,68.87,4.13,27,2019
"4876033",8467,328,1094,9889,85.62,3.32,11.06,2019
"4876085",3014,69,270,3353,89.89,2.06,8.05,2019
"4876129",0,0,0,0,NA,NA,NA,2019
"4876164",3009,283,1136,4428,67.95,6.39,25.65,2019
"4876182",10554,86,459,11099,95.09,0.77,4.14,2019
"4876209",7925,358,935,9218,85.97,3.88,10.14,2019
"4876210",13782,298,874,14954,92.16,1.99,5.84,2019
"4876244",23613,322,823,24758,95.38,1.3,3.32,2019
"1762932",430,11,128,569,75.57,1.93,22.5,2019
"1762934",239,28,96,363,65.84,7.71,26.45,2019
"1762948",4054,103,1071,5228,77.54,1.97,20.49,2019
"1762959",8456,152,2475,11083,76.3,1.37,22.33,2019
"1762985",187,6,97,290,64.48,2.07,33.45,2019
"1762998",66,34,38,138,47.83,24.64,27.54,2019
"1762226",10116,323,1868,12307,82.2,2.62,15.18,2019
"1762885",214,9,51,274,78.1,3.28,18.61,2019
"1762851",56,5,5,66,84.85,7.58,7.58,2019
"1762852",25,0,7,32,78.12,0,21.88,2019
"1762878",134,27,35,196,68.37,13.78,17.86,2019
"1762888",610,11,262,883,69.08,1.25,29.67,2019
"1762890",775,69,249,1093,70.91,6.31,22.78,2019
"1762891",191,7,66,264,72.35,2.65,25,2019
"1762906",1681,107,779,2567,65.49,4.17,30.35,2019
"1762012",2118,25,416,2559,82.77,0.98,16.26,2019
"1762032",216,2,95,313,69.01,0.64,30.35,2019
"1762075",1129,27,296,1452,77.75,1.86,20.39,2019
"1762087",644,12,140,796,80.9,1.51,17.59,2019
"1762201",1224,109,1282,2615,46.81,4.17,49.02,2019
"1762204",1565,242,1714,3521,44.45,6.87,48.68,2019
"1762219",320,9,122,451,70.95,2,27.05,2019
"1762025",10809,511,752,12072,89.54,4.23,6.23,2019
"1762027",165,0,91,256,64.45,0,35.55,2019
"1762030",46,0,21,67,68.66,0,31.34,2019
"1762031",202,0,122,324,62.35,0,37.65,2019
"1762035",5529,132,1120,6781,81.54,1.95,16.52,2019
"1762045",125,0,23,148,84.46,0,15.54,2019
"1762046",237,1,37,275,86.18,0.36,13.45,2019
"1762048",589,18,103,710,82.96,2.54,14.51,2019
"1762052",3769,99,975,4843,77.82,2.04,20.13,2019
"1762069",1126,36,229,1391,80.95,2.59,16.46,2019
"1762088",2372,22,498,2892,82.02,0.76,17.22,2019
"1762915",82,0,41,123,66.67,0,33.33,2019
"1762887",113,0,22,135,83.7,0,16.3,2019
"1762897",119,3,33,155,76.77,1.94,21.29,2019
"1762916",204,12,144,360,56.67,3.33,40,2019
"1762920",911,32,406,1349,67.53,2.37,30.1,2019
"1762930",1745,84,671,2500,69.8,3.36,26.84,2019
"1762933",427,19,79,525,81.33,3.62,15.05,2019
"4875208",9083,167,1466,10716,84.76,1.56,13.68,2019
"4875219",13760,704,983,15447,89.08,4.56,6.36,2019
"4875232",6458,312,4097,10867,59.43,2.87,37.7,2019
"4875233",4044,129,1082,5255,76.96,2.45,20.59,2019
"4875248",14826,291,1343,16460,90.07,1.77,8.16,2019
"4875270",0,0,0,0,NA,NA,NA,2019
"4875412",197,0,56,253,77.87,0,22.13,2019
"4875420",319,4,62,385,82.86,1.04,16.1,2019
"4875424",935,27,164,1126,83.04,2.4,14.56,2019
"4875432",905,40,315,1260,71.83,3.17,25,2019
"4875442",2304,46,695,3045,75.67,1.51,22.82,2019
"4875460",5775,652,3490,9917,58.23,6.57,35.19,2019
"4875470",31,22,66,119,26.05,18.49,55.46,2019
"4875476",284,23,128,435,65.29,5.29,29.43,2019
"4875482",7549,503,1429,9481,79.62,5.31,15.07,2019
"4875044",14438,159,736,15333,94.16,1.04,4.8,2019
"4875662",5926,743,2215,8884,66.7,8.36,24.93,2019
"4875701",9570,435,2190,12195,78.47,3.57,17.96,2019
"4875709",1464,28,264,1756,83.37,1.59,15.03,2019
"1762655",132,15,44,191,69.11,7.85,23.04,2019
"1762670",863,30,172,1065,81.03,2.82,16.15,2019
"1762677",744,35,174,953,78.07,3.67,18.26,2019
"1762690",1317,36,292,1645,80.06,2.19,17.75,2019
"1762695",78,0,23,101,77.23,0,22.77,2019
"1762806",1191,60,250,1501,79.35,4,16.66,2019
"1762828",361,22,135,518,69.69,4.25,26.06,2019
"1762867",131,3,85,219,59.82,1.37,38.81,2019
"1762875",327,23,102,452,72.35,5.09,22.57,2019
"1762879",19,5,6,30,63.33,16.67,20,2019
"1762880",203,2,74,279,72.76,0.72,26.52,2019
"1762884",872,72,252,1196,72.91,6.02,21.07,2019
"1762889",270,5,82,357,75.63,1.4,22.97,2019
"1762908",151,0,53,204,74.02,0,25.98,2019
"1762367",357,7,117,481,74.22,1.46,24.32,2019
"1762373",85,0,24,109,77.98,0,22.02,2019
"1762375",112,0,27,139,80.58,0,19.42,2019
"1762425",134,36,33,203,66.01,17.73,16.26,2019
"1762433",356,3,121,480,74.17,0.62,25.21,2019
"1762443",443,0,155,598,74.08,0,25.92,2019
"1762445",279,39,164,482,57.88,8.09,34.02,2019
"1762458",622,28,169,819,75.95,3.42,20.63,2019
"1762460",408,28,119,555,73.51,5.05,21.44,2019
"1762521",11749,620,2471,14840,79.17,4.18,16.65,2019
"1762537",47,0,0,47,100,0,0,2019
"1762539",371,19,95,485,76.49,3.92,19.59,2019
"1762540",528,44,85,657,80.37,6.7,12.94,2019
"1762546",610,14,64,688,88.66,2.03,9.3,2019
"1762325",149,15,22,186,80.11,8.06,11.83,2019
"1762336",7,0,5,12,58.33,0,41.67,2019
"1762347",605,16,110,731,82.76,2.19,15.05,2019
"1762354",426,37,108,571,74.61,6.48,18.91,2019
"1762357",127,12,30,169,75.15,7.1,17.75,2019
"1762374",129,10,64,203,63.55,4.93,31.53,2019
"1762378",326,14,141,481,67.78,2.91,29.31,2019
"1762422",296,13,127,436,67.89,2.98,29.13,2019
"1762426",252,2,114,368,68.48,0.54,30.98,2019
"1762431",269,36,95,400,67.25,9,23.75,2019
"1762434",121,0,47,168,72.02,0,27.98,2019
"1762436",150,7,115,272,55.15,2.57,42.28,2019
"1762241",337,10,52,399,84.46,2.51,13.03,2019
"1762348",53,1,7,61,86.89,1.64,11.48,2019
"1762349",209,2,50,261,80.08,0.77,19.16,2019
"1762362",108,0,44,152,71.05,0,28.95,2019
"1762615",1830,82,216,2128,86,3.85,10.15,2019
"1762626",2459,91,422,2972,82.74,3.06,14.2,2019
"1762628",260,4,39,303,85.81,1.32,12.87,2019
"1762629",4896,251,247,5394,90.77,4.65,4.58,2019
"1762649",150,7,57,214,70.09,3.27,26.64,2019
"1762664",1057,20,292,1369,77.21,1.46,21.33,2019
"1762667",174,0,63,237,73.42,0,26.58,2019
"1762704",16134,713,2211,19058,84.66,3.74,11.6,2019
"1762801",6490,310,1568,8368,77.56,3.7,18.74,2019
"1761720",52,3,14,69,75.36,4.35,20.29,2019
"1761726",896,22,71,989,90.6,2.22,7.18,2019
"3289144",7022,88,442,7552,92.98,1.17,5.85,2019
"3289145",8614,232,1101,9947,86.6,2.33,11.07,2019
"0880304",10414,299,364,11077,94.01,2.7,3.29,2019
"0880002",6811,232,1303,8346,81.61,2.78,15.61,2019
"0880004",13083,425,1355,14863,88.02,2.86,9.12,2019
"0880022",12097,304,2518,14919,81.08,2.04,16.88,2019
"0880026",11738,292,596,12626,92.97,2.31,4.72,2019
"0880033",9599,475,1628,11702,82.03,4.06,13.91,2019
"0880860",204,22,94,320,63.75,6.88,29.38,2019
"0880915",7573,58,607,8238,91.93,0.7,7.37,2019
"0880917",11603,323,930,12856,90.25,2.51,7.23,2019
"4879547",234,0,69,303,77.23,0,22.77,2019
"4879102",3019,111,1086,4216,71.61,2.63,25.76,2019
"4879830",2717,232,449,3398,79.96,6.83,13.21,2019
"4879837",50,17,115,182,27.47,9.34,63.19,2019
"4879839",181,44,217,442,40.95,9.95,49.1,2019
"4879845",522,109,925,1556,33.55,7.01,59.45,2019
"4879854",48,0,0,48,100,0,0,2019
"4879934",8309,374,523,9206,90.26,4.06,5.68,2019
"4879938",21444,566,1632,23642,90.7,2.39,6.9,2019
"4879411",2185,132,698,3015,72.47,4.38,23.15,2019
"4879506",271,12,75,358,75.7,3.35,20.95,2019
"4879838",1314,18,573,1905,68.98,0.94,30.08,2019
"4879852",219,8,143,370,59.19,2.16,38.65,2019
"4879905",3993,202,3370,7565,52.78,2.67,44.55,2019
"4879906",1271,13,9,1293,98.3,1.01,0.7,2019
"4879935",4970,237,1009,6216,79.95,3.81,16.23,2019
"4879936",30571,873,3993,35437,86.27,2.46,11.27,2019
"0881152",338,21,318,677,49.93,3.1,46.97,2019
"0881252",1560,61,282,1903,81.98,3.21,14.82,2019
"0881323",1553,55,309,1917,81.01,2.87,16.12,2019
"0881039",504,14,177,695,72.52,2.01,25.47,2019
"0881055",600,38,113,751,79.89,5.06,15.05,2019
"0881067",1441,51,598,2090,68.95,2.44,28.61,2019
"0881092",317,7,63,387,81.91,1.81,16.28,2019
"0881136",54,5,34,93,58.06,5.38,36.56,2019
"0881137",1295,132,757,2184,59.29,6.04,34.66,2019
"0881148",71,0,40,111,63.96,0,36.04,2019
"0881149",238,38,136,412,57.77,9.22,33.01,2019
"0881154",400,17,60,477,83.86,3.56,12.58,2019
"0881220",76,0,0,76,100,0,0,2019
"0881239",26,0,30,56,46.43,0,53.57,2019
"0881428",1115,38,302,1455,76.63,2.61,20.76,2019
"0881433",212,13,45,270,78.52,4.81,16.67,2019
"0881503",5695,41,600,6336,89.88,0.65,9.47,2019
"0881520",4553,83,741,5377,84.68,1.54,13.78,2019
"0881611",4340,92,169,4601,94.33,2,3.67,2019
"0881621",2345,56,87,2488,94.25,2.25,3.5,2019
"0881639",878,34,96,1008,87.1,3.37,9.52,2019
"0881071",99,5,18,122,81.15,4.1,14.75,2019
"0881076",167,4,51,222,75.23,1.8,22.97,2019
"0881101",4436,197,1166,5799,76.5,3.4,20.11,2019
"0881007",10061,285,1097,11443,87.92,2.49,9.59,2019
"4876263",24,0,0,24,100,0,0,2019
"4876402",0,0,0,0,NA,NA,NA,2019
"4876508",0,0,0,0,NA,NA,NA,2019
"4876573",0,0,9,9,0,0,100,2019
"4876596",0,0,0,0,NA,NA,NA,2019
"4876597",0,0,0,0,NA,NA,NA,2019
"4876598",0,0,0,0,NA,NA,NA,2019
"4876599",0,0,0,0,NA,NA,NA,2019
"4876623",67,3,11,81,82.72,3.7,13.58,2019
"4876650",43,0,21,64,67.19,0,32.81,2019
"4876654",22,3,32,57,38.6,5.26,56.14,2019
"4876820",44,0,6,50,88,0,12,2019
"4876836",0,0,0,0,NA,NA,NA,2019
"4876908",0,0,0,0,NA,NA,NA,2019
"4876939",0,0,0,0,NA,NA,NA,2019
"4876957",31,0,0,31,100,0,0,2019
"4876360",1038,62,500,1600,64.88,3.88,31.25,2019
"4876372",288,17,128,433,66.51,3.93,29.56,2019
"4876374",1237,76,343,1656,74.7,4.59,20.71,2019
"4876427",246,14,90,350,70.29,4,25.71,2019
"4876429",87,0,0,87,100,0,0,2019
"4876501",4572,134,1587,6293,72.65,2.13,25.22,2019
"4876502",13546,398,1425,15369,88.14,2.59,9.27,2019
"4876261",89,2,25,116,76.72,1.72,21.55,2019
"4876228",273,16,78,367,74.39,4.36,21.25,2019
"4876248",12542,199,466,13207,94.96,1.51,3.53,2019
"4877702",984,0,311,1295,75.98,0,24.02,2019
"4877705",6698,254,3499,10451,64.09,2.43,33.48,2019
"4877706",10323,259,2020,12602,81.92,2.06,16.03,2019
"4877802",9323,490,1075,10888,85.63,4.5,9.87,2019
"4877836",3348,112,1066,4526,73.97,2.47,23.55,2019
"4877856",1542,78,357,1977,78,3.95,18.06,2019
"4877879",1507,36,541,2084,72.31,1.73,25.96,2019
"4877961",64,0,39,103,62.14,0,37.86,2019
"4877962",879,66,234,1179,74.55,5.6,19.85,2019
"4877968",795,71,183,1049,75.79,6.77,17.45,2019
"4877971",161,0,70,231,69.7,0,30.3,2019
"4877982",303,0,3,306,99.02,0,0.98,2019
"4877086",6236,226,1460,7922,78.72,2.85,18.43,2019
"4877464",22,6,25,53,41.51,11.32,47.17,2019
"4877493",10401,92,581,11074,93.92,0.83,5.25,2019
"4877494",35308,461,806,36575,96.54,1.26,2.2,2019
"4877872",573,33,150,756,75.79,4.37,19.84,2019
"4877964",2496,43,761,3300,75.64,1.3,23.06,2019
"4877970",104,7,45,156,66.67,4.49,28.85,2019
"4877974",91,10,24,125,72.8,8,19.2,2019
"4877977",66,40,123,229,28.82,17.47,53.71,2019
"4877984",1237,42,272,1551,79.75,2.71,17.54,2019
"4877991",57,0,14,71,80.28,0,19.72,2019
"4877994",64,0,85,149,42.95,0,57.05,2019
"4877015",13341,640,3403,17384,76.74,3.68,19.58,2019
"4877022",4986,392,3877,9255,53.87,4.24,41.89,2019
"4875755",1456,54,334,1844,78.96,2.93,18.11,2019
"4875048",7530,60,525,8115,92.79,0.74,6.47,2019
"4875068",19700,129,761,20590,95.68,0.63,3.7,2019
"4875070",35113,269,1467,36849,95.29,0.73,3.98,2019
"4875087",11490,224,701,12415,92.55,1.8,5.65,2019
"4875092",7686,800,1482,9968,77.11,8.03,14.87,2019
"4875115",16519,346,2318,19183,86.11,1.8,12.08,2019
"4875127",367,51,188,606,60.56,8.42,31.02,2019
"4875142",3895,443,1304,5642,69.04,7.85,23.11,2019
"4875155",711,23,213,947,75.08,2.43,22.49,2019
"4875164",167,0,98,265,63.02,0,36.98,2019
"4875454",2837,99,108,3044,93.2,3.25,3.55,2019
"4875455",7028,202,2175,9405,74.73,2.15,23.13,2019
"4875478",311,14,78,403,77.17,3.47,19.35,2019
"4875481",77,5,32,114,67.54,4.39,28.07,2019
"4875488",182,3,66,251,72.51,1.2,26.29,2019
"4875494",2811,97,656,3564,78.87,2.72,18.41,2019
"4875497",1353,22,290,1665,81.26,1.32,17.42,2019
"4875554",621,4,202,827,75.09,0.48,24.43,2019
"4875556",240,31,137,408,58.82,7.6,33.58,2019
"4875566",168,0,142,310,54.19,0,45.81,2019
"4875567",1300,76,249,1625,80,4.68,15.32,2019
"4875641",34,0,9,43,79.07,0,20.93,2019
"4876865",54,5,9,68,79.41,7.35,13.24,2019
"4876877",1146,36,302,1484,77.22,2.43,20.35,2019
"4876945",584,47,245,876,66.67,5.37,27.97,2019
"4876951",392,10,56,458,85.59,2.18,12.23,2019
"4876656",571,11,130,712,80.2,1.54,18.26,2019
"4876681",201,6,87,294,68.37,2.04,29.59,2019
"4876661",1198,127,756,2081,57.57,6.1,36.33,2019
"4876666",73,1,17,91,80.22,1.1,18.68,2019
"4876676",65,6,27,98,66.33,6.12,27.55,2019
"4876678",57,0,27,84,67.86,0,32.14,2019
"4876686",51,8,25,84,60.71,9.52,29.76,2019
"4876001",9847,129,513,10489,93.88,1.23,4.89,2019
"4876010",12757,872,4105,17734,71.94,4.92,23.15,2019
"4876014",8682,605,1690,10977,79.09,5.51,15.4,2019
"4876018",8668,119,413,9200,94.22,1.29,4.49,2019
"4876044",1376,37,237,1650,83.39,2.24,14.36,2019
"4876064",451,13,81,545,82.75,2.39,14.86,2019
"4074452",104,0,27,131,79.39,0,20.61,2019
"4074457",109,6,43,158,68.99,3.8,27.22,2019
"4074463",15,20,40,75,20,26.67,53.33,2019
"4074431",217,0,100,317,68.45,0,31.55,2019
"4074525",2630,65,1039,3734,70.43,1.74,27.83,2019
"4074535",5,0,24,29,17.24,0,82.76,2019
"4074549",18,0,13,31,58.06,0,41.94,2019
"4074554",532,16,205,753,70.65,2.12,27.22,2019
"4074555",202,6,116,324,62.35,1.85,35.8,2019
"4074569",188,8,77,273,68.86,2.93,28.21,2019
"4074574",286,21,142,449,63.7,4.68,31.63,2019
"4074637",458,21,184,663,69.08,3.17,27.75,2019
"4074650",134,23,93,250,53.6,9.2,37.2,2019
"4074726",527,53,366,946,55.71,5.6,38.69,2019
"4074734",291,12,171,474,61.39,2.53,36.08,2019
"4074738",130,6,115,251,51.79,2.39,45.82,2019
"4074871",599,31,300,930,64.41,3.33,32.26,2019
"4074565",212,2,44,258,82.17,0.78,17.05,2019
"4074576",30,3,20,53,56.6,5.66,37.74,2019
"1761316",98,7,15,120,81.67,5.83,12.5,2019
"1761006",518,26,191,735,70.48,3.54,25.99,2019
"1761020",890,37,66,993,89.63,3.73,6.65,2019
"1761028",718,38,270,1026,69.98,3.7,26.32,2019
"4876520",1870,83,880,2833,66.01,2.93,31.06,2019
"4876522",12040,190,1421,13651,88.2,1.39,10.41,2019
"4876531",1213,50,480,1743,69.59,2.87,27.54,2019
"4876534",768,48,198,1014,75.74,4.73,19.53,2019
"4876543",9806,455,1586,11847,82.77,3.84,13.39,2019
"4876548",8991,290,953,10234,87.85,2.83,9.31,2019
"4876621",262,2,91,355,73.8,0.56,25.63,2019
"4876628",19,0,8,27,70.37,0,29.63,2019
"4876643",4927,263,235,5425,90.82,4.85,4.33,2019
"4876648",768,25,262,1055,72.8,2.37,24.83,2019
"4876657",2913,105,361,3379,86.21,3.11,10.68,2019
"4876012",8822,275,1198,10295,85.69,2.67,11.64,2019
"4876013",10896,477,1504,12877,84.62,3.7,11.68,2019
"4876017",15273,322,1434,17029,89.69,1.89,8.42,2019
"4876020",8484,379,1472,10335,82.09,3.67,14.24,2019
"4876054",4221,64,96,4381,96.35,1.46,2.19,2019
"4876059",1364,108,268,1740,78.39,6.21,15.4,2019
"4876457",1077,44,318,1439,74.84,3.06,22.1,2019
"4876436",54,0,30,84,64.29,0,35.71,2019
"4876448",1412,19,469,1900,74.32,1,24.68,2019
"4876452",4,0,28,32,12.5,0,87.5,2019
"4876471",418,52,224,694,60.23,7.49,32.28,2019
"4876487",765,8,218,991,77.19,0.81,22,2019
"4876524",919,44,150,1113,82.57,3.95,13.48,2019
"4876541",5339,314,1911,7564,70.58,4.15,25.26,2019
"4876554",554,38,157,749,73.97,5.07,20.96,2019
"4876556",412,22,157,591,69.71,3.72,26.57,2019
"4876887",40,0,11,51,78.43,0,21.57,2019
"4876934",232,23,104,359,64.62,6.41,28.97,2019
"4876950",749,94,578,1421,52.71,6.62,40.68,2019
"4876071",1152,60,153,1365,84.4,4.4,11.21,2019
"4876105",3926,181,2441,6548,59.96,2.76,37.28,2019
"4876110",7990,391,1968,10349,77.21,3.78,19.02,2019
"4074033",4058,41,283,4382,92.61,0.94,6.46,2019
"4074045",72,17,43,132,54.55,12.88,32.58,2019
"4074047",2195,42,349,2586,84.88,1.62,13.5,2019
"4074080",771,66,233,1070,72.06,6.17,21.78,2019
"4074083",249,18,120,387,64.34,4.65,31.01,2019
"4074001",105,11,14,130,80.77,8.46,10.77,2019
"4074008",9867,65,561,10493,94.03,0.62,5.35,2019
"4074030",1160,40,348,1548,74.94,2.58,22.48,2019
"4074032",614,33,250,897,68.45,3.68,27.87,2019
"4074034",24,8,21,53,45.28,15.09,39.62,2019
"4074042",70,3,77,150,46.67,2,51.33,2019
"4074044",2112,70,582,2764,76.41,2.53,21.06,2019
"4074056",1519,87,563,2169,70.03,4.01,25.96,2019
"4074061",606,51,137,794,76.32,6.42,17.25,2019
"4074062",268,15,91,374,71.66,4.01,24.33,2019
"4074108",2093,98,523,2714,77.12,3.61,19.27,2019
"4074115",5519,244,2221,7984,69.13,3.06,27.82,2019
"4074017",8307,315,2457,11079,74.98,2.84,22.18,2019
"4074026",220,5,107,332,66.27,1.51,32.23,2019
"4074028",435,16,149,600,72.5,2.67,24.83,2019
"4074114",6673,92,574,7339,90.93,1.25,7.82,2019
"4074126",2557,98,1090,3745,68.28,2.62,29.11,2019
"0881020",299,31,110,440,67.95,7.05,25,2019
"0881022",366,4,194,564,64.89,0.71,34.4,2019
"0881029",94,8,35,137,68.61,5.84,25.55,2019
"0881045",21,0,5,26,80.77,0,19.23,2019
"0881047",408,2,155,565,72.21,0.35,27.43,2019
"0881052",2895,60,734,3689,78.48,1.63,19.9,2019
"0881057",145,6,17,168,86.31,3.57,10.12,2019
"0881089",1334,144,686,2164,61.65,6.65,31.7,2019
"4984123",12224,897,1508,14629,83.56,6.13,10.31,2019
"4984339",1375,62,55,1492,92.16,4.16,3.69,2019
"4984501",4024,113,694,4831,83.3,2.34,14.37,2019
"4984050",3130,38,119,3287,95.22,1.16,3.62,2019
"4984010",13716,296,1219,15231,90.05,1.94,8,2019
"4984029",2890,21,180,3091,93.5,0.68,5.82,2019
"4984033",321,0,43,364,88.19,0,11.81,2019
"4984053",304,18,45,367,82.83,4.9,12.26,2019
"4984058",10468,850,715,12033,86.99,7.06,5.94,2019
"4984062",12042,1109,517,13668,88.1,8.11,3.78,2019
"4984064",163,6,25,194,84.02,3.09,12.89,2019
"4984069",149,0,25,174,85.63,0,14.37,2019
"4984097",6215,216,252,6683,93,3.23,3.77,2019
"4984109",8223,202,657,9082,90.54,2.22,7.23,2019
"4984117",8770,448,657,9875,88.81,4.54,6.65,2019
"4984313",36,10,0,46,78.26,21.74,0,2019
"4984401",11820,468,1956,14244,82.98,3.29,13.73,2019
"4984512",83,5,129,217,38.25,2.3,59.45,2019
"4984526",1363,90,235,1688,80.75,5.33,13.92,2019
"4984737",5388,76,802,6266,85.99,1.21,12.8,2019
"4984776",153,7,28,188,81.38,3.72,14.89,2019
"4984007",197,0,11,208,94.71,0,5.29,2019
"4984020",12373,982,343,13698,90.33,7.17,2.5,2019
"4984024",11,0,0,11,100,0,0,2019
"4984032",6160,135,496,6791,90.71,1.99,7.3,2019
"4984034",41,5,32,78,52.56,6.41,41.03,2019
"4984036",2248,47,162,2457,91.49,1.91,6.59,2019
"4984040",6910,260,306,7476,92.43,3.48,4.09,2019
"4984042",2648,140,95,2883,91.85,4.86,3.3,2019
"4984047",11388,522,1334,13244,85.99,3.94,10.07,2019
"4984051",160,0,7,167,95.81,0,4.19,2019
"4984067",11751,302,810,12863,91.36,2.35,6.3,2019
"4984070",8448,772,1119,10339,81.71,7.47,10.82,2019
"4984085",67,5,46,118,56.78,4.24,38.98,2019
"4984087",4444,75,233,4752,93.52,1.58,4.9,2019
"4984094",8815,402,360,9577,92.04,4.2,3.76,2019
"4984107",11566,494,1677,13737,84.2,3.6,12.21,2019
"4984108",7054,384,384,7822,90.18,4.91,4.91,2019
"4984112",95,59,25,179,53.07,32.96,13.97,2019
"4984128",6459,95,336,6890,93.74,1.38,4.88,2019
"4984180",0,0,0,0,NA,NA,NA,2019
"4984304",26,0,0,26,100,0,0,2019
"4984306",77,0,13,90,85.56,0,14.44,2019
"4984775",141,8,7,156,90.38,5.13,4.49,2019
"4984762",51,0,0,51,100,0,0,2019
"4984772",65,0,26,91,71.43,0,28.57,2019
"4984781",56,0,12,68,82.35,0,17.65,2019
"4984511",1006,16,358,1380,72.9,1.16,25.94,2019
"4984513",419,0,117,536,78.17,0,21.83,2019
"4984516",49,2,10,61,80.33,3.28,16.39,2019
"4984522",117,0,13,130,90,0,10,2019
"4877026",4451,212,3297,7960,55.92,2.66,41.42,2019
"4877027",9066,321,346,9733,93.15,3.3,3.55,2019
"4877047",9454,109,970,10533,89.76,1.03,9.21,2019
"4877005",9597,62,448,10107,94.95,0.61,4.43,2019
"4877007",19334,119,941,20394,94.8,0.58,4.61,2019
"4877017",7710,163,2214,10087,76.44,1.62,21.95,2019
"4877019",10369,194,670,11233,92.31,1.73,5.96,2019
"4877378",4540,21,1116,5677,79.97,0.37,19.66,2019
"4877356",10723,295,657,11675,91.85,2.53,5.63,2019
"4877357",6554,222,1286,8062,81.29,2.75,15.95,2019
"4877359",125,0,0,125,100,0,0,2019
"4877382",12876,190,314,13380,96.23,1.42,2.35,2019
"4877396",15951,540,2184,18675,85.41,2.89,11.69,2019
"4877419",287,27,146,460,62.39,5.87,31.74,2019
"4877428",0,0,0,0,NA,NA,NA,2019
"4877432",19,0,0,19,100,0,0,2019
"4877435",1304,32,237,1573,82.9,2.03,15.07,2019
"4877441",3802,10,130,3942,96.45,0.25,3.3,2019
"4877447",4424,95,525,5044,87.71,1.88,10.41,2019
"4877025",10705,420,1465,12590,85.03,3.34,11.64,2019
"4877038",6514,279,2282,9075,71.78,3.07,25.15,2019
"4877039",4454,139,3014,7607,58.55,1.83,39.62,2019
"4877040",14749,542,2494,17785,82.93,3.05,14.02,2019
"4877057",17170,424,2575,20169,85.13,2.1,12.77,2019
"4877060",9393,533,4239,14165,66.31,3.76,29.93,2019
"4877067",8035,184,1998,10217,78.64,1.8,19.56,2019
"4877068",3477,32,477,3986,87.23,0.8,11.97,2019
"4877077",24892,498,1707,27097,91.86,1.84,6.3,2019
"4877303",5818,156,715,6689,86.98,2.33,10.69,2019
"4877335",872,56,274,1202,72.55,4.66,22.8,2019
"4877368",79,0,24,103,76.7,0,23.3,2019
"4877381",12862,142,734,13738,93.62,1.03,5.34,2019
"4877385",7820,131,629,8580,91.14,1.53,7.33,2019
"2963558",202,4,63,269,75.09,1.49,23.42,2019
"2963560",25,0,61,86,29.07,0,70.93,2019
"2963624",1032,76,409,1517,68.03,5.01,26.96,2019
"2963675",45,0,28,73,61.64,0,38.36,2019
"2963738",0,0,0,0,NA,NA,NA,2019
"2963763",59,0,23,82,71.95,0,28.05,2019
"2963764",1406,30,487,1923,73.11,1.56,25.33,2019
"2963783",52,0,6,58,89.66,0,10.34,2019
"2963933",972,37,310,1319,73.69,2.81,23.5,2019
"2963936",169,27,60,256,66.02,10.55,23.44,2019
"2963939",327,13,169,509,64.24,2.55,33.2,2019
"2963944",411,11,260,682,60.26,1.61,38.12,2019
"2963952",123,0,16,139,88.49,0,11.51,2019
"2963089",1821,94,186,2101,86.67,4.47,8.85,2019
"2963106",2356,277,1847,4480,52.59,6.18,41.23,2019
"2963110",6994,405,841,8240,84.88,4.92,10.21,2019
"2963877",1035,12,271,1318,78.53,0.91,20.56,2019
"2963940",431,0,174,605,71.24,0,28.76,2019
"2963025",4754,155,281,5190,91.6,2.99,5.41,2019
"4074577",39,6,43,88,44.32,6.82,48.86,2019
"4878666",22127,3060,3867,29054,76.16,10.53,13.31,2019
"4878671",187,79,57,323,57.89,24.46,17.65,2019
"4878675",102,25,23,150,68,16.67,15.33,2019
"4878676",4966,97,249,5312,93.49,1.83,4.69,2019
"4878717",10197,69,286,10552,96.64,0.65,2.71,2019
"4878737",5328,185,108,5621,94.79,3.29,1.92,2019
"4878747",6359,137,475,6971,91.22,1.97,6.81,2019
"4878749",14468,366,594,15428,93.78,2.37,3.85,2019
"4878757",9837,117,983,10937,89.94,1.07,8.99,2019
"4878836",15,0,53,68,22.06,0,77.94,2019
"4878220",3383,522,1521,5426,62.35,9.62,28.03,2019
"4878224",4649,176,1123,5948,78.16,2.96,18.88,2019
"4878229",10480,1128,2588,14196,73.82,7.95,18.23,2019
"4878264",2046,113,665,2824,72.45,4,23.55,2019
"4878336",2662,112,1277,4051,65.71,2.76,31.52,2019
"4878352",49,0,57,106,46.23,0,53.77,2019
"4878368",1971,92,1245,3308,59.58,2.78,37.64,2019
"4878384",1019,0,702,1721,59.21,0,40.79,2019
"4878412",13288,368,1516,15172,87.58,2.43,9.99,2019
"4878413",13484,327,1191,15002,89.88,2.18,7.94,2019
"4878538",2140,135,880,3155,67.83,4.28,27.89,2019
"4878539",9798,297,2108,12203,80.29,2.43,17.27,2019
"4878550",11259,604,4950,16813,66.97,3.59,29.44,2019
"4878575",2387,812,256,3455,69.09,23.5,7.41,2019
"4878589",5326,1135,4132,10593,50.28,10.71,39.01,2019
"4878606",1681,43,307,2031,82.77,2.12,15.12,2019
"4878065",2883,32,541,3456,83.42,0.93,15.65,2019
"4878045",17027,746,1365,19138,88.97,3.9,7.13,2019
"4878052",1698,44,320,2062,82.35,2.13,15.52,2019
"4878064",4416,118,655,5189,85.1,2.27,12.62,2019
"4878108",11575,145,526,12246,94.52,1.18,4.3,2019
"4878130",24294,607,3253,28154,86.29,2.16,11.55,2019
"4878146",135,0,69,204,66.18,0,33.82,2019
"4878015",5052,137,85,5274,95.79,2.6,1.61,2019
"4878019",143,9,124,276,51.81,3.26,44.93,2019
"4878022",778,92,520,1390,55.97,6.62,37.41,2019
"4878026",1607,27,407,2041,78.74,1.32,19.94,2019
"4878027",75,13,0,88,85.23,14.77,0,2019
"4878040",5119,546,5847,11512,44.47,4.74,50.79,2019
"4879903",3839,188,1857,5884,65.24,3.2,31.56,2019
"4879912",24009,1165,3316,28490,84.27,4.09,11.64,2019
"4879915",8174,390,3901,12465,65.58,3.13,31.3,2019
"4879927",8464,593,2199,11256,75.2,5.27,19.54,2019
"4879932",7213,418,1268,8899,81.05,4.7,14.25,2019
"1683702",9330,298,1367,10995,84.86,2.71,12.43,2019
"5683112",134,0,0,134,100,0,0,2019
"1683262",319,35,30,384,83.07,9.11,7.81,2019
"5683025",144,0,135,279,51.61,0,48.39,2019
"1683209",53,59,20,132,40.15,44.7,15.15,2019
"1683233",24,0,0,24,100,0,0,2019
"5683414",159,46,3,208,76.44,22.12,1.44,2019
"1683454",177,0,9,186,95.16,0,4.84,2019
"1683460",0,0,0,0,NA,NA,NA,2019
"1683636",46,0,0,46,100,0,0,2019
"1683646",19369,841,2299,22509,86.05,3.74,10.21,2019
"1683825",76,0,21,97,78.35,0,21.65,2019
"1683840",65,0,38,103,63.11,0,36.89,2019
"1683844",0,0,0,0,NA,NA,NA,2019
"4073738",326,4,93,423,77.07,0.95,21.99,2019
"4073753",123,19,35,177,69.49,10.73,19.77,2019
"4073760",123,9,50,182,67.58,4.95,27.47,2019
"4073762",547,17,185,749,73.03,2.27,24.7,2019
"4073763",573,17,178,768,74.61,2.21,23.18,2019
"4073764",54,0,24,78,69.23,0,30.77,2019
"4073933",442,77,191,710,62.25,10.85,26.9,2019
"4073950",404,0,94,498,81.12,0,18.88,2019
"4073951",297,9,68,374,79.41,2.41,18.18,2019
"4073038",548,17,212,777,70.53,2.19,27.28,2019
"4073093",941,18,146,1105,85.16,1.63,13.21,2019
"4073441",29,3,30,62,46.77,4.84,48.39,2019
"4073491",151,27,61,239,63.18,11.3,25.52,2019
"4073650",246,11,83,340,72.35,3.24,24.41,2019
"4073720",52,5,7,64,81.25,7.81,10.94,2019
"4073503",1612,16,23,1651,97.64,0.97,1.39,2019
"4073554",905,46,307,1258,71.94,3.66,24.4,2019
"4073625",199,13,82,294,67.69,4.42,27.89,2019
"4073739",114,11,28,153,74.51,7.19,18.3,2019
"4073851",15,3,8,26,57.69,11.54,30.77,2019
"4073006",912,45,281,1238,73.67,3.63,22.7,2019
"4073007",850,20,168,1038,81.89,1.93,16.18,2019
"4073010",5672,298,633,6603,85.9,4.51,9.59,2019
"4073015",751,24,310,1085,69.22,2.21,28.57,2019
"4073033",100,4,38,142,70.42,2.82,26.76,2019
"4073051",2161,84,474,2719,79.48,3.09,17.43,2019
"4073053",172,4,70,246,69.92,1.63,28.46,2019
"4073061",534,10,123,667,80.06,1.5,18.44,2019
"4876707",3601,414,1210,5225,68.92,7.92,23.16,2019
"4876827",113,5,53,171,66.08,2.92,30.99,2019
"4876831",0,0,0,0,NA,NA,NA,2019
"4876834",1571,191,461,2223,70.67,8.59,20.74,2019
"4876837",404,0,158,562,71.89,0,28.11,2019
"4876845",83,0,26,109,76.15,0,23.85,2019
"4876856",1071,89,341,1501,71.35,5.93,22.72,2019
"4876858",82,1,44,127,64.57,0.79,34.65,2019
"4876009",5736,140,833,6709,85.5,2.09,12.42,2019
"4876031",4847,176,980,6003,80.74,2.93,16.33,2019
"4876036",8146,258,581,8985,90.66,2.87,6.47,2019
"4876302",3969,218,878,5065,78.36,4.3,17.33,2019
"4876308",7170,461,659,8290,86.49,5.56,7.95,2019
"4876370",70,6,42,118,59.32,5.08,35.59,2019
"4876380",1165,36,351,1552,75.06,2.32,22.62,2019
"4876424",2283,81,579,2943,77.57,2.75,19.67,2019
"4876442",2379,8,773,3160,75.28,0.25,24.46,2019
"4876444",1056,27,352,1435,73.59,1.88,24.53,2019
"4876445",64,0,67,131,48.85,0,51.15,2019
"4876449",768,50,170,988,77.73,5.06,17.21,2019
"4876450",4024,296,974,5294,76.01,5.59,18.4,2019
"4876462",999,7,218,1224,81.62,0.57,17.81,2019
"4876464",151,13,92,256,58.98,5.08,35.94,2019
"4876476",734,60,184,978,75.05,6.13,18.81,2019
"4876511",407,27,207,641,63.49,4.21,32.29,2019
"4878614",232,0,16,248,93.55,0,6.45,2019
"4878617",5942,166,682,6790,87.51,2.44,10.04,2019
"4878631",806,35,220,1061,75.97,3.3,20.74,2019
"4878635",132,0,18,150,88,0,12,2019
"4878656",521,15,175,711,73.28,2.11,24.61,2019
"4878663",345,2,7,354,97.46,0.56,1.98,2019
"4984532",3879,154,310,4343,89.32,3.55,7.14,2019
"4984601",7488,2559,686,10733,69.77,23.84,6.39,2019
"3587002",5605,401,2312,8318,67.38,4.82,27.8,2019
"3587012",15,5,66,86,17.44,5.81,76.74,2019
"3587412",165,29,132,326,50.61,8.9,40.49,2019
"3587413",3927,215,1619,5761,68.17,3.73,28.1,2019
"3587514",182,0,94,276,65.94,0,34.06,2019
"3587939",49,0,0,49,100,0,0,2019
"3289834",31,0,10,41,75.61,0,24.39,2019
"3289835",478,62,104,644,74.22,9.63,16.15,2019
"3289704",1620,22,182,1824,88.82,1.21,9.98,2019
"3289801",7838,476,1051,9365,83.69,5.08,11.22,2019
"3289015",11684,337,2755,14776,79.07,2.28,18.65,2019
"3289032",11553,501,1903,13957,82.78,3.59,13.63,2019
"3289046",64,0,155,219,29.22,0,70.78,2019
"3289047",49,5,33,87,56.32,5.75,37.93,2019
"3289101",8291,945,5902,15138,54.77,6.24,38.99,2019
"3289102",10106,455,4391,14952,67.59,3.04,29.37,2019
"3289106",5585,549,2730,8864,63.01,6.19,30.8,2019
"3289301",2216,84,498,2798,79.2,3,17.8,2019
"3289311",45,0,10,55,81.82,0,18.18,2019
"3289316",347,24,93,464,74.78,5.17,20.04,2019
"3289403",5433,119,501,6053,89.76,1.97,8.28,2019
"3289406",8510,249,1153,9912,85.86,2.51,11.63,2019
"3289413",341,0,10,351,97.15,0,2.85,2019
"3289434",9532,165,969,10666,89.37,1.55,9.08,2019
"3289156",8010,185,1332,9527,84.08,1.94,13.98,2019
"3289318",306,0,159,465,65.81,0,34.19,2019
"3289409",40,0,26,66,60.61,0,39.39,2019
"3289415",1079,21,412,1512,71.36,1.39,27.25,2019
"3289423",4238,67,309,4614,91.85,1.45,6.7,2019
"3289430",95,21,0,116,81.9,18.1,0,2019
"3289433",5577,128,1101,6806,81.94,1.88,16.18,2019
"3289436",15250,335,805,16390,93.04,2.04,4.91,2019
"3289440",218,31,66,315,69.21,9.84,20.95,2019
"3289447",2756,40,634,3430,80.35,1.17,18.48,2019
"3289451",3653,69,135,3857,94.71,1.79,3.5,2019
"3289007",262,0,75,337,77.74,0,22.26,2019
"3289008",345,29,102,476,72.48,6.09,21.43,2019
"3289012",13111,309,1022,14442,90.78,2.14,7.08,2019
"3289017",39,0,0,39,100,0,0,2019
"3289022",0,0,0,0,NA,NA,NA,2019
"3289109",3015,187,902,4104,73.46,4.56,21.98,2019
"3289110",15961,580,4640,21181,75.36,2.74,21.91,2019
"3289113",10900,291,717,11908,91.54,2.44,6.02,2019
"3289134",9670,730,1107,11507,84.04,6.34,9.62,2019
"3289039",55,0,51,106,51.89,0,48.11,2019
"3289310",115,0,53,168,68.45,0,31.55,2019
"3289418",42,0,60,102,41.18,0,58.82,2019
"3289509",14216,463,2258,16937,83.93,2.73,13.33,2019
"3289833",29,6,17,52,55.77,11.54,32.69,2019
"3289005",5504,152,959,6615,83.2,2.3,14.5,2019
"3289107",9611,382,2696,12689,75.74,3.01,21.25,2019
"3289129",17867,1033,1437,20337,87.85,5.08,7.07,2019
"3289002",11029,239,871,12139,90.86,1.97,7.18,2019
"3289026",0,0,0,0,NA,NA,NA,2019
"3289044",8743,93,509,9345,93.56,1,5.45,2019
"3289045",705,0,164,869,81.13,0,18.87,2019
"3289054",30,0,0,30,100,0,0,2019
"2963031",15526,498,1609,17633,88.05,2.82,9.12,2019
"2963036",412,0,67,479,86.01,0,13.99,2019
"2963060",652,5,142,799,81.6,0.63,17.77,2019
"2963070",2761,97,271,3129,88.24,3.1,8.66,2019
"2963091",483,2,60,545,88.62,0.37,11.01,2019
"2963105",6176,194,292,6662,92.7,2.91,4.38,2019
"2963112",5895,372,1970,8237,71.57,4.52,23.92,2019
"2963114",12015,488,2172,14675,81.87,3.33,14.8,2019
"2963119",12517,467,1213,14197,88.17,3.29,8.54,2019
"2963125",11267,318,2436,14021,80.36,2.27,17.37,2019
"2963130",10372,244,1401,12017,86.31,2.03,11.66,2019
"2963135",6894,181,1388,8463,81.46,2.14,16.4,2019
"2963143",4160,20,747,4927,84.43,0.41,15.16,2019
"2963146",12978,228,1318,14524,89.36,1.57,9.07,2019
"2963304",14246,206,832,15284,93.21,1.35,5.44,2019
"2963348",2461,82,167,2710,90.81,3.03,6.16,2019
"2963357",1713,68,255,2036,84.14,3.34,12.52,2019
"2963382",982,95,285,1362,72.1,6.98,20.93,2019
"2963431",82,0,36,118,69.49,0,30.51,2019
"2963469",351,24,103,478,73.43,5.02,21.55,2019
"2963530",244,17,107,368,66.3,4.62,29.08,2019
"2963531",101,2,35,138,73.19,1.45,25.36,2019
"2963107",2076,241,1839,4156,49.95,5.8,44.25,2019
"2963113",2925,134,1633,4692,62.34,2.86,34.8,2019
"2963117",4030,54,402,4486,89.84,1.2,8.96,2019
"2963120",1645,235,1304,3184,51.66,7.38,40.95,2019
"2963139",9761,262,962,10985,88.86,2.39,8.76,2019
"2963147",1870,417,1351,3638,51.4,11.46,37.14,2019
"2963330",44,0,27,71,61.97,0,38.03,2019
"2963333",188,3,148,339,55.46,0.88,43.66,2019
"2963341",1202,5,157,1364,88.12,0.37,11.51,2019
"2963343",1165,72,438,1675,69.55,4.3,26.15,2019
"2963345",182,25,33,240,75.83,10.42,13.75,2019
"2963359",440,5,92,537,81.94,0.93,17.13,2019
"2963381",124,2,46,172,72.09,1.16,26.74,2019
"2963384",444,48,227,719,61.75,6.68,31.57,2019
"2963534",202,8,117,327,61.77,2.45,35.78,2019
"2963536",242,2,109,353,68.56,0.57,30.88,2019
"2963538",53,9,42,104,50.96,8.65,40.38,2019
"2963539",42,0,24,66,63.64,0,36.36,2019
"4875252",11297,179,934,12410,91.03,1.44,7.53,2019
"4875253",5101,323,1037,6461,78.95,5,16.05,2019
"4875287",24092,477,3518,28087,85.78,1.7,12.53,2019
"4875409",4121,87,623,4831,85.3,1.8,12.9,2019
"4875411",142,8,192,342,41.52,2.34,56.14,2019
"4875416",770,111,232,1113,69.18,9.97,20.84,2019
"4875441",63,0,8,71,88.73,0,11.27,2019
"4875446",772,30,379,1181,65.37,2.54,32.09,2019
"4875447",311,15,114,440,70.68,3.41,25.91,2019
"4875462",3589,139,823,4551,78.86,3.05,18.08,2019
"4875469",63,12,33,108,58.33,11.11,30.56,2019
"4875473",1123,39,248,1410,79.65,2.77,17.59,2019
"1683706",11192,902,1676,13770,81.28,6.55,12.17,2019
"1683814",9256,481,1412,11149,83.02,4.31,12.66,2019
"1683876",504,55,113,672,75,8.18,16.82,2019
"1683228",163,14,19,196,83.16,7.14,9.69,2019
"1683313",1193,4,235,1432,83.31,0.28,16.41,2019
"1683406",5516,178,364,6058,91.05,2.94,6.01,2019
"1683520",84,6,13,103,81.55,5.83,12.62,2019
"1683644",3603,82,521,4206,85.66,1.95,12.39,2019
"1683316",3014,100,829,3943,76.44,2.54,21.02,2019
"1683436",161,5,14,180,89.44,2.78,7.78,2019
"1683238",38,0,0,38,100,0,0,2019
"4879821",1079,73,703,1855,58.17,3.94,37.9,2019
"4879836",1318,29,376,1723,76.49,1.68,21.82,2019
"4879041",798,23,228,1049,76.07,2.19,21.73,2019
"4879045",4861,155,1159,6175,78.72,2.51,18.77,2019
"4879052",325,13,98,436,74.54,2.98,22.48,2019
"4879922",2286,0,234,2520,90.71,0,9.29,2019
"4879924",15369,825,3883,20077,76.55,4.11,19.34,2019
"4879021",50,0,6,56,89.29,0,10.71,2019
"4879051",0,0,0,0,NA,NA,NA,2019
"4879054",184,12,54,250,73.6,4.8,21.6,2019
"4879063",196,3,79,278,70.5,1.08,28.42,2019
"4879065",5291,205,1706,7202,73.47,2.85,23.69,2019
"4879072",6508,230,1630,8368,77.77,2.75,19.48,2019
"4879079",843,45,243,1131,74.54,3.98,21.49,2019
"4879086",624,10,146,780,80,1.28,18.72,2019
"4879103",3055,125,747,3927,77.79,3.18,19.02,2019
"4879104",1822,69,561,2452,74.31,2.81,22.88,2019
"4879345",234,10,66,310,75.48,3.23,21.29,2019
"4879518",16,0,3,19,84.21,0,15.79,2019
"4879560",50,0,24,74,67.57,0,32.43,2019
"4879735",2464,212,1289,3965,62.14,5.35,32.51,2019
"4879081",1049,33,251,1333,78.69,2.48,18.83,2019
"4879098",124,2,28,154,80.52,1.3,18.18,2019
"4879108",3455,166,769,4390,78.7,3.78,17.52,2019
"4879780",25,19,41,85,29.41,22.35,48.24,2019
"4879901",1442,66,2161,3669,39.3,1.8,58.9,2019
"4879707",12974,304,1219,14497,89.49,2.1,8.41,2019
"4879762",13878,393,1466,15737,88.19,2.5,9.32,2019
"4879092",326,30,48,404,80.69,7.43,11.88,2019
"1762935",596,19,164,779,76.51,2.44,21.05,2019
"1762964",267,0,228,495,53.94,0,46.06,2019
"1762970",126,4,143,273,46.15,1.47,52.38,2019
"1762983",418,32,171,621,67.31,5.15,27.54,2019
"1762994",209,18,44,271,77.12,6.64,16.24,2019
"1762060",1443,121,406,1970,73.25,6.14,20.61,2019
"1762022",376,0,94,470,80,0,20,2019
"1762036",192,7,106,305,62.95,2.3,34.75,2019
"1762054",132,2,48,182,72.53,1.1,26.37,2019
"1762081",117,0,15,132,88.64,0,11.36,2019
"1762091",126,0,15,141,89.36,0,10.64,2019
"1762092",842,25,282,1149,73.28,2.18,24.54,2019
"1762956",189,4,153,346,54.62,1.16,44.22,2019
"1762957",153,3,135,291,52.58,1.03,46.39,2019
"1762960",3106,102,1297,4505,68.95,2.26,28.79,2019
"1762962",0,0,0,0,NA,NA,NA,2019
"1762963",99,2,146,247,40.08,0.81,59.11,2019
"1762984",461,21,222,704,65.48,2.98,31.53,2019
"1762988",258,7,197,462,55.84,1.52,42.64,2019
"0690212",5439,57,391,5887,92.39,0.97,6.64,2019
"0690245",6024,105,288,6417,93.88,1.64,4.49,2019
"0690277",14881,187,776,15844,93.92,1.18,4.9,2019
"0690290",2147,14,114,2275,94.37,0.62,5.01,2019
"0690302",9351,261,1024,10636,87.92,2.45,9.63,2019
"0690503",15222,349,1076,16647,91.44,2.1,6.46,2019
"0690605",8760,269,1353,10382,84.38,2.59,13.03,2019
"0690606",7807,229,960,8996,86.78,2.55,10.67,2019
"0690703",14474,191,850,15515,93.29,1.23,5.48,2019
"0690732",8044,192,574,8810,91.31,2.18,6.52,2019
"0690740",10592,210,1748,12550,84.4,1.67,13.93,2019
"0690742",346,5,28,379,91.29,1.32,7.39,2019
"0690021",1086,73,575,1734,62.63,4.21,33.16,2019
"0690059",7519,772,2615,10906,68.94,7.08,23.98,2019
"0690280",20193,626,3252,24071,83.89,2.6,13.51,2019
"0690743",95,0,15,110,86.36,0,13.64,2019
"0690405",12916,274,753,13943,92.63,1.97,5.4,2019
"0690706",18756,647,3837,23240,80.71,2.78,16.51,2019
"0690018",13080,365,3123,16568,78.95,2.2,18.85,2019
"0690250",26862,780,4263,31905,84.19,2.44,13.36,2019
"0690601",9444,311,1226,10981,86,2.83,11.16,2019
"0690254",8455,98,403,8956,94.41,1.09,4.5,2019
"0690710",7796,82,1352,9230,84.46,0.89,14.65,2019
"0690073",0,0,0,0,NA,NA,NA,2019
"0690079",0,0,0,0,NA,NA,NA,2019
"0690089",0,9,0,9,0,100,0,2019
"0690090",0,0,0,0,NA,NA,NA,2019
"0690094",4044,251,66,4361,92.73,5.76,1.51,2019
"0690095",0,0,0,0,NA,NA,NA,2019
"0690506",0,0,0,0,NA,NA,NA,2019
"0690747",0,0,0,0,NA,NA,NA,2019
"0690755",4163,94,486,4743,87.77,1.98,10.25,2019
"0690831",0,0,0,0,NA,NA,NA,2019
"0694043",12082,364,600,13046,92.61,2.79,4.6,2019
"0694087",18799,242,1000,20041,93.8,1.21,4.99,2019
"0694089",7718,63,450,8231,93.77,0.77,5.47,2019
"0694108",5734,186,1880,7800,73.51,2.38,24.1,2019
"0694116",14572,194,1458,16224,89.82,1.2,8.99,2019
"0694118",16113,220,1521,17854,90.25,1.23,8.52,2019
"0694122",21148,339,1449,22936,92.2,1.48,6.32,2019
"0694306",10064,157,459,10680,94.23,1.47,4.3,2019
"0694401",11027,174,1196,12397,88.95,1.4,9.65,2019
"0694508",889,26,82,997,89.17,2.61,8.22,2019
"0694515",2621,131,249,3001,87.34,4.37,8.3,2019
"0694518",9718,226,644,10588,91.78,2.13,6.08,2019
"0694530",9473,207,633,10313,91.85,2.01,6.14,2019
"0694536",22964,142,1867,24973,91.96,0.57,7.48,2019
"0694541",19229,443,2136,21808,88.17,2.03,9.79,2019
"0694546",14730,305,1328,16363,90.02,1.86,8.12,2019
"0694547",8007,59,336,8402,95.3,0.7,4,2019
"0694552",4780,3,160,4943,96.7,0.06,3.24,2019
"0694565",25628,481,2259,28368,90.34,1.7,7.96,2019
"0694566",15575,219,681,16475,94.54,1.33,4.13,2019
"4879016",0,0,0,0,NA,NA,NA,2019
"4879058",0,0,0,0,NA,NA,NA,2019
"4879085",1,0,6,7,14.29,0,85.71,2019
"4879094",11,0,0,11,100,0,0,2019
"4879105",0,0,0,0,NA,NA,NA,2019
"4879258",18,0,0,18,100,0,0,2019
"3289060",2916,95,1204,4215,69.18,2.25,28.56,2019
"3289061",2192,109,365,2666,82.22,4.09,13.69,2019
"3289074",18168,532,1467,20167,90.09,2.64,7.27,2019
"3289081",10089,311,692,11092,90.96,2.8,6.24,2019
"3289084",8653,220,489,9362,92.43,2.35,5.22,2019
"3289085",1133,88,28,1249,90.71,7.05,2.24,2019
"3289086",1697,68,162,1927,88.06,3.53,8.41,2019
"3289138",5566,406,123,6095,91.32,6.66,2.02,2019
"4876841",0,0,10,10,0,0,100,2019
"4876844",975,14,317,1306,74.66,1.07,24.27,2019
"4876874",0,0,0,0,NA,NA,NA,2019
"4876875",177,2,60,239,74.06,0.84,25.1,2019
"4876878",459,34,129,622,73.79,5.47,20.74,2019
"4876935",505,4,56,565,89.38,0.71,9.91,2019
"4876941",396,45,161,602,65.78,7.48,26.74,2019
"4876955",39,0,14,53,73.58,0,26.42,2019
"4876226",8659,76,200,8935,96.91,0.85,2.24,2019
"4876227",10387,512,513,11412,91.02,4.49,4.5,2019
"4876651",983,41,223,1247,78.83,3.29,17.88,2019
"4876680",70,0,38,108,64.81,0,35.19,2019
"4876060",2485,49,286,2820,88.12,1.74,10.14,2019
"4876148",7420,99,366,7885,94.1,1.26,4.64,2019
"4876305",1173,121,436,1730,67.8,6.99,25.2,2019
"4876306",4593,282,1079,5954,77.14,4.74,18.12,2019
"4876365",1468,60,413,1941,75.63,3.09,21.28,2019
"4876367",3055,9,520,3584,85.24,0.25,14.51,2019
"4876373",39,0,24,63,61.9,0,38.1,2019
"4876388",83,2,22,107,77.57,1.87,20.56,2019
"4876401",8228,639,1182,10049,81.88,6.36,11.76,2019
"4876435",154,4,48,206,74.76,1.94,23.3,2019
"4876455",248,4,109,361,68.7,1.11,30.19,2019
"4876472",463,63,117,643,72.01,9.8,18.2,2019
"4876484",278,23,55,356,78.09,6.46,15.45,2019
"4876022",4640,105,781,5526,83.97,1.9,14.13,2019
"4876073",1334,34,532,1900,70.21,1.79,28,2019
"4876655",2625,73,223,2921,89.87,2.5,7.63,2019
"4876798",0,0,0,0,NA,NA,NA,2019
"4876885",71,0,0,71,100,0,0,2019
"4876903",7809,643,3230,11682,66.85,5.5,27.65,2019
"4876379",133,4,41,178,74.72,2.25,23.03,2019
"4876070",201,99,5,305,65.9,32.46,1.64,2019
"4876126",7994,156,393,8543,93.57,1.83,4.6,2019
"4877384",7559,115,205,7879,95.94,1.46,2.6,2019
"4877423",2734,99,775,3608,75.78,2.74,21.48,2019
"4877568",4555,86,1030,5671,80.32,1.52,18.16,2019
"4877514",1287,6,615,1908,67.45,0.31,32.23,2019
"4877573",28511,615,1134,30260,94.22,2.03,3.75,2019
"4877585",236,0,102,338,69.82,0,30.18,2019
"4877613",387,18,84,489,79.14,3.68,17.18,2019
"4877615",185,20,111,316,58.54,6.33,35.13,2019
"4877627",7386,160,1163,8709,84.81,1.84,13.35,2019
"4877630",8631,400,2302,11333,76.16,3.53,20.31,2019
"4877663",303,43,142,488,62.09,8.81,29.1,2019
"4877707",5465,103,1210,6778,80.63,1.52,17.85,2019
"4877801",4381,673,973,6027,72.69,11.17,16.14,2019
"4877443",81,0,0,81,100,0,0,2019
"4877003",3973,146,579,4698,84.57,3.11,12.32,2019
"4877351",8909,613,2618,12140,73.39,5.05,21.57,2019
"4877372",3789,160,471,4420,85.72,3.62,10.66,2019
"4875479",514,29,166,709,72.5,4.09,23.41,2019
"4875486",724,49,97,870,83.22,5.63,11.15,2019
"4875496",1024,39,195,1258,81.4,3.1,15.5,2019
"4875550",179,6,123,308,58.12,1.95,39.94,2019
"4875560",301,5,146,452,66.59,1.11,32.3,2019
"4875574",454,39,214,707,64.21,5.52,30.27,2019
"4875631",842,14,275,1131,74.45,1.24,24.31,2019
"4875077",11923,326,418,12667,94.13,2.57,3.3,2019
"4875569",1001,11,317,1329,75.32,0.83,23.85,2019
"4875573",41,0,0,41,100,0,0,2019
"4875966",1290,78,515,1883,68.51,4.14,27.35,2019
"4875643",597,11,179,787,75.86,1.4,22.74,2019
"4875681",704,56,205,965,72.95,5.8,21.24,2019
"4875683",987,61,396,1444,68.35,4.22,27.42,2019
"4875691",913,145,498,1556,58.68,9.32,32.01,2019
"4875785",2648,125,663,3436,77.07,3.64,19.3,2019
"4875791",4155,34,503,4692,88.55,0.72,10.72,2019
"4875833",939,21,199,1159,81.02,1.81,17.17,2019
"4875835",2787,14,1601,4402,63.31,0.32,36.37,2019
"4875861",572,47,99,718,79.67,6.55,13.79,2019
"4875925",1193,37,260,1490,80.07,2.48,17.45,2019
"4875936",286,8,64,358,79.89,2.23,17.88,2019
"4875943",383,13,99,495,77.37,2.63,20,2019
"4875788",23,0,0,23,100,0,0,2019
"4875838",140,13,96,249,56.22,5.22,38.55,2019
"4875847",458,30,293,781,58.64,3.84,37.52,2019
"4875852",291,30,140,461,63.12,6.51,30.37,2019
"4875862",2794,114,1346,4254,65.68,2.68,31.64,2019
"4875926",316,20,130,466,67.81,4.29,27.9,2019
"4875939",1283,106,499,1888,67.96,5.61,26.43,2019
"4875946",903,61,411,1375,65.67,4.44,29.89,2019
"4875968",483,24,134,641,75.35,3.74,20.9,2019
"4875062",13479,375,2323,16177,83.32,2.32,14.36,2019
"4875069",10142,390,3284,13816,73.41,2.82,23.77,2019
"4875098",15950,341,1076,17367,91.84,1.96,6.2,2019
"4875105",33,0,18,51,64.71,0,35.29,2019
"4875141",925,41,165,1131,81.79,3.63,14.59,2019
"4875147",1704,0,776,2480,68.71,0,31.29,2019
"4875154",11569,358,972,12899,89.69,2.78,7.54,2019
"4875158",1069,61,243,1373,77.86,4.44,17.7,2019
"4875223",3338,108,1109,4555,73.28,2.37,24.35,2019
"4875225",8401,153,378,8932,94.06,1.71,4.23,2019
"4875229",9472,516,1097,11085,85.45,4.65,9.9,2019
"4875235",6478,533,926,7937,81.62,6.72,11.67,2019
"4875241",5436,513,5072,11021,49.32,4.65,46.02,2019
"4875244",5595,50,219,5864,95.41,0.85,3.73,2019
"4875415",90,0,0,90,100,0,0,2019
"4876251",212,4,42,258,82.17,1.55,16.28,2019
"4876268",53,2,30,85,62.35,2.35,35.29,2019
"4876311",612,13,14,639,95.77,2.03,2.19,2019
"4876364",39,2,28,69,56.52,2.9,40.58,2019
"4876366",545,52,188,785,69.43,6.62,23.95,2019
"1762011",92,0,16,108,85.19,0,14.81,2019
"1762016",1082,28,257,1367,79.15,2.05,18.8,2019
"1762017",407,19,79,505,80.59,3.76,15.64,2019
"1762021",402,0,77,479,83.92,0,16.08,2019
"1762028",160,10,107,277,57.76,3.61,38.63,2019
"1762838",504,26,191,721,69.9,3.61,26.49,2019
"1762818",81,3,33,117,69.23,2.56,28.21,2019
"1762819",143,2,37,182,78.57,1.1,20.33,2019
"1762821",2383,101,670,3154,75.55,3.2,21.24,2019
"1762843",60,4,8,72,83.33,5.56,11.11,2019
"1762859",1773,65,583,2421,73.23,2.68,24.08,2019
"1762865",605,16,212,833,72.63,1.92,25.45,2019
"1762881",3707,87,805,4599,80.6,1.89,17.5,2019
"1762883",247,6,66,319,77.43,1.88,20.69,2019
"1762896",3769,117,1308,5194,72.56,2.25,25.18,2019
"1762899",501,25,182,708,70.76,3.53,25.71,2019
"1762901",8546,834,1475,10855,78.73,7.68,13.59,2019
"1762905",179,0,43,222,80.63,0,19.37,2019
"1762953",51,0,58,109,46.79,0,53.21,2019
"1762231",2260,96,606,2962,76.3,3.24,20.46,2019
"1762238",179,22,55,256,69.92,8.59,21.48,2019
"1762249",5353,189,641,6183,86.58,3.06,10.37,2019
"1762266",33,0,0,33,100,0,0,2019
"1762271",689,47,143,879,78.38,5.35,16.27,2019
"1762294",4787,113,502,5402,88.62,2.09,9.29,2019
"1762316",184,1,48,233,78.97,0.43,20.6,2019
"1762321",1272,26,387,1685,75.49,1.54,22.97,2019
"1762330",541,13,223,777,69.63,1.67,28.7,2019
"1762344",3,0,0,3,100,0,0,2019
"1762051",276,0,85,361,76.45,0,23.55,2019
"1762059",65,13,104,182,35.71,7.14,57.14,2019
"1762078",23,0,10,33,69.7,0,30.3,2019
"1762095",3573,43,760,4376,81.65,0.98,17.37,2019
"1762097",970,10,101,1081,89.73,0.93,9.34,2019
"1762215",603,0,117,720,83.75,0,16.25,2019
"1762236",4909,74,421,5404,90.84,1.37,7.79,2019
"1762250",133,6,53,192,69.27,3.12,27.6,2019
"1762264",1069,93,271,1433,74.6,6.49,18.91,2019
"1762280",165,0,34,199,82.91,0,17.09,2019
"1762281",946,5,61,1012,93.48,0.49,6.03,2019
"4876088",3323,198,530,4051,82.03,4.89,13.08,2019
"4876103",3590,257,1345,5192,69.14,4.95,25.91,2019
"4876119",9578,582,4472,14632,65.46,3.98,30.56,2019
"4876127",48,0,0,48,100,0,0,2019
"4876357",152,7,38,197,77.16,3.55,19.29,2019
"4876238",108,0,34,142,76.06,0,23.94,2019
"4876247",3911,42,258,4211,92.88,1,6.13,2019
"4876265",439,12,127,578,75.95,2.08,21.97,2019
"4876426",3145,162,924,4231,74.33,3.83,21.84,2019
"4876437",1409,10,608,2027,69.51,0.49,30,2019
"4876538",315,8,37,360,87.5,2.22,10.28,2019
"4876544",3113,114,92,3319,93.79,3.43,2.77,2019
"4876569",689,8,115,812,84.85,0.99,14.16,2019
"4876578",330,7,96,433,76.21,1.62,22.17,2019
"4876624",506,81,140,727,69.6,11.14,19.26,2019
"4876627",429,10,92,531,80.79,1.88,17.33,2019
"4876634",2210,148,572,2930,75.43,5.05,19.52,2019
"4876639",389,41,129,559,69.59,7.33,23.08,2019
"4876652",418,23,78,519,80.54,4.43,15.03,2019
"4879699",0,0,0,0,NA,NA,NA,2019
"4879770",0,0,0,0,NA,NA,NA,2019
"4879911",1781,90,133,2004,88.87,4.49,6.64,2019
"4879916",0,0,0,0,NA,NA,NA,2019
"4879920",0,0,0,0,NA,NA,NA,2019
"4879928",13241,840,1448,15529,85.27,5.41,9.32,2019
"4879942",15,0,0,15,100,0,0,2019
"4879040",394,27,146,567,69.49,4.76,25.75,2019
"4879018",95,0,40,135,70.37,0,29.63,2019
"4879744",346,45,63,454,76.21,9.91,13.88,2019
"4879846",0,0,19,19,0,0,100,2019
"4879718",216,7,117,340,63.53,2.06,34.41,2019
"4879834",76,7,23,106,71.7,6.6,21.7,2019
"4879061",118,3,25,146,80.82,2.05,17.12,2019
"4879095",620,58,239,917,67.61,6.32,26.06,2019
"4879925",11813,665,2190,14668,80.54,4.53,14.93,2019
"4879525",983,6,154,1143,86,0.52,13.47,2019
"4879528",186,12,48,246,75.61,4.88,19.51,2019
"4879533",107,9,56,172,62.21,5.23,32.56,2019
"4879539",66,3,26,95,69.47,3.16,27.37,2019
"4879543",311,14,132,457,68.05,3.06,28.88,2019
"4879545",512,22,122,656,78.05,3.35,18.6,2019
"4879549",4022,159,1277,5458,73.69,2.91,23.4,2019
"4879556",3321,171,1079,4571,72.65,3.74,23.61,2019
"4879562",1027,9,220,1256,81.77,0.72,17.52,2019
"4879566",71,3,32,106,66.98,2.83,30.19,2019
"4879714",4816,99,658,5573,86.42,1.78,11.81,2019
"4879741",65,2,46,113,57.52,1.77,40.71,2019
"4879763",8964,263,2405,11632,77.06,2.26,20.68,2019
"4879777",68,0,26,94,72.34,0,27.66,2019
"0880124",8189,215,160,8564,95.62,2.51,1.87,2019
"0880125",3767,0,78,3845,97.97,0,2.03,2019
"0880203",12482,1166,1234,14882,83.87,7.83,8.29,2019
"0880210",14146,373,887,15406,91.82,2.42,5.76,2019
"0880211",14612,413,1851,16876,86.58,2.45,10.97,2019
"0880218",9919,865,725,11509,86.18,7.52,6.3,2019
"0880221",10692,501,2671,13864,77.12,3.61,19.27,2019
"0880224",7039,265,767,8071,87.21,3.28,9.5,2019
"0880232",8191,127,896,9214,88.9,1.38,9.72,2019
"0880246",6623,188,657,7468,88.69,2.52,8.8,2019
"0880540",1630,38,97,1765,92.35,2.15,5.5,2019
"0880542",1469,23,73,1565,93.87,1.47,4.66,2019
"0880543",2378,44,149,2571,92.49,1.71,5.8,2019
"0880010",10588,201,3000,13789,76.79,1.46,21.76,2019
"0880018",4023,0,75,4098,98.17,0,1.83,2019
"0880106",2032,35,82,2149,94.56,1.63,3.82,2019
"0880107",4332,128,182,4642,93.32,2.76,3.92,2019
"0880134",23800,269,503,24572,96.86,1.09,2.05,2019
"0880135",1447,21,60,1528,94.7,1.37,3.93,2019
"0880138",11199,213,301,11713,95.61,1.82,2.57,2019
"0880226",12034,271,1428,13733,87.63,1.97,10.4,2019
"0880231",14587,406,1920,16913,86.25,2.4,11.35,2019
"0880620",5236,278,1011,6525,80.25,4.26,15.49,2019
"0485034",1588,29,377,1994,79.64,1.45,18.91,2019
"0485051",12364,817,2213,15394,80.32,5.31,14.38,2019
"0485202",14537,342,903,15782,92.11,2.17,5.72,2019
"0485215",6432,303,603,7338,87.65,4.13,8.22,2019
"0485225",21826,755,2859,25440,85.79,2.97,11.24,2019
"0485226",13647,342,513,14502,94.1,2.36,3.54,2019
"4877374",188,0,45,233,80.69,0,19.31,2019
"4877375",17117,227,809,18153,94.29,1.25,4.46,2019
"4877376",84,0,171,255,32.94,0,67.06,2019
"4877414",5592,417,2845,8854,63.16,4.71,32.13,2019
"4877415",0,13,0,13,0,100,0,2019
"4877418",3096,125,969,4190,73.89,2.98,23.13,2019
"4877440",0,0,27,27,0,0,100,2019
"4877808",3788,146,645,4579,82.73,3.19,14.09,2019
"4875661",587,58,359,1004,58.47,5.78,35.76,2019
"4875668",843,13,140,996,84.64,1.31,14.06,2019
"4875669",263,0,16,279,94.27,0,5.73,2019
"4875693",2222,12,196,2430,91.44,0.49,8.07,2019
"4875703",14324,358,1945,16627,86.15,2.15,11.7,2019
"4875705",521,18,268,807,64.56,2.23,33.21,2019
"4875707",4840,87,446,5373,90.08,1.62,8.3,2019
"4875758",2660,59,725,3444,77.24,1.71,21.05,2019
"4875472",1094,48,312,1454,75.24,3.3,21.46,2019
"4875491",1323,85,391,1799,73.54,4.72,21.73,2019
"4875501",9110,404,3777,13291,68.54,3.04,28.42,2019
"4875571",907,18,163,1088,83.36,1.65,14.98,2019
"4875603",1634,93,568,2295,71.2,4.05,24.75,2019
"4875652",2961,287,1133,4381,67.59,6.55,25.86,2019
"4875686",3162,296,1276,4734,66.79,6.25,26.95,2019
"4875706",2207,61,868,3136,70.38,1.95,27.68,2019
"4875766",6510,551,2577,9638,67.55,5.72,26.74,2019
"4875789",2168,109,484,2761,78.52,3.95,17.53,2019
"4875845",735,62,366,1163,63.2,5.33,31.47,2019
"4875850",206,17,66,289,71.28,5.88,22.84,2019
"4875855",741,18,379,1138,65.11,1.58,33.3,2019
"4875930",536,0,196,732,73.22,0,26.78,2019
"4875944",439,23,56,518,84.75,4.44,10.81,2019
"4875964",5048,126,1520,6694,75.41,1.88,22.71,2019
"4875977",94,7,71,172,54.65,4.07,41.28,2019
"4875980",717,6,255,978,73.31,0.61,26.07,2019
"4875764",56,12,12,80,70,15,15,2019
"4875840",1702,108,572,2382,71.45,4.53,24.01,2019
"4875853",164,0,116,280,58.57,0,41.43,2019
"4875859",649,23,272,944,68.75,2.44,28.81,2019
"4875933",270,71,128,469,57.57,15.14,27.29,2019
"4875934",63,0,2,65,96.92,0,3.08,2019
"4875941",2130,93,393,2616,81.42,3.56,15.02,2019
"4875961",4949,353,843,6145,80.54,5.74,13.72,2019
"4875972",1593,18,941,2552,62.42,0.71,36.87,2019
"4875074",15663,266,1978,17907,87.47,1.49,11.05,2019
"4875088",8731,89,357,9177,95.14,0.97,3.89,2019
"4875089",10970,125,397,11492,95.46,1.09,3.45,2019
"4875101",98,9,63,170,57.65,5.29,37.06,2019
"4877088",12954,522,3903,17379,74.54,3,22.46,2019
"4877090",12757,638,2532,15927,80.1,4.01,15.9,2019
"4877098",7399,421,426,8246,89.73,5.11,5.17,2019
"4877326",15,0,22,37,40.54,0,59.46,2019
"4877327",5846,183,1773,7802,74.93,2.35,22.72,2019
"4877334",65,29,29,123,52.85,23.58,23.58,2019
"4877304",11631,262,1256,13149,88.46,1.99,9.55,2019
"4877306",3331,13,908,4252,78.34,0.31,21.35,2019
"4877331",2339,120,689,3148,74.3,3.81,21.89,2019
"4877011",3884,174,1864,5922,65.59,2.94,31.48,2019
"4877012",3344,455,2182,5981,55.91,7.61,36.48,2019
"4877013",3767,144,1912,5823,64.69,2.47,32.84,2019
"4876430",742,20,161,923,80.39,2.17,17.44,2019
"4074116",1021,44,349,1414,72.21,3.11,24.68,2019
"4074106",4334,215,2419,6968,62.2,3.09,34.72,2019
"4074365",1249,47,440,1736,71.95,2.71,25.35,2019
"4074727",384,36,335,755,50.86,4.77,44.37,2019
"4074748",144,10,73,227,63.44,4.41,32.16,2019
"4074747",33,3,72,108,30.56,2.78,66.67,2019
"4074039",1033,14,265,1312,78.73,1.07,20.2,2019
"4074137",10222,195,532,10949,93.36,1.78,4.86,2019
"4074019",5748,154,1086,6988,82.26,2.2,15.54,2019
"4074046",30,0,20,50,60,0,40,2019
"4074078",0,0,0,0,NA,NA,NA,2019
"4074082",20,0,4,24,83.33,0,16.67,2019
"4074359",163,3,70,236,69.07,1.27,29.66,2019
"4074458",17,2,6,25,68,8,24,2019
"4074477",9,0,0,9,100,0,0,2019
"4074146",4187,205,1209,5601,74.75,3.66,21.59,2019
"4074301",3114,97,1094,4305,72.33,2.25,25.41,2019
"4074330",853,45,184,1082,78.84,4.16,17.01,2019
"4074339",526,104,275,905,58.12,11.49,30.39,2019
"4074340",78,1,29,108,72.22,0.93,26.85,2019
"4074344",5052,294,1241,6587,76.7,4.46,18.84,2019
"4074347",647,40,247,934,69.27,4.28,26.45,2019
"4074352",1697,137,621,2455,69.12,5.58,25.3,2019
"4074360",12,0,5,17,70.59,0,29.41,2019
"4074361",5370,238,1007,6615,81.18,3.6,15.22,2019
"4074364",536,6,190,732,73.22,0.82,25.96,2019
"4074422",203,20,79,302,67.22,6.62,26.16,2019
"4074426",2619,305,1071,3995,65.56,7.63,26.81,2019
"4074460",44,2,41,87,50.57,2.3,47.13,2019
"4074469",546,12,279,837,65.23,1.43,33.33,2019
"4074470",420,5,202,627,66.99,0.8,32.22,2019
"4074552",299,18,170,487,61.4,3.7,34.91,2019
"4074557",139,8,68,215,64.65,3.72,31.63,2019
"4074558",99,2,69,170,58.24,1.18,40.59,2019
"4074567",21,0,54,75,28,0,72,2019
"4074633",121,16,29,166,72.89,9.64,17.47,2019
"4074641",235,12,62,309,76.05,3.88,20.06,2019
"4074701",7076,406,1899,9381,75.43,4.33,20.24,2019
"4074730",1367,147,302,1816,75.28,8.09,16.63,2019
"4877530",7894,345,1176,9415,83.84,3.66,12.49,2019
"4877550",7738,315,1691,9744,79.41,3.23,17.35,2019
"4877571",11584,434,1199,13217,87.64,3.28,9.07,2019
"4877584",29504,154,1144,30802,95.79,0.5,3.71,2019
"4877614",92,0,48,140,65.71,0,34.29,2019
"4877623",176,25,23,224,78.57,11.16,10.27,2019
"4877625",2578,40,795,3413,75.53,1.17,23.29,2019
"4877650",640,34,80,754,84.88,4.51,10.61,2019
"4877656",4946,306,953,6205,79.71,4.93,15.36,2019
"4877659",1451,81,203,1735,83.63,4.67,11.7,2019
"4877855",50,0,0,50,100,0,0,2019
"4877865",650,40,175,865,75.14,4.62,20.23,2019
"4876679",387,34,109,530,73.02,6.42,20.57,2019
"4876802",1572,52,361,1985,79.19,2.62,18.19,2019
"4876828",70,0,25,95,73.68,0,26.32,2019
"4876849",1033,45,389,1467,70.42,3.07,26.52,2019
"4876852",88,4,29,121,72.73,3.31,23.97,2019
"4876866",169,0,37,206,82.04,0,17.96,2019
"4876002",8882,73,714,9669,91.86,0.75,7.38,2019
"4876016",10259,364,655,11278,90.96,3.23,5.81,2019
"4876023",1760,58,513,2331,75.5,2.49,22.01,2019
"4876035",573,10,138,721,79.47,1.39,19.14,2019
"4876049",9959,379,899,11237,88.63,3.37,8,2019
"4876051",19586,231,827,20644,94.88,1.12,4.01,2019
"4876055",773,0,248,1021,75.71,0,24.29,2019
"4876063",22197,278,1204,23679,93.74,1.17,5.08,2019
"4876066",764,76,250,1090,70.09,6.97,22.94,2019
"4876086",6721,273,1354,8348,80.51,3.27,16.22,2019
"4876087",8833,266,589,9688,91.17,2.75,6.08,2019
"4876115",4013,234,1744,5991,66.98,3.91,29.11,2019
"4876123",10317,262,629,11208,92.05,2.34,5.61,2019
"4876135",6917,321,691,7929,87.24,4.05,8.71,2019
"4876201",7761,913,1071,9745,79.64,9.37,10.99,2019
"4876207",5039,52,424,5515,91.37,0.94,7.69,2019
"4876252",813,27,166,1006,80.82,2.68,16.5,2019
"4876264",476,27,150,653,72.89,4.13,22.97,2019
"4876309",4313,168,645,5126,84.14,3.28,12.58,2019
"4876310",5968,186,1195,7349,81.21,2.53,16.26,2019
"4876363",120,0,49,169,71.01,0,28.99,2019
"4876453",475,15,80,570,83.33,2.63,14.04,2019
"4876469",30,0,19,49,61.22,0,38.78,2019
"4876470",754,37,391,1182,63.79,3.13,33.08,2019
"4876481",51,0,0,51,100,0,0,2019
"4876523",0,0,0,0,NA,NA,NA,2019
"4876525",384,2,52,438,87.67,0.46,11.87,2019
"4876528",5059,99,1098,6256,80.87,1.58,17.55,2019
"4876301",3737,507,2236,6480,57.67,7.82,34.51,2019
"4876882",80,0,23,103,77.67,0,22.33,2019
"4876631",154,7,32,193,79.79,3.63,16.58,2019
"4876635",246,34,170,450,54.67,7.56,37.78,2019
"4876638",869,22,145,1036,83.88,2.12,14,2019
"4876673",380,17,63,460,82.61,3.7,13.7,2019
"4878041",10062,313,4161,14536,69.22,2.15,28.63,2019
"4878056",745,14,35,794,93.83,1.76,4.41,2019
"4878059",1046,6,761,1813,57.69,0.33,41.97,2019
"4878071",660,15,427,1102,59.89,1.36,38.75,2019
"4878107",79,19,57,155,50.97,12.26,36.77,2019
"4878112",1623,71,585,2279,71.22,3.12,25.67,2019
"4878114",6312,276,1053,7641,82.61,3.61,13.78,2019
"4878118",707,13,358,1078,65.58,1.21,33.21,2019
"4878124",2016,36,381,2433,82.86,1.48,15.66,2019
"4878142",32,0,21,53,60.38,0,39.62,2019
"4878159",309,17,64,390,79.23,4.36,16.41,2019
"4878145",24,0,13,37,64.86,0,35.14,2019
"4878147",474,0,117,591,80.2,0,19.8,2019
"4878151",335,10,209,554,60.47,1.81,37.73,2019
"4878214",5261,323,2247,7831,67.18,4.12,28.69,2019
"4878244",8094,346,673,9113,88.82,3.8,7.39,2019
"4878252",2237,77,342,2656,84.22,2.9,12.88,2019
"4878344",86,0,60,146,58.9,0,41.1,2019
"4878349",121,0,44,165,73.33,0,26.67,2019
"0485248",14601,398,1254,16253,89.84,2.45,7.72,2019
"0485250",7886,133,695,8714,90.5,1.53,7.98,2019
"0485257",12743,386,1738,14867,85.71,2.6,11.69,2019
"0485284",7052,84,170,7306,96.52,1.15,2.33,2019
"0485302",10694,440,3060,14194,75.34,3.1,21.56,2019
"0485306",7659,267,749,8675,88.29,3.08,8.63,2019
"0485320",179,11,121,311,57.56,3.54,38.91,2019
"0485321",939,64,577,1580,59.43,4.05,36.52,2019
"0485323",10174,400,2225,12799,79.49,3.13,17.38,2019
"0485326",14534,387,1292,16213,89.64,2.39,7.97,2019
"0485333",145,2,84,231,62.77,0.87,36.36,2019
"0485335",9119,326,1093,10538,86.53,3.09,10.37,2019
"0485336",82,12,51,145,56.55,8.28,35.17,2019
"0485361",1822,91,306,2219,82.11,4.1,13.79,2019
"0485367",8897,273,1746,10916,81.5,2.5,15.99,2019
"0485375",14322,511,2133,16966,84.42,3.01,12.57,2019
"0485533",836,18,202,1056,79.17,1.7,19.13,2019
"0485544",1163,8,260,1431,81.27,0.56,18.17,2019
"0485611",305,18,113,436,69.95,4.13,25.92,2019
"0485613",853,0,0,853,100,0,0,2019
"0485625",739,10,266,1015,72.81,0.99,26.21,2019
"0485634",724,22,902,1648,43.93,1.33,54.73,2019
"0485635",12290,484,1988,14762,83.25,3.28,13.47,2019
"0485641",8567,82,492,9141,93.72,0.9,5.38,2019
"0485646",629,12,139,780,80.64,1.54,17.82,2019
"0485648",4995,249,999,6243,80.01,3.99,16,2019
"0485710",20690,820,3510,25020,82.69,3.28,14.03,2019
"0485531",111,0,7,118,94.07,0,5.93,2019
"0485601",242,40,131,413,58.6,9.69,31.72,2019
"0485603",2297,117,839,3253,70.61,3.6,25.79,2019
"0485609",162,0,0,162,100,0,0,2019
"0485619",32,0,0,32,100,0,0,2019
"0485623",1551,195,482,2228,69.61,8.75,21.63,2019
"0485631",830,97,441,1368,60.67,7.09,32.24,2019
"0485637",425,27,60,512,83.01,5.27,11.72,2019
"0485643",2397,94,844,3335,71.87,2.82,25.31,2019
"0485704",12954,468,1482,14904,86.92,3.14,9.94,2019
"0485705",16452,1109,6026,23587,69.75,4.7,25.55,2019
"0485718",11433,220,974,12627,90.54,1.74,7.71,2019
"0485719",14849,1009,1482,17340,85.63,5.82,8.55,2019
"0485742",10145,178,276,10599,95.72,1.68,2.6,2019
"0485743",10624,252,698,11574,91.79,2.18,6.03,2019
"0485745",13876,717,1480,16073,86.33,4.46,9.21,2019
"0485747",8593,96,170,8859,97,1.08,1.92,2019
"0485749",7177,119,431,7727,92.88,1.54,5.58,2019
"0485933",995,4,325,1324,75.15,0.3,24.55,2019
"0485936",643,12,419,1074,59.87,1.12,39.01,2019
"0485938",567,11,233,811,69.91,1.36,28.73,2019
"0485942",5,0,23,28,17.86,0,82.14,2019
"0485712",13082,316,2528,15926,82.14,1.98,15.87,2019
"0485739",8334,234,498,9066,91.93,2.58,5.49,2019
"0485926",47,12,41,100,47,12,41,2019
"0485931",47,0,26,73,64.38,0,35.62,2019
"1683642",14654,436,2160,17250,84.95,2.53,12.52,2019
"1683647",7224,148,1187,8559,84.4,1.73,13.87,2019
"1683650",180,0,34,214,84.11,0,15.89,2019
"1683666",16,2,2,20,80,10,10,2019
"1683671",5,0,0,5,100,0,0,2019
"1683687",10032,322,1516,11870,84.52,2.71,12.77,2019
"4877449",34323,706,2099,37128,92.45,1.9,5.65,2019
"4877450",23614,322,1002,24938,94.69,1.29,4.02,2019
"4877456",292,32,205,529,55.2,6.05,38.75,2019
"4877459",21847,369,408,22624,96.57,1.63,1.8,2019
"4877476",51,0,11,62,82.26,0,17.74,2019
"4875656",1060,14,613,1687,62.83,0.83,36.34,2019
"4875667",257,33,163,453,56.73,7.28,35.98,2019
"4875672",4137,336,1497,5970,69.3,5.63,25.08,2019
"2963862",474,12,171,657,72.15,1.83,26.03,2019
"2963934",106,0,0,106,100,0,0,2019
"2963874",114,5,53,172,66.28,2.91,30.81,2019
"2963876",624,37,203,864,72.22,4.28,23.5,2019
"2963879",218,3,79,300,72.67,1,26.33,2019
"2963882",87,10,62,159,54.72,6.29,38.99,2019
"2963901",10023,342,3111,13476,74.38,2.54,23.09,2019
"2963945",278,0,132,410,67.8,0,32.2,2019
"2963955",28,0,39,67,41.79,0,58.21,2019
"2963960",776,16,318,1110,69.91,1.44,28.65,2019
"2963019",1522,100,252,1874,81.22,5.34,13.45,2019
"2963021",20964,255,1110,22329,93.89,1.14,4.97,2019
"2963030",60,12,39,111,54.05,10.81,35.14,2019
"2963033",14144,456,2003,16603,85.19,2.75,12.06,2019
"2963034",6074,133,335,6542,92.85,2.03,5.12,2019
"2963043",8577,108,763,9448,90.78,1.14,8.08,2019
"2963050",4773,193,904,5870,81.31,3.29,15.4,2019
"2963068",1438,88,404,1930,74.51,4.56,20.93,2019
"2963071",257,30,161,448,57.37,6.7,35.94,2019
"2963074",5192,124,1079,6395,81.19,1.94,16.87,2019
"2963077",3450,67,1060,4577,75.38,1.46,23.16,2019
"2963090",7493,250,1184,8927,83.94,2.8,13.26,2019
"2963101",1883,99,378,2360,79.79,4.19,16.02,2019
"2963108",8731,799,1731,11261,77.53,7.1,15.37,2019
"2963109",11969,280,1547,13796,86.76,2.03,11.21,2019
"2963116",15059,696,3621,19376,77.72,3.59,18.69,2019
"2963121",7004,496,2756,10256,68.29,4.84,26.87,2019
"2963122",14625,289,1167,16081,90.95,1.8,7.26,2019
"2963123",19479,476,2811,22766,85.56,2.09,12.35,2019
"2963126",5460,41,596,6097,89.55,0.67,9.78,2019
"2963127",1717,140,274,2131,80.57,6.57,12.86,2019
"2963131",6249,47,199,6495,96.21,0.72,3.06,2019
"2963461",1811,59,390,2260,80.13,2.61,17.26,2019
"2963468",766,14,195,975,78.56,1.44,20,2019
"2963471",195,0,59,254,76.77,0,23.23,2019
"2963532",358,18,164,540,66.3,3.33,30.37,2019
"2963541",107,3,63,173,61.85,1.73,36.42,2019
"2963645",3301,124,1369,4794,68.86,2.59,28.56,2019
"2963673",480,14,207,701,68.47,2,29.53,2019
"2963742",26,0,0,26,100,0,0,2019
"2963766",317,34,122,473,67.02,7.19,25.79,2019
"2963785",227,3,129,359,63.23,0.84,35.93,2019
"2963834",1455,66,504,2025,71.85,3.26,24.89,2019
"2963848",342,20,146,508,67.32,3.94,28.74,2019
"2963849",33,0,32,65,50.77,0,49.23,2019
"2963851",1120,23,353,1496,74.87,1.54,23.6,2019
"2963140",83,24,30,137,60.58,17.52,21.9,2019
"2963144",4147,31,289,4467,92.84,0.69,6.47,2019
"2963350",142,1,74,217,65.44,0.46,34.1,2019
"2963367",8385,143,600,9128,91.86,1.57,6.57,2019
"2963369",667,0,138,805,82.86,0,17.14,2019
"4877873",374,5,189,568,65.85,0.88,33.27,2019
"4877901",9022,1301,3957,14280,63.18,9.11,27.71,2019
"4877422",3722,202,658,4582,81.23,4.41,14.36,2019
"4877426",675,14,228,917,73.61,1.53,24.86,2019
"4877445",3038,60,1750,4848,62.67,1.24,36.1,2019
"4877081",10404,267,8175,18846,55.21,1.42,43.38,2019
"4877028",3878,219,1750,5847,66.32,3.75,29.93,2019
"4877058",6775,370,544,7689,88.11,4.81,7.08,2019
"4877023",7191,295,2351,9837,73.1,3,23.9,2019
"4877093",6708,361,5762,12831,52.28,2.81,44.91,2019
"4877360",1759,126,443,2328,75.56,5.41,19.03,2019
"4877042",17176,338,1737,19251,89.22,1.76,9.02,2019
"4877302",5650,299,334,6283,89.93,4.76,5.32,2019
"4877420",609,9,290,908,67.07,0.99,31.94,2019
"4877388",15924,190,772,16886,94.3,1.13,4.57,2019
"4877417",546,4,350,900,60.67,0.44,38.89,2019
"4877043",7762,111,1401,9274,83.7,1.2,15.11,2019
"4877089",15678,427,1257,17362,90.3,2.46,7.24,2019
"4877591",4466,106,1000,5572,80.15,1.9,17.95,2019
"4877703",2857,224,1760,4841,59.02,4.63,36.36,2019
"4877033",6409,293,2463,9165,69.93,3.2,26.87,2019
"4877064",14183,644,1312,16139,87.88,3.99,8.13,2019
"4877099",13226,679,3112,17017,77.72,3.99,18.29,2019
"4877201",0,0,0,0,NA,NA,NA,2019
"4877328",3664,161,734,4559,80.37,3.53,16.1,2019
"4877342",0,0,0,0,NA,NA,NA,2019
"4877350",40,4,8,52,76.92,7.69,15.38,2019
"4877377",11585,18,899,12502,92.67,0.14,7.19,2019
"4877406",14824,205,393,15422,96.12,1.33,2.55,2019
"4877407",16546,210,259,17015,97.24,1.23,1.52,2019
"4877436",14,0,0,14,100,0,0,2019
"4877453",80,0,19,99,80.81,0,19.19,2019
"4877460",0,0,7,7,0,0,100,2019
"4877498",14314,106,866,15286,93.64,0.69,5.67,2019
"4877523",6792,118,684,7594,89.44,1.55,9.01,2019
"4877580",299,32,0,331,90.33,9.67,0,2019
"4877661",189,0,69,258,73.26,0,26.74,2019
"4877976",14,12,18,44,31.82,27.27,40.91,2019
"4877987",74,0,14,88,84.09,0,15.91,2019
"4877993",14,0,21,35,40,0,60,2019
"4877032",3129,47,1139,4315,72.51,1.09,26.4,2019
"4877053",7474,252,1114,8840,84.55,2.85,12.6,2019
"4877056",10540,356,474,11370,92.7,3.13,4.17,2019
"4877065",12229,951,1667,14847,82.37,6.41,11.23,2019
"4877069",7469,101,705,8275,90.26,1.22,8.52,2019
"4877070",18815,266,1183,20264,92.85,1.31,5.84,2019
"4877320",7403,31,1643,9077,81.56,0.34,18.1,2019
"4877345",8979,136,232,9347,96.06,1.46,2.48,2019
"0881038",0,0,0,0,NA,NA,NA,2019
"0881129",9,0,39,48,18.75,0,81.25,2019
"0881138",26,0,12,38,68.42,0,31.58,2019
"0881227",0,0,0,0,NA,NA,NA,2019
"4878362",2843,69,551,3463,82.1,1.99,15.91,2019
"4878537",8545,301,3674,12520,68.25,2.4,29.35,2019
"4878560",871,36,437,1344,64.81,2.68,32.51,2019
"4878562",518,34,225,777,66.67,4.38,28.96,2019
"4878569",671,65,454,1190,56.39,5.46,38.15,2019
"4878579",996,0,420,1416,70.34,0,29.66,2019
"4878584",2677,220,2091,4988,53.67,4.41,41.92,2019
"4878596",15057,387,3346,18790,80.13,2.06,17.81,2019
"4878641",20520,248,1161,21929,93.57,1.13,5.29,2019
"4878655",823,24,140,987,83.38,2.43,14.18,2019
"4878661",87,10,28,125,69.6,8,22.4,2019
"4878605",1523,4,439,1966,77.47,0.2,22.33,2019
"4878611",3628,32,808,4468,81.2,0.72,18.08,2019
"4878619",1522,0,10,1532,99.35,0,0.65,2019
"4878648",2207,125,845,3177,69.47,3.93,26.6,2019
"4878653",6764,107,399,7270,93.04,1.47,5.49,2019
"4878729",11218,238,442,11898,94.28,2,3.71,2019
"4878638",670,24,192,886,75.62,2.71,21.67,2019
"4878618",93,1,36,130,71.54,0.77,27.69,2019
"4878620",5723,124,260,6107,93.71,2.03,4.26,2019
"4878629",3412,67,923,4402,77.51,1.52,20.97,2019
"4878645",4120,40,390,4550,90.55,0.88,8.57,2019
"4878650",418,6,111,535,78.13,1.12,20.75,2019
"4878662",569,19,184,772,73.7,2.46,23.83,2019
"4878719",288,5,135,428,67.29,1.17,31.54,2019
"4878723",10681,746,2100,13527,78.96,5.51,15.52,2019
"4878010",994,97,210,1301,76.4,7.46,16.14,2019
"4878014",1075,23,886,1984,54.18,1.16,44.66,2019
"4878023",8544,135,221,8900,96,1.52,2.48,2019
"4878025",1567,73,288,1928,81.28,3.79,14.94,2019
"4878061",1905,38,1133,3076,61.93,1.24,36.83,2019
"4878073",1577,152,431,2160,73.01,7.04,19.95,2019
"4878738",5976,55,185,6216,96.14,0.88,2.98,2019
"4878067",96,0,178,274,35.04,0,64.96,2019
"4878072",162,0,27,189,85.71,0,14.29,2019
"4878116",88,0,9,97,90.72,0,9.28,2019
"4878148",6806,162,748,7716,88.21,2.1,9.69,2019
"4878024",522,5,52,579,90.16,0.86,8.98,2019
"4878724",5389,173,1214,6776,79.53,2.55,17.92,2019
"4878727",12538,275,744,13557,92.48,2.03,5.49,2019
"4879382",2551,52,175,2778,91.83,1.87,6.3,2019
"4879415",4008,747,1824,6579,60.92,11.35,27.72,2019
"4879508",297,48,166,511,58.12,9.39,32.49,2019
"4879512",1396,13,602,2011,69.42,0.65,29.94,2019
"4879527",71,9,17,97,73.2,9.28,17.53,2019
"4879532",179,30,83,292,61.3,10.27,28.42,2019
"4879540",37,0,5,42,88.1,0,11.9,2019
"4879541",275,0,39,314,87.58,0,12.42,2019
"4879701",7263,341,2402,10006,72.59,3.41,24.01,2019
"4879748",53,0,28,81,65.43,0,34.57,2019
"4879754",22,0,8,30,73.33,0,26.67,2019
"4879783",60,4,23,87,68.97,4.6,26.44,2019
"4879842",113,41,56,210,53.81,19.52,26.67,2019
"4879907",11895,744,3879,16518,72.01,4.5,23.48,2019
"4879567",851,39,401,1291,65.92,3.02,31.06,2019
"4879719",76,0,113,189,40.21,0,59.79,2019
"4879730",45,0,26,71,63.38,0,36.62,2019
"4879756",2492,187,597,3276,76.07,5.71,18.22,2019
"4879759",0,0,0,0,NA,NA,NA,2019
"1683712",3843,94,270,4207,91.35,2.23,6.42,2019
"1683855",682,7,162,851,80.14,0.82,19.04,2019
"1683857",306,0,62,368,83.15,0,16.85,2019
"1683874",15,0,0,15,100,0,0,2019
"1683221",7678,207,1047,8932,85.96,2.32,11.72,2019
"1683236",701,10,85,796,88.07,1.26,10.68,2019
"1683243",9,0,0,9,100,0,0,2019
"1683244",114,0,0,114,100,0,0,2019
"1683274",2810,34,230,3074,91.41,1.11,7.48,2019
"1683330",1951,131,346,2428,80.35,5.4,14.25,2019
"1683338",5436,319,1375,7130,76.24,4.47,19.28,2019
"1683344",352,6,70,428,82.24,1.4,16.36,2019
"1683352",756,67,335,1158,65.28,5.79,28.93,2019
"1683871",659,15,109,783,84.16,1.92,13.92,2019
"1683852",290,11,67,368,78.8,2.99,18.21,2019
"1683856",1676,111,736,2523,66.43,4.4,29.17,2019
"1683866",0,16,21,37,0,43.24,56.76,2019
"5683013",53,0,60,113,46.9,0,53.1,2019
"5683113",703,7,89,799,87.98,0.88,11.14,2019
"5683119",79,0,0,79,100,0,0,2019
"5683120",186,0,58,244,76.23,0,23.77,2019
"1683217",285,1,10,296,96.28,0.34,3.38,2019
"1683234",434,5,123,562,77.22,0.89,21.89,2019
"1683254",1254,8,219,1481,84.67,0.54,14.79,2019
"1683272",98,0,14,112,87.5,0,12.5,2019
"1683277",65,0,9,74,87.84,0,12.16,2019
"1683278",115,5,2,122,94.26,4.1,1.64,2019
"1683321",131,11,62,204,64.22,5.39,30.39,2019
"1683322",1,0,13,14,7.14,0,92.86,2019
"1683337",21,0,0,21,100,0,0,2019
"1683355",1088,66,419,1573,69.17,4.2,26.64,2019
"1683429",233,1,38,272,85.66,0.37,13.97,2019
"1683440",7969,2083,448,10500,75.9,19.84,4.27,2019
"1683467",2215,63,576,2854,77.61,2.21,20.18,2019
"1683468",71,7,3,81,87.65,8.64,3.7,2019
"1683540",519,20,180,719,72.18,2.78,25.03,2019
"1683544",1795,120,481,2396,74.92,5.01,20.08,2019
"1683604",155,7,75,237,65.4,2.95,31.65,2019
"1683610",283,14,93,390,72.56,3.59,23.85,2019
"1683611",638,33,91,762,83.73,4.33,11.94,2019
"1683616",9602,72,1000,10674,89.96,0.67,9.37,2019
"1683624",386,4,133,523,73.8,0.76,25.43,2019
"1683632",113,18,26,157,71.97,11.46,16.56,2019
"1683638",2345,143,178,2666,87.96,5.36,6.68,2019
"1683643",65,0,0,65,100,0,0,2019
"5683110",1204,97,236,1537,78.33,6.31,15.35,2019
"1683201",12015,286,1670,13971,86,2.05,11.95,2019
"1683203",77,0,43,120,64.17,0,35.83,2019
"1683213",370,15,82,467,79.23,3.21,17.56,2019
"1683232",150,5,26,181,82.87,2.76,14.36,2019
"1683237",287,5,28,320,89.69,1.56,8.75,2019
"1683245",750,24,105,879,85.32,2.73,11.95,2019
"1683250",536,11,43,590,90.85,1.86,7.29,2019
"0694577",14972,323,1837,17132,87.39,1.89,10.72,2019
"0694590",12195,417,1977,14589,83.59,2.86,13.55,2019
"0694599",1220,25,201,1446,84.37,1.73,13.9,2019
"0694074",44,0,30,74,59.46,0,40.54,2019
"0694131",12391,179,442,13012,95.23,1.38,3.4,2019
"0694526",11468,190,732,12390,92.56,1.53,5.91,2019
"2963387",13,0,29,42,30.95,0,69.05,2019
"2963401",7080,286,1435,8801,80.45,3.25,16.3,2019
"2963430",130,8,79,217,59.91,3.69,36.41,2019
"2963432",170,11,15,196,86.73,5.61,7.65,2019
"2963434",215,4,29,248,86.69,1.61,11.69,2019
"2963452",356,6,133,495,71.92,1.21,26.87,2019
"2963436",507,30,121,658,77.05,4.56,18.39,2019
"2963439",58,6,36,100,58,6,36,2019
"4073142",6305,70,248,6623,95.2,1.06,3.74,2019
"4073169",726,0,42,768,94.53,0,5.47,2019
"4073446",1802,204,945,2951,61.06,6.91,32.02,2019
"4073449",815,1,270,1086,75.05,0.09,24.86,2019
"4073453",132,15,55,202,65.35,7.43,27.23,2019
"4073463",801,84,272,1157,69.23,7.26,23.51,2019
"4073529",1483,93,380,1956,75.82,4.75,19.43,2019
"4073538",1657,26,187,1870,88.61,1.39,10,2019
"4073549",61,7,8,76,80.26,9.21,10.53,2019
"4073550",712,66,184,962,74.01,6.86,19.13,2019
"4073050",19,0,0,19,100,0,0,2019
"4073098",1298,35,368,1701,76.31,2.06,21.63,2019
"4073054",1251,42,310,1603,78.04,2.62,19.34,2019
"4073059",794,26,295,1115,71.21,2.33,26.46,2019
"4073075",2685,120,809,3614,74.29,3.32,22.39,2019
"4073103",2205,68,373,2646,83.33,2.57,14.1,2019
"4073090",270,20,67,357,75.63,5.6,18.77,2019
"4073105",2239,15,540,2794,80.14,0.54,19.33,2019
"4073107",8147,233,2157,10537,77.32,2.21,20.47,2019
"4073565",253,8,124,385,65.71,2.08,32.21,2019
"4073571",24,0,0,24,100,0,0,2019
"4073647",154,0,39,193,79.79,0,20.21,2019
"4073655",267,10,72,349,76.5,2.87,20.63,2019
"4073666",66,0,24,90,73.33,0,26.67,2019
"4073667",175,6,62,243,72.02,2.47,25.51,2019
"4073701",6478,259,2074,8811,73.52,2.94,23.54,2019
"4073772",891,46,371,1308,68.12,3.52,28.36,2019
"4073834",408,12,190,610,66.89,1.97,31.15,2019
"4073859",386,14,123,523,73.8,2.68,23.52,2019
"4073931",138,3,45,186,74.19,1.61,24.19,2019
"4073938",227,3,46,276,82.25,1.09,16.67,2019
"4073939",406,57,56,519,78.23,10.98,10.79,2019
"4073944",115,21,40,176,65.34,11.93,22.73,2019
"4073949",384,12,231,627,61.24,1.91,36.84,2019
"4073555",42,4,10,56,75,7.14,17.86,2019
"4073736",216,7,18,241,89.63,2.9,7.47,2019
"4073747",131,16,9,156,83.97,10.26,5.77,2019
"4073004",246,35,80,361,68.14,9.7,22.16,2019
"4073029",444,22,147,613,72.43,3.59,23.98,2019
"4073030",988,132,445,1565,63.13,8.43,28.43,2019
"4073036",4946,149,1481,6576,75.21,2.27,22.52,2019
"4073041",109,11,34,154,70.78,7.14,22.08,2019
"4073049",1788,5,338,2131,83.9,0.23,15.86,2019
"4073062",381,27,177,585,65.13,4.62,30.26,2019
"4073080",2862,59,615,3536,80.94,1.67,17.39,2019
"4073569",128,5,97,230,55.65,2.17,42.17,2019
"4073601",2688,39,989,3716,72.34,1.05,26.61,2019
"4073624",547,30,162,739,74.02,4.06,21.92,2019
"4073641",165,1,39,205,80.49,0.49,19.02,2019
"4073703",9739,483,1524,11746,82.91,4.11,12.97,2019
"4073727",70,0,6,76,92.11,0,7.89,2019
"0881231",0,0,0,0,NA,NA,NA,2019
"0881232",9,0,0,9,100,0,0,2019
"0881237",17,0,0,17,100,0,0,2019
"0881242",208,0,28,236,88.14,0,11.86,2019
"0881303",2471,165,563,3199,77.24,5.16,17.6,2019
"0881403",3878,42,604,4524,85.72,0.93,13.35,2019
"0881429",20,0,0,20,100,0,0,2019
"0881507",5684,57,436,6177,92.02,0.92,7.06,2019
"0881612",0,0,0,0,NA,NA,NA,2019
"2963005",6267,42,160,6469,96.88,0.65,2.47,2019
"2963010",12043,293,1588,13924,86.49,2.1,11.4,2019
"2963011",13440,215,862,14517,92.58,1.48,5.94,2019
"2963012",3389,101,319,3809,88.97,2.65,8.37,2019
"2963013",546,23,41,610,89.51,3.77,6.72,2019
"2963061",49,0,9,58,84.48,0,15.52,2019
"2963084",5837,146,1297,7280,80.18,2.01,17.82,2019
"2963115",3635,426,3305,7366,49.35,5.78,44.87,2019
"2963128",11274,220,1541,13035,86.49,1.69,11.82,2019
"2963136",14030,748,3755,18533,75.7,4.04,20.26,2019
"2963141",8221,78,430,8729,94.18,0.89,4.93,2019
"2963334",1906,53,695,2654,71.82,2,26.19,2019
"2963352",369,0,153,522,70.69,0,29.31,2019
"2963353",1617,5,374,1996,81.01,0.25,18.74,2019
"1762246",2769,93,646,3508,78.93,2.65,18.42,2019
"1762262",553,4,183,740,74.73,0.54,24.73,2019
"1762274",1851,63,533,2447,75.64,2.57,21.78,2019
"1762297",187,34,0,221,84.62,15.38,0,2019
"1762314",113,0,57,170,66.47,0,33.53,2019
"1762356",131,13,35,179,73.18,7.26,19.55,2019
"1762361",83,6,61,150,55.33,4,40.67,2019
"1762379",567,14,204,785,72.23,1.78,25.99,2019
"1762414",529,15,189,733,72.17,2.05,25.78,2019
"1762417",1015,54,211,1280,79.3,4.22,16.48,2019
"1762427",549,18,170,737,74.49,2.44,23.07,2019
"1762439",2482,96,773,3351,74.07,2.86,23.07,2019
"1762450",3932,207,958,5097,77.14,4.06,18.8,2019
"1762510",546,0,101,647,84.39,0,15.61,2019
"1762401",6549,221,1144,7914,82.75,2.79,14.46,2019
"1762428",880,10,244,1134,77.6,0.88,21.52,2019
"1762468",856,23,212,1091,78.46,2.11,19.43,2019
"1762474",302,7,69,378,79.89,1.85,18.25,2019
"1762476",506,19,116,641,78.94,2.96,18.1,2019
"1762480",142,6,62,210,67.62,2.86,29.52,2019
"1762520",537,23,110,670,80.15,3.43,16.42,2019
"1762530",495,10,123,628,78.82,1.59,19.59,2019
"1762942",194,6,62,262,74.05,2.29,23.66,2019
"1762947",140,0,86,226,61.95,0,38.05,2019
"1762951",1415,74,415,1904,74.32,3.89,21.8,2019
"1762958",709,31,126,866,81.87,3.58,14.55,2019
"1762972",281,15,84,380,73.95,3.95,22.11,2019
"1762975",53,0,8,61,86.89,0,13.11,2019
"1762997",138,19,61,218,63.3,8.72,27.98,2019
"3611804",1396,24,205,1625,85.91,1.48,12.62,2019
"3611930",262,37,116,415,63.13,8.92,27.95,2019
"3611941",559,10,92,661,84.57,1.51,13.92,2019
"3611962",70,7,61,138,50.72,5.07,44.2,2019
"3611702",4706,77,318,5101,92.26,1.51,6.23,2019
"3611710",10744,101,589,11434,93.97,0.88,5.15,2019
"3611530",8751,338,411,9500,92.12,3.56,4.33,2019
"3611566",10448,162,575,11185,93.41,1.45,5.14,2019
"3611705",2455,75,168,2698,90.99,2.78,6.23,2019
"3611709",2443,54,54,2551,95.77,2.12,2.12,2019
"3611714",7099,115,729,7943,89.37,1.45,9.18,2019
"3611722",7695,343,1292,9330,82.48,3.68,13.85,2019
"3611725",8474,630,590,9694,87.41,6.5,6.09,2019
"3611727",9842,318,927,11087,88.77,2.87,8.36,2019
"3611730",4256,49,231,4536,93.83,1.08,5.09,2019
"3611746",19004,796,1205,21005,90.47,3.79,5.74,2019
"3611765",238,6,6,250,95.2,2.4,2.4,2019
"3611767",4541,64,384,4989,91.02,1.28,7.7,2019
"3611769",2812,24,462,3298,85.26,0.73,14.01,2019
"3611901",7625,485,1586,9696,78.64,5,16.36,2019
"3611950",3985,268,379,4632,86.03,5.79,8.18,2019
"3611952",1863,172,94,2129,87.51,8.08,4.42,2019
"3611717",11235,609,1941,13785,81.5,4.42,14.08,2019
"3611718",1013,10,59,1082,93.62,0.92,5.45,2019
"3611733",5249,23,184,5456,96.21,0.42,3.37,2019
"3611742",4006,94,258,4358,91.92,2.16,5.92,2019
"3611753",4255,23,116,4394,96.84,0.52,2.64,2019
"3611756",12577,194,800,13571,92.68,1.43,5.89,2019
"3611763",8437,250,757,9444,89.34,2.65,8.02,2019
"3611766",3703,38,373,4114,90.01,0.92,9.07,2019
"3611771",3159,64,377,3600,87.75,1.78,10.47,2019
"3611778",3815,61,370,4246,89.85,1.44,8.71,2019
"3611222",14777,408,2261,17446,84.7,2.34,12.96,2019
"3611233",22946,1022,6599,30567,75.07,3.34,21.59,2019
"3611235",26336,757,5245,32338,81.44,2.34,16.22,2019
"3611426",5747,83,448,6278,91.54,1.32,7.14,2019
"3611427",6642,149,805,7596,87.44,1.96,10.6,2019
"3611042",0,0,0,0,NA,NA,NA,2019
"3611101",12045,164,1687,13896,86.68,1.18,12.14,2019
"3611205",13044,344,3071,16459,79.25,2.09,18.66,2019
"3611215",26199,441,1805,28445,92.1,1.55,6.35,2019
"3611219",14699,1126,8400,24225,60.68,4.65,34.67,2019
"3611226",28309,748,8134,37191,76.12,2.01,21.87,2019
"3611228",13139,277,1708,15124,86.88,1.83,11.29,2019
"3611236",28828,551,4373,33752,85.41,1.63,12.96,2019
"3614706",2250,49,348,2647,85,1.85,13.15,2019
"3614709",460,11,101,572,80.42,1.92,17.66,2019
"3614710",1165,16,166,1347,86.49,1.19,12.32,2019
"3614711",471,29,174,674,69.88,4.3,25.82,2019
"3614729",225,44,147,416,54.09,10.58,35.34,2019
"3614011",2256,141,386,2783,81.06,5.07,13.87,2019
"3614020",7632,317,1709,9658,79.02,3.28,17.7,2019
"3614030",545,37,156,738,73.85,5.01,21.14,2019
"3614132",1836,15,420,2271,80.85,0.66,18.49,2019
"3614201",4022,309,1261,5592,71.92,5.53,22.55,2019
"3614206",6582,315,2060,8957,73.48,3.52,23,2019
"3614210",4280,351,1457,6088,70.3,5.77,23.93,2019
"3614222",5575,359,622,6556,85.04,5.48,9.49,2019
"3614301",3478,258,1838,5574,62.4,4.63,32.97,2019
"3612737",605,15,97,717,84.38,2.09,13.53,2019
"3612738",101,13,0,114,88.6,11.4,0,2019
"3612740",524,10,208,742,70.62,1.35,28.03,2019
"3612754",1834,92,609,2535,72.35,3.63,24.02,2019
"3612758",1396,15,240,1651,84.55,0.91,14.54,2019
"3612815",425,8,50,483,87.99,1.66,10.35,2019
"3612822",1892,64,353,2309,81.94,2.77,15.29,2019
"3612827",1136,19,237,1392,81.61,1.36,17.03,2019
"3612841",78,8,26,112,69.64,7.14,23.21,2019
"3612842",161,37,69,267,60.3,13.86,25.84,2019
"3612845",1651,55,254,1960,84.23,2.81,12.96,2019
"3612852",166,3,38,207,80.19,1.45,18.36,2019
"3612858",56,4,6,66,84.85,6.06,9.09,2019
"3612860",249,3,6,258,96.51,1.16,2.33,2019
"3612863",241,0,22,263,91.63,0,8.37,2019
"3612865",1086,41,310,1437,75.57,2.85,21.57,2019
"3612169",63,0,29,92,68.48,0,31.52,2019
"3612176",101,0,33,134,75.37,0,24.63,2019
"3612185",607,18,137,762,79.66,2.36,17.98,2019
"3612202",2962,160,992,4114,72,3.89,24.11,2019
"3612008",141,8,68,217,64.98,3.69,31.34,2019
"3612028",251,6,65,322,77.95,1.86,20.19,2019
"3612035",189,0,78,267,70.79,0,29.21,2019
"3612061",3475,248,148,3871,89.77,6.41,3.82,2019
"3612092",282,22,92,396,71.21,5.56,23.23,2019
"3612110",6373,140,732,7245,87.96,1.93,10.1,2019
"3612147",164,13,39,216,75.93,6.02,18.06,2019
"3612160",247,8,103,358,68.99,2.23,28.77,2019
"3612180",17744,809,2775,21328,83.2,3.79,13.01,2019
"3612184",2189,34,363,2586,84.65,1.31,14.04,2019
"3612196",1254,0,25,1279,98.05,0,1.95,2019
"3612198",2742,31,315,3088,88.8,1,10.2,2019
"3612208",8390,189,1322,9901,84.74,1.91,13.35,2019
"3612210",4451,156,666,5273,84.41,2.96,12.63,2019
"3612412",153,0,40,193,79.27,0,20.73,2019
"3612423",348,0,68,416,83.65,0,16.35,2019
"3612427",99,0,18,117,84.62,0,15.38,2019
"3612434",281,0,95,376,74.73,0,25.27,2019
"3612442",300,0,80,380,78.95,0,21.05,2019
"3612448",184,13,0,197,93.4,6.6,0,2019
"3612449",1116,9,108,1233,90.51,0.73,8.76,2019
"3612458",682,37,198,917,74.37,4.03,21.59,2019
"3612459",87,0,48,135,64.44,0,35.56,2019
"3612461",584,64,96,744,78.49,8.6,12.9,2019
"3612471",123,0,0,123,100,0,0,2019
"3614024",419,35,150,604,69.37,5.79,24.83,2019
"3614075",15824,558,2081,18463,85.71,3.02,11.27,2019
"3614081",801,140,387,1328,60.32,10.54,29.14,2019
"3614091",270,38,97,405,66.67,9.38,23.95,2019
"3614127",10851,174,1133,12158,89.25,1.43,9.32,2019
"3614836",264,12,61,337,78.34,3.56,18.1,2019
"3614850",21819,1743,1655,25217,86.52,6.91,6.56,2019
"3614865",804,92,232,1128,71.28,8.16,20.57,2019
"3614872",232,8,26,266,87.22,3.01,9.77,2019
"3614873",761,28,188,977,77.89,2.87,19.24,2019
"3614881",56,18,15,89,62.92,20.22,16.85,2019
"3614569",2015,111,512,2638,76.38,4.21,19.41,2019
"3614606",9217,262,2076,11555,79.77,2.27,17.97,2019
"3614617",8324,171,1063,9558,87.09,1.79,11.12,2019
"1761544",194,9,81,284,68.31,3.17,28.52,2019
"1761569",391,9,65,465,84.09,1.94,13.98,2019
"1761602",300,46,175,521,57.58,8.83,33.59,2019
"1761604",9349,415,2580,12344,75.74,3.36,20.9,2019
"1761018",342,20,51,413,82.81,4.84,12.35,2019
"1761054",1340,18,390,1748,76.66,1.03,22.31,2019
"1761230",393,0,77,470,83.62,0,16.38,2019
"1760175",7902,89,128,8119,97.33,1.1,1.58,2019
"1760201",13259,375,1411,15045,88.13,2.49,9.38,2019
"1760402",17128,765,2507,20400,83.96,3.75,12.29,2019
"1760406",5892,682,1987,8561,68.82,7.97,23.21,2019
"1760410",4064,25,297,4386,92.66,0.57,6.77,2019
"1760419",6309,268,1228,7805,80.83,3.43,15.73,2019
"1760436",4727,98,1093,5918,79.87,1.66,18.47,2019
"1760437",53,6,11,70,75.71,8.57,15.71,2019
"1760438",9316,295,1535,11146,83.58,2.65,13.77,2019
"1760440",14945,140,1758,16843,88.73,0.83,10.44,2019
"1760443",7040,198,959,8197,85.89,2.42,11.7,2019
"1760444",597,54,66,717,83.26,7.53,9.21,2019
"1760445",8777,225,1498,10500,83.59,2.14,14.27,2019
"1760457",4238,114,607,4959,85.46,2.3,12.24,2019
"1760941",600,37,162,799,75.09,4.63,20.28,2019
"1760610",20783,887,2038,23708,87.66,3.74,8.6,2019
"1760622",21162,520,2128,23810,88.88,2.18,8.94,2019
"1760660",16976,1622,2486,21084,80.52,7.69,11.79,2019
"1760706",6448,325,2044,8817,73.13,3.69,23.18,2019
"1760712",3463,68,767,4298,80.57,1.58,17.85,2019
"1760915",3011,55,744,3810,79.03,1.44,19.53,2019
"1760918",249,0,100,349,71.35,0,28.65,2019
"1760931",170,2,46,218,77.98,0.92,21.1,2019
"1760933",94,13,32,139,67.63,9.35,23.02,2019
"1760934",51,18,48,117,43.59,15.38,41.03,2019
"1760951",284,14,25,323,87.93,4.33,7.74,2019
"1760530",171,4,13,188,90.96,2.13,6.91,2019
"1760460",430,11,88,529,81.29,2.08,16.64,2019
"1760515",10057,127,1390,11574,86.89,1.1,12.01,2019
"1760553",285,4,21,310,91.94,1.29,6.77,2019
"1760565",13460,107,215,13782,97.66,0.78,1.56,2019
"1760602",537,60,0,597,89.95,10.05,0,2019
"1760076",9285,257,1138,10680,86.94,2.41,10.66,2019
"1760090",12562,227,1652,14441,86.99,1.57,11.44,2019
"1760098",11099,179,964,12242,90.66,1.46,7.87,2019
"1760101",11173,288,1784,13245,84.36,2.17,13.47,2019
"1760103",12716,157,1093,13966,91.05,1.12,7.83,2019
"1760126",15533,305,1215,17053,91.09,1.79,7.12,2019
"1760155",2211,135,596,2942,75.15,4.59,20.26,2019
"1760064",4004,264,840,5108,78.39,5.17,16.44,2019
"1760067",14230,169,965,15364,92.62,1.1,6.28,2019
"1760083",3508,30,61,3599,97.47,0.83,1.69,2019
"1760087",8209,161,1046,9416,87.18,1.71,11.11,2019
"1760048",9485,62,779,10326,91.86,0.6,7.54,2019
"1760025",13627,231,1314,15172,89.82,1.52,8.66,2019
"1760046",11243,329,728,12300,91.41,2.67,5.92,2019
"1760062",14630,249,1264,16143,90.63,1.54,7.83,2019
"1760074",12888,153,1532,14573,88.44,1.05,10.51,2019
"1760085",19028,535,3672,23235,81.89,2.3,15.8,2019
"1760097",4118,69,222,4409,93.4,1.56,5.04,2019
"1760104",4915,212,1085,6212,79.12,3.41,17.47,2019
"1760113",99,5,17,121,81.82,4.13,14.05,2019
"3611428",4752,110,691,5553,85.58,1.98,12.44,2019
"3611433",8175,288,2136,10599,77.13,2.72,20.15,2019
"3611507",2187,34,214,2435,89.82,1.4,8.79,2019
"3611510",9475,338,915,10728,88.32,3.15,8.53,2019
"3611557",2468,53,243,2764,89.29,1.92,8.79,2019
"3611568",995,12,35,1042,95.49,1.15,3.36,2019
"3611575",3728,140,658,4526,82.37,3.09,14.54,2019
"3611004",4418,162,668,5248,84.18,3.09,12.73,2019
"3611005",1048,55,212,1315,79.7,4.18,16.12,2019
"3611023",2663,91,172,2926,91.01,3.11,5.88,2019
"3611965",202,0,53,255,79.22,0,20.78,2019
"3611934",2382,85,99,2566,92.83,3.31,3.86,2019
"3611211",30467,888,9080,40435,75.35,2.2,22.46,2019
"3611372",19429,793,3564,23786,81.68,3.33,14.98,2019
"3611980",1795,79,164,2038,88.08,3.88,8.05,2019
"3611596",3134,86,278,3498,89.59,2.46,7.95,2019
"3611217",16319,523,1232,18074,90.29,2.89,6.82,2019
"3611516",2071,13,236,2320,89.27,0.56,10.17,2019
"3611779",11153,239,962,12354,90.28,1.93,7.79,2019
"3611790",4115,46,244,4405,93.42,1.04,5.54,2019
"3611803",8738,136,857,9731,89.8,1.4,8.81,2019
"3611940",1664,69,155,1888,88.14,3.65,8.21,2019
"3611948",274,0,0,274,100,0,0,2019
"3611951",3846,115,459,4420,87.01,2.6,10.38,2019
"3611740",2777,153,364,3294,84.3,4.64,11.05,2019
"3611206",22534,766,7863,31163,72.31,2.46,25.23,2019
"3611363",2532,37,235,2804,90.3,1.32,8.38,2019
"3611501",6968,155,611,7734,90.1,2,7.9,2019
"3611514",1544,65,62,1671,92.4,3.89,3.71,2019
"3611735",10501,174,1051,11726,89.55,1.48,8.96,2019
"3611792",2304,50,267,2621,87.91,1.91,10.19,2019
"3611968",3223,173,943,4339,74.28,3.99,21.73,2019
"3613364",38,0,14,52,73.08,0,26.92,2019
"3613404",34,0,24,58,58.62,0,41.38,2019
"3613410",80,10,8,98,81.63,10.2,8.16,2019
"3613415",27,0,0,27,100,0,0,2019
"3613435",94,2,9,105,89.52,1.9,8.57,2019
"3613441",103,0,0,103,100,0,0,2019
"3613472",43,0,0,43,100,0,0,2019
"3613484",32,0,53,85,37.65,0,62.35,2019
"3613488",46,0,10,56,82.14,0,17.86,2019
"3613494",121,0,4,125,96.8,0,3.2,2019
"3613623",8,0,7,15,53.33,0,46.67,2019
"3613628",86,0,6,92,93.48,0,6.52,2019
"3613636",63,3,8,74,85.14,4.05,10.81,2019
"3613641",12,0,11,23,52.17,0,47.83,2019
"3613643",13,0,0,13,100,0,0,2019
"3613647",34,0,0,34,100,0,0,2019
"3613651",46,0,12,58,79.31,0,20.69,2019
"3613666",74,0,8,82,90.24,0,9.76,2019
"3613167",1043,72,126,1241,84.05,5.8,10.15,2019
"3613312",152,4,43,199,76.38,2.01,21.61,2019
"3613317",1245,57,229,1531,81.32,3.72,14.96,2019
"3613323",3504,102,522,4128,84.88,2.47,12.65,2019
"3613436",18,2,10,30,60,6.67,33.33,2019
"3613454",201,11,76,288,69.79,3.82,26.39,2019
"3613459",750,53,206,1009,74.33,5.25,20.42,2019
"3613478",1078,24,58,1160,92.93,2.07,5,2019
"3613483",102,2,32,136,75,1.47,23.53,2019
"3614304",10612,394,2013,13019,81.51,3.03,15.46,2019
"3614454",2731,85,364,3180,85.88,2.67,11.45,2019
"3614466",640,7,8,655,97.71,1.07,1.22,2019
"3614469",2183,65,296,2544,85.81,2.56,11.64,2019
"3614472",3090,53,158,3301,93.61,1.61,4.79,2019
"3614504",608,47,119,774,78.55,6.07,15.37,2019
"3614507",335,15,70,420,79.76,3.57,16.67,2019
"3614514",2317,94,265,2676,86.58,3.51,9.9,2019
"3614532",1395,60,231,1686,82.74,3.56,13.7,2019
"3614533",715,51,113,879,81.34,5.8,12.86,2019
"3614555",483,6,59,548,88.14,1.09,10.77,2019
"3614769",377,10,43,430,87.67,2.33,10,2019
"3614731",417,2,118,537,77.65,0.37,21.97,2019
"3614740",372,9,89,470,79.15,1.91,18.94,2019
"3614743",577,50,140,767,75.23,6.52,18.25,2019
"3614760",6107,495,1470,8072,75.66,6.13,18.21,2019
"3614779",1853,87,753,2693,68.81,3.23,27.96,2019
"3614804",467,21,102,590,79.15,3.56,17.29,2019
"3614806",688,43,139,870,79.08,4.94,15.98,2019
"3614807",948,41,249,1238,76.58,3.31,20.11,2019
"3614819",128,5,93,226,56.64,2.21,41.15,2019
"3614105",1568,16,243,1827,85.82,0.88,13.3,2019
"3614203",735,57,312,1104,66.58,5.16,28.26,2019
"3614204",2704,292,1150,4146,65.22,7.04,27.74,2019
"3614221",20128,645,2472,23245,86.59,2.77,10.63,2019
"3614225",12115,439,2706,15260,79.39,2.88,17.73,2019
"3614062",953,76,281,1310,72.75,5.8,21.45,2019
"3614092",4034,151,619,4804,83.97,3.14,12.89,2019
"3614098",941,29,328,1298,72.5,2.23,25.27,2019
"3614108",1804,28,395,2227,81.01,1.26,17.74,2019
"3614136",1587,66,302,1955,81.18,3.38,15.45,2019
"3614143",349,4,80,433,80.6,0.92,18.48,2019
"3614094",16976,315,3000,20291,83.66,1.55,14.78,2019
"3614103",3810,77,731,4618,82.5,1.67,15.83,2019
"3614131",1701,56,329,2086,81.54,2.68,15.77,2019
"3614034",517,42,167,726,71.21,5.79,23,2019
"3614042",1140,49,441,1630,69.94,3.01,27.06,2019
"3614047",2098,90,335,2523,83.15,3.57,13.28,2019
"3614048",4795,280,1236,6311,75.98,4.44,19.58,2019
"3614052",6013,135,668,6816,88.22,1.98,9.8,2019
"3614055",433,0,160,593,73.02,0,26.98,2019
"3614059",3656,91,408,4155,87.99,2.19,9.82,2019
"3614837",1662,52,461,2175,76.41,2.39,21.2,2019
"3614838",604,16,154,774,78.04,2.07,19.9,2019
"3614855",179,3,102,284,63.03,1.06,35.92,2019
"4216743",1318,45,254,1617,81.51,2.78,15.71,2019
"4216749",1281,56,294,1631,78.54,3.43,18.03,2019
"4216803",8951,1157,299,10407,86.01,11.12,2.87,2019
"4216035",30,0,17,47,63.83,0,36.17,2019
"4216040",304,5,98,407,74.69,1.23,24.08,2019
"4216061",861,26,159,1046,82.31,2.49,15.2,2019
"4216110",118,0,27,145,81.38,0,18.62,2019
"4216114",189,2,47,238,79.41,0.84,19.75,2019
"4216840",151,0,26,177,85.31,0,14.69,2019
"4216849",124,4,10,138,89.86,2.9,7.25,2019
"4216852",87,9,43,139,62.59,6.47,30.94,2019
"4216876",78,3,32,113,69.03,2.65,28.32,2019
"4216879",97,0,78,175,55.43,0,44.57,2019
"4216921",130,5,60,195,66.67,2.56,30.77,2019
"3614618",7576,195,506,8277,91.53,2.36,6.11,2019
"3614217",8917,392,1612,10921,81.65,3.59,14.76,2019
"3614716",594,52,201,847,70.13,6.14,23.73,2019
"3614005",530,32,99,661,80.18,4.84,14.98,2019
"3614031",3580,117,490,4187,85.5,2.79,11.7,2019
"3614039",23,3,9,35,65.71,8.57,25.71,2019
"3614054",508,6,108,622,81.67,0.96,17.36,2019
"3614058",641,9,103,753,85.13,1.2,13.68,2019
"3614070",1528,135,572,2235,68.37,6.04,25.59,2019
"3614082",180,4,35,219,82.19,1.83,15.98,2019
"3614085",2395,80,153,2628,91.13,3.04,5.82,2019
"3614026",279,0,41,320,87.19,0,12.81,2019
"3614111",1102,18,194,1314,83.87,1.37,14.76,2019
"3614216",8777,327,1274,10378,84.57,3.15,12.28,2019
"3614728",327,20,115,462,70.78,4.33,24.89,2019
"3614777",165,13,81,259,63.71,5.02,31.27,2019
"3614846",231,16,83,330,70,4.85,25.15,2019
"3614895",3380,119,798,4297,78.66,2.77,18.57,2019
"3614006",3470,103,589,4162,83.37,2.47,14.15,2019
"3614615",5589,340,1151,7080,78.94,4.8,16.26,2019
"3614220",7926,291,1347,9564,82.87,3.04,14.08,2019
"3614228",8015,380,939,9334,85.87,4.07,10.06,2019
"3614411",4015,80,899,4994,80.4,1.6,18,2019
"3614420",6346,210,689,7245,87.59,2.9,9.51,2019
"3614423",1498,33,300,1831,81.81,1.8,16.38,2019
"3614424",10172,350,1596,12118,83.94,2.89,13.17,2019
"3614437",3260,126,598,3984,81.83,3.16,15.01,2019
"3614441",106,0,9,115,92.17,0,7.83,2019
"3614478",222,18,17,257,86.38,7,6.61,2019
"3614604",972,127,588,1687,57.62,7.53,34.85,2019
"3614610",5642,407,849,6898,81.79,5.9,12.31,2019
"3614611",4758,187,1576,6521,72.96,2.87,24.17,2019
"3614718",606,39,136,781,77.59,4.99,17.41,2019
"3614719",888,27,516,1431,62.05,1.89,36.06,2019
"3614737",1226,68,465,1759,69.7,3.87,26.44,2019
"3614748",187,7,81,275,68,2.55,29.45,2019
"3614757",1003,87,249,1339,74.91,6.5,18.6,2019
"3614802",318,4,36,358,88.83,1.12,10.06,2019
"3614817",873,35,87,995,87.74,3.52,8.74,2019
"3614821",1136,37,194,1367,83.1,2.71,14.19,2019
"3614825",272,3,14,289,94.12,1.04,4.84,2019
"3614845",7234,428,841,8503,85.08,5.03,9.89,2019
"3614880",522,19,126,667,78.26,2.85,18.89,2019
"3614883",1634,2,267,1903,85.86,0.11,14.03,2019
"3614891",1370,50,318,1738,78.83,2.88,18.3,2019
"4216374",586,16,184,786,74.55,2.04,23.41,2019
"4216504",5164,210,1010,6384,80.89,3.29,15.82,2019
"4216648",5138,179,934,6251,82.19,2.86,14.94,2019
"4216048",48,2,3,53,90.57,3.77,5.66,2019
"4216211",31,0,16,47,65.96,0,34.04,2019
"4216312",0,0,0,0,NA,NA,NA,2019
"4216328",89,0,10,99,89.9,0,10.1,2019
"4216444",0,0,0,0,NA,NA,NA,2019
"4216546",0,0,0,0,NA,NA,NA,2019
"4216563",0,0,0,0,NA,NA,NA,2019
"4216699",0,0,0,0,NA,NA,NA,2019
"4216728",11,3,8,22,50,13.64,36.36,2019
"4216821",126,0,0,126,100,0,0,2019
"4216835",61,0,9,70,87.14,0,12.86,2019
"1760120",13002,340,2140,15482,83.98,2.2,13.82,2019
"1760137",13107,344,895,14346,91.36,2.4,6.24,2019
"1760145",754,26,82,862,87.47,3.02,9.51,2019
"1760153",5472,363,1960,7795,70.2,4.66,25.14,2019
"4074079",1111,53,432,1596,69.61,3.32,27.07,2019
"4074107",6387,213,1530,8130,78.56,2.62,18.82,2019
"4074346",1635,125,951,2711,60.31,4.61,35.08,2019
"4074128",3692,108,682,4482,82.37,2.41,15.22,2019
"4074342",706,55,323,1084,65.13,5.07,29.8,2019
"4074343",799,53,330,1182,67.6,4.48,27.92,2019
"4074358",59,10,16,85,69.41,11.76,18.82,2019
"4074363",644,85,300,1029,62.59,8.26,29.15,2019
"4074370",844,70,445,1359,62.1,5.15,32.74,2019
"4074401",3651,900,1834,6385,57.18,14.1,28.72,2019
"4074429",4685,92,584,5361,87.39,1.72,10.89,2019
"4074441",1184,81,662,1927,61.44,4.2,34.35,2019
"4074446",160,2,36,198,80.81,1.01,18.18,2019
"4074456",58,0,38,96,60.42,0,39.58,2019
"4074467",4886,188,1084,6158,79.34,3.05,17.6,2019
"4074468",64,14,29,107,59.81,13.08,27.1,2019
"4074501",8367,331,2243,10941,76.47,3.03,20.5,2019
"4074530",43,2,19,64,67.19,3.12,29.69,2019
"4074534",36,1,25,62,58.06,1.61,40.32,2019
"4074543",90,0,57,147,61.22,0,38.78,2019
"4074562",255,6,131,392,65.05,1.53,33.42,2019
"4074640",80,2,33,115,69.57,1.74,28.7,2019
"4074728",2734,132,1358,4224,64.73,3.12,32.15,2019
"4074729",800,58,249,1107,72.27,5.24,22.49,2019
"4074804",5711,420,1421,7552,75.62,5.56,18.82,2019
"4074831",202,3,64,269,75.09,1.12,23.79,2019
"4074840",448,34,173,655,68.4,5.19,26.41,2019
"4074935",45,2,23,70,64.29,2.86,32.86,2019
"4074936",254,39,129,422,60.19,9.24,30.57,2019
"4074949",80,10,52,142,56.34,7.04,36.62,2019
"4074003",4107,192,1287,5586,73.52,3.44,23.04,2019
"4074015",3029,114,509,3652,82.94,3.12,13.94,2019
"4074029",1339,100,505,1944,68.88,5.14,25.98,2019
"4074035",861,80,422,1363,63.17,5.87,30.96,2019
"4074051",521,21,183,725,71.86,2.9,25.24,2019
"4074058",881,115,428,1424,61.87,8.08,30.06,2019
"4074059",1858,42,331,2231,83.28,1.88,14.84,2019
"4074074",10336,294,1106,11736,88.07,2.51,9.42,2019
"4074104",4255,309,631,5195,81.91,5.95,12.15,2019
"4074130",494,4,206,704,70.17,0.57,29.26,2019
"4074129",5948,230,977,7155,83.13,3.21,13.65,2019
"4074136",11395,423,1854,13672,83.35,3.09,13.56,2019
"4074366",441,29,144,614,71.82,4.72,23.45,2019
"4074368",16,0,21,37,43.24,0,56.76,2019
"4074438",17,3,26,46,36.96,6.52,56.52,2019
"4074867",171,2,108,281,60.85,0.71,38.43,2019
"4074930",498,63,233,794,62.72,7.93,29.35,2019
"4074117",6,0,6,12,50,0,50,2019
"4074053",1391,22,234,1647,84.46,1.34,14.21,2019
"4074066",10060,217,1930,12207,82.41,1.78,15.81,2019
"4074112",7045,446,1651,9142,77.06,4.88,18.06,2019
"4074940",575,18,328,921,62.43,1.95,35.61,2019
"4074945",79,5,70,154,51.3,3.25,45.45,2019
"4074946",24,0,21,45,53.33,0,46.67,2019
"4074962",1201,64,486,1751,68.59,3.66,27.76,2019
"3613489",230,0,43,273,84.25,0,15.75,2019
"3613608",476,13,83,572,83.22,2.27,14.51,2019
"3613617",2974,141,451,3566,83.4,3.95,12.65,2019
"3613640",136,8,21,165,82.42,4.85,12.73,2019
"3613655",830,70,540,1440,57.64,4.86,37.5,2019
"3613658",725,45,138,908,79.85,4.96,15.2,2019
"3613664",113,4,16,133,84.96,3.01,12.03,2019
"3613672",200,0,39,239,83.68,0,16.32,2019
"3613732",2762,86,255,3103,89.01,2.77,8.22,2019
"3613754",1018,35,308,1361,74.8,2.57,22.63,2019
"3613774",66,0,0,66,100,0,0,2019
"3613795",1146,25,138,1309,87.55,1.91,10.54,2019
"3613830",1726,113,419,2258,76.44,5,18.56,2019
"3613833",1237,42,217,1496,82.69,2.81,14.51,2019
"3613834",68,0,18,86,79.07,0,20.93,2019
"3613843",660,39,146,845,78.11,4.62,17.28,2019
"3613324",704,21,173,898,78.4,2.34,19.27,2019
"3613333",18,0,3,21,85.71,0,14.29,2019
"3613348",495,6,102,603,82.09,1,16.92,2019
"3613361",148,4,93,245,60.41,1.63,37.96,2019
"3613365",2572,40,519,3131,82.15,1.28,16.58,2019
"3613367",2633,34,555,3222,81.72,1.06,17.23,2019
"3613421",4616,135,653,5404,85.42,2.5,12.08,2019
"3613424",689,21,163,873,78.92,2.41,18.67,2019
"3613425",671,9,209,889,75.48,1.01,23.51,2019
"3613428",380,35,193,608,62.5,5.76,31.74,2019
"3613438",1144,51,211,1406,81.37,3.63,15.01,2019
"3613469",453,0,15,468,96.79,0,3.21,2019
"3613471",939,68,237,1244,75.48,5.47,19.05,2019
"3613477",377,6,53,436,86.47,1.38,12.16,2019
"3613480",1096,77,256,1429,76.7,5.39,17.91,2019
"3613492",4080,157,581,4818,84.68,3.26,12.06,2019
"4215954",735,16,217,968,75.93,1.65,22.42,2019
"4215693",69,0,0,69,100,0,0,2019
"4215695",135,0,48,183,73.77,0,26.23,2019
"4215739",156,0,45,201,77.61,0,22.39,2019
"4215754",185,59,14,258,71.71,22.87,5.43,2019
"4215761",19,0,38,57,33.33,0,66.67,2019
"4215772",350,15,200,565,61.95,2.65,35.4,2019
"4215776",21,0,4,25,84,0,16,2019
"4215783",37,6,4,47,78.72,12.77,8.51,2019
"4215821",44,2,15,61,72.13,3.28,24.59,2019
"4215827",90,0,16,106,84.91,0,15.09,2019
"4215829",477,5,61,543,87.85,0.92,11.23,2019
"4215849",346,13,114,473,73.15,2.75,24.1,2019
"4215925",54,2,15,71,76.06,2.82,21.13,2019
"4215943",1190,43,335,1568,75.89,2.74,21.36,2019
"4215346",180,0,28,208,86.54,0,13.46,2019
"4215362",225,9,95,329,68.39,2.74,28.88,2019
"4215428",540,20,184,744,72.58,2.69,24.73,2019
"4215445",906,60,187,1153,78.58,5.2,16.22,2019
"4215460",41,4,6,51,80.39,7.84,11.76,2019
"4215472",41,13,7,61,67.21,21.31,11.48,2019
"4215476",15,0,26,41,36.59,0,63.41,2019
"4215522",3615,120,1150,4885,74,2.46,23.54,2019
"4215530",1521,40,500,2061,73.8,1.94,24.26,2019
"4215534",268,0,98,366,73.22,0,26.78,2019
"4215550",537,21,160,718,74.79,2.92,22.28,2019
"4215610",1290,38,251,1579,81.7,2.41,15.9,2019
"4216922",636,14,144,794,80.1,1.76,18.14,2019
"4216933",2170,76,487,2733,79.4,2.78,17.82,2019
"4216937",59,0,12,71,83.1,0,16.9,2019
"4216939",93,0,25,118,78.81,0,21.19,2019
"4216943",145,6,68,219,66.21,2.74,31.05,2019
"4216946",810,26,174,1010,80.2,2.57,17.23,2019
"4216825",114,0,0,114,100,0,0,2019
"4216829",200,3,81,284,70.42,1.06,28.52,2019
"4216843",207,8,131,346,59.83,2.31,37.86,2019
"4216744",70,0,11,81,86.42,0,13.58,2019
"4216802",0,0,12,12,0,0,100,2019
"4216111",309,0,176,485,63.71,0,36.29,2019
"4216113",174,2,15,191,91.1,1.05,7.85,2019
"4216217",25,7,22,54,46.3,12.96,40.74,2019
"4216253",32,0,12,44,72.73,0,27.27,2019
"4216329",148,20,20,188,78.72,10.64,10.64,2019
"4216362",310,15,80,405,76.54,3.7,19.75,2019
"4216373",1050,11,275,1336,78.59,0.82,20.58,2019
"4216404",854,34,391,1279,66.77,2.66,30.57,2019
"4216417",2475,98,498,3071,80.59,3.19,16.22,2019
"4216502",5046,251,1392,6689,75.44,3.75,20.81,2019
"4216507",2947,127,651,3725,79.11,3.41,17.48,2019
"4216509",10416,139,1552,12107,86.03,1.15,12.82,2019
"4216619",104,6,24,134,77.61,4.48,17.91,2019
"4216641",867,14,170,1051,82.49,1.33,16.18,2019
"4216665",109,0,18,127,85.83,0,14.17,2019
"4216667",445,3,84,532,83.65,0.56,15.79,2019
"4216668",1183,21,265,1469,80.53,1.43,18.04,2019
"4216674",183,5,56,244,75,2.05,22.95,2019
"4216678",810,24,265,1099,73.7,2.18,24.11,2019
"4216733",60,0,24,84,71.43,0,28.57,2019
"4216734",97,0,20,117,82.91,0,17.09,2019
"4216820",227,10,166,403,56.33,2.48,41.19,2019
"4216833",1631,80,497,2208,73.87,3.62,22.51,2019
"4216834",107,8,30,145,73.79,5.52,20.69,2019
"4216851",264,0,0,264,100,0,0,2019
"4216875",1180,60,305,1545,76.38,3.88,19.74,2019
"4216882",63,4,70,137,45.99,2.92,51.09,2019
"4216901",3339,71,723,4133,80.79,1.72,17.49,2019
"4216911",139,0,35,174,79.89,0,20.11,2019
"4216929",760,24,161,945,80.42,2.54,17.04,2019
"4216002",5118,79,955,6152,83.19,1.28,15.52,2019
"4216023",1279,184,503,1966,65.06,9.36,25.58,2019
"4216041",693,3,143,839,82.6,0.36,17.04,2019
"4216049",985,33,260,1278,77.07,2.58,20.34,2019
"3407057",3877,202,604,4683,82.79,4.31,12.9,2019
"3407936",3396,93,282,3771,90.06,2.47,7.48,2019
"3407882",5205,93,378,5676,91.7,1.64,6.66,2019
"3407885",3185,153,499,3837,83.01,3.99,13,2019
"3407933",1082,0,34,1116,96.95,0,3.05,2019
"3407727",2289,5,238,2532,90.4,0.2,9.4,2019
"3407642",3187,40,248,3475,91.71,1.15,7.14,2019
"3407644",7879,175,751,8805,89.48,1.99,8.53,2019
"3407645",2725,28,222,2975,91.6,0.94,7.46,2019
"3407648",1976,46,138,2160,91.48,2.13,6.39,2019
"3407724",7646,263,831,8740,87.48,3.01,9.51,2019
"3407726",14022,417,1043,15482,90.57,2.69,6.74,2019
"3407732",1993,175,490,2658,74.98,6.58,18.43,2019
"3407748",8784,277,584,9645,91.07,2.87,6.05,2019
"4216868",160,0,96,256,62.5,0,37.5,2019
"4216950",949,23,299,1271,74.67,1.81,23.52,2019
"4216837",59,0,12,71,83.1,0,16.9,2019
"4216847",66,8,74,148,44.59,5.41,50,2019
"4216848",139,0,20,159,87.42,0,12.58,2019
"4216024",85,5,0,90,94.44,5.56,0,2019
"4216025",1715,27,323,2065,83.05,1.31,15.64,2019
"4216038",1081,30,259,1370,78.91,2.19,18.91,2019
"4216053",1538,37,210,1785,86.16,2.07,11.76,2019
"4216066",11414,198,478,12090,94.41,1.64,3.95,2019
"4216101",10473,453,3182,14108,74.23,3.21,22.55,2019
"4216105",5723,75,894,6692,85.52,1.12,13.36,2019
"4216123",654,19,128,801,81.65,2.37,15.98,2019
"4216134",1276,41,363,1680,75.95,2.44,21.61,2019
"4216140",49,0,18,67,73.13,0,26.87,2019
"4216145",1020,22,169,1211,84.23,1.82,13.96,2019
"4216157",1099,69,255,1423,77.23,4.85,17.92,2019
"4216161",259,8,76,343,75.51,2.33,22.16,2019
"4216238",143,5,32,180,79.44,2.78,17.78,2019
"4216242",1393,45,388,1826,76.29,2.46,21.25,2019
"4216255",430,11,168,609,70.61,1.81,27.59,2019
"4216332",7,0,12,19,36.84,0,63.16,2019
"4216371",993,58,309,1360,73.01,4.26,22.72,2019
"4216403",1927,79,430,2436,79.11,3.24,17.65,2019
"4216406",926,26,287,1239,74.74,2.1,23.16,2019
"4216415",2952,54,301,3307,89.27,1.63,9.1,2019
"4216423",1460,34,267,1761,82.91,1.93,15.16,2019
"4216435",495,11,198,704,70.31,1.56,28.12,2019
"4216611",817,43,165,1025,79.71,4.2,16.1,2019
"4216616",37,0,25,62,59.68,0,40.32,2019
"4216623",174,2,36,212,82.08,0.94,16.98,2019
"4216627",628,32,200,860,73.02,3.72,23.26,2019
"4216634",107,0,39,146,73.29,0,26.71,2019
"4216640",272,3,32,307,88.6,0.98,10.42,2019
"4216645",53,1,7,61,86.89,1.64,11.48,2019
"4216680",71,0,68,139,51.08,0,48.92,2019
"4216682",19,0,9,28,67.86,0,32.14,2019
"4216727",58,0,8,66,87.88,0,12.12,2019
"4216746",388,30,43,461,84.16,6.51,9.33,2019
"4216827",1818,13,25,1856,97.95,0.7,1.35,2019
"4216832",118,4,40,162,72.84,2.47,24.69,2019
"4216845",235,13,76,324,72.53,4.01,23.46,2019
"4216853",52,7,37,96,54.17,7.29,38.54,2019
"4216914",730,17,129,876,83.33,1.94,14.73,2019
"4216153",803,17,213,1033,77.73,1.65,20.62,2019
"3408034",6250,43,600,6893,90.67,0.62,8.7,2019
"3408045",874,32,223,1129,77.41,2.83,19.75,2019
"3408055",9475,162,376,10013,94.63,1.62,3.76,2019
"3408063",892,36,189,1117,79.86,3.22,16.92,2019
"3408065",2438,28,359,2825,86.3,0.99,12.71,2019
"3408070",3994,157,849,5000,79.88,3.14,16.98,2019
"3408072",95,0,5,100,95,0,5,2019
"3408078",2726,61,362,3149,86.57,1.94,11.5,2019
"3408083",3398,41,279,3718,91.39,1.1,7.5,2019
"3408089",1240,18,244,1502,82.56,1.2,16.25,2019
"3408223",1604,82,120,1806,88.82,4.54,6.64,2019
"3408215",4441,207,662,5310,83.63,3.9,12.47,2019
"3408221",2235,51,223,2509,89.08,2.03,8.89,2019
"3408224",154,4,27,185,83.24,2.16,14.59,2019
"4074965",908,122,755,1785,50.87,6.83,42.3,2019
"4074966",935,24,422,1381,67.7,1.74,30.56,2019
"4073066",127,0,19,146,86.99,0,13.01,2019
"4073068",3518,87,584,4189,83.98,2.08,13.94,2019
"4878239",7176,330,1082,8588,83.56,3.84,12.6,2019
"4878254",16031,127,747,16905,94.83,0.75,4.42,2019
"4878261",5581,86,136,5803,96.17,1.48,2.34,2019
"4878266",2285,128,49,2462,92.81,5.2,1.99,2019
"4878332",5670,205,3480,9355,60.61,2.19,37.2,2019
"4878353",64,6,62,132,48.48,4.55,46.97,2019
"4878503",5032,342,1131,6505,77.36,5.26,17.39,2019
"4878577",11963,2235,7913,22111,54.1,10.11,35.79,2019
"4878932",140,0,55,195,71.79,0,28.21,2019
"4878885",34,0,13,47,72.34,0,27.66,2019
"4878870",277,6,66,349,79.37,1.72,18.91,2019
"4878881",382,0,433,815,46.87,0,53.13,2019
"4878884",320,13,87,420,76.19,3.1,20.71,2019
"4878934",1634,119,627,2380,68.66,5,26.34,2019
"4878935",325,9,64,398,81.66,2.26,16.08,2019
"4878705",7737,892,244,8873,87.2,10.05,2.75,2019
"4878759",18971,330,1370,20671,91.78,1.6,6.63,2019
"4878563",45,5,51,101,44.55,4.95,50.5,2019
"4878133",6552,107,558,7217,90.79,1.48,7.73,2019
"4878258",14985,192,906,16083,93.17,1.19,5.63,2019
"4878404",5248,149,1456,6853,76.58,2.17,21.25,2019
"4878580",2427,237,1092,3756,64.62,6.31,29.07,2019
"4878639",2583,41,765,3389,76.22,1.21,22.57,2019
"4878628",11282,179,872,12333,91.48,1.45,7.07,2019
"4878728",8513,160,1335,10008,85.06,1.6,13.34,2019
"4878736",3535,71,72,3678,96.11,1.93,1.96,2019
"4878750",11319,116,423,11858,95.45,0.98,3.57,2019
"4878753",16080,512,3960,20552,78.24,2.49,19.27,2019
"4878827",196,11,183,390,50.26,2.82,46.92,2019
"4878832",644,33,660,1337,48.17,2.47,49.36,2019
"4878839",1496,230,992,2718,55.04,8.46,36.5,2019
"4878861",2989,89,904,3982,75.06,2.24,22.7,2019
"4878938",83,3,44,130,63.85,2.31,33.85,2019
"4878943",52,0,57,109,47.71,0,52.29,2019
"4878945",2695,84,1301,4080,66.05,2.06,31.89,2019
"4878963",295,21,40,356,82.87,5.9,11.24,2019
"4878837",64,0,29,93,68.82,0,31.18,2019
"4878941",426,63,446,935,45.56,6.74,47.7,2019
"4878944",177,14,50,241,73.44,5.81,20.75,2019
"4878950",704,0,96,800,88,0,12,2019
"4878248",5295,39,154,5488,96.48,0.71,2.81,2019
"4878207",8601,813,6029,15443,55.7,5.26,39.04,2019
"4878233",13517,1227,2546,17290,78.18,7.1,14.73,2019
"4878242",7005,313,1760,9078,77.16,3.45,19.39,2019
"4878251",18940,241,1429,20610,91.9,1.17,6.93,2019
"4878255",4354,25,137,4516,96.41,0.55,3.03,2019
"4878263",1109,45,258,1412,78.54,3.19,18.27,2019
"4878330",157,8,144,309,50.81,2.59,46.6,2019
"4878351",62,13,48,123,50.41,10.57,39.02,2019
"4878358",247,6,45,298,82.89,2.01,15.1,2019
"4878387",1943,99,1038,3080,63.08,3.21,33.7,2019
"4878408",2518,41,1544,4103,61.37,1,37.63,2019
"4878409",791,0,202,993,79.66,0,20.34,2019
"4878416",3597,53,1543,5193,69.27,1.02,29.71,2019
"4878543",1689,52,658,2399,70.4,2.17,27.43,2019
"4215611",250,3,87,340,73.53,0.88,25.59,2019
"4215617",97,2,42,141,68.79,1.42,29.79,2019
"4215622",438,0,175,613,71.45,0,28.55,2019
"4215623",232,0,25,257,90.27,0,9.73,2019
"4215633",140,11,98,249,56.22,4.42,39.36,2019
"4215646",56,0,10,66,84.85,0,15.15,2019
"4215661",160,25,19,204,78.43,12.25,9.31,2019
"4215087",41,0,10,51,80.39,0,19.61,2019
"4215060",246,0,49,295,83.39,0,16.61,2019
"4215082",106,0,0,106,100,0,0,2019
"4215088",135,15,22,172,78.49,8.72,12.79,2019
"4215131",2947,121,631,3699,79.67,3.27,17.06,2019
"4215132",6923,262,2718,9903,69.91,2.65,27.45,2019
"4215137",3719,130,840,4689,79.31,2.77,17.91,2019
"4215208",3293,183,1040,4516,72.92,4.05,23.03,2019
"4215823",446,22,90,558,79.93,3.94,16.13,2019
"4215832",84,12,30,126,66.67,9.52,23.81,2019
"4215841",124,6,22,152,81.58,3.95,14.47,2019
"4215847",106,3,37,146,72.6,2.05,25.34,2019
"4215860",368,15,108,491,74.95,3.05,22,2019
"4215865",443,10,177,630,70.32,1.59,28.1,2019
"4215688",314,32,110,456,68.86,7.02,24.12,2019
"4215692",422,0,97,519,81.31,0,18.69,2019
"4215714",1496,36,516,2048,73.05,1.76,25.2,2019
"4215723",0,0,15,15,0,0,100,2019
"4215218",5677,149,909,6735,84.29,2.21,13.5,2019
"4215235",12991,252,1845,15088,86.1,1.67,12.23,2019
"4215320",1757,156,539,2452,71.66,6.36,21.98,2019
"4215321",574,10,32,616,93.18,1.62,5.19,2019
"4215325",86,19,81,186,46.24,10.22,43.55,2019
"4215334",36,0,9,45,80,0,20,2019
"4215348",97,0,0,97,100,0,0,2019
"0906470",5280,169,460,5909,89.36,2.86,7.78,2019
"0906472",2347,0,53,2400,97.79,0,2.21,2019
"0906480",3183,117,441,3741,85.08,3.13,11.79,2019
"0906511",18097,293,2515,20905,86.57,1.4,12.03,2019
"0906513",11520,346,2926,14792,77.88,2.34,19.78,2019
"0906514",9219,179,597,9995,92.24,1.79,5.97,2019
"0906524",1851,43,124,2018,91.72,2.13,6.14,2019
"0906605",6879,371,1592,8842,77.8,4.2,18,2019
"0906608",3352,186,961,4499,74.51,4.13,21.36,2019
"0906611",11044,268,885,12197,90.55,2.2,7.26,2019
"0906702",487,259,930,1676,29.06,15.45,55.49,2019
"0906750",414,7,86,507,81.66,1.38,16.96,2019
"0906752",643,13,48,704,91.34,1.85,6.82,2019
"0906756",964,7,103,1074,89.76,0.65,9.59,2019
"0906770",10084,335,1246,11665,86.45,2.87,10.68,2019
"0906783",832,10,45,887,93.8,1.13,5.07,2019
"0906791",1809,8,126,1943,93.1,0.41,6.48,2019
"0906512",9808,210,1286,11304,86.77,1.86,11.38,2019
"0906516",17223,319,2344,19886,86.61,1.6,11.79,2019
"0906517",4957,149,803,5909,83.89,2.52,13.59,2019
"0906018",925,21,240,1186,77.99,1.77,20.24,2019
"0906035",2715,14,219,2948,92.1,0.47,7.43,2019
"0906226",5053,273,1218,6544,77.22,4.17,18.61,2019
"0906051",7810,554,3493,11857,65.87,4.67,29.46,2019
"0906096",4183,167,957,5307,78.82,3.15,18.03,2019
"0906234",2444,102,376,2922,83.64,3.49,12.87,2019
"0906264",41,0,2,43,95.35,0,4.65,2019
"3407826",1973,81,207,2261,87.26,3.58,9.16,2019
"3407750",1346,0,68,1414,95.19,0,4.81,2019
"3407762",3519,96,423,4038,87.15,2.38,10.48,2019
"3407847",639,61,46,746,85.66,8.18,6.17,2019
"3407849",3367,67,236,3670,91.74,1.83,6.43,2019
"3407852",1233,122,140,1495,82.47,8.16,9.36,2019
"3407856",1597,0,151,1748,91.36,0,8.64,2019
"3407008",5663,733,1529,7925,71.46,9.25,19.29,2019
"3407002",20652,503,3812,24967,82.72,2.01,15.27,2019
"3407012",3930,33,615,4578,85.85,0.72,13.43,2019
"3407014",1718,18,108,1844,93.17,0.98,5.86,2019
"3407017",10646,396,2125,13167,80.85,3.01,16.14,2019
"3407031",5527,69,788,6384,86.58,1.08,12.34,2019
"3407064",943,240,133,1316,71.66,18.24,10.11,2019
"3407065",9625,402,1277,11304,85.15,3.56,11.3,2019
"3407090",9423,102,755,10280,91.66,0.99,7.34,2019
"3407094",6873,144,540,7557,90.95,1.91,7.15,2019
"3407104",13395,735,4804,18934,70.75,3.88,25.37,2019
"3407302",20782,278,1295,22355,92.96,1.24,5.79,2019
"3407307",13435,410,1876,15721,85.46,2.61,11.93,2019
"3407403",2657,0,296,2953,89.98,0,10.02,2019
"3407423",1407,11,20,1438,97.84,0.76,1.39,2019
"3407430",9277,58,443,9778,94.88,0.59,4.53,2019
"3407504",2768,76,838,3682,75.18,2.06,22.76,2019
"3407006",8886,69,621,9576,92.79,0.72,6.48,2019
"3407011",9912,148,2589,12649,78.36,1.17,20.47,2019
"3407020",5295,14,442,5751,92.07,0.24,7.69,2019
"3407032",11600,109,1642,13351,86.88,0.82,12.3,2019
"3407035",3329,73,324,3726,89.35,1.96,8.7,2019
"3407036",12662,447,2297,15406,82.19,2.9,14.91,2019
"3407042",9355,258,823,10436,89.64,2.47,7.89,2019
"3407052",14517,264,1633,16414,88.44,1.61,9.95,2019
"3407067",5618,131,448,6197,90.66,2.11,7.23,2019
"3407078",4071,34,38,4143,98.26,0.82,0.92,2019
"3407087",19882,498,4132,24512,81.11,2.03,16.86,2019
"3407093",19316,942,3859,24117,80.09,3.91,16,2019
"3407201",6847,411,1393,8651,79.15,4.75,16.1,2019
"3407305",18408,603,3641,22652,81.26,2.66,16.07,2019
"3407419",3301,67,224,3592,91.9,1.87,6.24,2019
"3407436",4058,35,144,4237,95.78,0.83,3.4,2019
"3407481",5378,82,373,5833,92.2,1.41,6.39,2019
"3407506",6171,128,819,7118,86.7,1.8,11.51,2019
"3407647",1623,7,83,1713,94.75,0.41,4.85,2019
"3407649",2717,38,33,2788,97.45,1.36,1.18,2019
"3407675",9495,56,483,10034,94.63,0.56,4.81,2019
"3612203",10962,597,1640,13199,83.05,4.52,12.43,2019
"3612204",3346,131,469,3946,84.79,3.32,11.89,2019
"3612206",4576,271,1381,6228,73.47,4.35,22.17,2019
"3612010",8984,470,2218,11672,76.97,4.03,19,2019
"3612018",2760,21,279,3060,90.2,0.69,9.12,2019
"3612032",326,18,62,406,80.3,4.43,15.27,2019
"3612041",140,0,33,173,80.92,0,19.08,2019
"3612046",325,0,98,423,76.83,0,23.17,2019
"3612068",927,28,284,1239,74.82,2.26,22.92,2019
"3612071",77,0,50,127,60.63,0,39.37,2019
"3612072",760,32,179,971,78.27,3.3,18.43,2019
"3612074",1092,5,98,1195,91.38,0.42,8.2,2019
"3612095",4056,42,761,4859,83.47,0.86,15.66,2019
"3612138",1123,34,191,1348,83.31,2.52,14.17,2019
"3408330",9226,261,1079,10566,87.32,2.47,10.21,2019
"3408344",1479,28,305,1812,81.62,1.55,16.83,2019
"3408353",134,3,15,152,88.16,1.97,9.87,2019
"3408029",1558,0,414,1972,79.01,0,20.99,2019
"3408030",3852,81,690,4623,83.32,1.75,14.93,2019
"3408036",1920,17,303,2240,85.71,0.76,13.53,2019
"3408046",9597,174,922,10693,89.75,1.63,8.62,2019
"3408064",30,0,0,30,100,0,0,2019
"3408067",511,19,57,587,87.05,3.24,9.71,2019
"3408087",9335,337,1245,10917,85.51,3.09,11.4,2019
"3408097",1047,17,84,1148,91.2,1.48,7.32,2019
"3408212",83,5,4,92,90.22,5.43,4.35,2019
"3408012",12859,366,1433,14658,87.73,2.5,9.78,2019
"3408028",5666,157,656,6479,87.45,2.42,10.13,2019
"3408033",5688,21,345,6054,93.95,0.35,5.7,2019
"3408037",7115,305,905,8325,85.47,3.66,10.87,2019
"3408056",1484,0,25,1509,98.34,0,1.66,2019
"3408059",1930,9,188,2127,90.74,0.42,8.84,2019
"3408073",46,0,0,46,100,0,0,2019
"3408080",12511,142,743,13396,93.39,1.06,5.55,2019
"3408088",8064,146,1059,9269,87,1.58,11.43,2019
"3408109",7210,72,1140,8422,85.61,0.85,13.54,2019
"3408204",6823,213,699,7735,88.21,2.75,9.04,2019
"3408243",1045,9,57,1111,94.06,0.81,5.13,2019
"3408260",4877,150,1076,6103,79.91,2.46,17.63,2019
"3408270",2466,64,484,3014,81.82,2.12,16.06,2019
"3408319",382,13,19,414,92.27,3.14,4.59,2019
"3408401",10491,416,4597,15504,67.67,2.68,29.65,2019
"3408077",6336,76,486,6898,91.85,1.1,7.05,2019
"3408085",6343,130,282,6755,93.9,1.92,4.17,2019
"3408090",2571,53,151,2775,92.65,1.91,5.44,2019
"3408093",2941,124,598,3663,80.29,3.39,16.33,2019
"3408095",17,0,0,17,100,0,0,2019
"3408096",11580,217,1920,13717,84.42,1.58,14,2019
"3408104",5289,231,2830,8350,63.34,2.77,33.89,2019
"3408110",4578,196,913,5687,80.5,3.45,16.05,2019
"3408203",3526,111,415,4052,87.02,2.74,10.24,2019
"3408210",5559,107,715,6381,87.12,1.68,11.21,2019
"3408225",2608,28,227,2863,91.09,0.98,7.93,2019
"3408244",3721,107,597,4425,84.09,2.42,13.49,2019
"3408251",3512,86,536,4134,84.95,2.08,12.97,2019
"3408008",3087,70,353,3510,87.95,1.99,10.06,2019
"3408022",3224,47,440,3711,86.88,1.27,11.86,2019
"3408005",8322,212,823,9357,88.94,2.27,8.8,2019
"3408511",339,0,44,383,88.51,0,11.49,2019
"3612009",2643,78,298,3019,87.55,2.58,9.87,2019
"3612025",2013,34,238,2285,88.1,1.49,10.42,2019
"3612047",7399,584,1047,9030,81.94,6.47,11.59,2019
"3612052",538,20,123,681,79,2.94,18.06,2019
"3612058",376,14,159,549,68.49,2.55,28.96,2019
"3612063",132,0,67,199,66.33,0,33.67,2019
"3612064",112,0,58,170,65.88,0,34.12,2019
"3612076",455,33,142,630,72.22,5.24,22.54,2019
"3612120",193,19,53,265,72.83,7.17,20,2019
"3612125",539,28,55,622,86.66,4.5,8.84,2019
"3612150",259,0,64,323,80.19,0,19.81,2019
"3612188",4133,140,550,4823,85.69,2.9,11.4,2019
"3612192",640,9,73,722,88.64,1.25,10.11,2019
"3612207",709,72,398,1179,60.14,6.11,33.76,2019
"4878557",2958,252,548,3758,78.71,6.71,14.58,2019
"4878583",1326,319,837,2482,53.42,12.85,33.72,2019
"4878608",185,0,17,202,91.58,0,8.42,2019
"4878622",78,3,25,106,73.58,2.83,23.58,2019
"1761614",10491,309,1949,12749,82.29,2.42,15.29,2019
"1761721",194,12,23,229,84.72,5.24,10.04,2019
"1761732",651,4,75,730,89.18,0.55,10.27,2019
"1761737",150,6,28,184,81.52,3.26,15.22,2019
"1761771",265,5,32,302,87.75,1.66,10.6,2019
"1761772",83,10,8,101,82.18,9.9,7.92,2019
"1761774",327,12,19,358,91.34,3.35,5.31,2019
"1761776",430,31,27,488,88.11,6.35,5.53,2019
"1761777",259,11,91,361,71.75,3.05,25.21,2019
"1761816",148,6,25,179,82.68,3.35,13.97,2019
"1761275",1570,60,236,1866,84.14,3.22,12.65,2019
"1761283",396,17,154,567,69.84,3,27.16,2019
"1761329",437,7,84,528,82.77,1.33,15.91,2019
"1761334",242,11,37,290,83.45,3.79,12.76,2019
"1761344",98,7,47,152,64.47,4.61,30.92,2019
"1761359",93,8,30,131,70.99,6.11,22.9,2019
"1761363",96,0,45,141,68.09,0,31.91,2019
"1761373",769,4,129,902,85.25,0.44,14.3,2019
"1761401",9583,592,3297,13472,71.13,4.39,24.47,2019
"1761426",39,0,10,49,79.59,0,20.41,2019
"1761063",1481,29,256,1766,83.86,1.64,14.5,2019
"1761025",1672,17,343,2032,82.28,0.84,16.88,2019
"1761049",158,4,46,208,75.96,1.92,22.12,2019
"1761053",963,26,184,1173,82.1,2.22,15.69,2019
"1761065",3149,44,263,3456,91.12,1.27,7.61,2019
"1761080",3559,117,324,4000,88.97,2.92,8.1,2019
"1761107",11174,380,1676,13230,84.46,2.87,12.67,2019
"1761257",335,7,52,394,85.03,1.78,13.2,2019
"1761262",364,24,48,436,83.49,5.5,11.01,2019
"1761279",325,56,40,421,77.2,13.3,9.5,2019
"1761284",657,44,152,853,77.02,5.16,17.82,2019
"1761285",555,0,93,648,85.65,0,14.35,2019
"1761313",51,0,33,84,60.71,0,39.29,2019
"1761314",272,7,92,371,73.32,1.89,24.8,2019
"1761328",9,0,0,9,100,0,0,2019
"1761336",174,0,41,215,80.93,0,19.07,2019
"1761428",370,11,36,417,88.73,2.64,8.63,2019
"1761438",277,3,40,320,86.56,0.94,12.5,2019
"1761451",98,0,10,108,90.74,0,9.26,2019
"1761471",36,2,0,38,94.74,5.26,0,2019
"1761473",486,20,92,598,81.27,3.34,15.38,2019
"1761501",471,15,207,693,67.97,2.16,29.87,2019
"1761529",901,5,134,1040,86.63,0.48,12.88,2019
"1761537",918,5,243,1166,78.73,0.43,20.84,2019
"1761546",1247,56,288,1591,78.38,3.52,18.1,2019
"1761548",4015,60,413,4488,89.46,1.34,9.2,2019
"1761552",67,0,7,74,90.54,0,9.46,2019
"1761561",791,17,157,965,81.97,1.76,16.27,2019
"1761571",8236,159,1442,9837,83.72,1.62,14.66,2019
"1761572",442,23,113,578,76.47,3.98,19.55,2019
"1761723",866,43,138,1047,82.71,4.11,13.18,2019
"1761724",168,7,32,207,81.16,3.38,15.46,2019
"1761725",459,0,134,593,77.4,0,22.6,2019
"1761722",161,0,25,186,86.56,0,13.44,2019
"1761727",3284,106,652,4042,81.25,2.62,16.13,2019
"0906335",2294,16,160,2470,92.87,0.65,6.48,2019
"0906336",29,0,0,29,100,0,0,2019
"0906365",1492,43,295,1830,81.53,2.35,16.12,2019
"0906373",47,0,24,71,66.2,0,33.8,2019
"0906409",422,0,0,422,100,0,0,2019
"0906423",1972,4,193,2169,90.92,0.18,8.9,2019
"0906424",4271,104,427,4802,88.94,2.17,8.89,2019
"0906442",856,11,129,996,85.94,1.1,12.95,2019
"0906447",2149,45,137,2331,92.19,1.93,5.88,2019
"0906483",5178,172,853,6203,83.48,2.77,13.75,2019
"0906704",6356,386,2427,9169,69.32,4.21,26.47,2019
"0906705",7252,702,2253,10207,71.05,6.88,22.07,2019
"0906710",2356,121,1159,3636,64.8,3.33,31.88,2019
"0906716",5040,201,811,6052,83.28,3.32,13.4,2019
"0906010",20468,641,3529,24638,83.07,2.6,14.32,2019
"0906016",2339,61,238,2638,88.67,2.31,9.02,2019
"0906013",3219,28,215,3462,92.98,0.81,6.21,2019
"0906039",906,24,27,957,94.67,2.51,2.82,2019
"0906071",3194,86,352,3632,87.94,2.37,9.69,2019
"0906073",2061,37,58,2156,95.59,1.72,2.69,2019
"0906081",565,16,58,639,88.42,2.5,9.08,2019
"0906082",14741,450,1553,16744,88.04,2.69,9.27,2019
"0906098",4092,79,901,5072,80.68,1.56,17.76,2019
"0906105",7563,353,1839,9755,77.53,3.62,18.85,2019
"0906278",1600,19,219,1838,87.05,1.03,11.92,2019
"0906334",882,36,63,981,89.91,3.67,6.42,2019
"0906375",1303,0,75,1378,94.56,0,5.44,2019
"0906401",5763,543,1448,7754,74.32,7,18.67,2019
"0906777",551,10,53,614,89.74,1.63,8.63,2019
"0906786",3363,67,517,3947,85.2,1.7,13.1,2019
"0906796",425,9,54,488,87.09,1.84,11.07,2019
"0906804",5871,20,381,6272,93.61,0.32,6.07,2019
"3611754",6022,118,544,6684,90.1,1.77,8.14,2019
"3611795",7384,157,271,7812,94.52,2.01,3.47,2019
"3611957",352,5,35,392,89.8,1.28,8.93,2019
"3611201",26375,299,1919,28593,92.24,1.05,6.71,2019
"3611231",13373,364,1921,15658,85.41,2.32,12.27,2019
"3611417",8079,67,752,8898,90.8,0.75,8.45,2019
"3611109",2832,16,59,2907,97.42,0.55,2.03,2019
"3611351",0,0,0,0,NA,NA,NA,2019
"3611359",0,0,0,0,NA,NA,NA,2019
"3611424",0,0,0,0,NA,NA,NA,2019
"3611425",0,0,0,0,NA,NA,NA,2019
"3611451",0,0,0,0,NA,NA,NA,2019
"3611549",0,0,0,0,NA,NA,NA,2019
"3611556",0,0,0,0,NA,NA,NA,2019
"3611739",289,0,4,293,98.63,0,1.37,2019
"3611749",925,82,12,1019,90.78,8.05,1.18,2019
"3611794",0,0,0,0,NA,NA,NA,2019
"3611931",10,0,0,10,100,0,0,2019
"3611973",0,0,0,0,NA,NA,NA,2019
"3611955",1719,65,32,1816,94.66,3.58,1.76,2019
"3611958",280,13,62,355,78.87,3.66,17.46,2019
"3611970",117,0,0,117,100,0,0,2019
"3611972",250,57,151,458,54.59,12.45,32.97,2019
"3611976",532,40,98,670,79.4,5.97,14.63,2019
"3611010",6981,161,690,7832,89.13,2.06,8.81,2019
"3611020",1550,73,222,1845,84.01,3.96,12.03,2019
"3611203",22131,348,5797,28276,78.27,1.23,20.5,2019
"3612149",698,64,176,938,74.41,6.82,18.76,2019
"3612159",2911,188,428,3527,82.53,5.33,12.13,2019
"3612170",1760,25,177,1962,89.7,1.27,9.02,2019
"3612193",617,12,162,791,78,1.52,20.48,2019
"3612197",612,29,137,778,78.66,3.73,17.61,2019
"3612741",96,0,20,116,82.76,0,17.24,2019
"3612583",786,22,77,885,88.81,2.49,8.7,2019
"3612549",3309,117,362,3788,87.35,3.09,9.56,2019
"3612578",789,0,39,828,95.29,0,4.71,2019
"3612582",1410,0,14,1424,99.02,0,0.98,2019
"3612589",4276,46,440,4762,89.79,0.97,9.24,2019
"3612594",1341,109,217,1667,80.44,6.54,13.02,2019
"3612701",3196,112,811,4119,77.59,2.72,19.69,2019
"3612719",410,6,38,454,90.31,1.32,8.37,2019
"3612725",42,0,9,51,82.35,0,17.65,2019
"3612736",27,0,9,36,75,0,25,2019
"3612746",292,11,51,354,82.49,3.11,14.41,2019
"3612747",626,0,30,656,95.43,0,4.57,2019
"3612923",157,10,76,243,64.61,4.12,31.28,2019
"3612930",215,2,62,279,77.06,0.72,22.22,2019
"3612546",963,19,239,1221,78.87,1.56,19.57,2019
"3612886",113,0,13,126,89.68,0,10.32,2019
"3612887",1257,94,425,1776,70.78,5.29,23.93,2019
"3612918",720,25,151,896,80.36,2.79,16.85,2019
"3612920",732,13,231,976,75,1.33,23.67,2019
"3612837",350,28,27,405,86.42,6.91,6.67,2019
"3612878",188,11,61,260,72.31,4.23,23.46,2019
"3612911",0,0,0,0,NA,NA,NA,2019
"3612943",107,33,60,200,53.5,16.5,30,2019
"3612944",1341,48,281,1670,80.3,2.87,16.83,2019
"3612986",2071,135,362,2568,80.65,5.26,14.1,2019
"3612989",351,9,103,463,75.81,1.94,22.25,2019
"3612934",313,12,90,415,75.42,2.89,21.69,2019
"3612993",523,24,164,711,73.56,3.38,23.07,2019
"3612962",1859,113,264,2236,83.14,5.05,11.81,2019
"3612964",23,0,13,36,63.89,0,36.11,2019
"3612965",145,0,19,164,88.41,0,11.59,2019
"3612996",759,36,132,927,81.88,3.88,14.24,2019
"3612759",509,29,85,623,81.7,4.65,13.64,2019
"3612762",135,0,50,185,72.97,0,27.03,2019
"3612766",164,0,19,183,89.62,0,10.38,2019
"3612779",618,14,221,853,72.45,1.64,25.91,2019
"3612787",75,0,32,107,70.09,0,29.91,2019
"3612803",3014,41,531,3586,84.05,1.14,14.81,2019
"3612804",9799,219,1030,11048,88.69,1.98,9.32,2019
"3614858",328,22,162,512,64.06,4.3,31.64,2019
"3614860",430,17,100,547,78.61,3.11,18.28,2019
"3614864",342,8,131,481,71.1,1.66,27.23,2019
"3614869",433,17,47,497,87.12,3.42,9.46,2019
"3614874",80,0,38,118,67.8,0,32.2,2019
"3614877",134,6,51,191,70.16,3.14,26.7,2019
"3614884",103,0,28,131,78.63,0,21.37,2019
"3614207",7129,405,1792,9326,76.44,4.34,19.22,2019
"3614211",6208,594,2618,9420,65.9,6.31,27.79,2019
"3614418",384,19,104,507,75.74,3.75,20.51,2019
"3614435",1026,29,153,1208,84.93,2.4,12.67,2019
"3614468",6101,109,571,6781,89.97,1.61,8.42,2019
"3614489",2232,71,432,2735,81.61,2.6,15.8,2019
"3614525",747,0,238,985,75.84,0,24.16,2019
"3612307",1577,112,410,2099,75.13,5.34,19.53,2019
"3612405",158,21,4,183,86.34,11.48,2.19,2019
"3612411",107,0,21,128,83.59,0,16.41,2019
"3612015",990,52,101,1143,86.61,4.55,8.84,2019
"3612020",12036,541,1171,13748,87.55,3.94,8.52,2019
"3612031",44,12,32,88,50,13.64,36.36,2019
"3612036",79,0,25,104,75.96,0,24.04,2019
"3612051",1118,49,333,1500,74.53,3.27,22.2,2019
"3612053",1194,58,132,1384,86.27,4.19,9.54,2019
"3612054",6290,188,455,6933,90.73,2.71,6.56,2019
"3612056",647,41,121,809,79.98,5.07,14.96,2019
"3612057",626,0,148,774,80.88,0,19.12,2019
"3612070",533,19,171,723,73.72,2.63,23.65,2019
"3612075",830,2,298,1130,73.45,0.18,26.37,2019
"3612087",285,0,50,335,85.07,0,14.93,2019
"3612118",5788,155,726,6669,86.79,2.32,10.89,2019
"3612121",616,10,58,684,90.06,1.46,8.48,2019
"3612140",573,7,106,686,83.53,1.02,15.45,2019
"3612143",1623,73,277,1973,82.26,3.7,14.04,2019
"3612154",947,54,178,1179,80.32,4.58,15.1,2019
"3612155",611,42,176,829,73.7,5.07,21.23,2019
"3612157",1312,70,303,1685,77.86,4.15,17.98,2019
"3612167",790,69,269,1128,70.04,6.12,23.85,2019
"3612751",196,0,159,355,55.21,0,44.79,2019
"3612764",607,16,120,743,81.7,2.15,16.15,2019
"3612777",353,27,56,436,80.96,6.19,12.84,2019
"3612784",17,0,0,17,100,0,0,2019
"3612788",822,0,92,914,89.93,0,10.07,2019
"3612789",748,24,90,862,86.77,2.78,10.44,2019
"3612847",125,0,17,142,88.03,0,11.97,2019
"3612791",181,0,41,222,81.53,0,18.47,2019
"3612817",662,60,220,942,70.28,6.37,23.35,2019
"3612839",4533,103,649,5285,85.77,1.95,12.28,2019
"3612851",173,2,5,180,96.11,1.11,2.78,2019
"3612856",81,0,24,105,77.14,0,22.86,2019
"3612871",1470,54,204,1728,85.07,3.12,11.81,2019
"3612919",947,52,135,1134,83.51,4.59,11.9,2019
"3612921",859,36,91,986,87.12,3.65,9.23,2019
"3612922",15,0,1,16,93.75,0,6.25,2019
"3612956",425,36,134,595,71.43,6.05,22.52,2019
"3612961",99,0,75,174,56.9,0,43.1,2019
"3612969",142,0,58,200,71,0,29,2019
"3612970",130,1,15,146,89.04,0.68,10.27,2019
"3612980",320,12,203,535,59.81,2.24,37.94,2019
"3612912",704,33,153,890,79.1,3.71,17.19,2019
"3614892",2573,49,549,3171,81.14,1.55,17.31,2019
"3614894",396,0,67,463,85.53,0,14.47,2019
"3614897",271,21,22,314,86.31,6.69,7.01,2019
"3614903",2734,164,477,3375,81.01,4.86,14.13,2019
"3614904",4935,203,1104,6242,79.06,3.25,17.69,2019
"3614816",186,0,18,204,91.18,0,8.82,2019
"3614727",1778,96,395,2269,78.36,4.23,17.41,2019
"3614747",671,24,178,873,76.86,2.75,20.39,2019
"3614750",1613,108,338,2059,78.34,5.25,16.42,2019
"3614480",276,0,53,329,83.89,0,16.11,2019
"3614487",2150,128,102,2380,90.34,5.38,4.29,2019
"3614506",556,0,0,556,100,0,0,2019
"3614536",173,4,93,270,64.07,1.48,34.44,2019
"3614543",1130,36,68,1234,91.57,2.92,5.51,2019
"1761729",303,26,70,399,75.94,6.52,17.54,2019
"1761739",1418,81,400,1899,74.67,4.27,21.06,2019
"1761466",108,2,17,127,85.04,1.57,13.39,2019
"1761480",378,0,87,465,81.29,0,18.71,2019
"1760162",2133,189,359,2681,79.56,7.05,13.39,2019
"1760184",822,10,55,887,92.67,1.13,6.2,2019
"1760407",473,6,119,598,79.1,1,19.9,2019
"1760408",1775,94,239,2108,84.2,4.46,11.34,2019
"1760442",3146,55,270,3471,90.64,1.58,7.78,2019
"1760448",8411,140,524,9075,92.68,1.54,5.77,2019
"1760463",4728,73,632,5433,87.02,1.34,11.63,2019
"1760467",8709,301,706,9716,89.64,3.1,7.27,2019
"1760482",3446,214,507,4167,82.7,5.14,12.17,2019
"1760558",3999,58,274,4331,92.33,1.34,6.33,2019
"1760560",7681,152,691,8524,90.11,1.78,8.11,2019
"1760563",14081,252,745,15078,93.39,1.67,4.94,2019
"1760611",18790,1762,466,21018,89.4,8.38,2.22,2019
"1760616",20380,765,3424,24569,82.95,3.11,13.94,2019
"1760651",13130,1416,5314,19860,66.11,7.13,26.76,2019
"1762370",84,28,24,136,61.76,20.59,17.65,2019
"1762432",153,14,21,188,81.38,7.45,11.17,2019
"1762561",1751,50,435,2236,78.31,2.24,19.45,2019
"1762440",478,28,68,574,83.28,4.88,11.85,2019
"1762286",2024,43,452,2519,80.35,1.71,17.94,2019
"1762366",449,23,160,632,71.04,3.64,25.32,2019
"1762631",65,0,65,130,50,0,50,2019
"1762512",140,8,47,195,71.79,4.1,24.1,2019
"1762531",566,27,101,694,81.56,3.89,14.55,2019
"1762532",11,27,6,44,25,61.36,13.64,2019
"1762541",6,0,9,15,40,0,60,2019
"3858317",65,4,25,94,69.15,4.26,26.6,2019
"3858325",16,0,4,20,80,0,20,2019
"3858330",82,3,34,119,68.91,2.52,28.57,2019
"3858338",17,0,9,26,65.38,0,34.62,2019
"3858343",19,0,7,26,73.08,0,26.92,2019
"3858352",151,8,32,191,79.06,4.19,16.75,2019
"3858377",113,1,37,151,74.83,0.66,24.5,2019
"3858380",128,14,48,190,67.37,7.37,25.26,2019
"3858356",580,41,178,799,72.59,5.13,22.28,2019
"3858416",167,2,31,200,83.5,1,15.5,2019
"3858436",547,8,185,740,73.92,1.08,25,2019
"4658439",45,12,5,62,72.58,19.35,8.06,2019
"3858441",105,0,29,134,78.36,0,21.64,2019
"3858455",114,5,26,145,78.62,3.45,17.93,2019
"3858466",122,9,23,154,79.22,5.84,14.94,2019
"3858475",45,10,37,92,48.91,10.87,40.22,2019
"3858477",30,0,30,60,50,0,50,2019
"3858481",78,12,8,98,79.59,12.24,8.16,2019
"3858487",169,14,40,223,75.78,6.28,17.94,2019
"3858521",200,23,23,246,81.3,9.35,9.35,2019
"3858528",63,4,76,143,44.06,2.8,53.15,2019
"3858533",347,26,99,472,73.52,5.51,20.97,2019
"3858570",123,13,34,170,72.35,7.65,20,2019
"3858572",74,2,24,100,74,2,24,2019
"3858642",85,5,31,121,70.25,4.13,25.62,2019
"3858650",126,14,25,165,76.36,8.48,15.15,2019
"3858723",76,12,11,99,76.77,12.12,11.11,2019
"3858734",104,6,20,130,80,4.62,15.38,2019
"3858746",458,21,116,595,76.97,3.53,19.5,2019
"3611208",26832,481,6003,33316,80.54,1.44,18.02,2019
"3611210",18822,545,2526,21893,85.97,2.49,11.54,2019
"3611212",23257,947,7598,31802,73.13,2.98,23.89,2019
"3611221",24258,987,6252,31497,77.02,3.13,19.85,2019
"3611239",4796,164,1745,6705,71.53,2.45,26.03,2019
"3611361",8882,135,891,9908,89.64,1.36,8.99,2019
"3611364",11956,383,1131,13470,88.76,2.84,8.4,2019
"3611413",10478,185,1634,12297,85.21,1.5,13.29,2019
"3611429",6507,101,748,7356,88.46,1.37,10.17,2019
"3611434",16788,359,4559,21706,77.34,1.65,21,2019
"3611436",4640,64,706,5410,85.77,1.18,13.05,2019
"3611953",4625,146,551,5322,86.9,2.74,10.35,2019
"3611961",4488,109,899,5496,81.66,1.98,16.36,2019
"3611978",1082,60,173,1315,82.28,4.56,13.16,2019
"3611572",9176,169,674,10019,91.59,1.69,6.73,2019
"3611520",12340,222,1697,14259,86.54,1.56,11.9,2019
"3611550",13437,1011,2202,16650,80.7,6.07,13.23,2019
"3611561",14063,286,1311,15660,89.8,1.83,8.37,2019
"3611692",5707,197,1402,7306,78.11,2.7,19.19,2019
"3611096",1890,106,559,2555,73.97,4.15,21.88,2019
"3611102",11133,262,1550,12945,86,2.02,11.97,2019
"3611104",9651,186,1715,11552,83.54,1.61,14.85,2019
"3611207",25895,1431,6293,33619,77.02,4.26,18.72,2019
"3611213",19784,711,5009,25504,77.57,2.79,19.64,2019
"3611216",20707,569,3595,24871,83.26,2.29,14.45,2019
"3611225",19115,530,4491,24136,79.2,2.2,18.61,2019
"3611232",7198,312,1250,8760,82.17,3.56,14.27,2019
"3611238",21492,718,2850,25060,85.76,2.87,11.37,2019
"3611358",11057,281,1691,13029,84.86,2.16,12.98,2019
"3611365",13702,206,1797,15705,87.25,1.31,11.44,2019
"3611547",240,0,10,250,96,0,4,2019
"3611554",11100,251,953,12304,90.21,2.04,7.75,2019
"3613605",1599,18,323,1940,82.42,0.93,16.65,2019
"3613325",332,5,58,395,84.05,1.27,14.68,2019
"3613337",286,15,26,327,87.46,4.59,7.95,2019
"3613409",691,42,132,865,79.88,4.86,15.26,2019
"3613437",93,11,41,145,64.14,7.59,28.28,2019
"3613450",21,0,7,28,75,0,25,2019
"3613461",1058,46,133,1237,85.53,3.72,10.75,2019
"3613473",219,3,46,268,81.72,1.12,17.16,2019
"3613033",1149,18,215,1382,83.14,1.3,15.56,2019
"3613052",421,26,124,571,73.73,4.55,21.72,2019
"3613063",629,25,85,739,85.12,3.38,11.5,2019
"3613090",10744,750,690,12184,88.18,6.16,5.66,2019
"3613122",343,14,58,415,82.65,3.37,13.98,2019
"3613132",1194,13,132,1339,89.17,0.97,9.86,2019
"3613143",789,13,241,1043,75.65,1.25,23.11,2019
"3613209",4385,296,771,5452,80.43,5.43,14.14,2019
"3613211",1890,92,392,2374,79.61,3.88,16.51,2019
"3613319",255,0,20,275,92.73,0,7.27,2019
"3613320",601,29,171,801,75.03,3.62,21.35,2019
"3613340",2485,97,539,3121,79.62,3.11,17.27,2019
"3613353",5,4,0,9,55.56,44.44,0,2019
"3614530",1823,62,298,2183,83.51,2.84,13.65,2019
"3614550",448,18,163,629,71.22,2.86,25.91,2019
"3614605",2932,101,1175,4208,69.68,2.4,27.92,2019
"3614613",3514,263,1452,5229,67.2,5.03,27.77,2019
"3614625",4011,126,246,4383,91.51,2.87,5.61,2019
"3614712",1097,34,185,1316,83.36,2.58,14.06,2019
"3614714",111,8,95,214,51.87,3.74,44.39,2019
"3614733",1109,79,324,1512,73.35,5.22,21.43,2019
"3614738",1208,35,230,1473,82.01,2.38,15.61,2019
"3614744",366,29,39,434,84.33,6.68,8.99,2019
"3614772",1114,62,434,1610,69.19,3.85,26.96,2019
"3614784",314,20,56,390,80.51,5.13,14.36,2019
"3614809",711,6,184,901,78.91,0.67,20.42,2019
"3614822",287,2,126,415,69.16,0.48,30.36,2019
"3614040",588,0,124,712,82.58,0,17.42,2019
"3614066",364,39,131,534,68.16,7.3,24.53,2019
"3614213",7125,547,1476,9148,77.89,5.98,16.13,2019
"3614167",510,29,154,693,73.59,4.18,22.22,2019
"3614171",660,15,93,768,85.94,1.95,12.11,2019
"3614208",2792,195,1191,4178,66.83,4.67,28.51,2019
"3614212",3006,231,1380,4617,65.11,5,29.89,2019
"3614214",6413,267,1248,7928,80.89,3.37,15.74,2019
"3614223",8780,172,846,9798,89.61,1.76,8.63,2019
"3614227",8060,214,1927,10201,79.01,2.1,18.89,2019
"3614303",1491,168,844,2503,59.57,6.71,33.72,2019
"3614305",5577,249,1329,7155,77.95,3.48,18.57,2019
"3614416",1193,11,219,1423,83.84,0.77,15.39,2019
"3614428",2533,73,248,2854,88.75,2.56,8.69,2019
"3614462",165,6,14,185,89.19,3.24,7.57,2019
"3614467",3568,94,369,4031,88.51,2.33,9.15,2019
"3614475",153,0,10,163,93.87,0,6.13,2019
"3614477",519,28,38,585,88.72,4.79,6.5,2019
"3614505",1588,44,401,2033,78.11,2.16,19.72,2019
"3614519",4310,89,599,4998,86.23,1.78,11.98,2019
"3614551",1615,57,367,2039,79.21,2.8,18,2019
"3614561",1029,22,99,1150,89.48,1.91,8.61,2019
"3614589",2421,103,464,2988,81.02,3.45,15.53,2019
"3614591",516,16,84,616,83.77,2.6,13.64,2019
"3614608",3619,156,1360,5135,70.48,3.04,26.48,2019
"3614621",8889,362,3262,12513,71.04,2.89,26.07,2019
"3614623",7279,407,984,8670,83.96,4.69,11.35,2019
"3614624",12852,181,1270,14303,89.86,1.27,8.88,2019
"3614626",10552,398,1787,12737,82.85,3.12,14.03,2019
"3614721",68,0,7,75,90.67,0,9.33,2019
"3614723",328,12,74,414,79.23,2.9,17.87,2019
"4216402",237,0,107,344,68.9,0,31.1,2019
"4216601",10414,338,2678,13430,77.54,2.52,19.94,2019
"4216636",278,1,57,336,82.74,0.3,16.96,2019
"4216750",147,5,51,203,72.41,2.46,25.12,2019
"4216871",6,0,12,18,33.33,0,66.67,2019
"4216801",15146,1599,1294,18039,83.96,8.86,7.17,2019
"4216029",256,5,41,302,84.77,1.66,13.58,2019
"4216030",96,3,18,117,82.05,2.56,15.38,2019
"4216033",2307,36,270,2613,88.29,1.38,10.33,2019
"4216045",349,7,69,425,82.12,1.65,16.24,2019
"4216116",940,10,158,1108,84.84,0.9,14.26,2019
"4216117",6061,300,1155,7516,80.64,3.99,15.37,2019
"4216121",1671,43,491,2205,75.78,1.95,22.27,2019
"4216124",554,18,231,803,68.99,2.24,28.77,2019
"3614548",1391,16,172,1579,88.09,1.01,10.89,2019
"3614568",2195,13,58,2266,96.87,0.57,2.56,2019
"3614571",471,10,84,565,83.36,1.77,14.87,2019
"3614607",8193,482,889,9564,85.66,5.04,9.3,2019
"3614620",8973,770,1431,11174,80.3,6.89,12.81,2019
"3614715",835,61,219,1115,74.89,5.47,19.64,2019
"3614735",793,22,307,1122,70.68,1.96,27.36,2019
"3614741",530,33,209,772,68.65,4.27,27.07,2019
"3614754",213,24,50,287,74.22,8.36,17.42,2019
"3614783",64,0,40,104,61.54,0,38.46,2019
"3614808",195,0,37,232,84.05,0,15.95,2019
"3614755",812,35,360,1207,67.27,2.9,29.83,2019
"3614787",1665,70,397,2132,78.1,3.28,18.62,2019
"3614801",1520,57,431,2008,75.7,2.84,21.46,2019
"3614824",153,31,79,263,58.17,11.79,30.04,2019
"3614839",228,6,83,317,71.92,1.89,26.18,2019
"3614840",1080,17,187,1284,84.11,1.32,14.56,2019
"3614843",4283,144,769,5196,82.43,2.77,14.8,2019
"3614847",788,48,237,1073,73.44,4.47,22.09,2019
"3614867",1893,132,315,2340,80.9,5.64,13.46,2019
"3614871",1553,85,293,1931,80.42,4.4,15.17,2019
"3614882",1459,14,148,1621,90.01,0.86,9.13,2019
"3614901",3872,147,1139,5158,75.07,2.85,22.08,2019
"3614905",3169,46,491,3706,85.51,1.24,13.25,2019
"3614781",544,29,247,820,66.34,3.54,30.12,2019
"3614815",280,3,74,357,78.43,0.84,20.73,2019
"3614879",642,24,187,853,75.26,2.81,21.92,2019
"3614145",617,28,101,746,82.71,3.75,13.54,2019
"3614450",15525,397,1323,17245,90.03,2.3,7.67,2019
"3614580",19361,725,1739,21825,88.71,3.32,7.97,2019
"3614878",210,21,29,260,80.77,8.08,11.15,2019
"3614051",7330,186,475,7991,91.73,2.33,5.94,2019
"3614035",23,0,7,30,76.67,0,23.33,2019
"3614041",18,7,50,75,24,9.33,66.67,2019
"3614061",93,9,17,119,78.15,7.56,14.29,2019
"3614109",0,0,0,0,NA,NA,NA,2019
"3614112",44,0,0,44,100,0,0,2019
"3614126",191,0,32,223,85.65,0,14.35,2019
"3614130",45,7,15,67,67.16,10.45,22.39,2019
"3614135",38,0,5,43,88.37,0,11.63,2019
"3614168",6,0,0,6,100,0,0,2019
"3614169",63,0,0,63,100,0,0,2019
"3614173",91,0,10,101,90.1,0,9.9,2019
"3614261",4,0,0,4,100,0,0,2019
"3614302",0,0,30,30,0,0,100,2019
"4216858",1026,72,311,1409,72.82,5.11,22.07,2019
"4216863",139,3,119,261,53.26,1.15,45.59,2019
"4216926",268,14,67,349,76.79,4.01,19.2,2019
"4216915",1901,49,405,2355,80.72,2.08,17.2,2019
"4216923",434,16,116,566,76.68,2.83,20.49,2019
"4216925",1089,18,192,1299,83.83,1.39,14.78,2019
"4216928",385,31,106,522,73.75,5.94,20.31,2019
"4216932",212,61,58,331,64.05,18.43,17.52,2019
"4216935",422,3,81,506,83.4,0.59,16.01,2019
"4216941",20,0,4,24,83.33,0,16.67,2019
"4216947",1423,19,316,1758,80.94,1.08,17.97,2019
"4216630",1483,52,382,1917,77.36,2.71,19.93,2019
"4216666",951,37,231,1219,78.01,3.04,18.95,2019
"4217062",1299,25,275,1599,81.24,1.56,17.2,2019
"3858755",53,0,5,58,91.38,0,8.62,2019
"3858757",137,10,32,179,76.54,5.59,17.88,2019
"3858772",57,10,21,88,64.77,11.36,23.86,2019
"3858779",142,2,46,190,74.74,1.05,24.21,2019
"4073069",8723,284,1312,10319,84.53,2.75,12.71,2019
"4073079",119,10,60,189,62.96,5.29,31.75,2019
"4073086",2221,236,776,3233,68.7,7.3,24,2019
"4073092",223,14,105,342,65.2,4.09,30.7,2019
"4073097",57,0,0,57,100,0,0,2019
"4073116",4130,75,282,4487,92.04,1.67,6.28,2019
"4073129",4666,181,1514,6361,73.35,2.85,23.8,2019
"4073130",6750,99,1083,7932,85.1,1.25,13.65,2019
"4073150",1610,38,167,1815,88.71,2.09,9.2,2019
"4073173",1052,11,34,1097,95.9,1,3.1,2019
"4073179",1769,20,126,1915,92.38,1.04,6.58,2019
"4073459",247,19,96,362,68.23,5.25,26.52,2019
"4073505",15910,519,1942,18371,86.6,2.83,10.57,2019
"4073540",166,6,2,174,95.4,3.45,1.15,2019
"4073542",1200,54,357,1611,74.49,3.35,22.16,2019
"4073546",281,12,133,426,65.96,2.82,31.22,2019
"4073548",120,3,74,197,60.91,1.52,37.56,2019
"4073553",20,0,2,22,90.91,0,9.09,2019
"4073560",223,18,42,283,78.8,6.36,14.84,2019
"4073562",190,5,22,217,87.56,2.3,10.14,2019
"4073568",269,8,127,404,66.58,1.98,31.44,2019
"4073628",430,12,93,535,80.37,2.24,17.38,2019
"4073632",992,77,302,1371,72.36,5.62,22.03,2019
"4073646",108,6,76,190,56.84,3.16,40,2019
"4073055",2840,88,807,3735,76.04,2.36,21.61,2019
"4073078",3236,38,315,3589,90.16,1.06,8.78,2019
"4073946",10,0,4,14,71.43,0,28.57,2019
"4073012",12415,178,430,13023,95.33,1.37,3.3,2019
"4073019",0,0,0,0,NA,NA,NA,2019
"4073025",3857,23,178,4058,95.05,0.57,4.39,2019
"4073705",0,0,0,0,NA,NA,NA,2019
"4073841",122,6,50,178,68.54,3.37,28.09,2019
"4074041",818,0,88,906,90.29,0,9.71,2019
"4074048",1589,74,801,2464,64.49,3,32.51,2019
"4074050",68,0,47,115,59.13,0,40.87,2019
"4074052",268,9,132,409,65.53,2.2,32.27,2019
"4074054",195,32,76,303,64.36,10.56,25.08,2019
"4074071",50,0,15,65,76.92,0,23.08,2019
"4074723",281,18,233,532,52.82,3.38,43.8,2019
"4074724",57,3,44,104,54.81,2.88,42.31,2019
"4074733",853,53,286,1192,71.56,4.45,23.99,2019
"4074740",545,11,378,934,58.35,1.18,40.47,2019
"4074743",2254,134,934,3322,67.85,4.03,28.12,2019
"4074755",17,0,8,25,68,0,32,2019
"4074801",6377,519,1586,8482,75.18,6.12,18.7,2019
"4074820",8409,259,3146,11814,71.18,2.19,26.63,2019
"4074856",178,27,100,305,58.36,8.85,32.79,2019
"4074857",2733,181,635,3549,77.01,5.1,17.89,2019
"4074884",1229,195,778,2202,55.81,8.86,35.33,2019
"4074901",551,6,194,751,73.37,0.8,25.83,2019
"4074941",622,35,283,940,66.17,3.72,30.11,2019
"4074948",3041,49,1285,4375,69.51,1.12,29.37,2019
"4074953",3377,76,1000,4453,75.84,1.71,22.46,2019
"4074955",4279,269,1287,5835,73.33,4.61,22.06,2019
"3613354",1232,23,200,1455,84.67,1.58,13.75,2019
"3613403",1560,18,205,1783,87.49,1.01,11.5,2019
"3613406",227,13,73,313,72.52,4.15,23.32,2019
"3613416",650,38,168,856,75.93,4.44,19.63,2019
"3613439",1107,21,349,1477,74.95,1.42,23.63,2019
"3613027",12062,431,1418,13911,86.71,3.1,10.19,2019
"3613030",1198,39,198,1435,83.48,2.72,13.8,2019
"3613031",5303,259,541,6103,86.89,4.24,8.86,2019
"3613045",7779,1035,1681,10495,74.12,9.86,16.02,2019
"3613062",16,0,0,16,100,0,0,2019
"3613076",800,10,87,897,89.19,1.11,9.7,2019
"3613092",717,53,266,1036,69.21,5.12,25.68,2019
"3613104",5473,181,447,6101,89.71,2.97,7.33,2019
"3613124",33,0,3,36,91.67,0,8.33,2019
"3613144",472,16,74,562,83.99,2.85,13.17,2019
"3613147",325,19,82,426,76.29,4.46,19.25,2019
"3613152",2955,90,366,3411,86.63,2.64,10.73,2019
"3613158",419,46,146,611,68.58,7.53,23.9,2019
"3613159",1796,30,266,2092,85.85,1.43,12.72,2019
"3613165",3403,155,743,4301,79.12,3.6,17.28,2019
"3613203",4699,465,1945,7109,66.1,6.54,27.36,2019
"3613215",4686,234,512,5432,86.27,4.31,9.43,2019
"3613301",46,0,7,53,86.79,0,13.21,2019
"3613310",238,0,0,238,100,0,0,2019
"3613316",1974,174,567,2715,72.71,6.41,20.88,2019
"3613318",456,18,62,536,85.07,3.36,11.57,2019
"3613331",66,0,0,66,100,0,0,2019
"3613332",808,38,195,1041,77.62,3.65,18.73,2019
"3613335",417,7,75,499,83.57,1.4,15.03,2019
"3613343",624,6,102,732,85.25,0.82,13.93,2019
"3613350",3440,143,569,4152,82.85,3.44,13.7,2019
"3613360",28,1,0,29,96.55,3.45,0,2019
"3613491",1105,52,207,1364,81.01,3.81,15.18,2019
"3613475",5,0,0,5,100,0,0,2019
"3613486",326,25,44,395,82.53,6.33,11.14,2019
"3613490",544,0,110,654,83.18,0,16.82,2019
"3613495",727,22,98,847,85.83,2.6,11.57,2019
"3613613",927,8,184,1119,82.84,0.71,16.44,2019
"4215360",602,7,86,695,86.62,1.01,12.37,2019
"4215367",2987,17,78,3082,96.92,0.55,2.53,2019
"4215370",3951,100,842,4893,80.75,2.04,17.21,2019
"4215419",1170,83,352,1605,72.9,5.17,21.93,2019
"4215423",662,15,125,802,82.54,1.87,15.59,2019
"4215424",575,27,300,902,63.75,2.99,33.26,2019
"4215427",334,4,121,459,72.77,0.87,26.36,2019
"4215429",126,43,0,169,74.56,25.44,0,2019
"4215430",138,0,14,152,90.79,0,9.21,2019
"4215469",852,11,117,980,86.94,1.12,11.94,2019
"4215478",1909,47,489,2445,78.08,1.92,20,2019
"4215243",4901,172,478,5551,88.29,3.1,8.61,2019
"4215301",16630,453,3381,20464,81.26,2.21,16.52,2019
"4215312",1171,26,296,1493,78.43,1.74,19.83,2019
"4216151",39,0,13,52,75,0,25,2019
"4216154",731,40,260,1031,70.9,3.88,25.22,2019
"4216159",1590,19,536,2145,74.13,0.89,24.99,2019
"4216236",73,15,15,103,70.87,14.56,14.56,2019
"4216861",64,4,36,104,61.54,3.85,34.62,2019
"4216866",2668,130,849,3647,73.16,3.56,23.28,2019
"4216877",680,3,98,781,87.07,0.38,12.55,2019
"4216878",534,7,199,740,72.16,0.95,26.89,2019
"4216917",396,12,69,477,83.02,2.52,14.47,2019
"4216927",167,0,36,203,82.27,0,17.73,2019
"4216028",543,40,190,773,70.25,5.17,24.58,2019
"4216034",637,16,73,726,87.74,2.2,10.06,2019
"4216037",1632,55,154,1841,88.65,2.99,8.37,2019
"4216050",446,27,76,549,81.24,4.92,13.84,2019
"4216102",1870,52,403,2325,80.43,2.24,17.33,2019
"4216112",509,7,134,650,78.31,1.08,20.62,2019
"4216125",5388,146,1341,6875,78.37,2.12,19.51,2019
"4216127",4636,127,626,5389,86.03,2.36,11.62,2019
"4216137",3455,133,773,4361,79.22,3.05,17.73,2019
"4216141",496,15,161,672,73.81,2.23,23.96,2019
"4216143",870,0,192,1062,81.92,0,18.08,2019
"4216155",14,6,26,46,30.43,13.04,56.52,2019
"4216160",294,4,82,380,77.37,1.05,21.58,2019
"4216218",326,12,70,408,79.9,2.94,17.16,2019
"4216239",355,104,114,573,61.95,18.15,19.9,2019
"4216248",945,26,269,1240,76.21,2.1,21.69,2019
"4216249",687,20,156,863,79.61,2.32,18.08,2019
"4216250",127,12,48,187,67.91,6.42,25.67,2019
"4216256",186,2,308,496,37.5,0.4,62.1,2019
"4216263",70,0,46,116,60.34,0,39.66,2019
"4216311",177,2,34,213,83.1,0.94,15.96,2019
"4216321",9,0,22,31,29.03,0,70.97,2019
"4216326",100,14,37,151,66.23,9.27,24.5,2019
"4216940",81,0,8,89,91.01,0,8.99,2019
"4216860",56,0,54,110,50.91,0,49.09,2019
"4216638",9,0,5,14,64.29,0,35.71,2019
"4216692",188,11,77,276,68.12,3.99,27.9,2019
"4216323",5208,295,1326,6829,76.26,4.32,19.42,2019
"4216440",306,7,70,383,79.9,1.83,18.28,2019
"4216655",418,7,172,597,70.02,1.17,28.81,2019
"4216838",512,10,182,704,72.73,1.42,25.85,2019
"4216881",729,48,245,1022,71.33,4.7,23.97,2019
"4216938",216,15,60,291,74.23,5.15,20.62,2019
"4216828",1528,22,293,1843,82.91,1.19,15.9,2019
"4216656",367,12,107,486,75.51,2.47,22.02,2019
"3407712",14547,369,1810,16726,86.97,2.21,10.82,2019
"3407718",2247,11,97,2355,95.41,0.47,4.12,2019
"3407722",3086,58,138,3282,94.03,1.77,4.2,2019
"3407733",5328,139,364,5831,91.37,2.38,6.24,2019
"3407734",3743,103,1015,4861,77,2.12,20.88,2019
"3407746",5518,157,199,5874,93.94,2.67,3.39,2019
"3407830",2176,4,158,2338,93.07,0.17,6.76,2019
"3407840",10337,290,1127,11754,87.94,2.47,9.59,2019
"3407851",26,0,3,29,89.66,0,10.34,2019
"3407860",8212,267,1089,9568,85.83,2.79,11.38,2019
"3407930",2743,44,240,3027,90.62,1.45,7.93,2019
"3407935",131,0,10,141,92.91,0,7.09,2019
"3407946",1084,6,20,1110,97.66,0.54,1.8,2019
"3407977",222,4,5,231,96.1,1.73,2.16,2019
"3408530",2910,7,167,3084,94.36,0.23,5.42,2019
"3408551",1624,24,149,1797,90.37,1.34,8.29,2019
"3408648",10194,359,1035,11588,87.97,3.1,8.93,2019
"3408720",221,0,31,252,87.7,0,12.3,2019
"3408721",6592,139,651,7382,89.3,1.88,8.82,2019
"3408735",1737,43,246,2026,85.74,2.12,12.14,2019
"3408736",4629,30,245,4904,94.39,0.61,5,2019
"3408750",1240,5,50,1295,95.75,0.39,3.86,2019
"3408753",20885,449,1927,23261,89.79,1.93,8.28,2019
"3408755",8386,489,1398,10273,81.63,4.76,13.61,2019
"3408758",2976,121,440,3537,84.14,3.42,12.44,2019
"3408038",30,0,15,45,66.67,0,33.33,2019
"3408039",45,0,0,45,100,0,0,2019
"3408042",48,0,19,67,71.64,0,28.36,2019
"3408050",8774,132,1029,9935,88.31,1.33,10.36,2019
"3408053",16268,270,1086,17624,92.31,1.53,6.16,2019
"3408061",907,14,25,946,95.88,1.48,2.64,2019
"3408074",0,0,0,0,NA,NA,NA,2019
"3408081",15230,384,1177,16791,90.7,2.29,7.01,2019
"3408084",2299,30,222,2551,90.12,1.18,8.7,2019
"3408086",2650,137,371,3158,83.91,4.34,11.75,2019
"3408091",1366,84,507,1957,69.8,4.29,25.91,2019
"3408094",12683,345,1631,14659,86.52,2.35,11.13,2019
"3408314",174,0,0,174,100,0,0,2019
"3408316",76,6,17,99,76.77,6.06,17.17,2019
"3408348",54,0,8,62,87.1,0,12.9,2019
"3408352",148,0,16,164,90.24,0,9.76,2019
"3408002",7975,85,896,8956,89.05,0.95,10,2019
"3408003",10212,202,456,10870,93.95,1.86,4.2,2019
"3408007",1711,78,331,2120,80.71,3.68,15.61,2019
"3408014",173,0,14,187,92.51,0,7.49,2019
"3408015",6164,113,884,7161,86.08,1.58,12.34,2019
"3408021",14655,343,3318,18316,80.01,1.87,18.12,2019
"3408226",4214,182,857,5253,80.22,3.46,16.31,2019
"3408103",2916,218,1592,4726,61.7,4.61,33.69,2019
"3408098",2825,34,410,3269,86.42,1.04,12.54,2019
"3408102",1754,101,560,2415,72.63,4.18,23.19,2019
"3408230",1810,44,231,2085,86.81,2.11,11.08,2019
"3408234",12340,419,1155,13914,88.69,3.01,8.3,2019
"3408242",1132,16,126,1274,88.85,1.26,9.89,2019
"3408247",438,15,45,498,87.95,3.01,9.04,2019
"3408310",399,13,165,577,69.15,2.25,28.6,2019
"3408311",501,5,141,647,77.43,0.77,21.79,2019
"3408317",382,2,141,525,72.76,0.38,26.86,2019
"3408322",3344,9,335,3688,90.67,0.24,9.08,2019
"3612941",450,35,42,527,85.39,6.64,7.97,2019
"3612115",34,0,0,34,100,0,0,2019
"3612187",211,0,23,234,90.17,0,9.83,2019
"3612309",9595,414,700,10709,89.6,3.87,6.54,2019
"3612515",390,0,123,513,76.02,0,23.98,2019
"3612726",392,0,87,479,81.84,0,18.16,2019
"3612033",2865,130,193,3188,89.87,4.08,6.05,2019
"3612019",5578,51,274,5903,94.49,0.86,4.64,2019
"3612022",228,3,67,298,76.51,1.01,22.48,2019
"3612043",2280,108,510,2898,78.67,3.73,17.6,2019
"3612060",575,18,44,637,90.27,2.83,6.91,2019
"3612065",16516,288,850,17654,93.55,1.63,4.81,2019
"3612083",1147,24,244,1415,81.06,1.7,17.24,2019
"3612116",567,20,166,753,75.3,2.66,22.05,2019
"4074959",1918,66,695,2679,71.59,2.46,25.94,2019
"4074960",2218,224,2158,4600,48.22,4.87,46.91,2019
"4074523",1525,50,706,2281,66.86,2.19,30.95,2019
"4074547",1034,20,329,1383,74.77,1.45,23.79,2019
"4074553",386,12,122,520,74.23,2.31,23.46,2019
"4878624",7305,173,1558,9036,80.84,1.91,17.24,2019
"4878634",9728,252,423,10403,93.51,2.42,4.07,2019
"4878659",709,47,186,942,75.27,4.99,19.75,2019
"4878642",3219,147,446,3812,84.44,3.86,11.7,2019
"4878626",9514,290,1325,11129,85.49,2.61,11.91,2019
"4878632",286,10,98,394,72.59,2.54,24.87,2019
"4878636",1315,45,170,1530,85.95,2.94,11.11,2019
"4878643",1884,41,376,2301,81.88,1.78,16.34,2019
"4878652",1697,119,322,2138,79.37,5.57,15.06,2019
"4878681",16636,203,609,17448,95.35,1.16,3.49,2019
"4878702",7644,253,1816,9713,78.7,2.6,18.7,2019
"4878745",22659,1424,2673,26756,84.69,5.32,9.99,2019
"4878946",348,11,99,458,75.98,2.4,21.62,2019
"4878374",5679,118,592,6389,88.89,1.85,9.27,2019
"4878009",2331,75,436,2842,82.02,2.64,15.34,2019
"4878066",131,0,42,173,75.72,0,24.28,2019
"4878595",782,32,825,1639,47.71,1.95,50.34,2019
"4878672",493,21,97,611,80.69,3.44,15.88,2019
"4878109",10780,254,565,11599,92.94,2.19,4.87,2019
"4878029",0,0,0,0,NA,NA,NA,2019
"4878044",63,0,70,133,47.37,0,52.63,2019
"4878060",0,0,0,0,NA,NA,NA,2019
"4878104",21,3,35,59,35.59,5.08,59.32,2019
"4878150",0,0,0,0,NA,NA,NA,2019
"4878162",75,0,34,109,68.81,0,31.19,2019
"4878243",0,0,0,0,NA,NA,NA,2019
"4878335",0,0,0,0,NA,NA,NA,2019
"4878341",434,0,216,650,66.77,0,33.23,2019
"4878342",80,0,21,101,79.21,0,20.79,2019
"4878419",153,19,0,172,88.95,11.05,0,2019
"4878535",114,8,73,195,58.46,4.1,37.44,2019
"4878063",3077,121,443,3641,84.51,3.32,12.17,2019
"4878057",146,0,0,146,100,0,0,2019
"4878058",351,0,49,400,87.75,0,12.25,2019
"4878113",975,41,225,1241,78.57,3.3,18.13,2019
"4878122",118,0,12,130,90.77,0,9.23,2019
"4878123",866,21,100,987,87.74,2.13,10.13,2019
"4878125",17,0,11,28,60.71,0,39.29,2019
"4878141",157,4,62,223,70.4,1.79,27.8,2019
"4878143",47,0,0,47,100,0,0,2019
"4878144",29,0,0,29,100,0,0,2019
"4878163",3959,85,235,4279,92.52,1.99,5.49,2019
"4878205",812,35,222,1069,75.96,3.27,20.77,2019
"4878208",903,245,488,1636,55.2,14.98,29.83,2019
"4878209",15120,450,2053,17623,85.8,2.55,11.65,2019
"4878216",14063,775,2572,17410,80.78,4.45,14.77,2019
"4215327",512,17,115,644,79.5,2.64,17.86,2019
"4215344",416,3,106,525,79.24,0.57,20.19,2019
"4215201",5379,191,911,6481,83,2.95,14.06,2019
"4215636",1274,27,84,1385,91.99,1.95,6.06,2019
"4215696",99,4,92,195,50.77,2.05,47.18,2019
"4215035",731,48,210,989,73.91,4.85,21.23,2019
"4215222",2519,83,149,2751,91.57,3.02,5.42,2019
"4215313",113,0,23,136,83.09,0,16.91,2019
"4215712",56,0,18,74,75.68,0,24.32,2019
"4215780",40,0,29,69,57.97,0,42.03,2019
"4215870",416,19,122,557,74.69,3.41,21.9,2019
"4215068",13077,385,2865,16327,80.09,2.36,17.55,2019
"4215955",712,0,156,868,82.03,0,17.97,2019
"4215956",923,9,254,1186,77.82,0.76,21.42,2019
"4215009",5491,58,990,6539,83.97,0.89,15.14,2019
"4215034",683,9,204,896,76.23,1,22.77,2019
"4215049",422,13,89,524,80.53,2.48,16.98,2019
"4215052",1112,44,178,1334,83.36,3.3,13.34,2019
"4215422",28,0,69,97,28.87,0,71.13,2019
"4215431",1273,26,484,1783,71.4,1.46,27.15,2019
"4215432",136,1,79,216,62.96,0.46,36.57,2019
"4215434",80,0,29,109,73.39,0,26.61,2019
"4215438",695,14,189,898,77.39,1.56,21.05,2019
"4215440",52,0,27,79,65.82,0,34.18,2019
"4215026",1144,75,143,1362,83.99,5.51,10.5,2019
"4215055",443,18,130,591,74.96,3.05,22,2019
"4215116",5442,72,595,6109,89.08,1.18,9.74,2019
"4215229",4963,91,801,5855,84.77,1.55,13.68,2019
"4215774",879,29,204,1112,79.05,2.61,18.35,2019
"4215944",929,25,290,1244,74.68,2.01,23.31,2019
"4215007",115,50,0,165,69.7,30.3,0,2019
"4215014",1101,46,211,1358,81.08,3.39,15.54,2019
"4215022",3219,123,957,4299,74.88,2.86,22.26,2019
"4215051",182,0,63,245,74.29,0,25.71,2019
"4215054",97,6,20,123,78.86,4.88,16.26,2019
"4215056",431,20,100,551,78.22,3.63,18.15,2019
"4215066",4241,45,1248,5534,76.64,0.81,22.55,2019
"4215072",0,0,11,11,0,0,100,2019
"4215075",41,29,9,79,51.9,36.71,11.39,2019
"4215084",3844,178,740,4762,80.72,3.74,15.54,2019
"4215085",2621,58,546,3225,81.27,1.8,16.93,2019
"4215101",9091,314,831,10236,88.81,3.07,8.12,2019
"4215108",15044,343,1456,16843,89.32,2.04,8.64,2019
"4215139",2693,49,398,3140,85.76,1.56,12.68,2019
"4215142",515,0,35,550,93.64,0,6.36,2019
"3407601",16728,290,2062,19080,87.67,1.52,10.81,2019
"3407607",3077,38,396,3511,87.64,1.08,11.28,2019
"3407626",2639,56,117,2812,93.85,1.99,4.16,2019
"3407632",1746,55,42,1843,94.74,2.98,2.28,2019
"3407656",2951,61,247,3259,90.55,1.87,7.58,2019
"3407657",3328,33,466,3827,86.96,0.86,12.18,2019
"3407661",3618,9,240,3867,93.56,0.23,6.21,2019
"3407701",8871,183,896,9950,89.16,1.84,9.01,2019
"3407757",1937,20,281,2238,86.55,0.89,12.56,2019
"3407003",16703,311,1563,18577,89.91,1.67,8.41,2019
"3407004",2394,46,181,2621,91.34,1.76,6.91,2019
"3407005",5044,59,386,5489,91.89,1.07,7.03,2019
"3407009",4135,81,314,4530,91.28,1.79,6.93,2019
"3407040",7219,117,609,7945,90.86,1.47,7.67,2019
"3407981",3167,49,342,3558,89.01,1.38,9.61,2019
"3407865",567,43,55,665,85.26,6.47,8.27,2019
"3407932",3755,24,213,3992,94.06,0.6,5.34,2019
"3407940",5103,81,405,5589,91.3,1.45,7.25,2019
"3407979",205,0,0,205,100,0,0,2019
"3407060",11425,773,2773,14971,76.31,5.16,18.52,2019
"3407062",3122,252,655,4029,77.49,6.25,16.26,2019
"3407063",3046,376,566,3988,76.38,9.43,14.19,2019
"3407070",6232,98,647,6977,89.32,1.4,9.27,2019
"3407072",2089,22,303,2414,86.54,0.91,12.55,2019
"3407076",7926,212,609,8747,90.61,2.42,6.96,2019
"3407080",7086,150,688,7924,89.42,1.89,8.68,2019
"3407202",9889,639,2569,13097,75.51,4.88,19.62,2019
"3407440",1326,52,135,1513,87.64,3.44,8.92,2019
"3407442",3635,37,332,4004,90.78,0.92,8.29,2019
"3407446",5124,63,325,5512,92.96,1.14,5.9,2019
"3407508",6497,279,765,7541,86.16,3.7,10.14,2019
"3407461",5921,156,506,6583,89.94,2.37,7.69,2019
"3407470",16889,249,1212,18350,92.04,1.36,6.6,2019
"3407502",3570,126,808,4504,79.26,2.8,17.94,2019
"3407522",4643,91,1344,6078,76.39,1.5,22.11,2019
"3407621",8082,91,773,8946,90.34,1.02,8.64,2019
"3407627",1567,31,82,1680,93.27,1.85,4.88,2019
"3407029",6380,68,818,7266,87.81,0.94,11.26,2019
"3407027",1562,70,93,1725,90.55,4.06,5.39,2019
"3407081",6367,52,482,6901,92.26,0.75,6.98,2019
"3407457",1720,38,59,1817,94.66,2.09,3.25,2019
"3407605",2933,107,315,3355,87.42,3.19,9.39,2019
"3407720",1776,41,335,2152,82.53,1.91,15.57,2019
"3407801",7155,145,823,8123,88.08,1.79,10.13,2019
"3407028",2423,37,35,2495,97.11,1.48,1.4,2019
"3407204",4428,99,421,4948,89.49,2,8.51,2019
"3407480",5478,94,454,6026,90.91,1.56,7.53,2019
"3407643",3596,167,333,4096,87.79,4.08,8.13,2019
"3407702",1311,16,107,1434,91.42,1.12,7.46,2019
"3407928",6224,43,215,6482,96.02,0.66,3.32,2019
"3407980",827,6,72,905,91.38,0.66,7.96,2019
"3407417",3704,29,112,3845,96.33,0.75,2.91,2019
"3407458",3588,82,189,3859,92.98,2.12,4.9,2019
"3407704",1757,18,47,1822,96.43,0.99,2.58,2019
"3407843",4207,40,309,4556,92.34,0.88,6.78,2019
"3407069",1910,129,60,2099,91,6.15,2.86,2019
"3407086",5876,115,642,6633,88.59,1.73,9.68,2019
"3407311",190,0,15,205,92.68,0,7.32,2019
"3407495",0,0,0,0,NA,NA,NA,2019
"3612809",988,67,359,1414,69.87,4.74,25.39,2019
"3612831",5641,28,500,6169,91.44,0.45,8.11,2019
"3612833",1512,47,80,1639,92.25,2.87,4.88,2019
"3612958",651,0,200,851,76.5,0,23.5,2019
"3612017",143,16,28,187,76.47,8.56,14.97,2019
"3612023",696,25,103,824,84.47,3.03,12.5,2019
"3612029",393,13,63,469,83.8,2.77,13.43,2019
"3612042",95,0,19,114,83.33,0,16.67,2019
"3612045",173,11,48,232,74.57,4.74,20.69,2019
"3612066",621,6,130,757,82.03,0.79,17.17,2019
"3612077",2497,76,121,2694,92.69,2.82,4.49,2019
"3612078",7607,314,2097,10018,75.93,3.13,20.93,2019
"3612084",1877,76,175,2128,88.2,3.57,8.22,2019
"3612086",621,0,105,726,85.54,0,14.46,2019
"3614732",64,3,4,71,90.14,4.23,5.63,2019
"3614742",85,0,18,103,82.52,0,17.48,2019
"3614752",114,8,38,160,71.25,5,23.75,2019
"3614756",10,18,0,28,35.71,64.29,0,2019
"3614774",14,1,1,16,87.5,6.25,6.25,2019
"3614778",0,0,0,0,NA,NA,NA,2019
"3614788",13,0,0,13,100,0,0,2019
"3614827",100,0,0,100,100,0,0,2019
"3614853",0,0,0,0,NA,NA,NA,2019
"3614854",12,0,0,12,100,0,0,2019
"3614856",106,0,31,137,77.37,0,22.63,2019
"3614893",0,0,0,0,NA,NA,NA,2019
"3614032",2902,86,144,3132,92.66,2.75,4.6,2019
"3614134",47,0,0,47,100,0,0,2019
"4215625",12,0,33,45,26.67,0,73.33,2019
"4215628",209,0,45,254,82.28,0,17.72,2019
"4215635",92,0,0,92,100,0,0,2019
"4215531",1135,84,366,1585,71.61,5.3,23.09,2019
"4215135",1795,67,274,2136,84.04,3.14,12.83,2019
"4215067",834,37,176,1047,79.66,3.53,16.81,2019
"4215076",280,24,80,384,72.92,6.25,20.83,2019
"4215126",2843,55,250,3148,90.31,1.75,7.94,2019
"4215215",4639,123,692,5454,85.06,2.26,12.69,2019
"4215216",8998,159,1417,10574,85.1,1.5,13.4,2019
"4215217",10470,225,1222,11917,87.86,1.89,10.25,2019
"4215001",10960,205,2478,13643,80.33,1.5,18.16,2019
"4215004",153,0,13,166,92.17,0,7.83,2019
"4215015",456,17,13,486,93.83,3.5,2.67,2019
"4215028",69,0,17,86,80.23,0,19.77,2019
"4215031",217,0,50,267,81.27,0,18.73,2019
"4215038",65,35,25,125,52,28,20,2019
"4215043",714,2,76,792,90.15,0.25,9.6,2019
"4215045",1551,66,416,2033,76.29,3.25,20.46,2019
"4215057",5236,73,802,6111,85.68,1.19,13.12,2019
"4215063",4089,123,750,4962,82.41,2.48,15.11,2019
"4215064",107,0,0,107,100,0,0,2019
"4215444",133,0,14,147,90.48,0,9.52,2019
"4215462",117,0,46,163,71.78,0,28.22,2019
"4215468",672,0,254,926,72.57,0,27.43,2019
"4215483",144,2,53,199,72.36,1.01,26.63,2019
"4215486",711,9,247,967,73.53,0.93,25.54,2019
"4215501",4701,196,1528,6425,73.17,3.05,23.78,2019
"4215537",2248,104,994,3346,67.18,3.11,29.71,2019
"4215538",202,5,95,302,66.89,1.66,31.46,2019
"4215540",54,0,27,81,66.67,0,33.33,2019
"4216617",1059,18,161,1238,85.54,1.45,13,2019
"4216621",224,11,47,282,79.43,3.9,16.67,2019
"4216624",65,1,12,78,83.33,1.28,15.38,2019
"4216625",1233,39,321,1593,77.4,2.45,20.15,2019
"4216631",22,0,10,32,68.75,0,31.25,2019
"4216639",503,10,111,624,80.61,1.6,17.79,2019
"4216646",709,20,173,902,78.6,2.22,19.18,2019
"4216657",422,11,109,542,77.86,2.03,20.11,2019
"4216669",704,26,171,901,78.14,2.89,18.98,2019
"4216720",361,16,130,507,71.2,3.16,25.64,2019
"4216729",317,7,56,380,83.42,1.84,14.74,2019
"4216735",2039,100,491,2630,77.53,3.8,18.67,2019
"4216738",488,15,105,608,80.26,2.47,17.27,2019
"4216745",198,7,25,230,86.09,3.04,10.87,2019
"4876111",5354,278,1040,6672,80.25,4.17,15.59,2019
"4876112",12439,921,3338,16698,74.49,5.52,19.99,2019
"4876118",5072,49,465,5586,90.8,0.88,8.32,2019
"4876205",6401,280,649,7330,87.33,3.82,8.85,2019
"4876230",2911,62,1116,4089,71.19,1.52,27.29,2019
"4876239",343,22,114,479,71.61,4.59,23.8,2019
"4876245",649,8,134,791,82.05,1.01,16.94,2019
"4876432",356,17,168,541,65.8,3.14,31.05,2019
"4876460",114,0,0,114,100,0,0,2019
"4876704",1842,138,1160,3140,58.66,4.39,36.94,2019
"4876682",670,53,292,1015,66.01,5.22,28.77,2019
"4876692",3335,178,568,4081,81.72,4.36,13.92,2019
"4876706",10326,1126,1858,13310,77.58,8.46,13.96,2019
"1761486",509,0,90,599,84.97,0,15.03,2019
"1761490",366,7,79,452,80.97,1.55,17.48,2019
"1761530",1998,84,391,2473,80.79,3.4,15.81,2019
"1761545",180,9,70,259,69.5,3.47,27.03,2019
"1761563",161,2,61,224,71.88,0.89,27.23,2019
"1761568",1342,56,135,1533,87.54,3.65,8.81,2019
"1761605",3201,231,2437,5869,54.54,3.94,41.52,2019
"1761611",8477,267,1673,10417,81.38,2.56,16.06,2019
"1761701",11862,470,2807,15139,78.35,3.1,18.54,2019
"1761731",53,0,6,59,89.83,0,10.17,2019
"1761745",1474,24,125,1623,90.82,1.48,7.7,2019
"1761760",778,19,140,937,83.03,2.03,14.94,2019
"1761817",837,50,232,1119,74.8,4.47,20.73,2019
"1761821",11490,486,1434,13410,85.68,3.62,10.69,2019
"1761830",129,12,30,171,75.44,7.02,17.54,2019
"1761854",411,4,112,527,77.99,0.76,21.25,2019
"1761855",55,0,9,64,85.94,0,14.06,2019
"1761862",173,4,52,229,75.55,1.75,22.71,2019
"1761864",584,7,41,632,92.41,1.11,6.49,2019
"1761919",287,4,74,365,78.63,1.1,20.27,2019
"1761928",191,7,105,303,63.04,2.31,34.65,2019
"1761933",331,12,86,429,77.16,2.8,20.05,2019
"1761949",57,1,15,73,78.08,1.37,20.55,2019
"1761951",2611,89,542,3242,80.54,2.75,16.72,2019
"1761956",923,5,214,1142,80.82,0.44,18.74,2019
"1761088",2171,72,182,2425,89.53,2.97,7.51,2019
"1761089",280,4,48,332,84.34,1.2,14.46,2019
"1761103",7746,454,2048,10248,75.59,4.43,19.98,2019
"1761201",12495,463,2589,15547,80.37,2.98,16.65,2019
"1761232",479,29,77,585,81.88,4.96,13.16,2019
"1761242",456,13,68,537,84.92,2.42,12.66,2019
"1761254",3651,153,594,4398,83.02,3.48,13.51,2019
"1761261",262,2,62,326,80.37,0.61,19.02,2019
"1761239",350,25,126,501,69.86,4.99,25.15,2019
"1761252",1886,57,352,2295,82.18,2.48,15.34,2019
"1761259",347,23,85,455,76.26,5.05,18.68,2019
"1761315",62,8,11,81,76.54,9.88,13.58,2019
"1761317",143,7,23,173,82.66,4.05,13.29,2019
"3407044",4843,84,383,5310,91.21,1.58,7.21,2019
"3407045",3650,86,147,3883,94,2.21,3.79,2019
"3407054",10254,228,682,11164,91.85,2.04,6.11,2019
"3407068",2022,0,327,2349,86.08,0,13.92,2019
"3407071",7301,175,1262,8738,83.55,2,14.44,2019
"3407083",16627,314,2153,19094,87.08,1.64,11.28,2019
"3407102",3518,295,1688,5501,63.95,5.36,30.69,2019
"3407108",5658,217,3053,8928,63.37,2.43,34.2,2019
"3407109",10563,320,1306,12189,86.66,2.63,10.71,2019
"3407114",2218,222,935,3375,65.72,6.58,27.7,2019
"3407410",10393,191,803,11387,91.27,1.68,7.05,2019
"3407416",1913,96,223,2232,85.71,4.3,9.99,2019
"3407420",1513,63,140,1716,88.17,3.67,8.16,2019
"3407435",767,25,60,852,90.02,2.93,7.04,2019
"3407444",3770,111,777,4658,80.94,2.38,16.68,2019
"3407456",3890,25,177,4092,95.06,0.61,4.33,2019
"3407604",3814,52,358,4224,90.29,1.23,8.48,2019
"3407608",32,0,8,40,80,0,20,2019
"3407620",545,0,19,564,96.63,0,3.37,2019
"3407640",1558,0,68,1626,95.82,0,4.18,2019
"3407662",1652,24,325,2001,82.56,1.2,16.24,2019
"3407670",4490,33,167,4690,95.74,0.7,3.56,2019
"3407703",52,0,0,52,100,0,0,2019
"3407723",224,8,47,279,80.29,2.87,16.85,2019
"3407731",12138,153,501,12792,94.89,1.2,3.92,2019
"3407737",1298,0,137,1435,90.45,0,9.55,2019
"3407023",2361,20,125,2506,94.21,0.8,4.99,2019
"3407026",9693,297,1573,11563,83.83,2.57,13.6,2019
"3407030",23691,209,1282,25182,94.08,0.83,5.09,2019
"3407041",2393,16,104,2513,95.22,0.64,4.14,2019
"3407050",8577,249,2856,11682,73.42,2.13,24.45,2019
"3407058",1786,0,39,1825,97.86,0,2.14,2019
"3407059",4873,79,240,5192,93.86,1.52,4.62,2019
"3407066",5439,80,413,5932,91.69,1.35,6.96,2019
"3407075",3116,0,199,3315,94,0,6,2019
"3407079",4805,61,296,5162,93.08,1.18,5.73,2019
"3407082",1430,37,112,1579,90.56,2.34,7.09,2019
"3407088",1044,65,137,1246,83.79,5.22,11,2019
"3407092",2186,93,249,2528,86.47,3.68,9.85,2019
"3407103",8624,398,2813,11835,72.87,3.36,23.77,2019
"3407106",7949,630,2996,11575,68.67,5.44,25.88,2019
"3407010",9143,74,1295,10512,86.98,0.7,12.32,2019
"3407013",8556,179,1276,10011,85.47,1.79,12.75,2019
"3407018",8231,375,1771,10377,79.32,3.61,17.07,2019
"3407073",3221,12,733,3966,81.22,0.3,18.48,2019
"3611576",4207,93,213,4513,93.22,2.06,4.72,2019
"3611580",11890,211,1071,13172,90.27,1.6,8.13,2019
"3611598",3828,23,217,4068,94.1,0.57,5.33,2019
"3611706",16619,376,1418,18413,90.26,2.04,7.7,2019
"3611757",13161,324,1049,14534,90.55,2.23,7.22,2019
"3611764",3897,30,200,4127,94.43,0.73,4.85,2019
"3611770",19,0,7,26,73.08,0,26.92,2019
"3611788",5122,138,272,5532,92.59,2.49,4.92,2019
"3611791",7773,117,333,8223,94.53,1.42,4.05,2019
"3611796",1168,44,87,1299,89.92,3.39,6.7,2019
"3611942",1565,68,360,1993,78.52,3.41,18.06,2019
"3611947",101,20,57,178,56.74,11.24,32.02,2019
"3611003",11182,206,820,12208,91.6,1.69,6.72,2019
"3611021",6901,225,674,7800,88.47,2.88,8.64,2019
"3612108",37,9,0,46,80.43,19.57,0,2019
"3612117",1101,84,191,1376,80.01,6.1,13.88,2019
"3612122",1453,105,425,1983,73.27,5.3,21.43,2019
"3612123",1999,34,180,2213,90.33,1.54,8.13,2019
"3612148",1539,99,97,1735,88.7,5.71,5.59,2019
"3612153",340,0,8,348,97.7,0,2.3,2019
"3612156",322,0,24,346,93.06,0,6.94,2019
"3612158",2375,66,205,2646,89.76,2.49,7.75,2019
"3612173",670,20,82,772,86.79,2.59,10.62,2019
"3612720",50,0,12,62,80.65,0,19.35,2019
"3612752",128,0,11,139,92.09,0,7.91,2019
"3612763",206,0,56,262,78.63,0,21.37,2019
"3612768",286,0,8,294,97.28,0,2.72,2019
"3612770",66,0,11,77,85.71,0,14.29,2019
"3612808",95,9,43,147,64.63,6.12,29.25,2019
"3612810",193,7,70,270,71.48,2.59,25.93,2019
"3612814",530,0,105,635,83.46,0,16.54,2019
"3612819",83,0,25,108,76.85,0,23.15,2019
"3612824",409,34,12,455,89.89,7.47,2.64,2019
"3612836",205,12,54,271,75.65,4.43,19.93,2019
"3612843",155,45,46,246,63.01,18.29,18.7,2019
"3612844",102,0,12,114,89.47,0,10.53,2019
"3612849",83,0,83,166,50,0,50,2019
"3612857",215,5,35,255,84.31,1.96,13.73,2019
"3612859",796,32,90,918,86.71,3.49,9.8,2019
"3612861",200,3,70,273,73.26,1.1,25.64,2019
"3612873",298,9,56,363,82.09,2.48,15.43,2019
"3612883",1580,207,365,2152,73.42,9.62,16.96,2019
"3612901",10703,703,1851,13257,80.73,5.3,13.96,2019
"3612910",457,32,132,621,73.59,5.15,21.26,2019
"3612927",119,7,6,132,90.15,5.3,4.55,2019
"3612928",634,93,105,832,76.2,11.18,12.62,2019
"3612935",479,18,152,649,73.81,2.77,23.42,2019
"3612936",183,4,28,215,85.12,1.86,13.02,2019
"3612959",414,0,205,619,66.88,0,33.12,2019
"3612974",528,22,131,681,77.53,3.23,19.24,2019
"3612979",866,12,243,1121,77.25,1.07,21.68,2019
"3612981",765,3,310,1078,70.96,0.28,28.76,2019
"3612992",1417,39,283,1739,81.48,2.24,16.27,2019
"3612194",41,1,16,58,70.69,1.72,27.59,2019
"3612303",8906,290,1177,10373,85.86,2.8,11.35,2019
"3612404",1222,6,87,1315,92.93,0.46,6.62,2019
"3612409",317,0,0,317,100,0,0,2019
"3612414",2661,118,1304,4083,65.17,2.89,31.94,2019
"3612211",3708,98,347,4153,89.28,2.36,8.36,2019
"3614859",319,9,43,371,85.98,2.43,11.59,2019
"3614174",1888,75,322,2285,82.63,3.28,14.09,2019
"3614113",167,6,57,230,72.61,2.61,24.78,2019
"3614139",688,29,148,865,79.54,3.35,17.11,2019
"3614170",1026,18,167,1211,84.72,1.49,13.79,2019
"3614218",5734,329,1902,7965,71.99,4.13,23.88,2019
"3614414",2723,73,260,3056,89.1,2.39,8.51,2019
"3614415",45,0,32,77,58.44,0,41.56,2019
"3614456",6014,182,1300,7496,80.23,2.43,17.34,2019
"3614471",933,12,48,993,93.96,1.21,4.83,2019
"3614481",604,7,124,735,82.18,0.95,16.87,2019
"3614485",1343,56,204,1603,83.78,3.49,12.73,2019
"3614512",1684,12,200,1896,88.82,0.63,10.55,2019
"3614527",3493,47,1128,4668,74.83,1.01,24.16,2019
"4217073",1562,42,336,1940,80.52,2.16,17.32,2019
"4217074",2298,102,602,3002,76.55,3.4,20.05,2019
"4217078",7710,226,983,8919,86.44,2.53,11.02,2019
"4217093",382,0,16,398,95.98,0,4.02,2019
"4217211",145,2,52,199,72.86,1.01,26.13,2019
"4217011",12107,394,1251,13752,88.04,2.87,9.1,2019
"4217017",500,29,174,703,71.12,4.13,24.75,2019
"4217032",2552,73,615,3240,78.77,2.25,18.98,2019
"4217036",8583,89,667,9339,91.9,0.95,7.14,2019
"4217040",796,5,177,978,81.39,0.51,18.1,2019
"4217043",2367,230,351,2948,80.29,7.8,11.91,2019
"4217046",8714,434,2454,11602,75.11,3.74,21.15,2019
"4217051",1340,48,520,1908,70.23,2.52,27.25,2019
"4217053",1810,37,329,2176,83.18,1.7,15.12,2019
"4217055",13953,386,1608,15947,87.5,2.42,10.08,2019
"4217855",290,9,69,368,78.8,2.45,18.75,2019
"4217821",5855,199,1531,7585,77.19,2.62,20.18,2019
"4217836",56,0,23,79,70.89,0,29.11,2019
"4217840",238,0,50,288,82.64,0,17.36,2019
"4217859",940,40,167,1147,81.95,3.49,14.56,2019
"4217872",3203,53,1192,4448,72.01,1.19,26.8,2019
"4217885",73,0,12,85,85.88,0,14.12,2019
"4217934",131,2,42,175,74.86,1.14,24,2019
"4217941",221,0,80,301,73.42,0,26.58,2019
"4217961",2393,36,417,2846,84.08,1.26,14.65,2019
"4217967",808,25,209,1042,77.54,2.4,20.06,2019
"4217974",87,14,15,116,75,12.07,12.93,2019
"4217976",1770,53,880,2703,65.48,1.96,32.56,2019
"4217981",850,35,229,1114,76.3,3.14,20.56,2019
"4217052",479,29,133,641,74.73,4.52,20.75,2019
"4217063",776,42,450,1268,61.2,3.31,35.49,2019
"4217069",56,0,8,64,87.5,0,12.5,2019
"4217343",21,0,0,21,100,0,0,2019
"4217347",2111,10,213,2334,90.45,0.43,9.13,2019
"4217365",900,7,174,1081,83.26,0.65,16.1,2019
"4217505",307,0,194,501,61.28,0,38.72,2019
"4217512",5379,426,1529,7334,73.34,5.81,20.85,2019
"4217518",318,14,145,477,66.67,2.94,30.4,2019
"4217520",1692,108,138,1938,87.31,5.57,7.12,2019
"4217522",9760,292,2866,12918,75.55,2.26,22.19,2019
"4217752",1376,36,266,1678,82,2.15,15.85,2019
"4217763",67,8,11,86,77.91,9.3,12.79,2019
"4217765",350,10,71,431,81.21,2.32,16.47,2019
"4217841",1281,47,456,1784,71.8,2.63,25.56,2019
"4217851",2328,164,1120,3612,64.45,4.54,31.01,2019
"3408528",64,0,0,64,100,0,0,2019
"3408328",451,12,63,526,85.74,2.28,11.98,2019
"3408312",2601,14,352,2967,87.66,0.47,11.86,2019
"3408323",197,2,32,231,85.28,0.87,13.85,2019
"3408327",124,0,51,175,70.86,0,29.14,2019
"3408349",490,60,147,697,70.3,8.61,21.09,2019
"3408361",5546,258,685,6489,85.47,3.98,10.56,2019
"3408502",3533,36,43,3612,97.81,1,1.19,2019
"3408505",6215,71,594,6880,90.33,1.03,8.63,2019
"3408512",3763,95,220,4078,92.28,2.33,5.39,2019
"3408514",1612,101,181,1894,85.11,5.33,9.56,2019
"3408553",233,0,10,243,95.88,0,4.12,2019
"3408555",275,1,18,294,93.54,0.34,6.12,2019
"3408561",102,0,0,102,100,0,0,2019
"1761321",91,2,23,116,78.45,1.72,19.83,2019
"1761324",52,0,9,61,85.25,0,14.75,2019
"1761326",762,35,162,959,79.46,3.65,16.89,2019
"1761330",453,21,83,557,81.33,3.77,14.9,2019
"1761331",10,0,0,10,100,0,0,2019
"1761348",1615,19,334,1968,82.06,0.97,16.97,2019
"1761356",3771,61,807,4639,81.29,1.31,17.4,2019
"1761361",384,5,98,487,78.85,1.03,20.12,2019
"1761369",514,22,153,689,74.6,3.19,22.21,2019
"1761413",304,11,95,410,74.15,2.68,23.17,2019
"1761436",238,21,55,314,75.8,6.69,17.52,2019
"1761437",267,13,55,335,79.7,3.88,16.42,2019
"1761447",341,5,64,410,83.17,1.22,15.61,2019
"1761454",186,3,24,213,87.32,1.41,11.27,2019
"1761455",5559,249,1378,7186,77.36,3.47,19.18,2019
"1761458",197,14,106,317,62.15,4.42,33.44,2019
"1761484",260,9,104,373,69.71,2.41,27.88,2019
"1761485",160,4,41,205,78.05,1.95,20,2019
"1761491",738,8,131,877,84.15,0.91,14.94,2019
"1761520",5177,125,1029,6331,81.77,1.97,16.25,2019
"1761014",346,5,94,445,77.75,1.12,21.12,2019
"3858381",96,11,20,127,75.59,8.66,15.75,2019
"3858077",282,9,23,314,89.81,2.87,7.32,2019
"3858238",63,0,7,70,90,0,10,2019
"3858254",217,11,74,302,71.85,3.64,24.5,2019
"3858259",113,7,61,181,62.43,3.87,33.7,2019
"3858270",527,7,286,820,64.27,0.85,34.88,2019
"3858272",99,7,29,135,73.33,5.19,21.48,2019
"3858281",37,0,2,39,94.87,0,5.13,2019
"3858018",133,11,2,146,91.1,7.53,1.37,2019
"3858046",188,8,36,232,81.03,3.45,15.52,2019
"3858048",177,2,15,194,91.24,1.03,7.73,2019
"3858058",41,0,5,46,89.13,0,10.87,2019
"3858062",60,0,19,79,75.95,0,24.05,2019
"3858072",2857,163,692,3712,76.97,4.39,18.64,2019
"3858104",16239,1360,679,18278,88.84,7.44,3.71,2019
"3858233",87,0,37,124,70.16,0,29.84,2019
"3858235",148,0,38,186,79.57,0,20.43,2019
"3858249",929,26,198,1153,80.57,2.25,17.17,2019
"3858265",168,5,30,203,82.76,2.46,14.78,2019
"3858273",71,2,27,100,71,2,27,2019
"3858275",254,0,40,294,86.39,0,13.61,2019
"3858843",151,71,9,231,65.37,30.74,3.9,2019
"3858854",2924,105,244,3273,89.34,3.21,7.45,2019
"3858856",47,1,4,52,90.38,1.92,7.69,2019
"3858849",221,42,92,355,62.25,11.83,25.92,2019
"3858852",451,95,173,719,62.73,13.21,24.06,2019
"4073722",119,0,26,145,82.07,0,17.93,2019
"4073726",130,3,56,189,68.78,1.59,29.63,2019
"4073733",79,6,27,112,70.54,5.36,24.11,2019
"4073741",159,5,53,217,73.27,2.3,24.42,2019
"3611103",13661,220,1631,15512,88.07,1.42,10.51,2019
"3611209",25709,317,3326,29352,87.59,1.08,11.33,2019
"3611214",26111,765,4947,31823,82.05,2.4,15.55,2019
"3611220",20372,1309,5956,27637,73.71,4.74,21.55,2019
"3611230",23009,1214,5924,30147,76.32,4.03,19.65,2019
"3611355",20198,605,6968,27771,72.73,2.18,25.09,2019
"3611377",25610,1413,4308,31331,81.74,4.51,13.75,2019
"3611378",10810,254,1637,12701,85.11,2,12.89,2019
"3611411",5469,92,665,6226,87.84,1.48,10.68,2019
"3611416",6387,65,733,7185,88.89,0.9,10.2,2019
"3611423",8255,123,1224,9602,85.97,1.28,12.75,2019
"3611570",9116,96,1074,10286,88.63,0.93,10.44,2019
"3611577",3962,56,226,4244,93.36,1.32,5.33,2019
"3611590",12804,234,1263,14301,89.53,1.64,8.83,2019
"3611704",11338,471,903,12712,89.19,3.71,7.1,2019
"3611713",2672,94,336,3102,86.14,3.03,10.83,2019
"3611719",994,55,126,1175,84.6,4.68,10.72,2019
"3611724",959,0,18,977,98.16,0,1.84,2019
"3611741",8392,121,487,9000,93.24,1.34,5.41,2019
"3611752",2744,53,184,2981,92.05,1.78,6.17,2019
"3611755",3766,83,378,4227,89.09,1.96,8.94,2019
"3611780",5098,69,348,5515,92.44,1.25,6.31,2019
"3611797",2721,60,316,3097,87.86,1.94,10.2,2019
"3611937",5355,162,1278,6795,78.81,2.38,18.81,2019
"3611949",4495,202,240,4937,91.05,4.09,4.86,2019
"3611040",12011,222,725,12958,92.69,1.71,5.59,2019
"3611105",13240,217,1768,15225,86.96,1.43,11.61,2019
"3611106",14510,181,2226,16917,85.77,1.07,13.16,2019
"3611229",26099,428,4247,30774,84.81,1.39,13.8,2019
"3611234",27546,691,3506,31743,86.78,2.18,11.04,2019
"3611357",12457,196,1824,14477,86.05,1.35,12.6,2019
"3611367",11731,298,2319,14348,81.76,2.08,16.16,2019
"3611369",7855,240,1560,9655,81.36,2.49,16.16,2019
"3611415",7079,136,1166,8381,84.46,1.62,13.91,2019
"3611418",9334,244,1329,10907,85.58,2.24,12.18,2019
"3611421",10095,180,1274,11549,87.41,1.56,11.03,2019
"3611432",15768,214,2715,18697,84.33,1.14,14.52,2019
"3611715",1509,0,66,1575,95.81,0,4.19,2019
"3611716",3303,48,242,3593,91.93,1.34,6.74,2019
"3611721",2213,55,81,2349,94.21,2.34,3.45,2019
"3611731",9503,221,339,10063,94.44,2.2,3.37,2019
"3611777",3059,51,283,3393,90.16,1.5,8.34,2019
"3611783",6495,126,446,7067,91.91,1.78,6.31,2019
"3611786",1847,39,14,1900,97.21,2.05,0.74,2019
"3611787",10973,260,767,12000,91.44,2.17,6.39,2019
"3613618",638,25,84,747,85.41,3.35,11.24,2019
"3613621",171,5,53,229,74.67,2.18,23.14,2019
"3613622",776,47,129,952,81.51,4.94,13.55,2019
"3613634",1395,20,92,1507,92.57,1.33,6.1,2019
"3613650",521,25,81,627,83.09,3.99,12.92,2019
"3613694",518,11,62,591,87.65,1.86,10.49,2019
"3613733",1705,41,327,2073,82.25,1.98,15.77,2019
"3613743",1277,30,72,1379,92.6,2.18,5.22,2019
"3613760",15618,400,2735,18753,83.28,2.13,14.58,2019
"3613775",608,26,131,765,79.48,3.4,17.12,2019
"3613803",1098,84,292,1474,74.49,5.7,19.81,2019
"3613804",103,0,37,140,73.57,0,26.43,2019
"3613809",502,79,103,684,73.39,11.55,15.06,2019
"3613810",409,22,84,515,79.42,4.27,16.31,2019
"3614564",5216,165,646,6027,86.54,2.74,10.72,2019
"3614590",1624,129,468,2221,73.12,5.81,21.07,2019
"3614823",1176,18,325,1519,77.42,1.18,21.4,2019
"3614826",628,27,129,784,80.1,3.44,16.45,2019
"3614830",6816,359,1347,8522,79.98,4.21,15.81,2019
"3614033",700,6,46,752,93.09,0.8,6.12,2019
"3614009",1919,43,419,2381,80.6,1.81,17.6,2019
"3614012",716,10,160,886,80.81,1.13,18.06,2019
"3614028",637,14,92,743,85.73,1.88,12.38,2019
"3614037",302,20,115,437,69.11,4.58,26.32,2019
"3614060",94,6,88,188,50,3.19,46.81,2019
"3614072",7675,227,599,8501,90.28,2.67,7.05,2019
"3614120",15533,324,2814,18671,83.19,1.74,15.07,2019
"3614125",1198,18,219,1435,83.48,1.25,15.26,2019
"3614150",15263,416,3139,18818,81.11,2.21,16.68,2019
"3614172",1040,29,221,1290,80.62,2.25,17.13,2019
"3614889",452,15,104,571,79.16,2.63,18.21,2019
"3614898",439,24,163,626,70.13,3.83,26.04,2019
"3614476",854,11,86,951,89.8,1.16,9.04,2019
"3614427",698,13,110,821,85.02,1.58,13.4,2019
"3614432",1837,56,370,2263,81.18,2.47,16.35,2019
"3614433",1166,55,306,1527,76.36,3.6,20.04,2019
"3614482",2766,106,534,3406,81.21,3.11,15.68,2019
"3614510",1671,125,363,2159,77.4,5.79,16.81,2019
"3614516",713,44,198,955,74.66,4.61,20.73,2019
"3614526",7365,194,717,8276,88.99,2.34,8.66,2019
"3614534",11145,114,558,11817,94.31,0.96,4.72,2019
"3614541",714,22,191,927,77.02,2.37,20.6,2019
"3614544",596,12,121,729,81.76,1.65,16.6,2019
"3614546",1889,31,71,1991,94.88,1.56,3.57,2019
"3614612",12827,424,1755,15006,85.48,2.83,11.7,2019
"3614614",76,0,0,76,100,0,0,2019
"3614004",3586,143,490,4219,85,3.39,11.61,2019
"3614025",1307,16,216,1539,84.93,1.04,14.04,2019
"3614036",1795,26,259,2080,86.3,1.25,12.45,2019
"3614043",9064,371,1546,10981,82.54,3.38,14.08,2019
"3614422",804,19,100,923,87.11,2.06,10.83,2019
"3614619",4398,82,838,5318,82.7,1.54,15.76,2019
"3614622",4697,51,829,5577,84.22,0.91,14.86,2019
"3614701",12998,866,3049,16913,76.85,5.12,18.03,2019
"3614724",589,8,240,837,70.37,0.96,28.67,2019
"3614775",742,8,301,1051,70.6,0.76,28.64,2019
"3614782",683,51,174,908,75.22,5.62,19.16,2019
"3614803",320,0,53,373,85.79,0,14.21,2019
"3614810",3781,111,1235,5127,73.75,2.17,24.09,2019
"4216132",139,7,0,146,95.21,4.79,0,2019
"4216146",4659,294,1048,6001,77.64,4.9,17.46,2019
"4216150",2483,70,624,3177,78.16,2.2,19.64,2019
"4216210",275,8,57,340,80.88,2.35,16.76,2019
"4216213",40,2,10,52,76.92,3.85,19.23,2019
"4216226",2479,107,803,3389,73.15,3.16,23.69,2019
"4216229",1857,57,330,2244,82.75,2.54,14.71,2019
"4216230",135,7,31,173,78.03,4.05,17.92,2019
"4216232",1324,48,330,1702,77.79,2.82,19.39,2019
"4216240",441,8,170,619,71.24,1.29,27.46,2019
"4216244",100,0,27,127,78.74,0,21.26,2019
"4216262",914,65,203,1182,77.33,5.5,17.17,2019
"4216316",2069,61,294,2424,85.35,2.52,12.13,2019
"4216319",499,6,87,592,84.29,1.01,14.7,2019
"3612131",32,0,3,35,91.43,0,8.57,2019
"3612139",45,10,0,55,81.82,18.18,0,2019
"3612059",610,6,66,682,89.44,0.88,9.68,2019
"3612183",957,51,253,1261,75.89,4.04,20.06,2019
"3612932",337,14,158,509,66.21,2.75,31.04,2019
"3612027",1358,18,106,1482,91.63,1.21,7.15,2019
"3612037",1555,57,229,1841,84.46,3.1,12.44,2019
"3612090",1982,26,512,2520,78.65,1.03,20.32,2019
"3612093",435,21,168,624,69.71,3.37,26.92,2019
"3612106",931,8,97,1036,89.86,0.77,9.36,2019
"3612136",291,0,18,309,94.17,0,5.83,2019
"3612144",7906,225,1013,9144,86.46,2.46,11.08,2019
"3612165",66,0,2,68,97.06,0,2.94,2019
"3612168",664,26,217,907,73.21,2.87,23.93,2019
"3612175",165,4,28,197,83.76,2.03,14.21,2019
"3612190",114,6,40,160,71.25,3.75,25,2019
"3612407",60,13,12,85,70.59,15.29,14.12,2019
"3612489",116,40,36,192,60.42,20.83,18.75,2019
"3612433",221,12,44,277,79.78,4.33,15.88,2019
"3612435",76,0,13,89,85.39,0,14.61,2019
"3612456",323,10,9,342,94.44,2.92,2.63,2019
"3612492",43,12,17,72,59.72,16.67,23.61,2019
"3612494",196,0,114,310,63.23,0,36.77,2019
"3612508",6364,121,798,7283,87.38,1.66,10.96,2019
"3612514",1012,38,88,1138,88.93,3.34,7.73,2019
"3612518",1945,37,316,2298,84.64,1.61,13.75,2019
"3612521",454,11,195,660,68.79,1.67,29.55,2019
"3612528",4475,68,626,5169,86.57,1.32,12.11,2019
"3612529",734,60,147,941,78,6.38,15.62,2019
"3612531",986,42,85,1113,88.59,3.77,7.64,2019
"3612577",522,22,0,544,95.96,4.04,0,2019
"3612585",267,0,55,322,82.92,0,17.08,2019
"3612586",3465,166,416,4047,85.62,4.1,10.28,2019
"3612732",258,8,20,286,90.21,2.8,6.99,2019
"3612733",100,0,162,262,38.17,0,61.83,2019
"3612137",561,35,108,704,79.69,4.97,15.34,2019
"3612164",78,9,8,95,82.11,9.47,8.42,2019
"3612166",335,2,147,484,69.21,0.41,30.37,2019
"3612182",5014,155,844,6013,83.39,2.58,14.04,2019
"3612186",2295,28,134,2457,93.41,1.14,5.45,2019
"3612189",6343,588,1372,8303,76.39,7.08,16.52,2019
"3612302",8781,248,886,9915,88.56,2.5,8.94,2019
"3612420",85,21,0,106,80.19,19.81,0,2019
"3612439",90,8,45,143,62.94,5.59,31.47,2019
"3612450",83,0,0,83,100,0,0,2019
"3614479",33,0,35,68,48.53,0,51.47,2019
"3614486",138,0,14,152,90.79,0,9.21,2019
"3614511",153,0,15,168,91.07,0,8.93,2019
"3614529",36,0,0,36,100,0,0,2019
"3614537",59,0,0,59,100,0,0,2019
"3614539",31,7,0,38,81.58,18.42,0,2019
"3614542",29,5,0,34,85.29,14.71,0,2019
"3614549",26,21,4,51,50.98,41.18,7.84,2019
"3614588",69,0,0,69,100,0,0,2019
"3614592",27,0,0,27,100,0,0,2019
"3614627",0,0,0,0,NA,NA,NA,2019
"3614707",47,0,15,62,75.81,0,24.19,2019
"3614720",189,33,84,306,61.76,10.78,27.45,2019
"3614722",21,0,0,21,100,0,0,2019
"4073742",965,73,419,1457,66.23,5.01,28.76,2019
"4073460",1353,16,568,1937,69.85,0.83,29.32,2019
"4073487",26,3,39,68,38.24,4.41,57.35,2019
"4073501",5405,264,1383,7052,76.64,3.74,19.61,2019
"4073521",6557,367,1109,8033,81.63,4.57,13.81,2019
"4073530",122,6,52,180,67.78,3.33,28.89,2019
"4073544",77,0,27,104,74.04,0,25.96,2019
"4073547",467,7,185,659,70.86,1.06,28.07,2019
"4073551",21,0,4,25,84,0,16,2019
"4073557",163,4,10,177,92.09,2.26,5.65,2019
"4073572",1037,50,281,1368,75.8,3.65,20.54,2019
"4073620",390,15,53,458,85.15,3.28,11.57,2019
"4073768",449,33,176,658,68.24,5.02,26.75,2019
"4073848",510,33,152,695,73.38,4.75,21.87,2019
"4073003",8026,134,849,9009,89.09,1.49,9.42,2019
"4073027",308,52,166,526,58.56,9.89,31.56,2019
"4073043",70,0,24,94,74.47,0,25.53,2019
"4073044",6036,176,1650,7862,76.77,2.24,20.99,2019
"4073048",779,14,135,928,83.94,1.51,14.55,2019
"4073744",64,1,8,73,87.67,1.37,10.96,2019
"4073749",183,6,19,208,87.98,2.88,9.13,2019
"4073755",256,11,109,376,68.09,2.93,28.99,2019
"4073756",125,6,9,140,89.29,4.29,6.43,2019
"4073759",450,21,122,593,75.89,3.54,20.57,2019
"4073835",69,5,22,96,71.88,5.21,22.92,2019
"4073840",203,20,46,269,75.46,7.43,17.1,2019
"4073855",18,0,18,36,50,0,50,2019
"4073857",230,4,76,310,74.19,1.29,24.52,2019
"4073901",49,0,0,49,100,0,0,2019
"4074860",459,14,115,588,78.06,2.38,19.56,2019
"4074868",3089,446,1303,4838,63.85,9.22,26.93,2019
"4074869",210,7,91,308,68.18,2.27,29.55,2019
"4074878",351,38,125,514,68.29,7.39,24.32,2019
"4074943",42,3,14,59,71.19,5.08,23.73,2019
"4074954",1473,42,302,1817,81.07,2.31,16.62,2019
"4074956",443,41,212,696,63.65,5.89,30.46,2019
"4074133",17360,439,1858,19657,88.31,2.23,9.45,2019
"4074135",7947,325,1187,9459,84.02,3.44,12.55,2019
"4074332",540,23,159,722,74.79,3.19,22.02,2019
"4074333",264,7,138,409,64.55,1.71,33.74,2019
"4074338",1191,71,722,1984,60.03,3.58,36.39,2019
"4074354",4828,458,1460,6746,71.57,6.79,21.64,2019
"4074367",163,8,34,205,79.51,3.9,16.59,2019
"4074423",268,6,84,358,74.86,1.68,23.46,2019
"4074425",381,42,91,514,74.12,8.17,17.7,2019
"4074875",282,8,139,429,65.73,1.86,32.4,2019
"4074902",1135,67,279,1481,76.64,4.52,18.84,2019
"4074939",134,5,123,262,51.15,1.91,46.95,2019
"4074951",306,31,197,534,57.3,5.81,36.89,2019
"4074957",282,16,134,432,65.28,3.7,31.02,2019
"4074430",152,9,49,210,72.38,4.29,23.33,2019
"4074434",2691,88,662,3441,78.2,2.56,19.24,2019
"4074437",2529,103,1259,3891,65,2.65,32.36,2019
"4074442",270,20,85,375,72,5.33,22.67,2019
"4074556",109,0,47,156,69.87,0,30.13,2019
"4074560",169,7,61,237,71.31,2.95,25.74,2019
"3613811",1344,15,242,1601,83.95,0.94,15.12,2019
"3613856",2181,118,428,2727,79.98,4.33,15.69,2019
"3613904",3342,94,451,3887,85.98,2.42,11.6,2019
"3613607",479,37,168,684,70.03,5.41,24.56,2019
"3613616",647,0,58,705,91.77,0,8.23,2019
"3613637",1621,13,111,1745,92.89,0.74,6.36,2019
"3613665",288,0,43,331,87.01,0,12.99,2019
"3613680",392,15,115,522,75.1,2.87,22.03,2019
"3613681",305,20,56,381,80.05,5.25,14.7,2019
"3613687",172,0,25,197,87.31,0,12.69,2019
"3613734",621,7,108,736,84.38,0.95,14.67,2019
"3613757",465,3,56,524,88.74,0.57,10.69,2019
"3613820",6264,282,1152,7698,81.37,3.66,14.96,2019
"3613832",157,22,62,241,65.15,9.13,25.73,2019
"3613835",334,13,107,454,73.57,2.86,23.57,2019
"3613839",350,35,122,507,69.03,6.9,24.06,2019
"3613740",205,2,32,239,85.77,0.84,13.39,2019
"3613783",804,29,288,1121,71.72,2.59,25.69,2019
"3613801",475,24,134,633,75.04,3.79,21.17,2019
"3613633",88,8,28,124,70.97,6.45,22.58,2019
"3613646",685,29,159,873,78.47,3.32,18.21,2019
"3613648",764,13,119,896,85.27,1.45,13.28,2019
"3613661",499,9,50,558,89.43,1.61,8.96,2019
"3613736",673,15,168,856,78.62,1.75,19.63,2019
"3613739",255,27,70,352,72.44,7.67,19.89,2019
"3613750",305,9,97,411,74.21,2.19,23.6,2019
"3613778",1992,68,320,2380,83.7,2.86,13.45,2019
"3613782",278,6,42,326,85.28,1.84,12.88,2019
"3613838",1187,74,431,1692,70.15,4.37,25.47,2019
"3613864",354,20,73,447,79.19,4.47,16.33,2019
"3613029",2430,30,314,2774,87.6,1.08,11.32,2019
"3613032",3702,193,743,4638,79.82,4.16,16.02,2019
"3613068",1919,46,214,2179,88.07,2.11,9.82,2019
"3613080",1108,34,135,1277,86.77,2.66,10.57,2019
"3613088",8350,512,1289,10151,82.26,5.04,12.7,2019
"3613112",585,5,46,636,91.98,0.79,7.23,2019
"3613606",974,24,45,1043,93.38,2.3,4.31,2019
"3613452",1309,97,391,1797,72.84,5.4,21.76,2019
"3613470",118,38,121,277,42.6,13.72,43.68,2019
"3613485",314,17,115,446,70.4,3.81,25.78,2019
"3613612",814,13,173,1000,81.4,1.3,17.3,2019
"3613402",616,5,131,752,81.91,0.66,17.42,2019
"3613420",350,8,81,439,79.73,1.82,18.45,2019
"3613602",83,0,0,83,100,0,0,2019
"3613635",373,10,62,445,83.82,2.25,13.93,2019
"4215143",7642,137,842,8621,88.64,1.59,9.77,2019
"4215144",1544,31,354,1929,80.04,1.61,18.35,2019
"4215757",429,30,174,633,67.77,4.74,27.49,2019
"4215725",511,17,137,665,76.84,2.56,20.6,2019
"4215732",413,20,191,624,66.19,3.21,30.61,2019
"4215753",108,3,66,177,61.02,1.69,37.29,2019
"4215053",50,0,0,50,100,0,0,2019
"4215120",6544,214,1763,8521,76.8,2.51,20.69,2019
"4215238",4821,158,438,5417,89,2.92,8.09,2019
"4215770",49,3,38,90,54.44,3.33,42.22,2019
"4215775",224,12,99,335,66.87,3.58,29.55,2019
"4215777",38,0,10,48,79.17,0,20.83,2019
"4215902",3733,178,1258,5169,72.22,3.44,24.34,2019
"4215920",259,2,58,319,81.19,0.63,18.18,2019
"4216331",23,3,3,29,79.31,10.34,10.34,2019
"4216334",99,3,25,127,77.95,2.36,19.69,2019
"4216340",593,36,106,735,80.68,4.9,14.42,2019
"4216345",1236,47,213,1496,82.62,3.14,14.24,2019
"4216346",1198,48,221,1467,81.66,3.27,15.06,2019
"4216350",606,24,310,940,64.47,2.55,32.98,2019
"4216360",427,16,79,522,81.8,3.07,15.13,2019
"4216372",169,0,37,206,82.04,0,17.96,2019
"4216401",1387,56,293,1736,79.9,3.23,16.88,2019
"4216405",249,22,51,322,77.33,6.83,15.84,2019
"4216416",50,11,8,69,72.46,15.94,11.59,2019
"4216422",135,13,6,154,87.66,8.44,3.9,2019
"4216836",329,19,99,447,73.6,4.25,22.15,2019
"4216438",2423,29,692,3144,77.07,0.92,22.01,2019
"4216506",8851,189,1130,10170,87.03,1.86,11.11,2019
"4216508",5777,150,960,6887,83.88,2.18,13.94,2019
"4216510",8612,164,1331,10107,85.21,1.62,13.17,2019
"4216635",4277,58,1012,5347,79.99,1.08,18.93,2019
"4216131",299,10,47,356,83.99,2.81,13.2,2019
"4216133",450,10,157,617,72.93,1.62,25.45,2019
"4216136",271,10,89,370,73.24,2.7,24.05,2019
"4216142",1483,33,669,2185,67.87,1.51,30.62,2019
"4216156",928,25,226,1179,78.71,2.12,19.17,2019
"4216201",5482,219,1599,7300,75.1,3,21.9,2019
"4216223",45,3,49,97,46.39,3.09,50.52,2019
"4216224",369,4,93,466,79.18,0.86,19.96,2019
"4216228",145,2,45,192,75.52,1.04,23.44,2019
"4216233",354,9,149,512,69.14,1.76,29.1,2019
"4216235",404,11,71,486,83.13,2.26,14.61,2019
"4216246",75,8,18,101,74.26,7.92,17.82,2019
"4216254",1104,30,187,1321,83.57,2.27,14.16,2019
"4216258",646,23,149,818,78.97,2.81,18.22,2019
"4216259",601,28,183,812,74.01,3.45,22.54,2019
"4216301",4985,115,1442,6542,76.2,1.76,22.04,2019
"4216317",436,9,99,544,80.15,1.65,18.2,2019
"4216333",114,2,26,142,80.28,1.41,18.31,2019
"4216364",387,3,94,484,79.96,0.62,19.42,2019
"4216427",52,2,11,65,80,3.08,16.92,2019
"4216441",3211,67,699,3977,80.74,1.68,17.58,2019
"4216442",935,9,164,1108,84.39,0.81,14.8,2019
"4216511",3912,203,801,4916,79.58,4.13,16.29,2019
"4216602",9784,408,2384,12576,77.8,3.24,18.96,2019
"4216622",58,7,7,72,80.56,9.72,9.72,2019
"4216647",256,10,46,312,82.05,3.21,14.74,2019
"4216855",18,23,62,103,17.48,22.33,60.19,2019
"3407676",3046,21,253,3320,91.75,0.63,7.62,2019
"3407677",1892,0,71,1963,96.38,0,3.62,2019
"3407820",0,0,0,0,NA,NA,NA,2019
"3407870",16,0,0,16,100,0,0,2019
"3407880",60,0,0,60,100,0,0,2019
"3407881",4,0,0,4,100,0,0,2019
"3407926",9,0,0,9,100,0,0,2019
"3407939",43,0,0,43,100,0,0,2019
"3407961",0,0,0,0,NA,NA,NA,2019
"3407022",4204,119,913,5236,80.29,2.27,17.44,2019
"3407095",5805,706,927,7438,78.05,9.49,12.46,2019
"3407208",9040,348,1735,11123,81.27,3.13,15.6,2019
"3408318",3705,119,721,4545,81.52,2.62,15.86,2019
"3408321",51,8,24,83,61.45,9.64,28.92,2019
"4074132",3191,102,260,3553,89.81,2.87,7.32,2019
"4074848",1309,61,913,2283,57.34,2.67,39.99,2019
"4074851",2396,227,607,3230,74.18,7.03,18.79,2019
"4074855",1308,29,526,1863,70.21,1.56,28.23,2019
"4878389",353,4,244,601,58.74,0.67,40.6,2019
"4878391",40,0,39,79,50.63,0,49.37,2019
"4878410",8621,54,957,9632,89.5,0.56,9.94,2019
"4878414",13998,101,860,14959,93.58,0.68,5.75,2019
"4878501",16375,878,3936,21189,77.28,4.14,18.58,2019
"4878521",11888,5170,8266,25324,46.94,20.42,32.64,2019
"4878526",8253,2402,2742,13397,61.6,17.93,20.47,2019
"4878566",2936,632,1208,4776,61.47,13.23,25.29,2019
"4878593",887,40,628,1555,57.04,2.57,40.39,2019
"4878877",154,0,75,229,67.25,0,32.75,2019
"4878840",10505,617,4456,15578,67.43,3.96,28.6,2019
"4878860",0,0,21,21,0,0,100,2019
"4878872",187,36,260,483,38.72,7.45,53.83,2019
"4878933",397,15,158,570,69.65,2.63,27.72,2019
"4878953",281,65,31,377,74.54,17.24,8.22,2019
"4878954",375,46,92,513,73.1,8.97,17.93,2019
"4878021",70,0,5,75,93.33,0,6.67,2019
"4878003",3034,53,663,3750,80.91,1.41,17.68,2019
"4878004",393,0,38,431,91.18,0,8.82,2019
"4878012",80,0,16,96,83.33,0,16.67,2019
"4878039",543,8,95,646,84.06,1.24,14.71,2019
"4878043",7685,557,4447,12689,60.56,4.39,35.05,2019
"4878046",10213,470,5688,16371,62.38,2.87,34.74,2019
"4878050",124,0,79,203,61.08,0,38.92,2019
"4878055",494,24,103,621,79.55,3.86,16.59,2019
"4878070",5157,72,269,5498,93.8,1.31,4.89,2019
"4878851",0,0,25,25,0,0,100,2019
"4878852",9787,381,5818,15986,61.22,2.38,36.39,2019
"4878880",302,93,240,635,47.56,14.65,37.8,2019
"4878883",119,5,47,171,69.59,2.92,27.49,2019
"4878949",157,9,48,214,73.36,4.21,22.43,2019
"4878959",517,33,300,850,60.82,3.88,35.29,2019
"4878744",12501,424,2568,15493,80.69,2.74,16.58,2019
"4878748",18164,794,1281,20239,89.75,3.92,6.33,2019
"4878829",209,23,150,382,54.71,6.02,39.27,2019
"4878830",134,18,117,269,49.81,6.69,43.49,2019
"4878838",57,22,31,110,51.82,20,28.18,2019
"4878756",3999,0,340,4339,92.16,0,7.84,2019
"4878140",780,32,312,1124,69.4,2.85,27.76,2019
"4878221",8288,518,2766,11572,71.62,4.48,23.9,2019
"4878357",626,12,316,954,65.62,1.26,33.12,2019
"4878570",7199,183,1504,8886,81.02,2.06,16.93,2019
"4878654",5460,254,1368,7082,77.1,3.59,19.32,2019
"4878028",14237,480,2139,16856,84.46,2.85,12.69,2019
"4878101",1761,58,387,2206,79.83,2.63,17.54,2019
"4878102",4381,174,2313,6868,63.79,2.53,33.68,2019
"4878119",1179,27,549,1755,67.18,1.54,31.28,2019
"4878152",516,11,111,638,80.88,1.72,17.4,2019
"4878154",13475,183,799,14457,93.21,1.27,5.53,2019
"4878160",1231,51,285,1567,78.56,3.25,18.19,2019
"4878164",841,159,486,1486,56.59,10.7,32.71,2019
"4878204",2915,414,866,4195,69.49,9.87,20.64,2019
"4878212",7928,523,2333,10784,73.52,4.85,21.63,2019
"4878215",1585,92,172,1849,85.72,4.98,9.3,2019
"4878217",10238,902,2509,13649,75.01,6.61,18.38,2019
"4074561",607,46,164,817,74.3,5.63,20.07,2019
"4074601",4930,708,1620,7258,67.93,9.75,22.32,2019
"4074631",1953,122,957,3032,64.41,4.02,31.56,2019
"4074632",164,12,55,231,71,5.19,23.81,2019
"4074644",107,8,59,174,61.49,4.6,33.91,2019
"4074646",37,10,13,60,61.67,16.67,21.67,2019
"4074647",944,42,431,1417,66.62,2.96,30.42,2019
"4074651",181,11,61,253,71.54,4.35,24.11,2019
"4074653",1111,79,278,1468,75.68,5.38,18.94,2019
"4074630",174,13,58,245,71.02,5.31,23.67,2019
"4074643",124,12,48,184,67.39,6.52,26.09,2019
"4074445",885,15,257,1157,76.49,1.3,22.21,2019
"4074451",1111,7,429,1547,71.82,0.45,27.73,2019
"4074471",290,36,235,561,51.69,6.42,41.89,2019
"4074538",1104,28,510,1642,67.24,1.71,31.06,2019
"4074540",39,4,46,89,43.82,4.49,51.69,2019
"4074572",125,20,112,257,48.64,7.78,43.58,2019
"4074578",1693,95,619,2407,70.34,3.95,25.72,2019
"4074636",92,0,23,115,80,0,20,2019
"4074722",60,3,20,83,72.29,3.61,24.1,2019
"4074736",255,21,134,410,62.2,5.12,32.68,2019
"4074760",82,9,50,141,58.16,6.38,35.46,2019
"4074761",14,1,11,26,53.85,3.85,42.31,2019
"4074833",170,6,99,275,61.82,2.18,36,2019
"4074834",1956,60,800,2816,69.46,2.13,28.41,2019
"4074844",88,2,76,166,53.01,1.2,45.78,2019
"4074849",787,51,392,1230,63.98,4.15,31.87,2019
"4074850",57,3,46,106,53.77,2.83,43.4,2019
"4074427",332,11,150,493,67.34,2.23,30.43,2019
"4074432",2680,173,1313,4166,64.33,4.15,31.52,2019
"4074764",870,64,511,1445,60.21,4.43,35.36,2019
"4074826",264,23,125,412,64.08,5.58,30.34,2019
"4876821",1338,70,384,1792,74.67,3.91,21.43,2019
"4876824",0,0,9,9,0,0,100,2019
"4876832",167,7,50,224,74.55,3.12,22.32,2019
"4876842",75,0,19,94,79.79,0,20.21,2019
"4876853",353,27,150,530,66.6,5.09,28.3,2019
"4876857",587,49,164,800,73.38,6.12,20.5,2019
"4876873",34,0,7,41,82.93,0,17.07,2019
"4876901",9224,455,1938,11617,79.4,3.92,16.68,2019
"4876904",12479,458,1406,14343,87,3.19,9.8,2019
"4876905",3354,258,720,4332,77.42,5.96,16.62,2019
"4876932",800,26,266,1092,73.26,2.38,24.36,2019
"4876559",1879,49,200,2128,88.3,2.3,9.4,2019
"4876565",40,0,11,51,78.43,0,21.57,2019
"4876574",5002,125,1229,6356,78.7,1.97,19.34,2019
"4876637",186,10,55,251,74.1,3.98,21.91,2019
"4876653",294,5,169,468,62.82,1.07,36.11,2019
"4876665",757,9,188,954,79.35,0.94,19.71,2019
"4876670",332,13,131,476,69.75,2.73,27.52,2019
"4876690",223,12,144,379,58.84,3.17,37.99,2019
"4876693",319,6,189,514,62.06,1.17,36.77,2019
"4876705",7779,426,2427,10632,73.17,4.01,22.83,2019
"4876862",79,8,5,92,85.87,8.7,5.43,2019
"4876871",223,9,45,277,80.51,3.25,16.25,2019
"4876890",264,19,53,336,78.57,5.65,15.77,2019
"4876930",32,0,9,41,78.05,0,21.95,2019
"4876937",8,0,0,8,100,0,0,2019
"4876940",26,21,0,47,55.32,44.68,0,2019
"4215936",386,24,164,574,67.25,4.18,28.57,2019
"4215958",727,17,119,863,84.24,1.97,13.79,2019
"4215205",8919,155,1069,10143,87.93,1.53,10.54,2019
"4215210",8612,187,2141,10940,78.72,1.71,19.57,2019
"4215214",4894,171,1137,6202,78.91,2.76,18.33,2019
"4215221",12705,533,2830,16068,79.07,3.32,17.61,2019
"4215224",4563,147,889,5599,81.5,2.63,15.88,2019
"4215226",5290,174,824,6288,84.13,2.77,13.1,2019
"4215237",16372,262,1652,18286,89.53,1.43,9.03,2019
"4215784",29,0,0,29,100,0,0,2019
"4215680",44,0,18,62,70.97,0,29.03,2019
"4215350",165,0,5,170,97.06,0,2.94,2019
"4215021",2371,44,592,3007,78.85,1.46,19.69,2019
"4215112",1098,9,343,1450,75.72,0.62,23.66,2019
"4215227",10133,201,1269,11603,87.33,1.73,10.94,2019
"4215361",78,8,12,98,79.59,8.16,12.24,2019
"4215466",156,4,27,187,83.42,2.14,14.44,2019
"4215520",83,0,25,108,76.85,0,23.15,2019
"4215620",192,0,114,306,62.75,0,37.25,2019
"4215333",676,0,151,827,81.74,0,18.26,2019
"4215047",46,0,0,46,100,0,0,2019
"4215077",59,0,10,69,85.51,0,14.49,2019
"4215260",0,0,0,0,NA,NA,NA,2019
"4215668",4751,70,286,5107,93.03,1.37,5.6,2019
"4215290",0,0,0,0,NA,NA,NA,2019
"4215366",86,0,0,86,100,0,0,2019
"4215421",27,0,0,27,100,0,0,2019
"4215435",126,0,40,166,75.9,0,24.1,2019
"4215449",80,0,36,116,68.97,0,31.03,2019
"4215463",61,0,0,61,100,0,0,2019
"4215467",41,0,17,58,70.69,0,29.31,2019
"4215502",58,0,3,61,95.08,0,4.92,2019
"4215510",11,0,0,11,100,0,0,2019
"4215555",39,0,6,45,86.67,0,13.33,2019
"4215561",71,0,12,83,85.54,0,14.46,2019
"4215564",12,1,6,19,63.16,5.26,31.58,2019
"4215616",0,0,0,0,NA,NA,NA,2019
"4215621",35,0,0,35,100,0,0,2019
"4215638",84,0,20,104,80.77,0,19.23,2019
"4215691",40,0,0,40,100,0,0,2019
"4215727",56,0,28,84,66.67,0,33.33,2019
"4215737",27,0,3,30,90,0,10,2019
"4215738",57,0,42,99,57.58,0,42.42,2019
"4215746",27,0,30,57,47.37,0,52.63,2019
"4215750",64,11,53,128,50,8.59,41.41,2019
"3407039",9532,123,570,10225,93.22,1.2,5.57,2019
"3407043",4006,53,73,4132,96.95,1.28,1.77,2019
"3407055",14627,328,4899,19854,73.67,1.65,24.68,2019
"3407077",713,95,162,970,73.51,9.79,16.7,2019
"3407105",13068,638,3614,17320,75.45,3.68,20.87,2019
"3407111",15022,459,4543,20024,75.02,2.29,22.69,2019
"3407112",6770,1146,1779,9695,69.83,11.82,18.35,2019
"3407205",6344,260,738,7342,86.41,3.54,10.05,2019
"3407304",13069,458,2548,16075,81.3,2.85,15.85,2019
"3407306",16771,282,3054,20107,83.41,1.4,15.19,2019
"3407401",2094,65,51,2210,94.75,2.94,2.31,2019
"3407405",5906,166,322,6394,92.37,2.6,5.04,2019
"3407422",2198,36,100,2334,94.17,1.54,4.28,2019
"3407432",2492,15,162,2669,93.37,0.56,6.07,2019
"3408326",413,11,50,474,87.13,2.32,10.55,2019
"3408346",250,18,24,292,85.62,6.16,8.22,2019
"3408403",427,5,32,464,92.03,1.08,6.9,2019
"3408515",1622,13,67,1702,95.3,0.76,3.94,2019
"3408518",1819,101,335,2255,80.67,4.48,14.86,2019
"3408534",4337,105,297,4739,91.52,2.22,6.27,2019
"3408535",1550,0,33,1583,97.92,0,2.08,2019
"3408536",7507,174,124,7805,96.18,2.23,1.59,2019
"3408629",3110,72,895,4077,76.28,1.77,21.95,2019
"3408691",5591,189,501,6281,89.01,3.01,7.98,2019
"3408724",14539,284,1687,16510,88.06,1.72,10.22,2019
"3408740",537,52,102,691,77.71,7.53,14.76,2019
"3408816",15092,169,1174,16435,91.83,1.03,7.14,2019
"3408826",1926,20,141,2087,92.29,0.96,6.76,2019
"3408828",907,19,30,956,94.87,1.99,3.14,2019
"3408852",6208,97,431,6736,92.16,1.44,6.4,2019
"3408879",7377,382,886,8645,85.33,4.42,10.25,2019
"3408886",2324,50,181,2555,90.96,1.96,7.08,2019
"3408009",4129,105,754,4988,82.78,2.11,15.12,2019
"3408011",0,0,0,0,NA,NA,NA,2019
"3408016",10386,321,1438,12145,85.52,2.64,11.84,2019
"3408019",322,4,44,370,87.03,1.08,11.89,2019
"3408026",646,28,86,760,85,3.68,11.32,2019
"3408035",2675,29,300,3004,89.05,0.97,9.99,2019
"3408527",18658,355,1376,20389,91.51,1.74,6.75,2019
"3408751",1689,76,294,2059,82.03,3.69,14.28,2019
"3408824",3857,23,175,4055,95.12,0.57,4.32,2019
"3408820",11867,203,821,12891,92.06,1.57,6.37,2019
"3408802",1339,12,48,1399,95.71,0.86,3.43,2019
"3408805",3714,133,314,4161,89.26,3.2,7.55,2019
"3408821",145,0,0,145,100,0,0,2019
"3408827",1500,10,179,1689,88.81,0.59,10.6,2019
"3408829",1243,10,249,1502,82.76,0.67,16.58,2019
"3408831",18383,561,2167,21111,87.08,2.66,10.26,2019
"3408850",2578,54,195,2827,91.19,1.91,6.9,2019
"3408853",1731,0,38,1769,97.85,0,2.15,2019
"3408854",14795,383,998,16176,91.46,2.37,6.17,2019
"3408872",6400,260,602,7262,88.13,3.58,8.29,2019
"3408402",2514,68,351,2933,85.71,2.32,11.97,2019
"3408406",3567,219,580,4366,81.7,5.02,13.28,2019
"3408525",1691,96,77,1864,90.72,5.15,4.13,2019
"3408533",2215,0,225,2440,90.78,0,9.22,2019
"3408640",889,0,14,903,98.45,0,1.55,2019
"3408730",1568,16,171,1755,89.34,0.91,9.74,2019
"3408822",10276,196,687,11159,92.09,1.76,6.16,2019
"3612304",6660,132,1345,8137,81.85,1.62,16.53,2019
"3612308",3849,272,834,4955,77.68,5.49,16.83,2019
"3612440",737,25,39,801,92.01,3.12,4.87,2019
"3612460",51,30,55,136,37.5,22.06,40.44,2019
"3612481",510,0,79,589,86.59,0,13.41,2019
"3612482",59,0,80,139,42.45,0,57.55,2019
"3612491",486,56,70,612,79.41,9.15,11.44,2019
"3612517",157,27,31,215,73.02,12.56,14.42,2019
"3612563",2311,12,118,2441,94.67,0.49,4.83,2019
"3612564",2478,47,259,2784,89.01,1.69,9.3,2019
"3612581",869,45,93,1007,86.3,4.47,9.24,2019
"3612590",11968,301,706,12975,92.24,2.32,5.44,2019
"3612742",49,0,12,61,80.33,0,19.67,2019
"3612776",631,7,235,873,72.28,0.8,26.92,2019
"4878226",1600,109,700,2409,66.42,4.52,29.06,2019
"4878228",12293,1122,4996,18411,66.77,6.09,27.14,2019
"4878231",3290,86,54,3430,95.92,2.51,1.57,2019
"4878236",413,0,0,413,100,0,0,2019
"1762809",49,0,18,67,73.13,0,26.87,2019
"1762829",21,0,0,21,100,0,0,2019
"1762844",708,13,157,878,80.64,1.48,17.88,2019
"1762846",197,12,66,275,71.64,4.36,24,2019
"1762862",117,10,32,159,73.58,6.29,20.13,2019
"1762870",647,38,171,856,75.58,4.44,19.98,2019
"1762872",276,3,100,379,72.82,0.79,26.39,2019
"1762886",70,6,19,95,73.68,6.32,20,2019
"1762919",243,9,64,316,76.9,2.85,20.25,2019
"1762922",784,35,377,1196,65.55,2.93,31.52,2019
"1762927",111,5,34,150,74,3.33,22.67,2019
"1762449",1015,30,279,1324,76.66,2.27,21.07,2019
"1762380",74,33,22,129,57.36,25.58,17.05,2019
"1762420",1515,57,519,2091,72.45,2.73,24.82,2019
"1762421",167,23,16,206,81.07,11.17,7.77,2019
"1762451",774,13,159,946,81.82,1.37,16.81,2019
"1762452",85,0,44,129,65.89,0,34.11,2019
"1762479",251,6,38,295,85.08,2.03,12.88,2019
"1762519",0,0,51,51,0,0,100,2019
"1762533",282,12,51,345,81.74,3.48,14.78,2019
"1762534",423,9,124,556,76.08,1.62,22.3,2019
"1762551",274,14,42,330,83.03,4.24,12.73,2019
"1762625",257,42,63,362,70.99,11.6,17.4,2019
"1762635",211,0,74,285,74.04,0,25.96,2019
"1762807",279,7,47,333,83.78,2.1,14.11,2019
"1762810",281,3,78,362,77.62,0.83,21.55,2019
"1762831",158,9,24,191,82.72,4.71,12.57,2019
"1762832",3124,131,731,3986,78.37,3.29,18.34,2019
"1762835",246,3,154,403,61.04,0.74,38.21,2019
"1762836",236,4,45,285,82.81,1.4,15.79,2019
"1762842",233,12,56,301,77.41,3.99,18.6,2019
"1762858",854,98,190,1142,74.78,8.58,16.64,2019
"1762869",847,6,233,1086,77.99,0.55,21.45,2019
"1762876",73,3,19,95,76.84,3.16,20,2019
"1762877",153,9,60,222,68.92,4.05,27.03,2019
"1762892",94,2,46,142,66.2,1.41,32.39,2019
"1762893",311,4,120,435,71.49,0.92,27.59,2019
"1762895",589,56,162,807,72.99,6.94,20.07,2019
"1762912",350,9,136,495,70.71,1.82,27.47,2019
"1762921",125,0,28,153,81.7,0,18.3,2019
"1762923",136,2,44,182,74.73,1.1,24.18,2019
"1762940",81,0,32,113,71.68,0,28.32,2019
"1762946",3874,152,1233,5259,73.66,2.89,23.45,2019
"1762950",56,0,36,92,60.87,0,39.13,2019
"1762966",4700,186,1359,6245,75.26,2.98,21.76,2019
"1762969",61,5,60,126,48.41,3.97,47.62,2019
"1762642",476,0,85,561,84.85,0,15.15,2019
"1762661",523,29,56,608,86.02,4.77,9.21,2019
"1762666",165,5,62,232,71.12,2.16,26.72,2019
"1762668",455,10,111,576,78.99,1.74,19.27,2019
"1762671",201,6,28,235,85.53,2.55,11.91,2019
"1762672",58,1,26,85,68.24,1.18,30.59,2019
"1762693",487,41,59,587,82.96,6.98,10.05,2019
"1762701",331,21,207,559,59.21,3.76,37.03,2019
"1762093",127,7,59,193,65.8,3.63,30.57,2019
"4876958",80,0,0,80,100,0,0,2019
"4876953",64,0,3,67,95.52,0,4.48,2019
"4876116",17058,845,3440,21343,79.92,3.96,16.12,2019
"4876132",11382,509,907,12798,88.94,3.98,7.09,2019
"4876225",805,18,221,1044,77.11,1.72,21.17,2019
"4876233",926,67,187,1180,78.47,5.68,15.85,2019
"4876249",2504,42,344,2890,86.64,1.45,11.9,2019
"4876253",80,0,15,95,84.21,0,15.79,2019
"4876255",1576,65,531,2172,72.56,2.99,24.45,2019
"4876266",4496,220,657,5373,83.68,4.09,12.23,2019
"4876270",429,86,136,651,65.9,13.21,20.89,2019
"4876271",451,33,96,580,77.76,5.69,16.55,2019
"4876351",621,116,151,888,69.93,13.06,17,2019
"4876354",3878,91,976,4945,78.42,1.84,19.74,2019
"4876371",441,22,92,555,79.46,3.96,16.58,2019
"4876377",167,0,87,254,65.75,0,34.25,2019
"4876384",3236,330,1381,4947,65.41,6.67,27.92,2019
"4876389",371,11,81,463,80.13,2.38,17.49,2019
"4875032",10536,226,593,11355,92.79,1.99,5.22,2019
"4875057",4708,134,339,5181,90.87,2.59,6.54,2019
"4875058",678,32,163,873,77.66,3.67,18.67,2019
"4875065",4241,71,249,4561,92.98,1.56,5.46,2019
"4875647",4067,152,666,4885,83.25,3.11,13.63,2019
"4875559",1377,83,607,2067,66.62,4.02,29.37,2019
"4875563",1234,68,568,1870,65.99,3.64,30.37,2019
"4875630",789,17,398,1204,65.53,1.41,33.06,2019
"4875602",5007,223,1864,7094,70.58,3.14,26.28,2019
"4875604",9656,306,1358,11320,85.3,2.7,12,2019
"4875633",3973,78,1010,5061,78.5,1.54,19.96,2019
"4875644",3469,146,838,4453,77.9,3.28,18.82,2019
"4875650",2451,117,962,3530,69.43,3.31,27.25,2019
"4875657",2053,69,1175,3297,62.27,2.09,35.64,2019
"1761051",568,22,112,702,80.91,3.13,15.95,2019
"1761071",4517,145,1030,5692,79.36,2.55,18.1,2019
"1761102",4911,236,989,6136,80.04,3.85,16.12,2019
"1761104",5523,413,1832,7768,71.1,5.32,23.58,2019
"1761108",9622,559,1295,11476,83.84,4.87,11.28,2019
"1761109",9154,472,1292,10918,83.84,4.32,11.83,2019
"1761111",8243,151,1267,9661,85.32,1.56,13.11,2019
"1761115",7766,123,982,8871,87.54,1.39,11.07,2019
"1761243",85,0,33,118,72.03,0,27.97,2019
"1761270",2358,113,441,2912,80.98,3.88,15.14,2019
"1761032",10148,286,2787,13221,76.76,2.16,21.08,2019
"1761037",26,0,9,35,74.29,0,25.71,2019
"1761050",120,0,34,154,77.92,0,22.08,2019
"1761052",316,1,58,375,84.27,0.27,15.47,2019
"1761060",520,37,82,639,81.38,5.79,12.83,2019
"1761064",1307,59,289,1655,78.97,3.56,17.46,2019
"1761077",16,0,0,16,100,0,0,2019
"1761085",1116,44,286,1446,77.18,3.04,19.78,2019
"1761240",2135,129,209,2473,86.33,5.22,8.45,2019
"1761256",755,26,76,857,88.1,3.03,8.87,2019
"1761274",80,8,27,115,69.57,6.96,23.48,2019
"1761310",1329,20,284,1633,81.38,1.22,17.39,2019
"1761311",96,0,0,96,100,0,0,2019
"1761318",252,12,47,311,81.03,3.86,15.11,2019
"1761323",26,0,2,28,92.86,0,7.14,2019
"1761325",349,15,66,430,81.16,3.49,15.35,2019
"1761327",417,3,95,515,80.97,0.58,18.45,2019
"3407462",2355,37,161,2553,92.24,1.45,6.31,2019
"3407465",2465,44,44,2553,96.55,1.72,1.72,2019
"3407501",6219,247,4279,10745,57.88,2.3,39.82,2019
"3407513",2414,117,793,3324,72.62,3.52,23.86,2019
"3407606",698,9,87,794,87.91,1.13,10.96,2019
"3407738",1821,76,192,2089,87.17,3.64,9.19,2019
"3407739",1994,0,49,2043,97.6,0,2.4,2019
"3407850",2145,14,79,2238,95.84,0.63,3.53,2019
"3407871",6842,72,274,7188,95.19,1,3.81,2019
"3407921",3609,48,137,3794,95.12,1.27,3.61,2019
"3407931",974,23,34,1031,94.47,2.23,3.3,2019
"3407960",16569,287,1191,18047,91.81,1.59,6.6,2019
"3407974",3763,171,200,4134,91.03,4.14,4.84,2019
"3407107",8845,705,3657,13207,66.97,5.34,27.69,2019
"3407310",5819,119,159,6097,95.44,1.95,2.61,2019
"3407407",5724,51,963,6738,84.95,0.76,14.29,2019
"3407421",2388,61,204,2653,90.01,2.3,7.69,2019
"3407424",8871,170,715,9756,90.93,1.74,7.33,2019
"3407438",4000,17,369,4386,91.2,0.39,8.41,2019
"3407439",749,24,54,827,90.57,2.9,6.53,2019
"3407450",7942,79,289,8310,95.57,0.95,3.48,2019
"3407460",1145,44,80,1269,90.23,3.47,6.3,2019
"3407505",557,9,468,1034,53.87,0.87,45.26,2019
"3407524",3100,48,1033,4181,74.14,1.15,24.71,2019
"3407631",9748,159,1180,11087,87.92,1.43,10.64,2019
"3407652",7471,128,633,8232,90.76,1.55,7.69,2019
"3407740",9909,308,1913,12130,81.69,2.54,15.77,2019
"3407753",12967,468,2295,15730,82.43,2.98,14.59,2019
"3407756",1600,45,292,1937,82.6,2.32,15.07,2019
"3407758",1486,0,86,1572,94.53,0,5.47,2019
"3407760",2949,50,129,3128,94.28,1.6,4.12,2019
"3407848",1549,25,150,1724,89.85,1.45,8.7,2019
"3407857",1213,38,179,1430,84.83,2.66,12.52,2019
"3407630",2411,10,120,2541,94.88,0.39,4.72,2019
"3407641",1066,14,33,1113,95.78,1.26,2.96,2019
"3407650",6517,67,819,7403,88.03,0.91,11.06,2019
"3407660",4331,31,358,4720,91.76,0.66,7.58,2019
"3407666",11861,156,1055,13072,90.74,1.19,8.07,2019
"3407828",5332,142,380,5854,91.08,2.43,6.49,2019
"3407834",6235,105,463,6803,91.65,1.54,6.81,2019
"3407836",4084,83,369,4536,90.04,1.83,8.13,2019
"3407838",1098,21,20,1139,96.4,1.84,1.76,2019
"3407853",4075,26,80,4181,97.46,0.62,1.91,2019
"3407874",2951,4,100,3055,96.6,0.13,3.27,2019
"3407711",567,8,30,605,93.72,1.32,4.96,2019
"3611793",9445,79,716,10240,92.24,0.77,6.99,2019
"3611801",11648,227,1012,12887,90.39,1.76,7.85,2019
"3611933",2612,155,293,3060,85.36,5.07,9.58,2019
"3611939",404,5,48,457,88.4,1.09,10.5,2019
"3611946",4388,157,1417,5962,73.6,2.63,23.77,2019
"3611960",286,26,20,332,86.14,7.83,6.02,2019
"3611963",2168,57,602,2827,76.69,2.02,21.29,2019
"3611971",2152,70,346,2568,83.8,2.73,13.47,2019
"3611975",50,10,41,101,49.5,9.9,40.59,2019
"3611509",768,9,50,827,92.87,1.09,6.05,2019
"3611552",6238,512,334,7084,88.06,7.23,4.71,2019
"3611375",28826,355,3368,32549,88.56,1.09,10.35,2019
"3611420",11494,228,1399,13121,87.6,1.74,10.66,2019
"3611435",16319,242,2332,18893,86.38,1.28,12.34,2019
"3612786",185,0,30,215,86.05,0,13.95,2019
"3612790",1431,26,145,1602,89.33,1.62,9.05,2019
"3612801",5248,176,1010,6434,81.57,2.74,15.7,2019
"3612816",1613,18,359,1990,81.06,0.9,18.04,2019
"3612828",3274,101,465,3840,85.26,2.63,12.11,2019
"3612305",1672,201,423,2296,72.82,8.75,18.42,2019
"3612406",306,0,146,452,67.7,0,32.3,2019
"3612421",122,0,5,127,96.06,0,3.94,2019
"3612428",2303,17,259,2579,89.3,0.66,10.04,2019
"3612446",1702,58,276,2036,83.6,2.85,13.56,2019
"3612472",551,0,59,610,90.33,0,9.67,2019
"3612473",226,0,61,287,78.75,0,21.25,2019
"3612495",78,0,0,78,100,0,0,2019
"3612507",77,6,0,83,92.77,7.23,0,2019
"3612538",4459,130,495,5084,87.71,2.56,9.74,2019
"3612547",952,19,101,1072,88.81,1.77,9.42,2019
"3612553",8401,463,831,9695,86.65,4.78,8.57,2019
"3612567",959,11,139,1109,86.47,0.99,12.53,2019
"3612570",2270,62,105,2437,93.15,2.54,4.31,2019
"3612721",1750,112,208,2070,84.54,5.41,10.05,2019
"3612723",581,0,99,680,85.44,0,14.56,2019
"3612724",83,0,31,114,72.81,0,27.19,2019
"3612734",247,25,108,380,65,6.58,28.42,2019
"3612743",111,3,28,142,78.17,2.11,19.72,2019
"3612749",86,0,42,128,67.19,0,32.81,2019
"3612771",4502,244,974,5720,78.71,4.27,17.03,2019
"3612780",665,70,109,844,78.79,8.29,12.91,2019
"3612785",268,11,98,377,71.09,2.92,25.99,2019
"3612792",85,0,19,104,81.73,0,18.27,2019
"3612812",50,0,0,50,100,0,0,2019
"3612823",92,0,19,111,82.88,0,17.12,2019
"3612832",2071,87,603,2761,75.01,3.15,21.84,2019
"3612835",906,26,178,1110,81.62,2.34,16.04,2019
"3612850",1006,9,106,1121,89.74,0.8,9.46,2019
"3612853",639,15,97,751,85.09,2,12.92,2019
"3612855",93,2,21,116,80.17,1.72,18.1,2019
"3612870",592,12,151,755,78.41,1.59,20,2019
"3612874",80,0,8,88,90.91,0,9.09,2019
"3612914",224,9,116,349,64.18,2.58,33.24,2019
"3612916",652,31,212,895,72.85,3.46,23.69,2019
"3612917",325,10,197,532,61.09,1.88,37.03,2019
"3612937",466,9,183,658,70.82,1.37,27.81,2019
"3612946",1518,106,137,1761,86.2,6.02,7.78,2019
"3612950",181,3,93,277,65.34,1.08,33.57,2019
"3612985",426,27,53,506,84.19,5.34,10.47,2019
"3614814",666,35,39,740,90,4.73,5.27,2019
"3614818",830,9,114,953,87.09,0.94,11.96,2019
"3614820",196,19,87,302,64.9,6.29,28.81,2019
"3614841",316,0,52,368,85.87,0,14.13,2019
"3614842",211,0,98,309,68.28,0,31.72,2019
"3614870",3500,56,555,4111,85.14,1.36,13.5,2019
"3614886",2412,88,372,2872,83.98,3.06,12.95,2019
"3614057",2535,84,578,3197,79.29,2.63,18.08,2019
"3614068",2135,156,372,2663,80.17,5.86,13.97,2019
"3614069",291,0,22,313,92.97,0,7.03,2019
"3614101",512,17,186,715,71.61,2.38,26.01,2019
"3614102",411,15,29,455,90.33,3.3,6.37,2019
"3614063",4198,216,716,5130,81.83,4.21,13.96,2019
"3614065",433,20,182,635,68.19,3.15,28.66,2019
"1762206",3585,378,1305,5268,68.05,7.18,24.77,2019
"1762207",1861,189,1623,3673,50.67,5.15,44.19,2019
"1762014",1333,47,209,1589,83.89,2.96,13.15,2019
"1761449",126,3,37,166,75.9,1.81,22.29,2019
"1761031",498,36,80,614,81.11,5.86,13.03,2019
"1761041",450,16,146,612,73.53,2.61,23.86,2019
"1761048",1375,18,301,1694,81.17,1.06,17.77,2019
"1761072",3927,39,388,4354,90.19,0.9,8.91,2019
"1761074",1685,94,378,2157,78.12,4.36,17.52,2019
"1761078",413,2,93,508,81.3,0.39,18.31,2019
"1761084",1121,6,109,1236,90.7,0.49,8.82,2019
"1761101",5416,438,1698,7552,71.72,5.8,22.48,2019
"1761234",447,18,82,547,81.72,3.29,14.99,2019
"1761235",450,10,122,582,77.32,1.72,20.96,2019
"1761236",32,0,6,38,84.21,0,15.79,2019
"1761929",215,20,89,324,66.36,6.17,27.47,2019
"1761016",1686,51,209,1946,86.64,2.62,10.74,2019
"1761062",652,15,87,754,86.47,1.99,11.54,2019
"1761112",8,7,40,55,14.55,12.73,72.73,2019
"1761560",244,0,32,276,88.41,0,11.59,2019
"1761773",144,6,40,190,75.79,3.16,21.05,2019
"1761856",2713,84,383,3180,85.31,2.64,12.04,2019
"1761944",4172,79,997,5248,79.5,1.51,19,2019
"1761877",561,20,83,664,84.49,3.01,12.5,2019
"1761460",112,1,18,131,85.5,0.76,13.74,2019
"1761479",17,0,11,28,60.71,0,39.29,2019
"1761550",6434,311,812,7557,85.14,4.12,10.75,2019
"1761728",418,14,68,500,83.6,2.8,13.6,2019
"1761775",104,0,10,114,91.23,0,8.77,2019
"1761263",206,5,38,249,82.73,2.01,15.26,2019
"1761320",258,5,34,297,86.87,1.68,11.45,2019
"1761417",94,0,20,114,82.46,0,17.54,2019
"1761442",195,7,69,271,71.96,2.58,25.46,2019
"1761607",3738,40,556,4334,86.25,0.92,12.83,2019
"1761769",204,4,32,240,85,1.67,13.33,2019
"1761377",490,16,109,615,79.67,2.6,17.72,2019
"1761459",127,9,28,164,77.44,5.49,17.07,2019
"1761754",362,10,55,427,84.78,2.34,12.88,2019
"1761839",203,7,38,248,81.85,2.82,15.32,2019
"1761914",664,6,145,815,81.47,0.74,17.79,2019
"1761818",530,43,104,677,78.29,6.35,15.36,2019
"1761852",56,0,15,71,78.87,0,21.13,2019
"1761853",4454,149,373,4976,89.51,2.99,7.5,2019
"1761880",1295,15,207,1517,85.37,0.99,13.65,2019
"1761912",425,13,119,557,76.3,2.33,21.36,2019
"1761917",208,3,65,276,75.36,1.09,23.55,2019
"1761938",7503,101,1727,9331,80.41,1.08,18.51,2019
"1761940",70,8,29,107,65.42,7.48,27.1,2019
"1761943",558,26,109,693,80.52,3.75,15.73,2019
"1761733",305,2,44,351,86.89,0.57,12.54,2019
"1761027",35,0,0,35,100,0,0,2019
"1761043",32,0,6,38,84.21,0,15.79,2019
"1761079",50,0,15,65,76.92,0,23.08,2019
"1761258",51,0,12,63,80.95,0,19.05,2019
"1761278",152,12,15,179,84.92,6.7,8.38,2019
"1761433",28,0,8,36,77.78,0,22.22,2019
"1761553",49,2,29,80,61.25,2.5,36.25,2019
"1761562",16,0,11,27,59.26,0,40.74,2019
"1761616",2271,40,452,2763,82.19,1.45,16.36,2019
"1761333",105,4,34,143,73.43,2.8,23.78,2019
"1761338",83,13,18,114,72.81,11.4,15.79,2019
"1761342",2826,54,521,3401,83.09,1.59,15.32,2019
"1761345",260,9,41,310,83.87,2.9,13.23,2019
"1761350",8704,199,1395,10298,84.52,1.93,13.55,2019
"1761354",3623,211,753,4587,78.98,4.6,16.42,2019
"1761368",433,24,97,554,78.16,4.33,17.51,2019
"1762554",405,8,61,474,85.44,1.69,12.87,2019
"1762572",191,9,22,222,86.04,4.05,9.91,2019
"1762618",2058,109,652,2819,73,3.87,23.13,2019
"1762621",369,15,96,480,76.88,3.12,20,2019
"1762624",121,7,47,175,69.14,4,26.86,2019
"1762656",5225,308,1282,6815,76.67,4.52,18.81,2019
"1762675",2165,87,364,2616,82.76,3.33,13.91,2019
"1762681",1715,67,315,2097,81.78,3.2,15.02,2019
"1762827",442,14,110,566,78.09,2.47,19.43,2019
"1762018",941,61,277,1279,73.57,4.77,21.66,2019
"1762077",71,4,58,133,53.38,3.01,43.61,2019
"1762949",205,4,104,313,65.5,1.28,33.23,2019
"1762979",375,11,108,494,75.91,2.23,21.86,2019
"1762999",460,7,161,628,73.25,1.11,25.64,2019
"1762063",351,3,113,467,75.16,0.64,24.2,2019
"1762234",11556,154,1895,13605,84.94,1.13,13.93,2019
"1762442",910,29,187,1126,80.82,2.58,16.61,2019
"1762467",1350,15,149,1514,89.17,0.99,9.84,2019
"1762558",1086,73,152,1311,82.84,5.57,11.59,2019
"1762694",996,16,171,1183,84.19,1.35,14.45,2019
"1762864",8243,271,1525,10039,82.11,2.7,15.19,2019
"1762967",80,5,30,115,69.57,4.35,26.09,2019
"1762340",534,10,172,716,74.58,1.4,24.02,2019
"1762423",176,14,62,252,69.84,5.56,24.6,2019
"1762501",732,17,276,1025,71.41,1.66,26.93,2019
"4073932",603,17,185,805,74.91,2.11,22.98,2019
"4073945",798,41,210,1049,76.07,3.91,20.02,2019
"4073071",15373,567,1495,17435,88.17,3.25,8.57,2019
"4073072",15381,814,1306,17501,87.89,4.65,7.46,2019
"4073073",106,0,75,181,58.56,0,41.44,2019
"4073084",1943,59,714,2716,71.54,2.17,26.29,2019
"4073099",20611,290,2011,22912,89.96,1.27,8.78,2019
"4073108",3408,91,1084,4583,74.36,1.99,23.65,2019
"4073120",14383,1023,2019,17425,82.54,5.87,11.59,2019
"4073401",9117,1229,3262,13608,67,9.03,23.97,2019
"4073437",29,0,14,43,67.44,0,32.56,2019
"4073438",894,63,439,1396,64.04,4.51,31.45,2019
"4073456",517,49,191,757,68.3,6.47,25.23,2019
"4073537",163,10,56,229,71.18,4.37,24.45,2019
"4073552",407,8,91,506,80.43,1.58,17.98,2019
"4073556",40,5,13,58,68.97,8.62,22.41,2019
"4073639",188,7,57,252,74.6,2.78,22.62,2019
"4073645",424,21,119,564,75.18,3.72,21.1,2019
"4073716",231,4,26,261,88.51,1.53,9.96,2019
"4073717",1922,65,456,2443,78.67,2.66,18.67,2019
"4073719",24,6,4,34,70.59,17.65,11.76,2019
"4073106",3465,105,1064,4634,74.77,2.27,22.96,2019
"4073111",3026,100,1633,4759,63.58,2.1,34.31,2019
"4073114",5190,561,2036,7787,66.65,7.2,26.15,2019
"4073119",6920,403,2449,9772,70.81,4.12,25.06,2019
"4073127",7039,308,1727,9074,77.57,3.39,19.03,2019
"4073131",1246,30,103,1379,90.36,2.18,7.47,2019
"3611553",5717,192,583,6492,88.06,2.96,8.98,2019
"3611559",2353,57,139,2549,92.31,2.24,5.45,2019
"3611565",2824,31,255,3110,90.8,1,8.2,2019
"3611545",4116,30,213,4359,94.43,0.69,4.89,2019
"3611563",6881,232,937,8050,85.48,2.88,11.64,2019
"3611569",426,0,61,487,87.47,0,12.53,2019
"3611581",6111,194,460,6765,90.33,2.87,6.8,2019
"3611691",15828,759,4125,20712,76.42,3.66,19.92,2019
"3611701",7309,333,897,8539,85.6,3.9,10.5,2019
"3611720",8100,183,605,8888,91.13,2.06,6.81,2019
"3611726",5031,125,537,5693,88.37,2.2,9.43,2019
"3611738",4932,124,366,5422,90.96,2.29,6.75,2019
"3611743",14343,331,523,15197,94.38,2.18,3.44,2019
"3611693",3950,44,823,4817,82,0.91,17.09,2019
"3611944",1573,66,320,1959,80.3,3.37,16.33,2019
"3611954",1222,0,236,1458,83.81,0,16.19,2019
"3611956",121,6,0,127,95.28,4.72,0,2019
"3611959",143,17,80,240,59.58,7.08,33.33,2019
"3611964",831,0,150,981,84.71,0,15.29,2019
"3611368",21682,2118,4833,28633,75.72,7.4,16.88,2019
"3611385",29678,478,5345,35501,83.6,1.35,15.06,2019
"3611412",9350,160,1585,11095,84.27,1.44,14.29,2019
"3611414",9198,250,1293,10741,85.63,2.33,12.04,2019
"3611430",0,0,0,0,NA,NA,NA,2019
"3611518",3642,41,317,4000,91.05,1.02,7.92,2019
"3611542",8616,162,1220,9998,86.18,1.62,12.2,2019
"3611548",544,0,0,544,100,0,0,2019
"3611558",2536,26,328,2890,87.75,0.9,11.35,2019
"3611560",2024,29,304,2357,85.87,1.23,12.9,2019
"3611579",1790,0,176,1966,91.05,0,8.95,2019
"3611694",6992,206,1299,8497,82.29,2.42,15.29,2019
"3611697",1245,0,211,1456,85.51,0,14.49,2019
"3611703",4792,177,319,5288,90.62,3.35,6.03,2019
"3611729",7728,234,654,8616,89.69,2.72,7.59,2019
"3611732",1332,34,87,1453,91.67,2.34,5.99,2019
"3611747",6517,186,300,7003,93.06,2.66,4.28,2019
"3611751",4473,140,405,5018,89.14,2.79,8.07,2019
"3611758",16836,261,1468,18565,90.69,1.41,7.91,2019
"3611768",7426,138,270,7834,94.79,1.76,3.45,2019
"3611772",14918,359,2026,17303,86.22,2.07,11.71,2019
"3611782",4501,171,485,5157,87.28,3.32,9.4,2019
"3611784",6862,214,782,7858,87.33,2.72,9.95,2019
"3611798",2898,230,451,3579,80.97,6.43,12.6,2019
"3611932",158,24,294,476,33.19,5.04,61.76,2019
"3611935",1183,12,90,1285,92.06,0.93,7,2019
"3613642",2920,39,896,3855,75.75,1.01,23.24,2019
"3613654",626,9,237,872,71.79,1.03,27.18,2019
"3613656",642,23,299,964,66.6,2.39,31.02,2019
"3613659",146,0,25,171,85.38,0,14.62,2019
"3613660",517,51,50,618,83.66,8.25,8.09,2019
"3613669",4905,182,1013,6100,80.41,2.98,16.61,2019
"3613682",200,12,70,282,70.92,4.26,24.82,2019
"3613697",689,17,137,843,81.73,2.02,16.25,2019
"3613118",1687,65,413,2165,77.92,3,19.08,2019
"3613120",676,35,87,798,84.71,4.39,10.9,2019
"3613131",1182,10,218,1410,83.83,0.71,15.46,2019
"3613614",81,0,38,119,68.07,0,31.93,2019
"3613624",1607,42,248,1897,84.71,2.21,13.07,2019
"3613625",665,8,87,760,87.5,1.05,11.45,2019
"3614067",1657,113,181,1951,84.93,5.79,9.28,2019
"3614080",1404,22,374,1800,78,1.22,20.78,2019
"3614086",11490,110,1631,13231,86.84,0.83,12.33,2019
"3614129",401,45,102,548,73.18,8.21,18.61,2019
"3614138",484,15,230,729,66.39,2.06,31.55,2019
"3614141",2554,74,545,3173,80.49,2.33,17.18,2019
"3614202",1473,46,250,1769,83.27,2.6,14.13,2019
"3614209",2942,101,794,3837,76.67,2.63,20.69,2019
"3614215",11942,549,4219,16710,71.47,3.29,25.25,2019
"3614425",4471,80,354,4905,91.15,1.63,7.22,2019
"3614219",4455,123,968,5546,80.33,2.22,17.45,2019
"3614224",15038,315,2473,17826,84.36,1.77,13.87,2019
"3614226",11361,316,1149,12826,88.58,2.46,8.96,2019
"3614445",2775,64,547,3386,81.96,1.89,16.15,2019
"3614464",2431,14,362,2807,86.6,0.5,12.9,2019
"3614470",2575,91,511,3177,81.05,2.86,16.08,2019
"3614502",3681,101,451,4233,86.96,2.39,10.65,2019
"3614513",4502,243,1004,5749,78.31,4.23,17.46,2019
"3614517",950,78,204,1232,77.11,6.33,16.56,2019
"3614521",696,23,289,1008,69.05,2.28,28.67,2019
"3614522",3080,109,722,3911,78.75,2.79,18.46,2019
"3614545",69,0,0,69,100,0,0,2019
"3614559",6375,116,621,7112,89.64,1.63,8.73,2019
"3614560",680,5,142,827,82.22,0.6,17.17,2019
"3614572",1645,53,337,2035,80.84,2.6,16.56,2019
"3614585",49,0,5,54,90.74,0,9.26,2019
"3614586",3955,89,272,4316,91.64,2.06,6.3,2019
"3614609",13853,619,2899,17371,79.75,3.56,16.69,2019
"3614616",9829,274,1519,11622,84.57,2.36,13.07,2019
"3614708",57,0,12,69,82.61,0,17.39,2019
"3614717",215,0,67,282,76.24,0,23.76,2019
"3614726",239,29,331,599,39.9,4.84,55.26,2019
"3614736",60,4,20,84,71.43,4.76,23.81,2019
"3614739",829,26,320,1175,70.55,2.21,27.23,2019
"3614753",388,12,104,504,76.98,2.38,20.63,2019
"3614767",474,17,226,717,66.11,2.37,31.52,2019
"3614770",942,54,212,1208,77.98,4.47,17.55,2019
"3614008",390,10,181,581,67.13,1.72,31.15,2019
"3614805",343,3,93,439,78.13,0.68,21.18,2019
"3614812",998,52,254,1304,76.53,3.99,19.48,2019
"3614813",732,61,203,996,73.49,6.12,20.38,2019
"3614861",322,11,189,522,61.69,2.11,36.21,2019
"3614885",213,7,54,274,77.74,2.55,19.71,2019
"3614001",3121,53,890,4064,76.8,1.3,21.9,2019
"3614013",527,28,154,709,74.33,3.95,21.72,2019
"4216055",2770,14,393,3177,87.19,0.44,12.37,2019
"4216056",1765,60,334,2159,81.75,2.78,15.47,2019
"4216115",1058,10,213,1281,82.59,0.78,16.63,2019
"4216120",800,15,124,939,85.2,1.6,13.21,2019
"4216130",729,33,131,893,81.63,3.7,14.67,2019
"4216148",6232,157,1038,7427,83.91,2.11,13.98,2019
"4216214",3506,218,608,4332,80.93,5.03,14.04,2019
"4216222",599,10,358,967,61.94,1.03,37.02,2019
"4216260",135,0,49,184,73.37,0,26.63,2019
"4216314",1762,55,364,2181,80.79,2.52,16.69,2019
"4216341",664,15,101,780,85.13,1.92,12.95,2019
"4216353",880,55,277,1212,72.61,4.54,22.85,2019
"4216407",3516,75,1057,4648,75.65,1.61,22.74,2019
"4216410",534,5,107,646,82.66,0.77,16.56,2019
"1761625",0,0,0,0,NA,NA,NA,2019
"1761705",4284,37,215,4536,94.44,0.82,4.74,2019
"1761751",43,0,0,43,100,0,0,2019
"1761955",54,6,20,80,67.5,7.5,25,2019
"4074085",587,49,219,855,68.65,5.73,25.61,2019
"4074119",1683,105,437,2225,75.64,4.72,19.64,2019
"4074337",1412,101,373,1886,74.87,5.36,19.78,2019
"4074075",8109,1206,1495,10810,75.01,11.16,13.83,2019
"4074081",442,58,244,744,59.41,7.8,32.8,2019
"4074105",10531,363,1361,12255,85.93,2.96,11.11,2019
"4074110",3291,132,1496,4919,66.9,2.68,30.41,2019
"4074131",883,21,219,1123,78.63,1.87,19.5,2019
"4074134",5127,152,707,5986,85.65,2.54,11.81,2019
"4074331",2208,99,842,3149,70.12,3.14,26.74,2019
"4074349",87,7,43,137,63.5,5.11,31.39,2019
"4074369",522,36,208,766,68.15,4.7,27.15,2019
"4074447",4177,146,1849,6172,67.68,2.37,29.96,2019
"4074720",118,4,61,183,64.48,2.19,33.33,2019
"4074750",60,5,68,133,45.11,3.76,51.13,2019
"4074756",157,8,115,280,56.07,2.86,41.07,2019
"4074006",9034,360,1425,10819,83.5,3.33,13.17,2019
"4074010",2972,78,901,3951,75.22,1.97,22.8,2019
"4074014",13657,230,841,14728,92.73,1.56,5.71,2019
"4074016",1524,78,666,2268,67.2,3.44,29.37,2019
"4074038",501,40,285,826,60.65,4.84,34.5,2019
"4074055",15808,207,1211,17226,91.77,1.2,7.03,2019
"4074060",139,13,52,204,68.14,6.37,25.49,2019
"4074068",0,0,2,2,0,0,100,2019
"4074072",505,8,219,732,68.99,1.09,29.92,2019
"4074563",523,26,249,798,65.54,3.26,31.2,2019
"4074741",320,9,113,442,72.4,2.04,25.57,2019
"4074745",2217,111,1425,3753,59.07,2.96,37.97,2019
"4074759",382,14,174,570,67.02,2.46,30.53,2019
"4074824",314,15,131,460,68.26,3.26,28.48,2019
"4074827",78,0,45,123,63.41,0,36.59,2019
"4074839",114,8,103,225,50.67,3.56,45.78,2019
"4074854",511,29,129,669,76.38,4.33,19.28,2019
"4074859",1496,42,746,2284,65.5,1.84,32.66,2019
"4074872",927,72,254,1253,73.98,5.75,20.27,2019
"4074881",1195,31,573,1799,66.43,1.72,31.85,2019
"4074883",438,6,373,817,53.61,0.73,45.65,2019
"4074931",191,12,274,477,40.04,2.52,57.44,2019
"4074963",140,7,51,198,70.71,3.54,25.76,2019
"4074084",135,11,48,194,69.59,5.67,24.74,2019
"4074103",336,11,10,357,94.12,3.08,2.8,2019
"4074120",2052,91,312,2455,83.58,3.71,12.71,2019
"4074127",4791,230,1611,6632,72.24,3.47,24.29,2019
"4074145",6351,174,989,7514,84.52,2.32,13.16,2019
"4074350",247,4,60,311,79.42,1.29,19.29,2019
"4074403",9289,502,2427,12218,76.03,4.11,19.86,2019
"4074421",1332,39,477,1848,72.08,2.11,25.81,2019
"4074428",269,116,110,495,54.34,23.43,22.22,2019
"4074454",974,17,235,1226,79.45,1.39,19.17,2019
"4074455",807,79,381,1267,63.69,6.24,30.07,2019
"4074462",2006,187,839,3032,66.16,6.17,27.67,2019
"4074464",7714,524,2500,10738,71.84,4.88,23.28,2019
"4074002",490,79,208,777,63.06,10.17,26.77,2019
"4074012",20855,547,1606,23008,90.64,2.38,6.98,2019
"4074020",1886,304,677,2867,65.78,10.6,23.61,2019
"4073139",5772,171,1434,7377,78.24,2.32,19.44,2019
"4073145",474,11,24,509,93.12,2.16,4.72,2019
"4073159",9954,188,1877,12019,82.82,1.56,15.62,2019
"4073162",10388,234,1032,11654,89.14,2.01,8.86,2019
"4073170",13138,271,887,14296,91.9,1.9,6.2,2019
"4073430",341,43,95,479,71.19,8.98,19.83,2019
"4073448",1419,99,481,1999,70.99,4.95,24.06,2019
"4073458",184,69,134,387,47.55,17.83,34.63,2019
"4073526",683,38,104,825,82.79,4.61,12.61,2019
"4073527",1458,3,191,1652,88.26,0.18,11.56,2019
"4073539",55,9,25,89,61.8,10.11,28.09,2019
"4073541",915,0,144,1059,86.4,0,13.6,2019
"4073002",238,40,89,367,64.85,10.9,24.25,2019
"4073009",332,11,146,489,67.89,2.25,29.86,2019
"4073095",654,13,167,834,78.42,1.56,20.02,2019
"4073024",202,8,65,275,73.45,2.91,23.64,2019
"4073042",226,9,158,393,57.51,2.29,40.2,2019
"4073065",3114,36,229,3379,92.16,1.07,6.78,2019
"4073109",4649,423,1981,7053,65.92,6,28.09,2019
"4073115",6612,177,1544,8333,79.35,2.12,18.53,2019
"4073132",9455,374,979,10808,87.48,3.46,9.06,2019
"4073149",1342,38,556,1936,69.32,1.96,28.72,2019
"4073151",591,6,5,602,98.17,1,0.83,2019
"4073165",1861,69,227,2157,86.28,3.2,10.52,2019
"4073425",9,5,4,18,50,27.78,22.22,2019
"4073432",270,14,152,436,61.93,3.21,34.86,2019
"4073433",822,33,226,1081,76.04,3.05,20.91,2019
"4073444",19,7,38,64,29.69,10.94,59.38,2019
"4073013",18178,251,1148,19577,92.85,1.28,5.86,2019
"4073017",343,27,188,558,61.47,4.84,33.69,2019
"4073112",12668,327,1581,14576,86.91,2.24,10.85,2019
"4073117",1530,79,932,2541,60.21,3.11,36.68,2019
"4074829",81,5,93,179,45.25,2.79,51.96,2019
"4074837",67,0,52,119,56.3,0,43.7,2019
"4074843",75,6,35,116,64.66,5.17,30.17,2019
"4074873",3206,281,797,4284,74.84,6.56,18.6,2019
"4074932",657,20,212,889,73.9,2.25,23.85,2019
"4074942",25,4,30,59,42.37,6.78,50.85,2019
"4074944",308,28,113,449,68.6,6.24,25.17,2019
"4074964",572,32,411,1015,56.35,3.15,40.49,2019
"4074845",84,11,66,161,52.17,6.83,40.99,2019
"4074735",418,17,216,651,64.21,2.61,33.18,2019
"4074753",15,0,0,15,100,0,0,2019
"4074825",413,12,322,747,55.29,1.61,43.11,2019
"4074011",9929,90,590,10609,93.59,0.85,5.56,2019
"4074021",6014,78,1001,7093,84.79,1.1,14.11,2019
"4074023",3357,75,937,4369,76.84,1.72,21.45,2019
"4074036",2131,51,454,2636,80.84,1.93,17.22,2019
"4074037",5932,28,336,6296,94.22,0.44,5.34,2019
"4074070",4419,124,965,5508,80.23,2.25,17.52,2019
"4876632",376,4,208,588,63.95,0.68,35.37,2019
"4876633",1556,10,227,1793,86.78,0.56,12.66,2019
"4876636",518,3,53,574,90.24,0.52,9.23,2019
"4876641",419,30,129,578,72.49,5.19,22.32,2019
"4876649",174,19,52,245,71.02,7.76,21.22,2019
"4876664",825,47,342,1214,67.96,3.87,28.17,2019
"4876431",962,11,308,1281,75.1,0.86,24.04,2019
"4876433",535,8,39,582,91.92,1.37,6.7,2019
"4876561",318,7,47,372,85.48,1.88,12.63,2019
"3613626",627,26,244,897,69.9,2.9,27.2,2019
"3613037",2999,201,362,3562,84.19,5.64,10.16,2019
"3613044",870,72,151,1093,79.6,6.59,13.82,2019
"3613053",1546,30,245,1821,84.9,1.65,13.45,2019
"3613846",114,0,31,145,78.62,0,21.38,2019
"3613850",7799,309,828,8936,87.28,3.46,9.27,2019
"3613861",127,0,0,127,100,0,0,2019
"3613862",1338,47,314,1699,78.75,2.77,18.48,2019
"3613155",174,11,25,210,82.86,5.24,11.9,2019
"3613078",3338,113,433,3884,85.94,2.91,11.15,2019
"3613639",104,0,6,110,94.55,0,5.45,2019
"3613756",163,0,30,193,84.46,0,15.54,2019
"3613042",746,15,133,894,83.45,1.68,14.88,2019
"3613135",2313,70,247,2630,87.95,2.66,9.39,2019
"3613327",579,13,185,777,74.52,1.67,23.81,2019
"3613413",5569,103,721,6393,87.11,1.61,11.28,2019
"3613502",10031,360,2545,12936,77.54,2.78,19.67,2019
"3613342",71,0,9,80,88.75,0,11.25,2019
"3613619",3482,102,496,4080,85.34,2.5,12.16,2019
"3613730",1051,53,156,1260,83.41,4.21,12.38,2019
"3613476",1244,41,206,1491,83.43,2.75,13.82,2019
"3613615",314,0,71,385,81.56,0,18.44,2019
"3613679",509,8,138,655,77.71,1.22,21.07,2019
"3613812",677,27,222,926,73.11,2.92,23.97,2019
"3613440",13004,412,2845,16261,79.97,2.53,17.5,2019
"3613308",1047,68,116,1231,85.05,5.52,9.42,2019
"3613460",1415,74,346,1835,77.11,4.03,18.86,2019
"3613807",373,2,139,514,72.57,0.39,27.04,2019
"3613808",438,46,81,565,77.52,8.14,14.34,2019
"3613069",7992,164,1192,9348,85.49,1.75,12.75,2019
"3613674",8,0,24,32,25,0,75,2019
"3613677",8,0,0,8,100,0,0,2019
"3613678",163,0,29,192,84.9,0,15.1,2019
"3613692",16,0,6,22,72.73,0,27.27,2019
"3613695",39,0,0,39,100,0,0,2019
"3613696",37,0,0,37,100,0,0,2019
"3613751",64,9,0,73,87.67,12.33,0,2019
"3613784",31,8,0,39,79.49,20.51,0,2019
"3613794",16,0,0,16,100,0,0,2019
"3613806",87,3,25,115,75.65,2.61,21.74,2019
"3613826",15,0,0,15,100,0,0,2019
"3613845",63,0,0,63,100,0,0,2019
"3613847",28,0,0,28,100,0,0,2019
"3613860",7,0,0,7,100,0,0,2019
"3613902",8,0,0,8,100,0,0,2019
"4215921",19,0,15,34,55.88,0,44.12,2019
"4215922",49,0,20,69,71.01,0,28.99,2019
"4215945",13,0,22,35,37.14,0,62.86,2019
"4215951",181,0,40,221,81.9,0,18.1,2019
"4215953",39,0,0,39,100,0,0,2019
"4215960",136,0,41,177,76.84,0,23.16,2019
"4215962",58,2,10,70,82.86,2.86,14.29,2019
"4215353",52,0,0,52,100,0,0,2019
"4215376",548,17,115,680,80.59,2.5,16.91,2019
"4215005",3341,87,531,3959,84.39,2.2,13.41,2019
"4215018",285,0,80,365,78.08,0,21.92,2019
"4215037",3746,53,720,4519,82.89,1.17,15.93,2019
"4215042",3248,54,435,3737,86.91,1.45,11.64,2019
"4215059",1429,46,268,1743,81.99,2.64,15.38,2019
"4216420",181,9,47,237,76.37,3.8,19.83,2019
"4216421",861,28,99,988,87.15,2.83,10.02,2019
"4216433",1687,36,346,2069,81.54,1.74,16.72,2019
"4216434",466,23,438,927,50.27,2.48,47.25,2019
"4216613",448,5,110,563,79.57,0.89,19.54,2019
"4216620",101,4,34,139,72.66,2.88,24.46,2019
"4216650",545,10,177,732,74.45,1.37,24.18,2019
"4216677",80,37,45,162,49.38,22.84,27.78,2019
"4216694",32,0,25,57,56.14,0,43.86,2019
"4216726",219,0,60,279,78.49,0,21.51,2019
"4216001",14116,567,3015,17698,79.76,3.2,17.04,2019
"4216022",116,4,33,153,75.82,2.61,21.57,2019
"4216027",77,2,16,95,81.05,2.11,16.84,2019
"4216052",912,28,104,1044,87.36,2.68,9.96,2019
"4216054",129,10,42,181,71.27,5.52,23.2,2019
"4216671",129,7,50,186,69.35,3.76,26.88,2019
"4216651",1003,42,304,1349,74.35,3.11,22.54,2019
"4216662",1669,63,524,2256,73.98,2.79,23.23,2019
"4216664",522,8,186,716,72.91,1.12,25.98,2019
"4216673",1775,46,325,2146,82.71,2.14,15.14,2019
"4216689",122,7,61,190,64.21,3.68,32.11,2019
"4216693",1156,38,315,1509,76.61,2.52,20.87,2019
"4216695",343,7,77,427,80.33,1.64,18.03,2019
"4216701",5448,271,1550,7269,74.95,3.73,21.32,2019
"4216740",329,32,85,446,73.77,7.17,19.06,2019
"4216046",5774,172,283,6229,92.7,2.76,4.54,2019
"4216051",971,15,221,1207,80.45,1.24,18.31,2019
"4216057",4104,284,376,4764,86.15,5.96,7.89,2019
"4216059",2918,47,414,3379,86.36,1.39,12.25,2019
"4216063",2696,86,446,3228,83.52,2.66,13.82,2019
"4216020",398,3,61,462,86.15,0.65,13.2,2019
"4216036",68,3,19,90,75.56,3.33,21.11,2019
"4216844",809,23,208,1040,77.79,2.21,20,2019
"4216859",192,4,44,240,80,1.67,18.33,2019
"4216865",681,0,58,739,92.15,0,7.85,2019
"4216327",932,31,193,1156,80.62,2.68,16.7,2019
"4216342",633,11,122,766,82.64,1.44,15.93,2019
"4216343",291,0,0,291,100,0,0,2019
"4216354",3539,108,878,4525,78.21,2.39,19.4,2019
"4216361",4,0,4,8,50,0,50,2019
"4216365",6411,259,1342,8012,80.02,3.23,16.75,2019
"4216412",3869,109,443,4421,87.51,2.47,10.02,2019
"4216424",1473,41,491,2005,73.47,2.04,24.49,2019
"4216428",4010,112,719,4841,82.83,2.31,14.85,2019
"4216503",4003,239,1385,5627,71.14,4.25,24.61,2019
"3408823",3401,88,173,3662,92.87,2.4,4.72,2019
"3408836",1279,21,27,1327,96.38,1.58,2.03,2019
"3408840",5371,275,427,6073,88.44,4.53,7.03,2019
"3408848",2832,37,303,3172,89.28,1.17,9.55,2019
"3408857",13355,507,1010,14872,89.8,3.41,6.79,2019
"3408863",3670,200,398,4268,85.99,4.69,9.33,2019
"3408865",9688,189,1878,11755,82.42,1.61,15.98,2019
"3408867",1710,24,85,1819,94.01,1.32,4.67,2019
"3408876",7479,147,656,8282,90.3,1.77,7.92,2019
"3408880",1417,0,173,1590,89.12,0,10.88,2019
"3408887",470,0,31,501,93.81,0,6.19,2019
"3408889",3669,183,381,4233,86.68,4.32,9,2019
"3408105",5539,239,2963,8741,63.37,2.73,33.9,2019
"3408343",1512,21,185,1718,88.01,1.22,10.77,2019
"4074022",496,43,176,715,69.37,6.01,24.62,2019
"4074027",242,14,133,389,62.21,3.6,34.19,2019
"4074063",9709,405,2177,12291,78.99,3.3,17.71,2019
"4074073",1688,57,387,2132,79.17,2.67,18.15,2019
"4878237",6884,398,3679,10961,62.8,3.63,33.56,2019
"4878240",19729,995,2769,23493,83.98,4.24,11.79,2019
"4878249",19063,710,884,20657,92.28,3.44,4.28,2019
"4878363",7699,539,2176,10414,73.93,5.18,20.89,2019
"4878393",545,14,272,831,65.58,1.68,32.73,2019
"4878415",10475,325,2484,13284,78.85,2.45,18.7,2019
"4878417",1042,12,221,1275,81.73,0.94,17.33,2019
"4878504",15868,759,1514,18141,87.47,4.18,8.35,2019
"4878545",39,23,47,109,35.78,21.1,43.12,2019
"4878548",87,0,79,166,52.41,0,47.59,2019
"4878565",0,0,61,61,0,0,100,2019
"4878588",36,0,9,45,80,0,20,2019
"4878594",204,13,309,526,38.78,2.47,58.75,2019
"4878602",7622,317,1376,9315,81.83,3.4,14.77,2019
"4878607",48,0,9,57,84.21,0,15.79,2019
"4878621",5692,59,1215,6966,81.71,0.85,17.44,2019
"4878640",15634,303,2491,18428,84.84,1.64,13.52,2019
"4878644",4314,363,1303,5980,72.14,6.07,21.79,2019
"4878670",37,0,10,47,78.72,0,21.28,2019
"4878731",11857,126,554,12537,94.58,1.01,4.42,2019
"4878734",7219,115,417,7751,93.14,1.48,5.38,2019
"4878741",16090,2565,3009,21664,74.27,11.84,13.89,2019
"4878746",10522,134,238,10894,96.59,1.23,2.18,2019
"4878613",25711,288,938,26937,95.45,1.07,3.48,2019
"4878615",258,4,69,331,77.95,1.21,20.85,2019
"4878623",405,0,30,435,93.1,0,6.9,2019
"4878754",8174,83,559,8816,92.72,0.94,6.34,2019
"4878406",272,0,111,383,71.02,0,28.98,2019
"4878598",47,0,6,53,88.68,0,11.32,2019
"4878657",2420,55,245,2720,88.97,2.02,9.01,2019
"4878536",108,8,13,129,83.72,6.2,10.08,2019
"4878541",9063,446,3488,12997,69.73,3.43,26.84,2019
"4878542",10192,674,6484,17350,58.74,3.88,37.37,2019
"4878561",116,5,58,179,64.8,2.79,32.4,2019
"4878564",18,0,21,39,46.15,0,53.85,2019
"4878567",48,0,94,142,33.8,0,66.2,2019
"4878573",6384,169,3312,9865,64.71,1.71,33.57,2019
"4878574",9579,201,5768,15548,61.61,1.29,37.1,2019
"4878585",50,0,64,114,43.86,0,56.14,2019
"4878590",70,0,11,81,86.42,0,13.58,2019
"4878591",59,0,20,79,74.68,0,25.32,2019
"4878633",11225,189,552,11966,93.81,1.58,4.61,2019
"4878665",14369,151,271,14791,97.15,1.02,1.83,2019
"4878677",14,0,0,14,100,0,0,2019
"4878712",0,0,0,0,NA,NA,NA,2019
"4878802",21,0,0,21,100,0,0,2019
"4878843",54,0,0,54,100,0,0,2019
"4878871",7,0,0,7,100,0,0,2019
"4878931",111,0,40,151,73.51,0,26.49,2019
"4878951",0,0,0,0,NA,NA,NA,2019
"4878069",1175,34,347,1556,75.51,2.19,22.3,2019
"4878132",9738,57,667,10462,93.08,0.54,6.38,2019
"4878732",5485,227,155,5867,93.49,3.87,2.64,2019
"4878833",245,30,257,532,46.05,5.64,48.31,2019
"4878218",9353,775,2355,12483,74.93,6.21,18.87,2019
"4876491",106,10,40,156,67.95,6.41,25.64,2019
"4876504",6917,548,1642,9107,75.95,6.02,18.03,2019
"4876530",440,21,214,675,65.19,3.11,31.7,2019
"4876626",356,31,70,457,77.9,6.78,15.32,2019
"4876078",2587,48,473,3108,83.24,1.54,15.22,2019
"4876106",8193,671,1598,10462,78.31,6.41,15.27,2019
"4876474",70,0,19,89,78.65,0,21.35,2019
"4876483",338,18,93,449,75.28,4.01,20.71,2019
"4876490",37,0,10,47,78.72,0,21.28,2019
"4876557",1295,81,498,1874,69.1,4.32,26.57,2019
"4876579",1300,72,214,1586,81.97,4.54,13.49,2019
"4876015",5523,244,715,6482,85.21,3.76,11.03,2019
"4876028",21730,614,1931,24275,89.52,2.53,7.95,2019
"4876034",9122,94,74,9290,98.19,1.01,0.8,2019
"4876050",1699,66,384,2149,79.06,3.07,17.87,2019
"4876053",9060,265,1536,10861,83.42,2.44,14.14,2019
"4876058",5523,227,765,6515,84.77,3.48,11.74,2019
"4876542",16447,454,1293,18194,90.4,2.5,7.11,2019
"4876527",834,9,164,1007,82.82,0.89,16.29,2019
"4876537",1643,25,146,1814,90.57,1.38,8.05,2019
"4876539",2702,77,403,3182,84.92,2.42,12.66,2019
"4876550",3590,126,1240,4956,72.44,2.54,25.02,2019
"4876566",55,0,43,98,56.12,0,43.88,2019
"4876567",2766,46,744,3556,77.78,1.29,20.92,2019
"4876577",773,67,374,1214,63.67,5.52,30.81,2019
"4876622",306,12,126,444,68.92,2.7,28.38,2019
"4876629",464,36,221,721,64.36,4.99,30.65,2019
"4876645",2876,111,759,3746,76.78,2.96,20.26,2019
"4876687",589,21,159,769,76.59,2.73,20.68,2019
"4876710",8291,548,1975,10814,76.67,5.07,18.26,2019
"4876711",2474,289,707,3470,71.3,8.33,20.37,2019
"4876825",2028,76,495,2599,78.03,2.92,19.05,2019
"0906114",7292,442,2160,9894,73.7,4.47,21.83,2019
"0906119",5593,164,794,6551,85.38,2.5,12.12,2019
"0906247",1026,14,81,1121,91.53,1.25,7.23,2019
"0906260",3381,73,634,4088,82.71,1.79,15.51,2019
"0906281",2559,42,261,2862,89.41,1.47,9.12,2019
"0906282",424,0,0,424,100,0,0,2019
"0906333",2519,10,90,2619,96.18,0.38,3.44,2019
"0906376",88,0,0,88,100,0,0,2019
"0906378",2360,58,112,2530,93.28,2.29,4.43,2019
"0906782",737,0,174,911,80.9,0,19.1,2019
"0906759",2122,63,271,2456,86.4,2.57,11.03,2019
"0906785",243,11,21,275,88.36,4,7.64,2019
"0906812",4686,135,150,4971,94.27,2.72,3.02,2019
"0906855",3015,150,255,3420,88.16,4.39,7.46,2019
"0906906",3111,9,238,3358,92.64,0.27,7.09,2019
"0906002",7239,233,1255,8727,82.95,2.67,14.38,2019
"0906026",1832,0,195,2027,90.38,0,9.62,2019
"0906032",6440,162,674,7276,88.51,2.23,9.26,2019
"0906037",6742,173,649,7564,89.13,2.29,8.58,2019
"0906043",1740,17,64,1821,95.55,0.93,3.51,2019
"0906057",2144,52,163,2359,90.89,2.2,6.91,2019
"0906067",7549,337,735,8621,87.57,3.91,8.53,2019
"0906084",5008,0,244,5252,95.35,0,4.65,2019
"0906089",1150,20,147,1317,87.32,1.52,11.16,2019
"0906090",311,14,42,367,84.74,3.81,11.44,2019
"0906103",1227,0,60,1287,95.34,0,4.66,2019
"0906108",6934,237,1703,8874,78.14,2.67,19.19,2019
"4215074",2765,97,646,3508,78.82,2.77,18.42,2019
"4215078",105,0,79,184,57.07,0,42.93,2019
"4215083",238,0,134,372,63.98,0,36.02,2019
"4215089",2228,93,563,2884,77.25,3.22,19.52,2019
"4215136",7984,210,1830,10024,79.65,2.09,18.26,2019
"4215202",8457,238,1427,10122,83.55,2.35,14.1,2019
"4215204",3057,56,540,3653,83.68,1.53,14.78,2019
"4215206",11728,426,2456,14610,80.27,2.92,16.81,2019
"4215211",4694,120,742,5556,84.49,2.16,13.35,2019
"4215316",45,0,3,48,93.75,0,6.25,2019
"4215317",14178,188,1345,15711,90.24,1.2,8.56,2019
"4215207",3527,162,1075,4764,74.03,3.4,22.57,2019
"4215209",4630,112,859,5601,82.66,2,15.34,2019
"4215213",8503,468,1206,10177,83.55,4.6,11.85,2019
"4215223",2658,14,430,3102,85.69,0.45,13.86,2019
"4215225",468,12,85,565,82.83,2.12,15.04,2019
"4215233",1168,0,334,1502,77.76,0,22.24,2019
"4215315",188,0,35,223,84.3,0,15.7,2019
"4215322",655,8,107,770,85.06,1.04,13.9,2019
"4215324",194,6,79,279,69.53,2.15,28.32,2019
"4215133",2280,71,598,2949,77.31,2.41,20.28,2019
"4215329",473,25,56,554,85.38,4.51,10.11,2019
"4215330",1794,23,176,1993,90.02,1.15,8.83,2019
"4215340",407,27,23,457,89.06,5.91,5.03,2019
"4215357",568,0,40,608,93.42,0,6.58,2019
"4215377",174,0,59,233,74.68,0,25.32,2019
"4215379",32,0,13,45,71.11,0,28.89,2019
"4215332",2846,51,639,3536,80.49,1.44,18.07,2019
"4215337",174,0,27,201,86.57,0,13.43,2019
"4215341",260,0,49,309,84.14,0,15.86,2019
"4215349",521,12,146,679,76.73,1.77,21.5,2019
"4215358",230,14,28,272,84.56,5.15,10.29,2019
"4215359",69,0,0,69,100,0,0,2019
"4215368",140,0,55,195,71.79,0,28.21,2019
"4215425",6512,160,1760,8432,77.23,1.9,20.87,2019
"4215363",183,0,74,257,71.21,0,28.79,2019
"4215364",241,2,43,286,84.27,0.7,15.03,2019
"4215433",288,0,67,355,81.13,0,18.87,2019
"4215436",934,55,229,1218,76.68,4.52,18.8,2019
"4215442",602,20,235,857,70.25,2.33,27.42,2019
"4216679",225,6,95,326,69.02,1.84,29.14,2019
"4216683",110,10,31,151,72.85,6.62,20.53,2019
"4216691",94,17,35,146,64.38,11.64,23.97,2019
"4216724",45,0,13,58,77.59,0,22.41,2019
"4216730",26,7,24,57,45.61,12.28,42.11,2019
"3407716",3273,59,240,3572,91.63,1.65,6.72,2019
"3407717",800,14,83,897,89.19,1.56,9.25,2019
"3407751",5899,180,143,6222,94.81,2.89,2.3,2019
"3407755",2014,58,150,2222,90.64,2.61,6.75,2019
"3407827",1376,78,214,1668,82.49,4.68,12.83,2019
"3407832",1119,10,144,1273,87.9,0.79,11.31,2019
"3407842",45,0,0,45,100,0,0,2019
"3407876",3275,65,208,3548,92.31,1.83,5.86,2019
"3407927",1490,15,85,1590,93.71,0.94,5.35,2019
"3407934",457,5,54,516,88.57,0.97,10.47,2019
"3407945",2859,23,227,3109,91.96,0.74,7.3,2019
"3407950",6730,55,362,7147,94.17,0.77,5.07,2019
"3407463",3318,23,225,3566,93.05,0.64,6.31,2019
"3407206",5122,364,2408,7894,64.88,4.61,30.5,2019
"3408332",11168,372,2201,13741,81.28,2.71,16.02,2019
"3408020",845,15,93,953,88.67,1.57,9.76,2019
"3408066",2962,94,579,3635,81.49,2.59,15.93,2019
"3408031",3622,50,720,4392,82.47,1.14,16.39,2019
"3408043",9978,131,908,11017,90.57,1.19,8.24,2019
"3408202",698,31,80,809,86.28,3.83,9.89,2019
"3408817",14389,239,936,15564,92.45,1.54,6.01,2019
"3408833",2828,26,297,3151,89.75,0.83,9.43,2019
"3408205",9399,72,739,10210,92.06,0.71,7.24,2019
"3408240",0,0,0,0,NA,NA,NA,2019
"3408246",14,0,38,52,26.92,0,73.08,2019
"3408320",0,0,0,0,NA,NA,NA,2019
"3408808",78,0,7,85,91.76,0,8.24,2019
"3408844",12857,271,675,13803,93.15,1.96,4.89,2019
"3408890",8,0,0,8,100,0,0,2019
"3408071",3154,111,279,3544,89,3.13,7.87,2019
"3408217",0,0,0,0,NA,NA,NA,2019
"3408340",453,0,0,453,100,0,0,2019
"3408542",1475,68,190,1733,85.11,3.92,10.96,2019
"3408560",1261,50,56,1367,92.25,3.66,4.1,2019
"3408611",5079,252,2975,8306,61.15,3.03,35.82,2019
"3408690",6326,30,553,6909,91.56,0.43,8,2019
"3408731",6927,65,626,7618,90.93,0.85,8.22,2019
"3408757",12019,886,3694,16599,72.41,5.34,22.25,2019
"3408804",903,15,54,972,92.9,1.54,5.56,2019
"3408809",1990,33,179,2202,90.37,1.5,8.13,2019
"3408810",3007,13,76,3096,97.13,0.42,2.45,2019
"3408904",5370,56,309,5735,93.64,0.98,5.39,2019
"3408861",9998,2953,3733,16684,59.93,17.7,22.37,2019
"3408882",4801,73,878,5752,83.47,1.27,15.26,2019
"3408884",2727,98,382,3207,85.03,3.06,11.91,2019
"3408241",365,10,29,404,90.35,2.48,7.18,2019
"3408830",5724,106,601,6431,89.01,1.65,9.35,2019
"3408832",684,223,145,1052,65.02,21.2,13.78,2019
"3408001",207,17,102,326,63.5,5.21,31.29,2019
"3408006",150,8,19,177,84.75,4.52,10.73,2019
"3408010",3562,46,735,4343,82.02,1.06,16.92,2019
"3408023",107,0,36,143,74.83,0,25.17,2019
"3408027",1454,115,357,1926,75.49,5.97,18.54,2019
"3408048",4119,47,521,4687,87.88,1,11.12,2019
"3408069",3833,184,703,4720,81.21,3.9,14.89,2019
"3408106",3305,79,409,3793,87.13,2.08,10.78,2019
"3408107",4561,81,693,5335,85.49,1.52,12.99,2019
"3408201",3566,42,292,3900,91.44,1.08,7.49,2019
"3408004",3731,0,298,4029,92.6,0,7.4,2019
"3612503",196,4,43,243,80.66,1.65,17.7,2019
"3612463",569,45,73,687,82.82,6.55,10.63,2019
"3612484",1072,0,93,1165,92.02,0,7.98,2019
"3612498",2060,32,291,2383,86.45,1.34,12.21,2019
"3612523",608,22,120,750,81.07,2.93,16,2019
"3612525",941,53,98,1092,86.17,4.85,8.97,2019
"3612526",1325,26,171,1522,87.06,1.71,11.24,2019
"3612533",7901,142,569,8612,91.74,1.65,6.61,2019
"3612545",1588,93,347,2028,78.3,4.59,17.11,2019
"3612565",368,15,140,523,70.36,2.87,26.77,2019
"3612569",3462,123,411,3996,86.64,3.08,10.29,2019
"3612572",3466,111,163,3740,92.67,2.97,4.36,2019
"3612592",448,0,55,503,89.07,0,10.93,2019
"3612729",442,70,196,708,62.43,9.89,27.68,2019
"4878219",4242,252,1077,5571,76.14,4.52,19.33,2019
"4878223",12436,1282,4356,18074,68.81,7.09,24.1,2019
"4878225",2782,145,1285,4212,66.05,3.44,30.51,2019
"4878227",11738,553,2473,14764,79.5,3.75,16.75,2019
"1761467",345,12,64,421,81.95,2.85,15.2,2019
"1761468",54,0,0,54,100,0,0,2019
"1761482",219,4,45,268,81.72,1.49,16.79,2019
"1761517",1002,6,250,1258,79.65,0.48,19.87,2019
"1761531",1062,27,249,1338,79.37,2.02,18.61,2019
"1761532",190,9,36,235,80.85,3.83,15.32,2019
"1761536",970,53,156,1179,82.27,4.5,13.23,2019
"1761541",30,0,11,41,73.17,0,26.83,2019
"1761542",1135,34,342,1511,75.12,2.25,22.63,2019
"1761554",13521,377,3300,17198,78.62,2.19,19.19,2019
"1761570",605,14,145,764,79.19,1.83,18.98,2019
"1761730",108,1,52,161,67.08,0.62,32.3,2019
"1761734",907,37,190,1134,79.98,3.26,16.75,2019
"1761735",130,0,24,154,84.42,0,15.58,2019
"1761736",598,2,45,645,92.71,0.31,6.98,2019
"1761011",825,31,53,909,90.76,3.41,5.83,2019
"1761012",741,27,73,841,88.11,3.21,8.68,2019
"1761019",1209,40,84,1333,90.7,3,6.3,2019
"1761021",7261,329,1304,8894,81.64,3.7,14.66,2019
"1761038",330,11,103,444,74.32,2.48,23.2,2019
"1761042",222,0,72,294,75.51,0,24.49,2019
"1761070",437,24,66,527,82.92,4.55,12.52,2019
"1761073",6678,160,270,7108,93.95,2.25,3.8,2019
"1761075",351,11,81,443,79.23,2.48,18.28,2019
"1761250",811,34,188,1033,78.51,3.29,18.2,2019
"1761260",294,3,105,402,73.13,0.75,26.12,2019
"1761264",3822,160,688,4670,81.84,3.43,14.73,2019
"1761273",999,43,203,1245,80.24,3.45,16.31,2019
"1761276",18,0,10,28,64.29,0,35.71,2019
"1761277",1038,34,216,1288,80.59,2.64,16.77,2019
"1761282",2669,206,595,3470,76.92,5.94,17.15,2019
"1761312",161,7,28,196,82.14,3.57,14.29,2019
"1761319",475,19,90,584,81.34,3.25,15.41,2019
"1761335",128,0,24,152,84.21,0,15.79,2019
"1761341",2779,42,457,3278,84.78,1.28,13.94,2019
"1761346",25,0,6,31,80.65,0,19.35,2019
"1761360",1027,20,67,1114,92.19,1.8,6.01,2019
"1761367",268,11,84,363,73.83,3.03,23.14,2019
"1761370",468,21,110,599,78.13,3.51,18.36,2019
"1761412",504,11,74,589,85.57,1.87,12.56,2019
"1761422",884,27,315,1226,72.1,2.2,25.69,2019
"1761423",209,9,66,284,73.59,3.17,23.24,2019
"1761425",144,0,57,201,71.64,0,28.36,2019
"1761439",84,0,19,103,81.55,0,18.45,2019
"1761448",1162,56,160,1378,84.33,4.06,11.61,2019
"1761462",3777,170,562,4509,83.77,3.77,12.46,2019
"1761469",806,6,208,1020,79.02,0.59,20.39,2019
"1761470",111,15,50,176,63.07,8.52,28.41,2019
"1761472",231,5,38,274,84.31,1.82,13.87,2019
"1761474",84,2,22,108,77.78,1.85,20.37,2019
"1761475",88,2,30,120,73.33,1.67,25,2019
"1761489",275,20,70,365,75.34,5.48,19.18,2019
"1761519",91,0,10,101,90.1,0,9.9,2019
"1761526",185,0,86,271,68.27,0,31.73,2019
"1761533",670,28,196,894,74.94,3.13,21.92,2019
"0906109",9276,298,1343,10917,84.97,2.73,12.3,2019
"0906242",467,0,35,502,93.03,0,6.97,2019
"0906249",2554,34,230,2818,90.63,1.21,8.16,2019
"0906269",9,0,0,9,100,0,0,2019
"0906279",2161,146,270,2577,83.86,5.67,10.48,2019
"0906320",8622,469,1649,10740,80.28,4.37,15.35,2019
"0906331",1651,39,226,1916,86.17,2.04,11.8,2019
"0906351",5717,97,802,6616,86.41,1.47,12.12,2019
"0906416",5037,204,656,5897,85.42,3.46,11.12,2019
"0906420",1545,18,116,1679,92.02,1.07,6.91,2019
"0906450",12050,344,2996,15390,78.3,2.24,19.47,2019
"0906457",15600,597,3097,19294,80.85,3.09,16.05,2019
"0906477",4587,44,343,4974,92.22,0.88,6.9,2019
"0906481",467,16,74,557,83.84,2.87,13.29,2019
"0906614",10737,619,1193,12549,85.56,4.93,9.51,2019
"0906751",1045,20,139,1204,86.79,1.66,11.54,2019
"0906779",2847,130,370,3347,85.06,3.88,11.05,2019
"0906787",2786,113,294,3193,87.25,3.54,9.21,2019
"0906790",12199,403,1870,14472,84.29,2.78,12.92,2019
"0906794",297,10,27,334,88.92,2.99,8.08,2019
"0906795",4499,88,549,5136,87.6,1.71,10.69,2019
"0906811",10226,191,507,10924,93.61,1.75,4.64,2019
"0906850",6923,68,540,7531,91.93,0.9,7.17,2019
"0906883",3375,18,54,3447,97.91,0.52,1.57,2019
"0906896",3288,62,80,3430,95.86,1.81,2.33,2019
"0906901",3334,153,595,4082,81.68,3.75,14.58,2019
"0906907",2983,85,157,3225,92.5,2.64,4.87,2019
"0906417",1604,107,172,1883,85.18,5.68,9.13,2019
"0906443",6242,201,469,6912,90.31,2.91,6.79,2019
"0906451",7938,450,1847,10235,77.56,4.4,18.05,2019
"0906455",1064,46,91,1201,88.59,3.83,7.58,2019
"0906460",14630,413,1613,16656,87.84,2.48,9.68,2019
"3610469",17741,1129,3429,22299,79.56,5.06,15.38,2019
"3610514",3981,20,71,4072,97.77,0.49,1.74,2019
"3610526",685,0,0,685,100,0,0,2019
"3610578",267,0,0,267,100,0,0,2019
"3610591",8164,92,652,8908,91.65,1.03,7.32,2019
"3610605",6694,176,385,7255,92.27,2.43,5.31,2019
"3610701",17931,1088,4546,23565,76.09,4.62,19.29,2019
"3610002",19929,3788,9742,33459,59.56,11.32,29.12,2019
"3610029",23977,627,6866,31470,76.19,1.99,21.82,2019
"3610031",18134,413,3197,21744,83.4,1.9,14.7,2019
"3610034",13200,500,2456,16156,81.7,3.09,15.2,2019
"3610040",13728,452,2230,16410,83.66,2.75,13.59,2019
"3610103",0,0,0,0,NA,NA,NA,2019
"3610154",0,0,0,0,NA,NA,NA,2019
"3610173",0,0,0,0,NA,NA,NA,2019
"3611237",13407,597,3052,17056,78.61,3.5,17.89,2019
"3611354",14592,288,5045,19925,73.23,1.45,25.32,2019
"3611356",5985,75,1441,7501,79.79,1,19.21,2019
"3611360",7273,287,981,8541,85.15,3.36,11.49,2019
"3611362",5996,46,946,6988,85.8,0.66,13.54,2019
"3611366",4068,46,420,4534,89.72,1.01,9.26,2019
"3611370",6567,142,1141,7850,83.66,1.81,14.54,2019
"3611371",0,0,0,0,NA,NA,NA,2019
"3611374",16337,385,2827,19549,83.57,1.97,14.46,2019
"3611379",11421,273,1679,13373,85.4,2.04,12.56,2019
"3611419",10522,163,1482,12167,86.48,1.34,12.18,2019
"3611422",8508,446,1010,9964,85.39,4.48,10.14,2019
"3407418",712,26,24,762,93.44,3.41,3.15,2019
"3407452",3537,55,184,3776,93.67,1.46,4.87,2019
"3407503",3832,96,1471,5399,70.98,1.78,27.25,2019
"3407512",3284,100,211,3595,91.35,2.78,5.87,2019
"3407514",4058,193,1848,6099,66.54,3.16,30.3,2019
"3407603",2470,59,263,2792,88.47,2.11,9.42,2019
"3407624",2644,36,98,2778,95.18,1.3,3.53,2019
"3407628",5600,89,681,6370,87.91,1.4,10.69,2019
"3407001",4335,277,410,5022,86.32,5.52,8.16,2019
"3407016",7988,91,815,8894,89.81,1.02,9.16,2019
"3407021",713,18,34,765,93.2,2.35,4.44,2019
"3407024",15286,336,1857,17479,87.45,1.92,10.62,2019
"3407033",2408,89,236,2733,88.11,3.26,8.64,2019
"3407034",3076,86,156,3318,92.71,2.59,4.7,2019
"3407046",1346,0,11,1357,99.19,0,0.81,2019
"3407047",18701,342,2751,21794,85.81,1.57,12.62,2019
"3407074",868,23,46,937,92.64,2.45,4.91,2019
"3407110",10018,186,829,11033,90.8,1.69,7.51,2019
"3407203",5898,353,1151,7402,79.68,4.77,15.55,2019
"3407728",17392,624,1938,19954,87.16,3.13,9.71,2019
"3407646",5306,32,521,5859,90.56,0.55,8.89,2019
"3407663",4713,53,562,5328,88.46,0.99,10.55,2019
"3407719",7686,138,571,8395,91.55,1.64,6.8,2019
"3407721",1098,83,66,1247,88.05,6.66,5.29,2019
"3407730",5146,201,474,5821,88.4,3.45,8.14,2019
"3407735",5845,456,803,7104,82.28,6.42,11.3,2019
"3407747",10939,329,624,11892,91.99,2.77,5.25,2019
"3407823",2664,215,452,3331,79.98,6.45,13.57,2019
"3407764",2212,22,251,2485,89.01,0.89,10.1,2019
"3407803",1136,9,112,1257,90.37,0.72,8.91,2019
"3407821",3098,91,163,3352,92.42,2.71,4.86,2019
"3407822",206,20,53,279,73.84,7.17,19,2019
"3407825",3112,17,360,3489,89.19,0.49,10.32,2019
"3407833",50,0,6,56,89.29,0,10.71,2019
"3407846",15,0,0,15,100,0,0,2019
"3407863",1289,20,156,1465,87.99,1.37,10.65,2019
"3407869",8693,67,409,9169,94.81,0.73,4.46,2019
"3407878",206,27,7,240,85.83,11.25,2.92,2019
"3407901",7808,116,452,8376,93.22,1.38,5.4,2019
"3407922",3870,38,236,4144,93.39,0.92,5.69,2019
"3407976",270,0,32,302,89.4,0,10.6,2019
"3407866",7957,121,545,8623,92.28,1.4,6.32,2019
"3407920",9234,204,364,9802,94.21,2.08,3.71,2019
"3407924",2495,0,86,2581,96.67,0,3.33,2019
"3407970",57,0,0,57,100,0,0,2019
"3611001",8122,148,843,9113,89.13,1.62,9.25,2019
"3611024",1835,15,149,1999,91.8,0.75,7.45,2019
"3611050",10287,100,562,10949,93.95,0.91,5.13,2019
"3611204",18344,449,4604,23397,78.4,1.92,19.68,2019
"3611218",20349,382,4117,24848,81.89,1.54,16.57,2019
"3611223",23474,406,4071,27951,83.98,1.45,14.56,2019
"3611224",13527,534,4869,18930,71.46,2.82,25.72,2019
"3611373",25424,607,4255,30286,83.95,2,14.05,2019
"3611030",5636,131,524,6291,89.59,2.08,8.33,2019
"3611967",7278,135,649,8062,90.28,1.67,8.05,2019
"3611977",718,4,87,809,88.75,0.49,10.75,2019
"3611762",6769,109,676,7554,89.61,1.44,8.95,2019
"3611776",7139,192,627,7958,89.71,2.41,7.88,2019
"3611789",2549,26,300,2875,88.66,0.9,10.43,2019
"5005738",436,18,28,482,90.46,3.73,5.81,2019
"5005742",241,24,8,273,88.28,8.79,2.93,2019
"5005767",410,13,104,527,77.8,2.47,19.73,2019
"5005820",183,10,61,254,72.05,3.94,24.02,2019
"5005827",104,0,11,115,90.43,0,9.57,2019
"5005867",234,4,73,311,75.24,1.29,23.47,2019
"5005444",607,12,50,669,90.73,1.79,7.47,2019
"5005456",409,13,64,486,84.16,2.67,13.17,2019
"5005457",525,11,87,623,84.27,1.77,13.96,2019
"5005461",1674,77,171,1922,87.1,4.01,8.9,2019
"5005486",637,20,49,706,90.23,2.83,6.94,2019
"5005488",2490,14,313,2817,88.39,0.5,11.11,2019
"5005651",601,27,48,676,88.91,3.99,7.1,2019
"5005652",234,3,53,290,80.69,1.03,18.28,2019
"5005654",405,0,60,465,87.1,0,12.9,2019
"5005667",678,39,171,888,76.35,4.39,19.26,2019
"5005676",1726,71,202,1999,86.34,3.55,10.11,2019
"5005677",868,32,112,1012,85.77,3.16,11.07,2019
"5005678",47,0,0,47,100,0,0,2019
"5005743",1219,61,294,1574,77.45,3.88,18.68,2019
"5005748",131,2,17,150,87.33,1.33,11.33,2019
"5005778",216,7,46,269,80.3,2.6,17.1,2019
"5005825",37,0,0,37,100,0,0,2019
"5005833",96,0,12,108,88.89,0,11.11,2019
"5005857",853,48,238,1139,74.89,4.21,20.9,2019
"5005872",258,14,126,398,64.82,3.52,31.66,2019
"5005873",217,35,38,290,74.83,12.07,13.1,2019
"5005902",80,0,16,96,83.33,0,16.67,2019
"5005052",97,0,10,107,90.65,0,9.35,2019
"5005089",1456,120,331,1907,76.35,6.29,17.36,2019
"5005151",530,2,91,623,85.07,0.32,14.61,2019
"5005346",1612,190,258,2060,78.25,9.22,12.52,2019
"5005355",226,56,20,302,74.83,18.54,6.62,2019
"5005356",222,88,18,328,67.68,26.83,5.49,2019
"5005363",600,188,145,933,64.31,20.15,15.54,2019
"5005440",602,15,136,753,79.95,1.99,18.06,2019
"5005360",62,16,5,83,74.7,19.28,6.02,2019
"5005042",190,14,27,231,82.25,6.06,11.69,2019
"5005841",143,8,31,182,78.57,4.4,17.03,2019
"5005031",36,0,0,36,100,0,0,2019
"5005077",402,18,110,530,75.85,3.4,20.75,2019
"5005341",113,48,42,203,55.67,23.65,20.69,2019
"5005751",287,12,15,314,91.4,3.82,4.78,2019
"5005757",298,6,33,337,88.43,1.78,9.79,2019
"5005846",329,10,193,532,61.84,1.88,36.28,2019
"3408723",11196,240,1585,13021,85.98,1.84,12.17,2019
"3408734",2852,169,352,3373,84.55,5.01,10.44,2019
"3408752",954,21,210,1185,80.51,1.77,17.72,2019
"3408759",13807,629,4940,19376,71.26,3.25,25.5,2019
"3408812",4225,50,288,4563,92.59,1.1,6.31,2019
"3610472",15725,1166,4944,21835,72.02,5.34,22.64,2019
"3610518",367,0,29,396,92.68,0,7.32,2019
"3610537",810,0,16,826,98.06,0,1.94,2019
"3610546",402,0,8,410,98.05,0,1.95,2019
"3610309",10051,194,1278,11523,87.23,1.68,11.09,2019
"3610467",28314,1949,6779,37042,76.44,5.26,18.3,2019
"3610604",3384,73,351,3808,88.87,1.92,9.22,2019
"3610928",1461,28,230,1719,84.99,1.63,13.38,2019
"3610456",22509,1466,6885,30860,72.94,4.75,22.31,2019
"2304912",238,19,119,376,63.3,5.05,31.65,2019
"2304915",3199,152,586,3937,81.25,3.86,14.88,2019
"2304925",29,0,2,31,93.55,0,6.45,2019
"2304937",2061,37,661,2759,74.7,1.34,23.96,2019
"2304949",302,0,85,387,78.04,0,21.96,2019
"2304962",55,0,0,55,100,0,0,2019
"2304965",683,24,170,877,77.88,2.74,19.38,2019
"2304974",1026,19,279,1324,77.49,1.44,21.07,2019
"2304003",141,0,8,149,94.63,0,5.37,2019
"2304015",1194,113,302,1609,74.21,7.02,18.77,2019
"2304019",18,0,0,18,100,0,0,2019
"2304029",602,10,87,699,86.12,1.43,12.45,2019
"2304030",763,0,0,763,100,0,0,2019
"2304038",5023,345,644,6012,83.55,5.74,10.71,2019
"2304064",3740,311,439,4490,83.3,6.93,9.78,2019
"2304068",369,28,162,559,66.01,5.01,28.98,2019
"2304069",534,21,35,590,90.51,3.56,5.93,2019
"2304091",276,24,40,340,81.18,7.06,11.76,2019
"2304093",2721,47,363,3131,86.91,1.5,11.59,2019
"2304364",2308,61,248,2617,88.19,2.33,9.48,2019
"2304412",3204,148,418,3770,84.99,3.93,11.09,2019
"2304413",62,0,33,95,65.26,0,34.74,2019
"2304426",1554,137,221,1912,81.28,7.17,11.56,2019
"2304435",301,21,106,428,70.33,4.91,24.77,2019
"2304449",456,19,64,539,84.6,3.53,11.87,2019
"2304459",251,22,146,419,59.9,5.25,34.84,2019
"2304544",269,58,0,327,82.26,17.74,0,2019
"2304573",190,6,11,207,91.79,2.9,5.31,2019
"2304623",291,18,59,368,79.08,4.89,16.03,2019
"2304625",31,0,8,39,79.49,0,20.51,2019
"2304629",0,0,0,0,NA,NA,NA,2019
"2304634",608,10,161,779,78.05,1.28,20.67,2019
"2304648",208,8,61,277,75.09,2.89,22.02,2019
"2304653",220,15,57,292,75.34,5.14,19.52,2019
"2304674",125,0,57,182,68.68,0,31.32,2019
"2304733",115,0,11,126,91.27,0,8.73,2019
"2304736",2774,301,969,4044,68.6,7.44,23.96,2019
"2304745",333,17,68,418,79.67,4.07,16.27,2019
"2304764",16,0,2,18,88.89,0,11.11,2019
"2304772",233,51,78,362,64.36,14.09,21.55,2019
"2304774",200,26,69,295,67.8,8.81,23.39,2019
"2304785",608,73,283,964,63.07,7.57,29.36,2019
"2304787",157,9,49,215,73.02,4.19,22.79,2019
"2304851",40,0,2,42,95.24,0,4.76,2019
"2304854",610,15,75,700,87.14,2.14,10.71,2019
"0572617",8,0,17,25,32,0,68,2019
"0572060",193,49,30,272,70.96,18.01,11.03,2019
"0572134",128,0,54,182,70.33,0,29.67,2019
"0572205",8752,403,1205,10360,84.48,3.89,11.63,2019
"0572374",234,0,120,354,66.1,0,33.9,2019
"0572454",1472,55,584,2111,69.73,2.61,27.66,2019
"0572140",112,0,33,145,77.24,0,22.76,2019
"0572204",8361,428,3150,11939,70.03,3.58,26.38,2019
"0572013",547,73,243,863,63.38,8.46,28.16,2019
"0572863",469,8,208,685,68.47,1.17,30.36,2019
"0572843",671,0,269,940,71.38,0,28.62,2019
"0572847",723,51,265,1039,69.59,4.91,25.51,2019
"0572858",1030,42,228,1300,79.23,3.23,17.54,2019
"0572930",103,0,13,116,88.79,0,11.21,2019
"4402904",9835,193,2563,12591,78.11,1.53,20.36,2019
"4402909",10316,306,3545,14167,72.82,2.16,25.02,2019
"4402917",4173,29,485,4687,89.03,0.62,10.35,2019
"2502360",21126,335,1884,23345,90.49,1.43,8.07,2019
"2502375",3624,43,211,3878,93.45,1.11,5.44,2019
"2502047",54,21,0,75,72,28,0,2019
"2502203",16,0,14,30,53.33,0,46.67,2019
"2502357",24,0,0,24,100,0,0,2019
"2502457",0,8,0,8,0,100,0,2019
"2502553",97,0,14,111,87.39,0,12.61,2019
"2502557",1392,179,179,1750,79.54,10.23,10.23,2019
"2502561",65,0,72,137,47.45,0,52.55,2019
"2502562",1219,17,56,1292,94.35,1.32,4.33,2019
"2502564",66,0,0,66,100,0,0,2019
"2502584",0,0,0,0,NA,NA,NA,2019
"2502637",77,0,0,77,100,0,0,2019
"2502641",42,8,67,117,35.9,6.84,57.26,2019
"2502643",0,0,0,0,NA,NA,NA,2019
"2502651",8,0,0,8,100,0,0,2019
"2502663",28,0,36,64,43.75,0,56.25,2019
"2502791",156,50,28,234,66.67,21.37,11.97,2019
"4402802",201,0,52,253,79.45,0,20.55,2019
"4402826",164,0,14,178,92.13,0,7.87,2019
"4402841",0,0,0,0,NA,NA,NA,2019
"4402872",64,0,68,132,48.48,0,51.52,2019
"4402873",106,0,0,106,100,0,0,2019
"4402876",219,0,0,219,100,0,0,2019
"4402912",0,0,0,0,NA,NA,NA,2019
"2502780",15855,726,3329,19910,79.63,3.65,16.72,2019
"4402808",674,0,90,764,88.22,0,11.78,2019
"4402812",359,12,32,403,89.08,2.98,7.94,2019
"4402818",6709,154,736,7599,88.29,2.03,9.69,2019
"4402825",1822,19,190,2031,89.71,0.94,9.35,2019
"4402827",746,23,88,857,87.05,2.68,10.27,2019
"4402857",2803,93,263,3159,88.73,2.94,8.33,2019
"4402881",966,59,19,1044,92.53,5.65,1.82,2019
"4402898",555,0,26,581,95.52,0,4.48,2019
"4402907",7232,420,1710,9362,77.25,4.49,18.27,2019
"2502332",5416,68,230,5714,94.78,1.19,4.03,2019
"2502346",8074,254,943,9271,87.09,2.74,10.17,2019
"2502366",0,0,0,0,NA,NA,NA,2019
"2502368",10408,190,1314,11912,87.37,1.6,11.03,2019
"2502445",7864,220,323,8407,93.54,2.62,3.84,2019
"2502453",9959,176,1462,11597,85.88,1.52,12.61,2019
"2502468",1960,22,26,2008,97.61,1.1,1.29,2019
"4197484",67,0,19,86,77.91,0,22.09,2019
"4197486",263,9,10,282,93.26,3.19,3.55,2019
"4197496",2372,130,496,2998,79.12,4.34,16.54,2019
"4197526",12228,708,2221,15157,80.68,4.67,14.65,2019
"4197534",428,0,67,495,86.46,0,13.54,2019
"4197537",2567,44,482,3093,82.99,1.42,15.58,2019
"4197538",584,9,84,677,86.26,1.33,12.41,2019
"4197630",1486,80,531,2097,70.86,3.81,25.32,2019
"4197707",2128,16,448,2592,82.1,0.62,17.28,2019
"4197721",72,2,32,106,67.92,1.89,30.19,2019
"4197730",97,2,2,101,96.04,1.98,1.98,2019
"4197732",25,0,13,38,65.79,0,34.21,2019
"4197734",917,19,139,1075,85.3,1.77,12.93,2019
"4197752",0,0,0,0,NA,NA,NA,2019
"3303743",4488,188,732,5408,82.99,3.48,13.54,2019
"3303745",521,32,88,641,81.28,4.99,13.73,2019
"3303750",272,0,27,299,90.97,0,9.03,2019
"3303755",2460,122,37,2619,93.93,4.66,1.41,2019
"3303770",126,0,0,126,100,0,0,2019
"3303771",269,5,70,344,78.2,1.45,20.35,2019
"3303774",613,46,94,753,81.41,6.11,12.48,2019
"3303820",11826,316,1366,13508,87.55,2.34,10.11,2019
"3303826",953,0,73,1026,92.88,0,7.12,2019
"3303832",129,6,12,147,87.76,4.08,8.16,2019
"3303269",920,14,153,1087,84.64,1.29,14.08,2019
"3303276",2826,51,423,3300,85.64,1.55,12.82,2019
"3303303",5384,202,664,6250,86.14,3.23,10.62,2019
"3303441",54,0,15,69,78.26,0,21.74,2019
"3303461",1537,33,192,1762,87.23,1.87,10.9,2019
"3303470",1591,102,300,1993,79.83,5.12,15.05,2019
"3303446",2075,0,456,2531,81.98,0,18.02,2019
"3303450",373,0,46,419,89.02,0,10.98,2019
"3303465",680,27,130,837,81.24,3.23,15.53,2019
"3303581",1198,36,209,1443,83.02,2.49,14.48,2019
"3303598",1222,41,207,1470,83.13,2.79,14.08,2019
"3303741",1304,62,195,1561,83.54,3.97,12.49,2019
"3303748",1914,124,108,2146,89.19,5.78,5.03,2019
"3303813",1274,0,98,1372,92.86,0,7.14,2019
"3303817",358,49,40,447,80.09,10.96,8.95,2019
"3303824",2645,444,98,3187,82.99,13.93,3.07,2019
"3303837",562,0,56,618,90.94,0,9.06,2019
"3303838",395,62,47,504,78.37,12.3,9.33,2019
"3303842",6333,164,540,7037,90,2.33,7.67,2019
"3303846",354,32,26,412,85.92,7.77,6.31,2019
"3303858",1750,16,87,1853,94.44,0.86,4.7,2019
"3303882",517,24,53,594,87.04,4.04,8.92,2019
"3303884",1251,7,83,1341,93.29,0.52,6.19,2019
"3303885",2617,18,162,2797,93.56,0.64,5.79,2019
"3303873",1952,84,120,2156,90.54,3.9,5.57,2019
"2303904",3195,140,252,3587,89.07,3.9,7.03,2019
"2303905",817,11,101,929,87.94,1.18,10.87,2019
"2303907",517,14,45,576,89.76,2.43,7.81,2019
"2303909",4097,33,421,4551,90.02,0.73,9.25,2019
"3303561",2276,234,384,2894,78.65,8.09,13.27,2019
"3303583",334,8,54,396,84.34,2.02,13.64,2019
"3303607",124,14,16,154,80.52,9.09,10.39,2019
"3303609",236,0,89,325,72.62,0,27.38,2019
"3303780",96,12,47,155,61.94,7.74,30.32,2019
"3303814",927,28,217,1172,79.1,2.39,18.52,2019
"2502538",1485,14,185,1684,88.18,0.83,10.99,2019
"2502630",749,11,13,773,96.9,1.42,1.68,2019
"2502639",1252,46,213,1511,82.86,3.04,14.1,2019
"2502670",624,0,86,710,87.89,0,12.11,2019
"2502723",5016,259,1658,6933,72.35,3.74,23.91,2019
"2502725",738,42,151,931,79.27,4.51,16.22,2019
"4402806",5616,44,391,6051,92.81,0.73,6.46,2019
"4402816",11809,265,1264,13338,88.54,1.99,9.48,2019
"4402828",2503,42,475,3020,82.88,1.39,15.73,2019
"4402832",1841,0,78,1919,95.94,0,4.06,2019
"4402838",1194,0,157,1351,88.38,0,11.62,2019
"4402864",11379,151,1708,13238,85.96,1.14,12.9,2019
"4402878",5736,198,635,6569,87.32,3.01,9.67,2019
"4402892",1809,15,93,1917,94.37,0.78,4.85,2019
"3610520",4568,62,503,5133,88.99,1.21,9.8,2019
"3610590",2524,53,127,2704,93.34,1.96,4.7,2019
"3610960",5354,194,627,6175,86.7,3.14,10.15,2019
"3610001",11866,227,904,12997,91.3,1.75,6.96,2019
"3610035",9628,276,4620,14524,66.29,1.9,31.81,2019
"3610065",13924,407,924,15255,91.27,2.67,6.06,2019
"3610075",10487,276,625,11388,92.09,2.42,5.49,2019
"3610110",0,0,0,0,NA,NA,NA,2019
"3610168",0,0,0,0,NA,NA,NA,2019
"3610174",0,0,0,0,NA,NA,NA,2019
"3610199",0,0,0,0,NA,NA,NA,2019
"3610311",0,0,0,0,NA,NA,NA,2019
"3610505",308,0,60,368,83.7,0,16.3,2019
"3610517",152,0,0,152,100,0,0,2019
"3610545",0,0,0,0,NA,NA,NA,2019
"3610596",337,8,109,454,74.23,1.76,24.01,2019
"3610910",0,0,0,0,NA,NA,NA,2019
"3610911",0,0,0,0,NA,NA,NA,2019
"3610914",115,0,0,115,100,0,0,2019
"3610915",30,0,0,30,100,0,0,2019
"3610922",577,0,46,623,92.62,0,7.38,2019
"3610932",31,19,0,50,62,38,0,2019
"3610933",169,8,0,177,95.48,4.52,0,2019
"3610953",58,0,0,58,100,0,0,2019
"3610979",76,0,0,76,100,0,0,2019
"3610988",212,0,23,235,90.21,0,9.79,2019
"3610607",2267,17,132,2416,93.83,0.7,5.46,2019
"3610468",20958,870,4500,26328,79.6,3.3,17.09,2019
"3610550",9240,2059,2445,13744,67.23,14.98,17.79,2019
"3610952",5526,378,3378,9282,59.53,4.07,36.39,2019
"3610984",866,26,69,961,90.11,2.71,7.18,2019
"3610516",1912,27,183,2122,90.1,1.27,8.62,2019
"3610018",4386,81,260,4727,92.79,1.71,5.5,2019
"3610027",18858,754,4344,23956,78.72,3.15,18.13,2019
"3610036",15042,513,1705,17260,87.15,2.97,9.88,2019
"3610170",0,0,0,0,NA,NA,NA,2019
"3610171",0,0,0,0,NA,NA,NA,2019
"3610304",10704,253,3646,14603,73.3,1.73,24.97,2019
"3610308",9043,433,1068,10544,85.76,4.11,10.13,2019
"3610459",12142,527,4199,16868,71.98,3.12,24.89,2019
"3610466",18716,1712,3788,24216,77.29,7.07,15.64,2019
"3610474",2439,152,1032,3623,67.32,4.2,28.48,2019
"3610509",6300,152,411,6863,91.8,2.21,5.99,2019
"3610519",107,0,0,107,100,0,0,2019
"3610523",2770,42,138,2950,93.9,1.42,4.68,2019
"3612769",183,0,0,183,100,0,0,2019
"3612781",71,32,15,118,60.17,27.12,12.71,2019
"3612811",33,0,0,33,100,0,0,2019
"3612862",0,0,0,0,NA,NA,NA,2019
"3612864",19,0,0,19,100,0,0,2019
"3612872",16,0,0,16,100,0,0,2019
"3612884",172,4,20,196,87.76,2.04,10.2,2019
"3612151",365,11,30,406,89.9,2.71,7.39,2019
"3612205",9640,242,1179,11061,87.15,2.19,10.66,2019
"3612464",384,15,120,519,73.99,2.89,23.12,2019
"3612486",584,0,16,600,97.33,0,2.67,2019
"3612522",1498,53,348,1899,78.88,2.79,18.33,2019
"3612575",804,0,19,823,97.69,0,2.31,2019
"3612924",22,0,15,37,59.46,0,40.54,2019
"0572932",365,38,152,555,65.77,6.85,27.39,2019
"0572943",598,31,296,925,64.65,3.35,32,2019
"0572951",248,7,125,380,65.26,1.84,32.89,2019
"0572955",115,0,77,192,59.9,0,40.1,2019
"0572958",1448,101,1142,2691,53.81,3.75,42.44,2019
"0572132",862,47,384,1293,66.67,3.63,29.7,2019
"0572142",613,32,171,816,75.12,3.92,20.96,2019
"0572143",9928,431,2480,12839,77.33,3.36,19.32,2019
"0572206",5631,295,3063,8989,62.64,3.28,34.07,2019
"0572327",456,9,212,677,67.36,1.33,31.31,2019
"0572332",21,0,15,36,58.33,0,41.67,2019
"0572335",3681,468,2003,6152,59.83,7.61,32.56,2019
"0572359",61,13,134,208,29.33,6.25,64.42,2019
"0572360",1393,21,917,2331,59.76,0.9,39.34,2019
"0572396",3717,211,1120,5048,73.63,4.18,22.19,2019
"0572404",9272,379,854,10505,88.26,3.61,8.13,2019
"0572424",15,10,8,33,45.45,30.3,24.24,2019
"0572428",20,7,3,30,66.67,23.33,10,2019
"0572433",839,75,385,1299,64.59,5.77,29.64,2019
"0572038",12,0,16,28,42.86,0,57.14,2019
"0572039",538,28,228,794,67.76,3.53,28.72,2019
"0572210",5759,360,920,7039,81.82,5.11,13.07,2019
"0572227",4511,149,556,5216,86.48,2.86,10.66,2019
"0572324",574,62,235,871,65.9,7.12,26.98,2019
"0572340",32,0,22,54,59.26,0,40.74,2019
"0572390",2000,96,993,3089,64.75,3.11,32.15,2019
"0572003",201,30,119,350,57.43,8.57,34,2019
"0572006",629,8,467,1104,56.97,0.72,42.3,2019
"0572736",1543,245,568,2356,65.49,10.4,24.11,2019
"0572136",368,15,121,504,73.02,2.98,24.01,2019
"0572857",346,13,193,552,62.68,2.36,34.96,2019
"0572950",100,6,44,150,66.67,4,29.33,2019
"0572626",521,88,42,651,80.03,13.52,6.45,2019
"0572440",72,0,23,95,75.79,0,24.21,2019
"0572517",50,30,31,111,45.05,27.03,27.93,2019
"0572841",29,20,36,85,34.12,23.53,42.35,2019
"0572945",66,0,33,99,66.67,0,33.33,2019
"0572722",622,236,371,1229,50.61,19.2,30.19,2019
"0572113",8984,655,938,10577,84.94,6.19,8.87,2019
"0572181",0,0,0,0,NA,NA,NA,2019
"0572315",6750,518,1320,8588,78.6,6.03,15.37,2019
"0572576",924,319,506,1749,52.83,18.24,28.93,2019
"0572668",104,0,0,104,100,0,0,2019
"0572768",274,6,211,491,55.8,1.22,42.97,2019
"0572449",86,0,46,132,65.15,0,34.85,2019
"5398006",13158,91,88,13337,98.66,0.68,0.66,2019
"5398007",10910,157,792,11859,92,1.32,6.68,2019
"5398011",12221,305,778,13304,91.86,2.29,5.85,2019
"5398019",3975,49,76,4100,96.95,1.2,1.85,2019
"5398024",2328,37,8,2373,98.1,1.56,0.34,2019
"5398031",11662,217,454,12333,94.56,1.76,3.68,2019
"5398034",16623,298,725,17646,94.2,1.69,4.11,2019
"5398045",5300,130,236,5666,93.54,2.29,4.17,2019
"5398051",1337,10,275,1622,82.43,0.62,16.95,2019
"5398072",8591,148,466,9205,93.33,1.61,5.06,2019
"5398104",6473,341,1472,8286,78.12,4.12,17.76,2019
"5398107",13338,270,605,14213,93.84,1.9,4.26,2019
"5398168",10249,234,1335,11818,86.72,1.98,11.3,2019
"5398177",7641,266,373,8280,92.28,3.21,4.5,2019
"4197801",6093,152,1128,7373,82.64,2.06,15.3,2019
"4197826",331,0,119,450,73.56,0,26.44,2019
"4197827",860,17,199,1076,79.93,1.58,18.49,2019
"4197833",290,16,40,346,83.82,4.62,11.56,2019
"4197843",183,15,56,254,72.05,5.91,22.05,2019
"4197035",10654,184,467,11305,94.24,1.63,4.13,2019
"4197051",5569,99,715,6383,87.25,1.55,11.2,2019
"4197053",1066,25,156,1247,85.49,2,12.51,2019
"4197067",705,20,138,863,81.69,2.32,15.99,2019
"4197101",1179,75,219,1473,80.04,5.09,14.87,2019
"4197351",3255,258,163,3676,88.55,7.02,4.43,2019
"4197378",1932,92,386,2410,80.17,3.82,16.02,2019
"4197394",1901,149,347,2397,79.31,6.22,14.48,2019
"4197403",3505,349,262,4116,85.16,8.48,6.37,2019
"4197413",396,43,47,486,81.48,8.85,9.67,2019
"4197414",87,15,14,116,75,12.93,12.07,2019
"4197441",149,7,55,211,70.62,3.32,26.07,2019
"4197452",572,15,89,676,84.62,2.22,13.17,2019
"4197454",472,0,68,540,87.41,0,12.59,2019
"4197457",3267,140,591,3998,81.72,3.5,14.78,2019
"4197469",773,43,162,978,79.04,4.4,16.56,2019
"4197477",13266,503,2123,15892,83.48,3.17,13.36,2019
"4197487",3042,62,355,3459,87.94,1.79,10.26,2019
"4197497",445,36,163,644,69.1,5.59,25.31,2019
"4197499",575,16,239,830,69.28,1.93,28.8,2019
"4197116",8104,528,847,9479,85.49,5.57,8.94,2019
"4197125",52,0,0,52,100,0,0,2019
"4197130",265,8,0,273,97.07,2.93,0,2019
"4197131",970,24,217,1211,80.1,1.98,17.92,2019
"4197134",173,0,0,173,100,0,0,2019
"4197144",65,0,0,65,100,0,0,2019
"4197146",2108,36,226,2370,88.95,1.52,9.54,2019
"4197147",129,11,26,166,77.71,6.63,15.66,2019
"4197202",16651,412,1241,18304,90.97,2.25,6.78,2019
"4197218",5044,70,362,5476,92.11,1.28,6.61,2019
"4197227",2349,127,98,2574,91.26,4.93,3.81,2019
"4197303",13356,449,1186,14991,89.09,3,7.91,2019
"4197325",2138,91,114,2343,91.25,3.88,4.87,2019
"4197327",1143,29,117,1289,88.67,2.25,9.08,2019
"4197007",23856,590,1082,25528,93.45,2.31,4.24,2019
"4197019",1071,34,112,1217,88,2.79,9.2,2019
"4197857",165,1,43,209,78.95,0.48,20.57,2019
"4197032",1424,52,213,1689,84.31,3.08,12.61,2019
"4197023",2946,269,652,3867,76.18,6.96,16.86,2019
"5398941",166,8,103,277,59.93,2.89,37.18,2019
"0695226",0,0,0,0,NA,NA,NA,2019
"0695236",1202,23,306,1531,78.51,1.5,19.99,2019
"0695251",250,23,28,301,83.06,7.64,9.3,2019
"0695254",280,0,36,316,88.61,0,11.39,2019
"0695320",3871,86,483,4440,87.18,1.94,10.88,2019
"0695329",840,11,227,1078,77.92,1.02,21.06,2019
"0695357",3149,66,428,3643,86.44,1.81,11.75,2019
"0695358",7334,141,1306,8781,83.52,1.61,14.87,2019
"0695360",3488,21,400,3909,89.23,0.54,10.23,2019
"0695368",3443,34,510,3987,86.36,0.85,12.79,2019
"0695369",299,0,71,370,80.81,0,19.19,2019
"0695370",9899,278,1881,12058,82.09,2.31,15.6,2019
"0695376",14750,321,1149,16220,90.94,1.98,7.08,2019
"0695386",2617,10,430,3057,85.61,0.33,14.07,2019
"4402893",10970,450,1811,13231,82.91,3.4,13.69,2019
"4402895",13313,367,2983,16663,79.9,2.2,17.9,2019
"4402910",7115,180,840,8135,87.46,2.21,10.33,2019
"4402914",6438,611,1753,8802,73.14,6.94,19.92,2019
"4402915",5967,232,1157,7356,81.12,3.15,15.73,2019
"4402921",3930,107,423,4460,88.12,2.4,9.48,2019
"4402919",9609,368,1620,11597,82.86,3.17,13.97,2019
"2502019",5961,65,500,6526,91.34,1,7.66,2019
"2502052",4032,59,154,4245,94.98,1.39,3.63,2019
"2502061",3439,34,193,3666,93.81,0.93,5.26,2019
"2502066",6416,175,331,6922,92.69,2.53,4.78,2019
"2502071",196,0,0,196,100,0,0,2019
"2502116",11294,186,743,12223,92.4,1.52,6.08,2019
"2502124",15648,797,2698,19143,81.74,4.16,14.09,2019
"2502132",9856,223,1369,11448,86.09,1.95,11.96,2019
"2502143",9791,164,1129,11084,88.33,1.48,10.19,2019
"2502150",10743,288,2228,13259,81.02,2.17,16.8,2019
"2502155",21003,330,1554,22887,91.77,1.44,6.79,2019
"2502169",22066,441,2961,25468,86.64,1.73,11.63,2019
"2502189",5480,245,444,6169,88.83,3.97,7.2,2019
"2502191",3213,139,318,3670,87.55,3.79,8.66,2019
"2502199",711,35,67,813,87.45,4.31,8.24,2019
"2502043",7954,95,824,8873,89.64,1.07,9.29,2019
"2502048",8068,181,401,8650,93.27,2.09,4.64,2019
"2502050",8954,95,837,9886,90.57,0.96,8.47,2019
"2502062",10587,190,1194,11971,88.44,1.59,9.97,2019
"2502072",9729,214,957,10900,89.26,1.96,8.78,2019
"2502110",1232,14,45,1291,95.43,1.08,3.49,2019
"2502113",3885,8,224,4117,94.36,0.19,5.44,2019
"2502122",7223,182,1186,8591,84.08,2.12,13.81,2019
"2502125",10461,322,1922,12705,82.34,2.53,15.13,2019
"2502128",14040,219,2306,16565,84.76,1.32,13.92,2019
"2502139",13117,322,1202,14641,89.59,2.2,8.21,2019
"2502140",8484,280,710,9474,89.55,2.96,7.49,2019
"2502148",19728,540,2757,23025,85.68,2.35,11.97,2019
"2502152",6597,316,918,7831,84.24,4.04,11.72,2019
"2502190",6489,225,675,7389,87.82,3.05,9.14,2019
"2502302",9157,96,1478,10731,85.33,0.89,13.77,2019
"5005450",1527,75,307,1909,79.99,3.93,16.08,2019
"5005462",695,14,96,805,86.34,1.74,11.93,2019
"5005463",166,3,18,187,88.77,1.6,9.63,2019
"5005655",1038,19,219,1276,81.35,1.49,17.16,2019
"5005656",1043,170,136,1349,77.32,12.6,10.08,2019
"5005681",118,3,30,151,78.15,1.99,19.87,2019
"5005735",1318,97,307,1722,76.54,5.63,17.83,2019
"0696059",112,9,84,205,54.63,4.39,40.98,2019
"0696069",275,13,78,366,75.14,3.55,21.31,2019
"0696130",4015,131,877,5023,79.93,2.61,17.46,2019
"0696136",7,0,15,22,31.82,0,68.18,2019
"0696150",9922,396,1449,11767,84.32,3.37,12.31,2019
"1596713",266,7,121,394,67.51,1.78,30.71,2019
"1596729",261,8,61,330,79.09,2.42,18.48,2019
"1596762",810,62,13,885,91.53,7.01,1.47,2019
"1596773",48,6,5,59,81.36,10.17,8.47,2019
"1596783",325,39,231,595,54.62,6.55,38.82,2019
"1596792",9778,419,1901,12098,80.82,3.46,15.71,2019
"0696064",1533,24,318,1875,81.76,1.28,16.96,2019
"0696073",1322,68,88,1478,89.45,4.6,5.95,2019
"0696087",188,0,61,249,75.5,0,24.5,2019
"3612929",283,2,29,314,90.13,0.64,9.24,2019
"3612933",16,0,10,26,61.54,0,38.46,2019
"3612939",97,0,0,97,100,0,0,2019
"3612973",38,5,7,50,76,10,14,2019
"3612975",130,6,0,136,95.59,4.41,0,2019
"3612976",109,2,9,120,90.83,1.67,7.5,2019
"3612977",37,0,0,37,100,0,0,2019
"3612978",122,0,21,143,85.31,0,14.69,2019
"3612997",456,29,28,513,88.89,5.65,5.46,2019
"3612998",125,0,98,223,56.05,0,43.95,2019
"3612983",2773,77,498,3348,82.83,2.3,14.87,2019
"3612987",103,0,3,106,97.17,0,2.83,2019
"3612413",731,53,250,1034,70.7,5.13,24.18,2019
"3612418",131,0,15,146,89.73,0,10.27,2019
"3612419",218,0,10,228,95.61,0,4.39,2019
"3612422",84,6,25,115,73.04,5.22,21.74,2019
"3612429",123,0,0,123,100,0,0,2019
"3612430",417,18,57,492,84.76,3.66,11.59,2019
"3612443",1274,0,130,1404,90.74,0,9.26,2019
"3612470",132,0,51,183,72.13,0,27.87,2019
"3612477",6640,114,1059,7813,84.99,1.46,13.55,2019
"3612513",100,0,36,136,73.53,0,26.47,2019
"3612540",2526,59,174,2759,91.55,2.14,6.31,2019
"3612520",869,55,114,1038,83.72,5.3,10.98,2019
"3612485",373,43,138,554,67.33,7.76,24.91,2019
"3612493",76,0,0,76,100,0,0,2019
"3612516",540,9,90,639,84.51,1.41,14.08,2019
"3612524",5341,86,511,5938,89.95,1.45,8.61,2019
"3612534",5633,357,1604,7594,74.18,4.7,21.12,2019
"3612542",1919,27,321,2267,84.65,1.19,14.16,2019
"3612571",3449,48,390,3887,88.73,1.23,10.03,2019
"3612601",13125,457,2517,16099,81.53,2.84,15.63,2019
"3612748",672,89,137,898,74.83,9.91,15.26,2019
"3612760",173,11,67,251,68.92,4.38,26.69,2019
"3612765",287,0,30,317,90.54,0,9.46,2019
"3612775",641,12,60,713,89.9,1.68,8.42,2019
"3612778",214,10,21,245,87.35,4.08,8.57,2019
"3612783",497,72,58,627,79.27,11.48,9.25,2019
"3612821",86,0,32,118,72.88,0,27.12,2019
"3612834",2200,119,270,2589,84.97,4.6,10.43,2019
"3612838",227,8,27,262,86.64,3.05,10.31,2019
"3612846",1232,37,214,1483,83.07,2.49,14.43,2019
"3612866",15999,455,1174,17628,90.76,2.58,6.66,2019
"3612885",1449,10,480,1939,74.73,0.52,24.76,2019
"3612903",629,17,51,697,90.24,2.44,7.32,2019
"4215851",1927,53,841,2821,68.31,1.88,29.81,2019
"4215868",462,35,154,651,70.97,5.38,23.66,2019
"4215901",1067,127,841,2035,52.43,6.24,41.33,2019
"4215904",5140,148,1177,6465,79.51,2.29,18.21,2019
"4215909",1774,57,357,2188,81.08,2.61,16.32,2019
"4215934",12,0,0,12,100,0,0,2019
"4215946",2215,46,590,2851,77.69,1.61,20.69,2019
"4215948",153,19,32,204,75,9.31,15.69,2019
"4215952",452,14,138,604,74.83,2.32,22.85,2019
"4215963",3412,90,1281,4783,71.34,1.88,26.78,2019
"4215232",5923,198,236,6357,93.17,3.11,3.71,2019
"4215241",7151,68,532,7751,92.26,0.88,6.86,2019
"4215311",520,0,90,610,85.25,0,14.75,2019
"4215314",1218,40,347,1605,75.89,2.49,21.62,2019
"5398223",14827,332,1231,16390,90.46,2.03,7.51,2019
"5398235",38,0,0,38,100,0,0,2019
"5398245",1597,104,212,1913,83.48,5.44,11.08,2019
"5398250",3336,165,322,3823,87.26,4.32,8.42,2019
"5398253",851,0,46,897,94.87,0,5.13,2019
"5398262",415,0,58,473,87.74,0,12.26,2019
"5398587",181,7,51,239,75.73,2.93,21.34,2019
"5398601",857,84,147,1088,78.77,7.72,13.51,2019
"5398612",1095,48,111,1254,87.32,3.83,8.85,2019
"5398638",436,18,97,551,79.13,3.27,17.6,2019
"5398642",6536,100,354,6990,93.51,1.43,5.06,2019
"5398264",6299,143,1065,7507,83.91,1.9,14.19,2019
"5398275",7798,111,267,8176,95.38,1.36,3.27,2019
"5398281",565,6,72,643,87.87,0.93,11.2,2019
"5398292",7401,190,789,8380,88.32,2.27,9.42,2019
"5398296",9744,45,307,10096,96.51,0.45,3.04,2019
"5398305",126,0,29,155,81.29,0,18.71,2019
"5398331",1882,115,414,2411,78.06,4.77,17.17,2019
"5398336",298,0,46,344,86.63,0,13.37,2019
"5398339",1234,24,194,1452,84.99,1.65,13.36,2019
"5398356",556,16,182,754,73.74,2.12,24.14,2019
"5398358",356,8,60,424,83.96,1.89,14.15,2019
"5398372",9212,181,970,10363,88.89,1.75,9.36,2019
"5398373",8619,152,652,9423,91.47,1.61,6.92,2019
"5398375",9286,147,516,9949,93.34,1.48,5.19,2019
"5398388",2341,33,121,2495,93.83,1.32,4.85,2019
"5398392",1274,19,86,1379,92.39,1.38,6.24,2019
"5398422",7314,99,358,7771,94.12,1.27,4.61,2019
"5398446",3418,91,450,3959,86.33,2.3,11.37,2019
"5398527",114,0,35,149,76.51,0,23.49,2019
"5398498",10044,319,914,11277,89.07,2.83,8.1,2019
"5398516",9074,254,751,10079,90.03,2.52,7.45,2019
"5398524",1402,0,89,1491,94.03,0,5.97,2019
"5398535",296,0,59,355,83.38,0,16.62,2019
"5398547",637,0,116,753,84.59,0,15.41,2019
"5398550",3919,148,797,4864,80.57,3.04,16.39,2019
"5398557",1110,6,240,1356,81.86,0.44,17.7,2019
"5398559",0,0,0,0,NA,NA,NA,2019
"5398562",47,0,0,47,100,0,0,2019
"5398565",198,0,85,283,69.96,0,30.04,2019
"5398576",1753,59,184,1996,87.83,2.96,9.22,2019
"5398581",208,20,107,335,62.09,5.97,31.94,2019
"5398589",2521,64,324,2909,86.66,2.2,11.14,2019
"5398590",119,2,8,129,92.25,1.55,6.2,2019
"5398607",10614,117,563,11294,93.98,1.04,4.98,2019
"2501730",4911,96,305,5312,92.45,1.81,5.74,2019
"2501835",4480,206,573,5259,85.19,3.92,10.9,2019
"2501904",5532,85,588,6205,89.15,1.37,9.48,2019
"2501908",1456,11,135,1602,90.89,0.69,8.43,2019
"2501945",7744,63,315,8122,95.35,0.78,3.88,2019
"2501950",7092,116,628,7836,90.51,1.48,8.01,2019
"2501952",3485,72,332,3889,89.61,1.85,8.54,2019
"2501984",1258,46,114,1418,88.72,3.24,8.04,2019
"2501518",1222,6,199,1427,85.63,0.42,13.95,2019
"2501520",5425,98,263,5786,93.76,1.69,4.55,2019
"2501522",1157,20,83,1260,91.83,1.59,6.59,2019
"2501527",4786,43,446,5275,90.73,0.82,8.45,2019
"2501536",2521,18,241,2780,90.68,0.65,8.67,2019
"2501540",3593,157,449,4199,85.57,3.74,10.69,2019
"0695410",302,7,86,395,76.46,1.77,21.77,2019
"0695429",45,0,13,58,77.59,0,22.41,2019
"0695446",2177,119,214,2510,86.73,4.74,8.53,2019
"0695453",3655,184,823,4662,78.4,3.95,17.65,2019
"0695469",574,12,171,757,75.83,1.59,22.59,2019
"0695471",259,11,0,270,95.93,4.07,0,2019
"0695310",814,0,140,954,85.32,0,14.68,2019
"0695252",4662,177,382,5221,89.29,3.39,7.32,2019
"0695311",630,53,256,939,67.09,5.64,27.26,2019
"0695333",629,30,153,812,77.46,3.69,18.84,2019
"0695338",3875,95,806,4776,81.13,1.99,16.88,2019
"0695345",259,33,135,427,60.66,7.73,31.62,2019
"0695354",7286,182,1422,8890,81.96,2.05,16,2019
"0695364",0,0,0,0,NA,NA,NA,2019
"0695379",1307,44,250,1601,81.64,2.75,15.62,2019
"0695388",3466,61,608,4135,83.82,1.48,14.7,2019
"0695401",12197,359,1079,13635,89.45,2.63,7.91,2019
"0695407",10808,355,1622,12785,84.54,2.78,12.69,2019
"0695417",75,0,66,141,53.19,0,46.81,2019
"0695426",557,0,51,608,91.61,0,8.39,2019
"0695427",115,0,0,115,100,0,0,2019
"0695428",694,43,237,974,71.25,4.41,24.33,2019
"0695432",244,0,82,326,74.85,0,25.15,2019
"0695437",4907,169,1004,6080,80.71,2.78,16.51,2019
"0695443",40,0,41,81,49.38,0,50.62,2019
"0695463",55,0,18,73,75.34,0,24.66,2019
"0695468",342,16,201,559,61.18,2.86,35.96,2019
"0695488",79,0,0,79,100,0,0,2019
"0695511",87,9,12,108,80.56,8.33,11.11,2019
"0695546",557,32,574,1163,47.89,2.75,49.36,2019
"0695556",142,14,56,212,66.98,6.6,26.42,2019
"0695563",264,0,77,341,77.42,0,22.58,2019
"0695569",127,21,30,178,71.35,11.8,16.85,2019
"0695660",8477,257,1859,10593,80.02,2.43,17.55,2019
"0695663",798,32,54,884,90.27,3.62,6.11,2019
"0695007",133,0,0,133,100,0,0,2019
"0695014",20266,357,995,21618,93.75,1.65,4.6,2019
"0695033",3271,81,214,3566,91.73,2.27,6,2019
"0695039",226,24,64,314,71.97,7.64,20.38,2019
"0695112",17489,618,2772,20879,83.76,2.96,13.28,2019
"0695126",13364,357,1310,15031,88.91,2.38,8.72,2019
"0695134",12119,103,221,12443,97.4,0.83,1.78,2019
"0695202",1157,123,1646,2926,39.54,4.2,56.25,2019
"0695209",11780,333,1069,13182,89.36,2.53,8.11,2019
"0695222",1816,136,387,2339,77.64,5.81,16.55,2019
"7200688",2110,105,2022,4237,49.8,2.48,47.72,2019
"7200705",5828,124,2575,8527,68.35,1.45,30.2,2019
"7200720",3844,62,2720,6626,58.01,0.94,41.05,2019
"7200745",11174,100,4593,15867,70.42,0.63,28.95,2019
"7200771",7905,546,3748,12199,64.8,4.48,30.72,2019
"7200915",6031,125,4459,10615,56.82,1.18,42.01,2019
"7200917",3174,227,4925,8326,38.12,2.73,59.15,2019
"7200920",4067,358,2396,6821,59.62,5.25,35.13,2019
"7200966",4819,94,928,5841,82.5,1.61,15.89,2019
"7200987",16348,371,3848,20567,79.49,1.8,18.71,2019
"7200601",2974,60,2475,5509,53.98,1.09,44.93,2019
"7200616",1732,136,1581,3449,50.22,3.94,45.84,2019
"7200627",6397,424,4573,11394,56.14,3.72,40.14,2019
"7200638",3122,58,2719,5899,52.92,0.98,46.09,2019
"0696092",95,0,21,116,81.9,0,18.1,2019
"0696114",1152,26,156,1334,86.36,1.95,11.69,2019
"0696124",136,0,56,192,70.83,0,29.17,2019
"0696140",431,0,49,480,89.79,0,10.21,2019
"0696141",151,13,20,184,82.07,7.07,10.87,2019
"0696142",321,0,13,334,96.11,0,3.89,2019
"0696143",1258,96,204,1558,80.74,6.16,13.09,2019
"0696161",6662,54,211,6927,96.17,0.78,3.05,2019
"1596704",2067,149,456,2672,77.36,5.58,17.07,2019
"1596716",725,24,128,877,82.67,2.74,14.6,2019
"1596720",12643,1173,3084,16900,74.81,6.94,18.25,2019
"1596725",920,58,80,1058,86.96,5.48,7.56,2019
"1596732",6325,217,1125,7667,82.5,2.83,14.67,2019
"1596734",14600,272,929,15801,92.4,1.72,5.88,2019
"1596749",4573,276,1055,5904,77.46,4.67,17.87,2019
"1596755",854,10,202,1066,80.11,0.94,18.95,2019
"1596756",1806,46,282,2134,84.63,2.16,13.21,2019
"1596769",48,0,60,108,44.44,0,55.56,2019
"1596774",84,9,26,119,70.59,7.56,21.85,2019
"1596778",4125,155,1516,5796,71.17,2.67,26.16,2019
"1596779",692,16,89,797,86.83,2.01,11.17,2019
"1596786",10938,352,1485,12775,85.62,2.76,11.62,2019
"1596797",16106,672,2004,18782,85.75,3.58,10.67,2019
"1596826",11810,511,2397,14718,80.24,3.47,16.29,2019
"0696015",40,0,0,40,100,0,0,2019
"0696024",252,0,171,423,59.57,0,40.43,2019
"0696028",412,0,147,559,73.7,0,26.3,2019
"0696003",15056,638,2716,18410,81.78,3.47,14.75,2019
"0696025",822,18,163,1003,81.95,1.79,16.25,2019
"0696055",1096,42,399,1537,71.31,2.73,25.96,2019
"0696033",140,19,50,209,66.99,9.09,23.92,2019
"0696034",106,2,28,136,77.94,1.47,20.59,2019
"0696040",53,0,10,63,84.13,0,15.87,2019
"0696058",147,1,47,195,75.38,0.51,24.1,2019
"0696068",22,0,27,49,44.9,0,55.1,2019
"1596708",3176,256,356,3788,83.84,6.76,9.4,2019
"1596710",86,0,75,161,53.42,0,46.58,2019
"1596737",988,105,547,1640,60.24,6.4,33.35,2019
"1596747",175,8,57,240,72.92,3.33,23.75,2019
"1596757",142,0,71,213,66.67,0,33.33,2019
"1596759",0,33,87,120,0,27.5,72.5,2019
"1596764",185,14,51,250,74,5.6,20.4,2019
"1596780",116,17,62,195,59.49,8.72,31.79,2019
"1596790",3088,59,317,3464,89.15,1.7,9.15,2019
"1596816",14724,408,2093,17225,85.48,2.37,12.15,2019
"0695466",272,31,34,337,80.71,9.2,10.09,2019
"0695490",4273,83,879,5235,81.62,1.59,16.79,2019
"0695551",458,37,75,570,80.35,6.49,13.16,2019
"0695562",1084,8,244,1336,81.14,0.6,18.26,2019
"0695587",10,0,31,41,24.39,0,75.61,2019
"0695601",49,10,9,68,72.06,14.71,13.24,2019
"0695620",6232,75,396,6703,92.97,1.12,5.91,2019
"0695132",11134,229,677,12040,92.48,1.9,5.62,2019
"0695135",7050,101,397,7548,93.4,1.34,5.26,2019
"0695136",14621,335,744,15700,93.13,2.13,4.74,2019
"0695212",6247,182,757,7186,86.93,2.53,10.53,2019
"0695227",189,0,33,222,85.14,0,14.86,2019
"0695305",0,0,0,0,NA,NA,NA,2019
"0695312",41,0,29,70,58.57,0,41.43,2019
"4215062",2470,185,780,3435,71.91,5.39,22.71,2019
"4215065",3896,147,935,4978,78.26,2.95,18.78,2019
"4215102",11062,184,1172,12418,89.08,1.48,9.44,2019
"4215106",7984,133,1455,9572,83.41,1.39,15.2,2019
"4215129",3983,97,330,4410,90.32,2.2,7.48,2019
"4215140",1090,36,332,1458,74.76,2.47,22.77,2019
"4215203",4741,117,783,5641,84.05,2.07,13.88,2019
"4215323",1431,29,316,1776,80.57,1.63,17.79,2019
"4215342",1934,28,211,2173,89,1.29,9.71,2019
"4215641",173,2,56,231,74.89,0.87,24.24,2019
"4215665",499,0,68,567,88.01,0,11.99,2019
"4215681",1394,68,384,1846,75.51,3.68,20.8,2019
"4215722",745,16,162,923,80.72,1.73,17.55,2019
"4215728",1077,19,319,1415,76.11,1.34,22.54,2019
"4215731",48,0,53,101,47.52,0,52.48,2019
"4215734",96,18,78,192,50,9.38,40.62,2019
"4215741",22,0,6,28,78.57,0,21.43,2019
"4215744",43,0,11,54,79.63,0,20.37,2019
"4215752",0,17,0,17,0,100,0,2019
"4215824",1665,25,471,2161,77.05,1.16,21.8,2019
"4215846",1315,64,139,1518,86.63,4.22,9.16,2019
"4215906",3525,75,1279,4879,72.25,1.54,26.21,2019
"4215937",263,0,36,299,87.96,0,12.04,2019
"4215940",574,5,103,682,84.16,0.73,15.1,2019
"4215957",164,0,90,254,64.57,0,35.43,2019
"4215634",166,0,39,205,80.98,0,19.02,2019
"4215656",3502,129,668,4299,81.46,3,15.54,2019
"4215663",197,0,30,227,86.78,0,13.22,2019
"4215666",5460,197,1123,6780,80.53,2.91,16.56,2019
"4215670",976,93,331,1400,69.71,6.64,23.64,2019
"4215923",484,7,178,669,72.35,1.05,26.61,2019
"4215926",830,13,227,1070,77.57,1.21,21.21,2019
"4215935",972,70,358,1400,69.43,5,25.57,2019
"4215961",229,0,75,304,75.33,0,24.67,2019
"4215762",268,7,58,333,80.48,2.1,17.42,2019
"4215760",48,0,17,65,73.85,0,26.15,2019
"4215767",4271,129,1528,5928,72.05,2.18,25.78,2019
"4215773",134,3,45,182,73.63,1.65,24.73,2019
"4215655",93,1,5,99,93.94,1.01,5.05,2019
"4215658",3415,31,587,4033,84.68,0.77,14.55,2019
"4215662",96,0,16,112,85.71,0,14.29,2019
"4215672",1221,44,148,1413,86.41,3.11,10.47,2019
"4215677",120,0,50,170,70.59,0,29.41,2019
"4215683",2674,136,610,3420,78.19,3.98,17.84,2019
"4215686",305,3,11,319,95.61,0.94,3.45,2019
"5005050",64,0,0,64,100,0,0,2019
"5005141",59,2,47,108,54.63,1.85,43.52,2019
"5005405",0,0,0,0,NA,NA,NA,2019
"5005408",3562,185,336,4083,87.24,4.53,8.23,2019
"5005439",0,0,0,0,NA,NA,NA,2019
"5005447",24,0,6,30,80,0,20,2019
"5005481",0,0,0,0,NA,NA,NA,2019
"5005485",30,0,0,30,100,0,0,2019
"5005740",0,0,27,27,0,0,100,2019
"5005850",59,0,0,59,100,0,0,2019
"5005862",105,0,21,126,83.33,0,16.67,2019
"5005901",4,0,3,7,57.14,0,42.86,2019
"0906807",2618,20,41,2679,97.72,0.75,1.53,2019
"0906810",15775,483,2760,19018,82.95,2.54,14.51,2019
"2501543",2629,131,125,2885,91.13,4.54,4.33,2019
"2501545",12180,294,1068,13542,89.94,2.17,7.89,2019
"2501569",4683,65,308,5056,92.62,1.29,6.09,2019
"2501604",12362,462,2001,14825,83.39,3.12,13.5,2019
"2501752",14535,191,1004,15730,92.4,1.21,6.38,2019
"2501801",14134,333,1484,15951,88.61,2.09,9.3,2019
"2501826",10124,213,1133,11470,88.27,1.86,9.88,2019
"2501907",5221,75,579,5875,88.87,1.28,9.86,2019
"2501949",2865,12,122,2999,95.53,0.4,4.07,2019
"2501951",1279,31,44,1354,94.46,2.29,3.25,2019
"2501840",1301,70,894,2265,57.44,3.09,39.47,2019
"2501841",10693,368,4088,15149,70.59,2.43,26.99,2019
"2501851",7671,289,2248,10208,75.15,2.83,22.02,2019
"2501867",8564,156,455,9175,93.34,1.7,4.96,2019
"2501938",4939,150,672,5761,85.73,2.6,11.66,2019
"2501982",2546,34,139,2719,93.64,1.25,5.11,2019
"2501720",7895,150,485,8530,92.56,1.76,5.69,2019
"2501742",6162,161,315,6638,92.83,2.43,4.75,2019
"2501747",1910,30,241,2181,87.57,1.38,11.05,2019
"2501756",1938,13,108,2059,94.12,0.63,5.25,2019
"2501834",2205,90,153,2448,90.07,3.68,6.25,2019
"2501062",3516,190,465,4171,84.3,4.56,11.15,2019
"2501068",628,10,50,688,91.28,1.45,7.27,2019
"2501071",425,46,55,526,80.8,8.75,10.46,2019
"2501072",512,8,110,630,81.27,1.27,17.46,2019
"2501073",2270,0,136,2406,94.35,0,5.65,2019
"2501075",5780,279,557,6616,87.36,4.22,8.42,2019
"2501096",855,87,118,1060,80.66,8.21,11.13,2019
"2501223",862,40,165,1067,80.79,3.75,15.46,2019
"2501264",55,0,25,80,68.75,0,31.25,2019
"2501342",318,0,47,365,87.12,0,12.88,2019
"2501240",1581,240,277,2098,75.36,11.44,13.2,2019
"2501242",160,0,0,160,100,0,0,2019
"2501256",242,2,49,293,82.59,0.68,16.72,2019
"2501267",2056,52,264,2372,86.68,2.19,11.13,2019
"2501344",467,10,69,546,85.53,1.83,12.64,2019
"2501349",414,3,83,500,82.8,0.6,16.6,2019
"2501355",310,12,76,398,77.89,3.02,19.1,2019
"2501360",1034,20,171,1225,84.41,1.63,13.96,2019
"2501420",12344,474,2147,14965,82.49,3.17,14.35,2019
"2501431",1060,20,87,1167,90.83,1.71,7.46,2019
"2501451",1624,0,0,1624,100,0,0,2019
"2501467",73,0,38,111,65.77,0,34.23,2019
"2501473",2555,210,105,2870,89.02,7.32,3.66,2019
"2501506",1135,57,212,1404,80.84,4.06,15.1,2019
"2304862",1284,37,241,1562,82.2,2.37,15.43,2019
"2304863",367,4,67,438,83.79,0.91,15.3,2019
"2304694",806,16,148,970,83.09,1.65,15.26,2019
"2304756",1097,110,407,1614,67.97,6.82,25.22,2019
"2304768",143,16,34,193,74.09,8.29,17.62,2019
"2304780",204,11,120,335,60.9,3.28,35.82,2019
"2304781",164,22,56,242,67.77,9.09,23.14,2019
"2304786",449,154,215,818,54.89,18.83,26.28,2019
"2304852",25,3,1,29,86.21,10.34,3.45,2019
"2304861",1069,56,127,1252,85.38,4.47,10.14,2019
"2304917",963,7,110,1080,89.17,0.65,10.19,2019
"2304921",516,18,125,659,78.3,2.73,18.97,2019
"2304950",1638,88,174,1900,86.21,4.63,9.16,2019
"2304971",633,33,100,766,82.64,4.31,13.05,2019
"7200670",1079,39,1562,2680,40.26,1.46,58.28,2019
"7200687",6770,267,2608,9645,70.19,2.77,27.04,2019
"7200693",8614,289,10132,19035,45.25,1.52,53.23,2019
"7200714",3691,73,2135,5899,62.57,1.24,36.19,2019
"7200716",6634,400,4026,11060,59.98,3.62,36.4,2019
"7200719",3956,159,4483,8598,46.01,1.85,52.14,2019
"7200725",20563,221,9472,30256,67.96,0.73,31.31,2019
"7200731",2013,167,2181,4361,46.16,3.83,50.01,2019
"7200736",11608,496,5134,17238,67.34,2.88,29.78,2019
"7200740",547,14,179,740,73.92,1.89,24.19,2019
"7200780",2374,0,1608,3982,59.62,0,40.38,2019
"7200924",10441,405,8384,19230,54.3,2.11,43.6,2019
"7200926",21964,688,13462,36114,60.82,1.91,37.28,2019
"7200934",29,0,0,29,100,0,0,2019
"7200959",14216,332,3137,17685,80.38,1.88,17.74,2019
"7200976",15395,353,5676,21424,71.86,1.65,26.49,2019
"7200606",586,38,1322,1946,30.11,1.95,67.93,2019
"7200610",5240,458,3097,8795,59.58,5.21,35.21,2019
"7200646",6044,457,5151,11652,51.87,3.92,44.21,2019
"7200653",1696,177,1723,3596,47.16,4.92,47.91,2019
"7200766",5633,174,2264,8071,69.79,2.16,28.05,2019
"7200773",4742,36,1804,6582,72.04,0.55,27.41,2019
"7200775",323,35,116,474,68.14,7.38,24.47,2019
"7200777",9697,147,2938,12782,75.86,1.15,22.99,2019
"7200901",1619,220,921,2760,58.66,7.97,33.37,2019
"7200741",840,112,372,1324,63.44,8.46,28.1,2019
"7200971",5539,78,3040,8657,63.98,0.9,35.12,2019
"7200680",11194,399,6771,18364,60.96,2.17,36.87,2019
"7200778",11234,208,3056,14498,77.49,1.43,21.08,2019
"7200962",3540,118,3171,6829,51.84,1.73,46.43,2019
"7200631",173,0,456,629,27.5,0,72.5,2019
"7200965",1093,28,1393,2514,43.48,1.11,55.41,2019
"7200659",8519,614,5027,14160,60.16,4.34,35.5,2019
"7200784",8270,360,5078,13708,60.33,2.63,37.04,2019
"7200694",0,17,13,30,0,56.67,43.33,2019
"7200727",14406,118,4728,19252,74.83,0.61,24.56,2019
"7200786",29,0,70,99,29.29,0,70.71,2019
"7200936",0,0,0,0,NA,NA,NA,2019
"7200950",0,0,0,0,NA,NA,NA,2019
"7200951",0,0,0,0,NA,NA,NA,2019
"7200960",0,0,0,0,NA,NA,NA,2019
"2502476",6620,100,762,7482,88.48,1.34,10.18,2019
"2502493",3522,61,204,3787,93,1.61,5.39,2019
"2502575",837,127,104,1068,78.37,11.89,9.74,2019
"2502576",1598,13,187,1798,88.88,0.72,10.4,2019
"2502655",1262,46,114,1422,88.75,3.23,8.02,2019
"2502657",1435,77,190,1702,84.31,4.52,11.16,2019
"2502673",3056,109,445,3610,84.65,3.02,12.33,2019
"2502675",2730,106,260,3096,88.18,3.42,8.4,2019
"2502702",1381,57,88,1526,90.5,3.74,5.77,2019
"2502769",3799,111,250,4160,91.32,2.67,6.01,2019
"4402804",503,58,138,699,71.96,8.3,19.74,2019
"4402814",2550,62,366,2978,85.63,2.08,12.29,2019
"4402817",2164,22,70,2256,95.92,0.98,3.1,2019
"4402822",2088,17,196,2301,90.74,0.74,8.52,2019
"0695313",346,5,95,446,77.58,1.12,21.3,2019
"0695317",236,24,81,341,69.21,7.04,23.75,2019
"0695404",14811,455,1074,16340,90.64,2.78,6.57,2019
"0695415",385,17,40,442,87.1,3.85,9.05,2019
"0695420",152,0,29,181,83.98,0,16.02,2019
"0695445",918,37,113,1068,85.96,3.46,10.58,2019
"0695449",393,36,113,542,72.51,6.64,20.85,2019
"0695974",16,0,0,16,100,0,0,2019
"0695005",2457,66,151,2674,91.88,2.47,5.65,2019
"0695008",16289,440,1149,17878,91.11,2.46,6.43,2019
"0695018",2636,64,149,2849,92.52,2.25,5.23,2019
"0695020",17028,290,1274,18592,91.59,1.56,6.85,2019
"0695041",77,0,23,100,77,0,23,2019
"0695051",20501,332,846,21679,94.57,1.53,3.9,2019
"0695064",259,154,8,421,61.52,36.58,1.9,2019
"0695065",2937,10,273,3220,91.21,0.31,8.48,2019
"0695110",5987,56,504,6547,91.45,0.86,7.7,2019
"0695111",14317,444,1408,16169,88.55,2.75,8.71,2019
"0695124",16291,187,771,17249,94.45,1.08,4.47,2019
"0695125",19309,247,1532,21088,91.56,1.17,7.26,2019
"0695131",9341,29,330,9700,96.3,0.3,3.4,2019
"0695133",7707,147,920,8774,87.84,1.68,10.49,2019
"0695215",4277,269,2066,6612,64.69,4.07,31.25,2019
"0695223",1067,33,174,1274,83.75,2.59,13.66,2019
"0695224",65,20,0,85,76.47,23.53,0,2019
"0695303",333,4,34,371,89.76,1.08,9.16,2019
"0695318",87,0,32,119,73.11,0,26.89,2019
"0695321",1384,67,230,1681,82.33,3.99,13.68,2019
"0695327",1961,66,526,2553,76.81,2.59,20.6,2019
"0695340",10496,163,1142,11801,88.94,1.38,9.68,2019
"0695348",9120,115,1282,10517,86.72,1.09,12.19,2019
"0695571",90,0,38,128,70.31,0,29.69,2019
"0695240",13953,333,2192,16478,84.68,2.02,13.3,2019
"0695366",5354,235,546,6135,87.27,3.83,8.9,2019
"0695367",6238,98,881,7217,86.43,1.36,12.21,2019
"0695374",461,8,100,569,81.02,1.41,17.57,2019
"0695382",11735,185,1600,13520,86.8,1.37,11.83,2019
"0695439",188,6,26,220,85.45,2.73,11.82,2019
"0695444",194,0,20,214,90.65,0,9.35,2019
"0695323",314,4,92,410,76.59,0.98,22.44,2019
"0695465",910,24,160,1094,83.18,2.19,14.63,2019
"0695672",1583,88,282,1953,81.05,4.51,14.44,2019
"0695834",9827,141,645,10613,92.59,1.33,6.08,2019
"0695460",1028,0,239,1267,81.14,0,18.86,2019
"0695494",64,0,0,64,100,0,0,2019
"3303848",2169,63,179,2411,89.96,2.61,7.42,2019
"3303849",452,20,63,535,84.49,3.74,11.78,2019
"3303854",385,13,38,436,88.3,2.98,8.72,2019
"3303864",592,40,154,786,75.32,5.09,19.59,2019
"3303087",4737,82,190,5009,94.57,1.64,3.79,2019
"3303103",12270,319,1650,14239,86.17,2.24,11.59,2019
"3303109",3857,16,227,4100,94.07,0.39,5.54,2019
"3303234",1591,27,169,1787,89.03,1.51,9.46,2019
"3303033",1670,19,47,1736,96.2,1.09,2.71,2019
"3303057",905,0,20,925,97.84,0,2.16,2019
"3303060",10290,377,1585,12252,83.99,3.08,12.94,2019
"3303082",601,13,53,667,90.1,1.95,7.95,2019
"3303076",4458,32,342,4832,92.26,0.66,7.08,2019
"3303301",11272,331,1803,13406,84.08,2.47,13.45,2019
"0906820",6440,104,351,6895,93.4,1.51,5.09,2019
"0906897",5854,15,221,6090,96.12,0.25,3.63,2019
"0906604",7503,384,1984,9871,76.01,3.89,20.1,2019
"0906469",1049,64,81,1194,87.86,5.36,6.78,2019
"0906475",4075,18,250,4343,93.83,0.41,5.76,2019
"0906484",14029,404,1752,16185,86.68,2.5,10.82,2019
"0906612",2672,0,120,2792,95.7,0,4.3,2019
"0906615",5806,313,1189,7308,79.45,4.28,16.27,2019
"0906712",3030,49,257,3336,90.83,1.47,7.7,2019
"0906831",4858,60,130,5048,96.24,1.19,2.58,2019
"0906851",9637,188,745,10570,91.17,1.78,7.05,2019
"0906853",1391,25,109,1525,91.21,1.64,7.15,2019
"0906854",9847,280,915,11042,89.18,2.54,8.29,2019
"0906878",2413,30,141,2584,93.38,1.16,5.46,2019
"0906903",4656,14,82,4752,97.98,0.29,1.73,2019
"0906403",2236,87,124,2447,91.38,3.56,5.07,2019
"0906415",5716,48,480,6244,91.54,0.77,7.69,2019
"0906422",2481,113,174,2768,89.63,4.08,6.29,2019
"0906441",1697,82,95,1874,90.55,4.38,5.07,2019
"0906468",5965,221,487,6673,89.39,3.31,7.3,2019
"0906488",6688,429,849,7966,83.96,5.39,10.66,2019
"0906492",15571,556,2561,18688,83.32,2.98,13.7,2019
"0906607",2169,84,538,2791,77.71,3.01,19.28,2019
"0906754",698,7,19,724,96.41,0.97,2.62,2019
"0906755",307,0,15,322,95.34,0,4.66,2019
"0906255",1464,32,231,1727,84.77,1.85,13.38,2019
"0906256",814,11,73,898,90.65,1.22,8.13,2019
"0906262",220,0,148,368,59.78,0,40.22,2019
"0906268",3117,360,292,3769,82.7,9.55,7.75,2019
"0906339",3045,22,144,3211,94.83,0.69,4.48,2019
"0906377",1005,0,154,1159,86.71,0,13.29,2019
"0906382",3590,45,477,4112,87.31,1.09,11.6,2019
"0906385",5616,59,665,6340,88.58,0.93,10.49,2019
"0906118",8541,220,1419,10180,83.9,2.16,13.94,2019
"0906239",3596,173,860,4629,77.68,3.74,18.58,2019
"0906330",1079,24,144,1247,86.53,1.92,11.55,2019
"0906371",3847,62,256,4165,92.36,1.49,6.15,2019
"0906374",2273,109,464,2846,79.87,3.83,16.3,2019
"3606390",34,0,6,40,85,0,15,2019
"0906410",8975,355,815,10145,88.47,3.5,8.03,2019
"0906413",4831,99,458,5388,89.66,1.84,8.5,2019
"0906418",3943,140,1115,5198,75.86,2.69,21.45,2019
"0906437",7732,166,499,8397,92.08,1.98,5.94,2019
"0906438",933,0,146,1079,86.47,0,13.53,2019
"0906022",63,0,0,63,100,0,0,2019
"3610527",290,0,26,316,91.77,0,8.23,2019
"3610533",2477,42,100,2619,94.58,1.6,3.82,2019
"3610538",5535,0,277,5812,95.23,0,4.77,2019
"3610547",2301,0,219,2520,91.31,0,8.69,2019
"3610548",1145,59,117,1321,86.68,4.47,8.86,2019
"3610567",6208,162,397,6767,91.74,2.39,5.87,2019
"3610570",3605,56,388,4049,89.03,1.38,9.58,2019
"3610606",5079,113,440,5632,90.18,2.01,7.81,2019
"3610801",11653,693,2412,14758,78.96,4.7,16.34,2019
"3610803",3612,137,257,4006,90.16,3.42,6.42,2019
"3610804",4889,24,211,5124,95.41,0.47,4.12,2019
"3610805",6223,271,1108,7602,81.86,3.56,14.58,2019
"3610916",1141,16,111,1268,89.98,1.26,8.75,2019
"3610927",2966,116,651,3733,79.45,3.11,17.44,2019
"2304859",320,12,6,338,94.67,3.55,1.78,2019
"2304969",386,23,74,483,79.92,4.76,15.32,2019
"2304979",331,12,35,378,87.57,3.17,9.26,2019
"2304983",494,42,111,647,76.35,6.49,17.16,2019
"2304986",534,15,94,643,83.05,2.33,14.62,2019
"2304987",328,13,63,404,81.19,3.22,15.59,2019
"2304024",174,3,34,211,82.46,1.42,16.11,2019
"2304032",3212,10,225,3447,93.18,0.29,6.53,2019
"2304040",1119,48,251,1418,78.91,3.39,17.7,2019
"2304294",1194,46,361,1601,74.58,2.87,22.55,2019
"2304005",7763,223,1730,9716,79.9,2.3,17.81,2019
"2304009",1939,64,408,2411,80.42,2.65,16.92,2019
"2304020",513,12,94,619,82.88,1.94,15.19,2019
"2304039",2868,58,328,3254,88.14,1.78,10.08,2019
"2304049",1190,0,140,1330,89.47,0,10.53,2019
"2304066",295,0,54,349,84.53,0,15.47,2019
"2304076",963,34,81,1078,89.33,3.15,7.51,2019
"2304079",1597,58,100,1755,91,3.3,5.7,2019
"2304084",2416,41,177,2634,91.72,1.56,6.72,2019
"2304088",488,13,71,572,85.31,2.27,12.41,2019
"2304096",3001,84,324,3409,88.03,2.46,9.5,2019
"2304097",1302,19,76,1397,93.2,1.36,5.44,2019
"2304101",7481,568,1037,9086,82.34,6.25,11.41,2019
"2304216",164,4,43,211,77.73,1.9,20.38,2019
"2502324",7406,229,498,8133,91.06,2.82,6.12,2019
"2502038",11205,138,598,11941,93.84,1.16,5.01,2019
"2502045",4211,109,445,4765,88.37,2.29,9.34,2019
"2502054",2969,33,159,3161,93.93,1.04,5.03,2019
"2502067",5962,39,325,6326,94.25,0.62,5.14,2019
"2502108",1992,11,88,2091,95.27,0.53,4.21,2019
"2502120",4022,165,739,4926,81.65,3.35,15,2019
"2502135",17200,481,1887,19568,87.9,2.46,9.64,2019
"2502301",16557,476,4053,21086,78.52,2.26,19.22,2019
"2502330",3766,165,558,4489,83.89,3.68,12.43,2019
"2502370",6123,267,569,6959,87.99,3.84,8.18,2019
"2502421",6464,30,281,6775,95.41,0.44,4.15,2019
"2502461",2565,0,92,2657,96.54,0,3.46,2019
"2502467",6035,43,324,6402,94.27,0.67,5.06,2019
"2502115",7568,155,1413,9136,82.84,1.7,15.47,2019
"2502030",2001,0,30,2031,98.52,0,1.48,2019
"2502081",6566,94,483,7143,91.92,1.32,6.76,2019
"2502109",1928,11,37,1976,97.57,0.56,1.87,2019
"2502149",13483,355,2183,16021,84.16,2.22,13.63,2019
"2502151",15666,729,2837,19232,81.46,3.79,14.75,2019
"2502170",6771,90,1009,7870,86.04,1.14,12.82,2019
"0572928",170,23,113,306,55.56,7.52,36.93,2019
"0572354",617,57,263,937,65.85,6.08,28.07,2019
"0572412",179,0,90,269,66.54,0,33.46,2019
"0572019",8377,129,1130,9636,86.93,1.34,11.73,2019
"0572034",16060,1037,1804,18901,84.97,5.49,9.54,2019
"0572035",0,0,0,0,NA,NA,NA,2019
"0572037",1,0,12,13,7.69,0,92.31,2019
"0572059",8,0,12,20,40,0,60,2019
"0572119",0,0,0,0,NA,NA,NA,2019
"0572149",0,0,0,0,NA,NA,NA,2019
"0572325",11,0,2,13,84.62,0,15.38,2019
"0572546",62,9,10,81,76.54,11.11,12.35,2019
"0572636",3,0,0,3,100,0,0,2019
"0572670",40,0,0,40,100,0,0,2019
"4402835",2100,73,128,2301,91.26,3.17,5.56,2019
"2502718",2116,98,157,2371,89.25,4.13,6.62,2019
"2502719",5406,118,868,6392,84.57,1.85,13.58,2019
"2502724",5144,663,2082,7889,65.2,8.4,26.39,2019
"2502739",2403,56,189,2648,90.75,2.11,7.14,2019
"2502740",13752,513,3731,17996,76.42,2.85,20.73,2019
"2502762",3318,32,316,3666,90.51,0.87,8.62,2019
"2502767",4739,120,444,5303,89.36,2.26,8.37,2019
"2502779",2111,66,207,2384,88.55,2.77,8.68,2019
"4402813",2963,19,300,3282,90.28,0.58,9.14,2019
"4402840",8659,411,1197,10267,84.34,4,11.66,2019
"4402836",56,0,0,56,100,0,0,2019
"4402837",1384,14,163,1561,88.66,0.9,10.44,2019
"4402858",220,0,13,233,94.42,0,5.58,2019
"4402882",5241,129,500,5870,89.28,2.2,8.52,2019
"4402891",7888,535,910,9333,84.52,5.73,9.75,2019
"4402842",5788,243,837,6868,84.27,3.54,12.19,2019
"4402861",8679,200,1216,10095,85.97,1.98,12.05,2019
"4402906",9800,233,654,10687,91.7,2.18,6.12,2019
"4402905",7132,346,1402,8880,80.32,3.9,15.79,2019
"2502026",8911,239,876,10026,88.88,2.38,8.74,2019
"2502032",1369,14,42,1425,96.07,0.98,2.95,2019
"2502053",4493,45,197,4735,94.89,0.95,4.16,2019
"2502090",5146,45,350,5541,92.87,0.81,6.32,2019
"2502093",3909,114,235,4258,91.8,2.68,5.52,2019
"2502141",5986,111,828,6925,86.44,1.6,11.96,2019
"2502144",9446,341,899,10686,88.4,3.19,8.41,2019
"2502359",6154,75,334,6563,93.77,1.14,5.09,2019
"2502646",913,0,104,1017,89.77,0,10.23,2019
"2502647",52,0,0,52,100,0,0,2019
"2502649",5629,76,655,6360,88.51,1.19,10.3,2019
"2502744",3454,161,983,4598,75.12,3.5,21.38,2019
"2502746",4145,173,1817,6135,67.56,2.82,29.62,2019
"2502748",4168,119,491,4778,87.23,2.49,10.28,2019
"2502760",9474,270,736,10480,90.4,2.58,7.02,2019
"2502766",6007,161,402,6570,91.43,2.45,6.12,2019
"2502770",1765,21,102,1888,93.49,1.11,5.4,2019
"2502184",12547,308,1161,14016,89.52,2.2,8.28,2019
"2502186",8035,128,712,8875,90.54,1.44,8.02,2019
"2502188",5590,266,639,6495,86.07,4.1,9.84,2019
"2502420",4796,22,218,5036,95.23,0.44,4.33,2019
"2502465",3861,57,249,4167,92.66,1.37,5.98,2019
"2502466",2708,87,164,2959,91.52,2.94,5.54,2019
"2502472",14356,293,1035,15684,91.53,1.87,6.6,2019
"2502534",234,41,16,291,80.41,14.09,5.5,2019
"5398001",10406,176,665,11247,92.52,1.56,5.91,2019
"5398273",9843,212,1127,11182,88.03,1.9,10.08,2019
"5398277",14479,295,1051,15825,91.49,1.86,6.64,2019
"5398283",137,24,0,161,85.09,14.91,0,2019
"5398290",11843,140,1090,13073,90.59,1.07,8.34,2019
"5398294",2381,53,265,2699,88.22,1.96,9.82,2019
"5398320",483,20,126,629,76.79,3.18,20.03,2019
"5398328",3331,57,439,3827,87.04,1.49,11.47,2019
"5398330",67,0,0,67,100,0,0,2019
"5398365",2223,67,200,2490,89.28,2.69,8.03,2019
"5398368",6694,226,699,7619,87.86,2.97,9.17,2019
"5398387",14400,294,1624,16318,88.25,1.8,9.95,2019
"5398396",238,21,23,282,84.4,7.45,8.16,2019
"5398402",2930,151,523,3604,81.3,4.19,14.51,2019
"3303766",3516,176,532,4224,83.24,4.17,12.59,2019
"3303048",1171,36,237,1444,81.09,2.49,16.41,2019
"3303227",407,12,47,466,87.34,2.58,10.09,2019
"3303457",277,4,23,304,91.12,1.32,7.57,2019
"3303782",1081,31,101,1213,89.12,2.56,8.33,2019
"3303853",219,0,16,235,93.19,0,6.81,2019
"3303601",143,11,30,184,77.72,5.98,16.3,2019
"3303779",294,6,32,332,88.55,1.81,9.64,2019
"3303852",188,0,0,188,100,0,0,2019
"3303047",526,29,144,699,75.25,4.15,20.6,2019
"3303255",879,12,39,930,94.52,1.29,4.19,2019
"3303456",271,14,42,327,82.87,4.28,12.84,2019
"3303079",10308,141,1087,11536,89.36,1.22,9.42,2019
"3303254",1588,45,141,1774,89.52,2.54,7.95,2019
"3303304",2591,38,94,2723,95.15,1.4,3.45,2019
"3303046",890,14,34,938,94.88,1.49,3.62,2019
"3303231",96,21,19,136,70.59,15.44,13.97,2019
"3303238",38,0,1,39,97.44,0,2.56,2019
"3303245",665,43,73,781,85.15,5.51,9.35,2019
"3303249",2813,42,193,3048,92.29,1.38,6.33,2019
"3303258",878,48,48,974,90.14,4.93,4.93,2019
"3303285",831,35,95,961,86.47,3.64,9.89,2019
"3303293",78,0,8,86,90.7,0,9.3,2019
"3303575",7,0,0,7,100,0,0,2019
"3303586",239,11,22,272,87.87,4.04,8.09,2019
"3303593",172,12,12,196,87.76,6.12,6.12,2019
"3303032",1910,23,40,1973,96.81,1.17,2.03,2019
"3303037",1406,76,143,1625,86.52,4.68,8.8,2019
"3303042",2364,91,225,2680,88.21,3.4,8.4,2019
"3303044",1653,31,71,1755,94.19,1.77,4.05,2019
"3303049",2836,0,132,2968,95.55,0,4.45,2019
"3303062",10686,118,617,11421,93.56,1.03,5.4,2019
"3303086",1336,57,216,1609,83.03,3.54,13.42,2019
"3303110",7464,38,311,7813,95.53,0.49,3.98,2019
"3303225",1190,8,124,1322,90.02,0.61,9.38,2019
"3303261",1498,36,97,1631,91.85,2.21,5.95,2019
"3303268",452,5,43,500,90.4,1,8.6,2019
"3303291",25,0,12,37,67.57,0,32.43,2019
"3303449",684,29,72,785,87.13,3.69,9.17,2019
"3303458",2900,73,235,3208,90.4,2.28,7.33,2019
"3303031",4048,36,115,4199,96.4,0.86,2.74,2019
"3303038",11784,295,789,12868,91.58,2.29,6.13,2019
"3303045",4474,61,505,5040,88.77,1.21,10.02,2019
"3303102",11558,450,1483,13491,85.67,3.34,10.99,2019
"3303106",4835,93,316,5244,92.2,1.77,6.03,2019
"5005464",1122,57,116,1295,86.64,4.4,8.96,2019
"5005465",1770,190,109,2069,85.55,9.18,5.27,2019
"5005472",617,14,82,713,86.54,1.96,11.5,2019
"5005487",573,5,40,618,92.72,0.81,6.47,2019
"5005489",1069,184,74,1327,80.56,13.87,5.58,2019
"5005491",2040,64,253,2357,86.55,2.72,10.73,2019
"5005602",4547,225,581,5353,84.94,4.2,10.85,2019
"5005070",231,0,16,247,93.52,0,6.48,2019
"5005053",157,0,9,166,94.58,0,5.42,2019
"5005058",133,8,19,160,83.12,5,11.88,2019
"5005059",162,0,19,181,89.5,0,10.5,2019
"5005072",159,0,30,189,84.13,0,15.87,2019
"5005101",1391,169,379,1939,71.74,8.72,19.55,2019
"5005146",221,0,59,280,78.93,0,21.07,2019
"3610940",12691,2961,2423,18075,70.21,16.38,13.41,2019
"3610977",10223,514,5532,16269,62.84,3.16,34,2019
"3610980",4442,55,301,4798,92.58,1.15,6.27,2019
"3610998",881,0,86,967,91.11,0,8.89,2019
"3610004",1756,21,0,1777,98.82,1.18,0,2019
"3610025",35461,1199,4695,41355,85.75,2.9,11.35,2019
"3610030",10359,507,1822,12688,81.64,4,14.36,2019
"3610037",7499,247,1835,9581,78.27,2.58,19.15,2019
"3610552",6502,843,1227,8572,75.85,9.83,14.31,2019
"3610577",803,8,18,829,96.86,0.97,2.17,2019
"3610589",3468,39,313,3820,90.79,1.02,8.19,2019
"3610595",2118,76,160,2354,89.97,3.23,6.8,2019
"3610601",4707,151,410,5268,89.35,2.87,7.78,2019
"3610603",6474,50,516,7040,91.96,0.71,7.33,2019
"3610901",7639,143,827,8609,88.73,1.66,9.61,2019
"3610917",519,0,8,527,98.48,0,1.52,2019
"3610918",3822,72,273,4167,91.72,1.73,6.55,2019
"3610969",384,11,61,456,84.21,2.41,13.38,2019
"3610974",1002,25,100,1127,88.91,2.22,8.87,2019
"3610983",1792,37,132,1961,91.38,1.89,6.73,2019
"3610271",0,0,0,0,NA,NA,NA,2019
"3610312",18519,731,2068,21318,86.87,3.43,9.7,2019
"3610452",18863,1147,6427,26437,71.35,4.34,24.31,2019
"3610462",23971,1035,4530,29536,81.16,3.5,15.34,2019
"3610473",16158,1038,3993,21189,76.26,4.9,18.84,2019
"3610501",356,8,59,423,84.16,1.89,13.95,2019
"3610506",1829,21,0,1850,98.86,1.14,0,2019
"3610005",4363,0,0,4363,100,0,0,2019
"3610010",15299,304,1212,16815,90.98,1.81,7.21,2019
"3610016",26822,463,1915,29200,91.86,1.59,6.56,2019
"3610017",9062,285,316,9663,93.78,2.95,3.27,2019
"3610026",12870,301,2308,15479,83.14,1.94,14.91,2019
"3610033",16398,349,3086,19833,82.68,1.76,15.56,2019
"3610069",3066,50,114,3230,94.92,1.55,3.53,2019
"3610111",0,0,0,0,NA,NA,NA,2019
"3610115",0,0,0,0,NA,NA,NA,2019
"3610128",27309,535,2225,30069,90.82,1.78,7.4,2019
"3610153",0,0,0,0,NA,NA,NA,2019
"3610169",0,0,0,0,NA,NA,NA,2019
"3610310",6396,244,1886,8526,75.02,2.86,22.12,2019
"3610576",1767,0,41,1808,97.73,0,2.27,2019
"3610549",5182,110,499,5791,89.48,1.9,8.62,2019
"3610553",2388,691,273,3352,71.24,20.61,8.14,2019
"3610560",1530,77,76,1683,90.91,4.58,4.52,2019
"3610580",5609,19,356,5984,93.73,0.32,5.95,2019
"3612913",406,8,96,510,79.61,1.57,18.82,2019
"3612926",693,31,254,978,70.86,3.17,25.97,2019
"3612942",376,0,16,392,95.92,0,4.08,2019
"3612945",154,23,25,202,76.24,11.39,12.38,2019
"3612952",78,4,47,129,60.47,3.1,36.43,2019
"3612953",3553,320,854,4727,75.16,6.77,18.07,2019
"3612955",101,0,57,158,63.92,0,36.08,2019
"3612957",498,34,150,682,73.02,4.99,21.99,2019
"3612960",268,16,49,333,80.48,4.8,14.71,2019
"3612966",917,42,173,1132,81.01,3.71,15.28,2019
"3612967",321,44,98,463,69.33,9.5,21.17,2019
"3612972",1865,31,389,2285,81.62,1.36,17.02,2019
"3612306",7794,336,1141,9271,84.07,3.62,12.31,2019
"3612401",12212,528,1573,14313,85.32,3.69,10.99,2019
"0572537",246,52,35,333,73.87,15.62,10.51,2019
"4197476",123,0,5,128,96.09,0,3.91,2019
"4197493",120,13,13,146,82.19,8.9,8.9,2019
"4197603",9934,225,1719,11878,83.63,1.89,14.47,2019
"4197604",0,0,0,0,NA,NA,NA,2019
"4197633",432,0,147,579,74.61,0,25.39,2019
"4197711",9,3,7,19,47.37,15.79,36.84,2019
"4197233",10979,324,2379,13682,80.24,2.37,17.39,2019
"4197236",10807,144,2128,13079,82.63,1.1,16.27,2019
"4197305",12493,221,1899,14613,85.49,1.51,13,2019
"4197329",50,0,18,68,73.53,0,26.47,2019
"4197341",1090,36,210,1336,81.59,2.69,15.72,2019
"4197343",55,0,50,105,52.38,0,47.62,2019
"4197347",540,28,157,725,74.48,3.86,21.66,2019
"4197348",478,35,96,609,78.49,5.75,15.76,2019
"4197364",162,13,16,191,84.82,6.81,8.38,2019
"4197390",251,29,48,328,76.52,8.84,14.63,2019
"4197396",948,115,224,1287,73.66,8.94,17.4,2019
"4197406",9,0,21,30,30,0,70,2019
"4197408",5389,65,426,5880,91.65,1.11,7.24,2019
"4197909",22,0,0,22,100,0,0,2019
"4197920",47,1,9,57,82.46,1.75,15.79,2019
"4197008",11170,296,670,12136,92.04,2.44,5.52,2019
"4197020",306,0,25,331,92.45,0,7.55,2019
"4197026",956,59,123,1138,84.01,5.18,10.81,2019
"4197027",4149,114,533,4796,86.51,2.38,11.11,2019
"4197045",18377,347,1835,20559,89.39,1.69,8.93,2019
"4197050",72,9,14,95,75.79,9.47,14.74,2019
"4197062",10252,178,745,11175,91.74,1.59,6.67,2019
"4197068",10248,228,518,10994,93.21,2.07,4.71,2019
"4197070",8957,538,690,10185,87.94,5.28,6.77,2019
"4197071",7270,436,1482,9188,79.12,4.75,16.13,2019
"4197102",137,0,10,147,93.2,0,6.8,2019
"4197108",192,0,34,226,84.96,0,15.04,2019
"4197117",199,0,63,262,75.95,0,24.05,2019
"4197121",459,0,86,545,84.22,0,15.78,2019
"4197124",19012,885,933,20830,91.27,4.25,4.48,2019
"4197128",11781,570,1911,14262,82.6,4,13.4,2019
"4197135",235,0,46,281,83.63,0,16.37,2019
"4197136",582,16,116,714,81.51,2.24,16.25,2019
"4197213",12653,291,1079,14023,90.23,2.08,7.69,2019
"4197217",13378,357,959,14694,91.04,2.43,6.53,2019
"4197220",9755,316,1301,11372,85.78,2.78,11.44,2019
"4197221",4879,97,173,5149,94.76,1.88,3.36,2019
"4197006",25312,955,955,27222,92.98,3.51,3.51,2019
"5398610",909,38,308,1255,72.43,3.03,24.54,2019
"5398617",415,21,56,492,84.35,4.27,11.38,2019
"5398619",172,16,44,232,74.14,6.9,18.97,2019
"5398641",11,0,0,11,100,0,0,2019
"5398651",314,23,50,387,81.14,5.94,12.92,2019
"5398671",7823,181,596,8600,90.97,2.1,6.93,2019
"5398022",7367,137,957,8461,87.07,1.62,11.31,2019
"5398023",16191,288,1303,17782,91.05,1.62,7.33,2019
"5398026",13925,220,673,14818,93.97,1.48,4.54,2019
"5398027",11311,240,394,11945,94.69,2.01,3.3,2019
"5398029",10822,182,267,11271,96.02,1.61,2.37,2019
"5398036",13463,395,1094,14952,90.04,2.64,7.32,2019
"5398056",13006,121,922,14049,92.58,0.86,6.56,2019
"5398058",14846,309,675,15830,93.78,1.95,4.26,2019
"5398133",18584,906,2160,21650,85.84,4.18,9.98,2019
"5398101",7587,406,1206,9199,82.48,4.41,13.11,2019
"5398106",9360,306,1335,11001,85.08,2.78,12.14,2019
"5398148",4046,100,470,4616,87.65,2.17,10.18,2019
"5398178",8607,209,1079,9895,86.98,2.11,10.9,2019
"5398199",9501,132,250,9883,96.13,1.34,2.53,2019
"5398201",10573,612,1757,12942,81.7,4.73,13.58,2019
"5398204",14819,534,1679,17032,87.01,3.14,9.86,2019
"5398205",4884,134,185,5203,93.87,2.58,3.56,2019
"5398232",1561,5,123,1689,92.42,0.3,7.28,2019
"5398238",0,0,0,0,NA,NA,NA,2019
"5398241",632,39,162,833,75.87,4.68,19.45,2019
"5398247",2854,36,319,3209,88.94,1.12,9.94,2019
"5398591",1143,121,241,1505,75.95,8.04,16.01,2019
"5398602",77,0,0,77,100,0,0,2019
"5398631",1261,38,302,1601,78.76,2.37,18.86,2019
"5398635",578,13,171,762,75.85,1.71,22.44,2019
"5398644",212,0,0,212,100,0,0,2019
"5398650",324,12,24,360,90,3.33,6.67,2019
"5398673",135,3,72,210,64.29,1.43,34.29,2019
"5398802",9492,479,1471,11442,82.96,4.19,12.86,2019
"5398812",1146,18,547,1711,66.98,1.05,31.97,2019
"5398823",3223,135,601,3959,81.41,3.41,15.18,2019
"5398826",2704,133,281,3118,86.72,4.27,9.01,2019
"5398843",509,8,149,666,76.43,1.2,22.37,2019
"5398850",426,31,109,566,75.27,5.48,19.26,2019
"5398858",683,40,83,806,84.74,4.96,10.3,2019
"5398862",1089,41,45,1175,92.68,3.49,3.83,2019
"5398923",175,0,247,422,41.47,0,58.53,2019
"5398933",260,7,78,345,75.36,2.03,22.61,2019
"5398938",634,5,90,729,86.97,0.69,12.35,2019
"5398951",2834,57,639,3530,80.28,1.61,18.1,2019
"5398953",1977,35,281,2293,86.22,1.53,12.25,2019
"5398003",15926,512,2109,18547,85.87,2.76,11.37,2019
"5398021",10245,146,426,10817,94.71,1.35,3.94,2019
"5398032",12454,159,1343,13956,89.24,1.14,9.62,2019
"5398038",11509,218,400,12127,94.9,1.8,3.3,2019
"5398053",7856,90,217,8163,96.24,1.1,2.66,2019
"5398068",173,28,7,208,83.17,13.46,3.37,2019
"5398249",1808,81,233,2122,85.2,3.82,10.98,2019
"5398272",8394,156,610,9160,91.64,1.7,6.66,2019
"5398033",15450,458,616,16524,93.5,2.77,3.73,2019
"5398040",9559,126,514,10199,93.72,1.24,5.04,2019
"5398164",129,0,0,129,100,0,0,2019
"5398240",1040,15,105,1160,89.66,1.29,9.05,2019
"0695232",66,0,0,66,100,0,0,2019
"0695245",515,8,144,667,77.21,1.2,21.59,2019
"0695249",1427,21,189,1637,87.17,1.28,11.55,2019
"0695023",14375,198,1179,15752,91.26,1.26,7.48,2019
"0695035",22368,168,1124,23660,94.54,0.71,4.75,2019
"0695062",12963,556,1463,14982,86.52,3.71,9.77,2019
"0695713",3365,199,527,4091,82.25,4.86,12.88,2019
"0695746",8091,58,229,8378,96.57,0.69,2.73,2019
"0695758",19636,533,1338,21507,91.3,2.48,6.22,2019
"0695765",12086,137,689,12912,93.6,1.06,5.34,2019
"0695815",7120,181,1925,9226,77.17,1.96,20.86,2019
"0695818",8761,275,907,9943,88.11,2.77,9.12,2019
"0695821",12677,410,1957,15044,84.27,2.73,13.01,2019
"0695822",13365,318,2296,15979,83.64,1.99,14.37,2019
"4197304",10847,292,1159,12298,88.2,2.37,9.42,2019
"4197306",11422,290,497,12209,93.55,2.38,4.07,2019
"4197357",97,0,11,108,89.81,0,10.19,2019
"4197366",674,0,98,772,87.31,0,12.69,2019
"4197371",223,0,23,246,90.65,0,9.35,2019
"4197385",991,26,204,1221,81.16,2.13,16.71,2019
"4197389",606,27,64,697,86.94,3.87,9.18,2019
"4197424",5945,280,987,7212,82.43,3.88,13.69,2019
"4197426",3361,191,316,3868,86.89,4.94,8.17,2019
"4197434",257,0,85,342,75.15,0,24.85,2019
"4197458",1441,74,435,1950,73.9,3.79,22.31,2019
"4197462",1369,3,220,1592,85.99,0.19,13.82,2019
"4197465",691,36,319,1046,66.06,3.44,30.5,2019
"4197466",283,34,146,463,61.12,7.34,31.53,2019
"4197488",425,0,57,482,88.17,0,11.83,2019
"4197490",80,0,12,92,86.96,0,13.04,2019
"4197503",3483,136,477,4096,85.03,3.32,11.65,2019
"4197522",173,14,73,260,66.54,5.38,28.08,2019
"4197523",1837,236,408,2481,74.04,9.51,16.44,2019
"4197543",220,11,46,277,79.42,3.97,16.61,2019
"4197544",851,72,170,1093,77.86,6.59,15.55,2019
"4197731",143,0,39,182,78.57,0,21.43,2019
"4197754",6873,224,1483,8580,80.1,2.61,17.28,2019
"4197620",50,8,37,95,52.63,8.42,38.95,2019
"4197621",114,0,4,118,96.61,0,3.39,2019
"4197622",144,0,52,196,73.47,0,26.53,2019
"4197623",752,79,262,1093,68.8,7.23,23.97,2019
"4197710",46,2,5,53,86.79,3.77,9.43,2019
"4197720",1549,126,354,2029,76.34,6.21,17.45,2019
"4197735",10,30,13,53,18.87,56.6,24.53,2019
"4197360",709,2,247,958,74.01,0.21,25.78,2019
"4197362",1169,97,344,1610,72.61,6.02,21.37,2019
"4197367",3726,142,664,4532,82.22,3.13,14.65,2019
"4197370",2929,111,261,3301,88.73,3.36,7.91,2019
"4197380",794,14,158,966,82.19,1.45,16.36,2019
"4197392",2180,54,216,2450,88.98,2.2,8.82,2019
"4197404",11927,428,1192,13547,88.04,3.16,8.8,2019
"4197405",17240,559,1416,19215,89.72,2.91,7.37,2019
"4197410",253,11,59,323,78.33,3.41,18.27,2019
"4197415",5097,398,1053,6548,77.84,6.08,16.08,2019
"4197416",273,12,120,405,67.41,2.96,29.63,2019
"4197430",141,4,20,165,85.45,2.42,12.12,2019
"4197435",760,9,141,910,83.52,0.99,15.49,2019
"4197439",5830,246,998,7074,82.41,3.48,14.11,2019
"4197442",658,78,171,907,72.55,8.6,18.85,2019
"3303229",1854,107,232,2193,84.54,4.88,10.58,2019
"3303243",326,4,43,373,87.4,1.07,11.53,2019
"3303263",1213,176,281,1670,72.63,10.54,16.83,2019
"3303444",539,22,15,576,93.58,3.82,2.6,2019
"3303448",270,2,22,294,91.84,0.68,7.48,2019
"3303464",337,14,63,414,81.4,3.38,15.22,2019
"3303466",650,0,29,679,95.73,0,4.27,2019
"3303608",1115,45,134,1294,86.17,3.48,10.36,2019
"3303765",236,0,9,245,96.33,0,3.67,2019
"3303773",2529,75,573,3177,79.6,2.36,18.04,2019
"3303816",492,0,72,564,87.23,0,12.77,2019
"3303830",895,0,12,907,98.68,0,1.32,2019
"3303235",2993,129,837,3959,75.6,3.26,21.14,2019
"3303237",859,11,49,919,93.47,1.2,5.33,2019
"3612410",201,0,5,206,97.57,0,2.43,2019
"3612424",80,29,13,122,65.57,23.77,10.66,2019
"3612431",376,8,18,402,93.53,1.99,4.48,2019
"3612444",158,2,58,218,72.48,0.92,26.61,2019
"3612451",351,0,129,480,73.12,0,26.88,2019
"3612454",84,7,24,115,73.04,6.09,20.87,2019
"3612457",375,26,77,478,78.45,5.44,16.11,2019
"3613072",257,7,79,343,74.93,2.04,23.03,2019
"3613077",2180,173,368,2721,80.12,6.36,13.52,2019
"3613108",2175,89,208,2472,87.99,3.6,8.41,2019
"3613156",686,10,53,749,91.59,1.34,7.08,2019
"3613164",747,29,102,878,85.08,3.3,11.62,2019
"3613202",1715,230,738,2683,63.92,8.57,27.51,2019
"3613204",4714,728,2461,7903,59.65,9.21,31.14,2019
"3613207",3895,320,964,5179,75.21,6.18,18.61,2019
"3613290",0,0,0,0,NA,NA,NA,2019
"3613303",404,0,31,435,92.87,0,7.13,2019
"3613309",1846,80,310,2236,82.56,3.58,13.86,2019
"3613313",103,3,50,156,66.03,1.92,32.05,2019
"3613314",80,0,44,124,64.52,0,35.48,2019
"3613322",311,7,67,385,80.78,1.82,17.4,2019
"3613021",13440,524,2744,16708,80.44,3.14,16.42,2019
"3613304",594,6,97,697,85.22,0.86,13.92,2019
"3613110",708,19,157,884,80.09,2.15,17.76,2019
"3613126",11606,349,1679,13634,85.13,2.56,12.31,2019
"3613145",614,19,57,690,88.99,2.75,8.26,2019
"3613206",6224,294,1275,7793,79.87,3.77,16.36,2019
"3613039",5832,265,512,6609,88.24,4.01,7.75,2019
"3613083",639,9,116,764,83.64,1.18,15.18,2019
"3613101",588,94,208,890,66.07,10.56,23.37,2019
"3613114",2165,26,156,2347,92.25,1.11,6.65,2019
"3613140",1409,33,358,1800,78.28,1.83,19.89,2019
"3613142",2023,143,401,2567,78.81,5.57,15.62,2019
"3613146",618,22,190,830,74.46,2.65,22.89,2019
"3613160",602,9,113,724,83.15,1.24,15.61,2019
"3613166",1839,55,391,2285,80.48,2.41,17.11,2019
"3613205",4349,327,2261,6937,62.69,4.71,32.59,2019
"3613210",6008,432,1199,7639,78.65,5.66,15.7,2019
"3613212",7380,369,1166,8915,82.78,4.14,13.08,2019
"3613431",534,27,100,661,80.79,4.08,15.13,2019
"3613326",1968,70,286,2324,84.68,3.01,12.31,2019
"3613411",988,19,259,1266,78.04,1.5,20.46,2019
"3613417",1359,0,308,1667,81.52,0,18.48,2019
"3613433",537,23,92,652,82.36,3.53,14.11,2019
"3613464",384,22,182,588,65.31,3.74,30.95,2019
"4215347",241,0,60,301,80.07,0,19.93,2019
"4215378",0,0,21,21,0,0,100,2019
"4215456",955,84,216,1255,76.1,6.69,17.21,2019
"4215474",559,17,218,794,70.4,2.14,27.46,2019
"4215480",612,19,151,782,78.26,2.43,19.31,2019
"4215489",140,0,37,177,79.1,0,20.9,2019
"4215492",43,0,0,43,100,0,0,2019
"4215536",124,8,42,174,71.26,4.6,24.14,2019
"4215541",1057,29,257,1343,78.7,2.16,19.14,2019
"4215479",659,26,167,852,77.35,3.05,19.6,2019
"4215521",511,20,148,679,75.26,2.95,21.8,2019
"4215554",867,25,194,1086,79.83,2.3,17.86,2019
"4215601",20232,785,3966,24983,80.98,3.14,15.87,2019
"4215642",15626,391,2336,18353,85.14,2.13,12.73,2019
"5398070",4220,24,420,4664,90.48,0.51,9.01,2019
"5398110",9720,126,269,10115,96.09,1.25,2.66,2019
"5398117",14125,171,669,14965,94.39,1.14,4.47,2019
"5398119",11813,328,628,12769,92.51,2.57,4.92,2019
"5398121",11660,459,824,12943,90.09,3.55,6.37,2019
"5398155",12581,289,732,13602,92.49,2.12,5.38,2019
"4197127",1068,65,213,1346,79.35,4.83,15.82,2019
"4197031",5992,188,1057,7237,82.8,2.6,14.61,2019
"4197137",354,19,62,435,81.38,4.37,14.25,2019
"4197324",393,21,85,499,78.76,4.21,17.03,2019
"4197057",1,0,3,4,25,0,75,2019
"4197086",10245,349,784,11378,90.04,3.07,6.89,2019
"4197089",4200,181,258,4639,90.54,3.9,5.56,2019
"4197208",0,0,0,0,NA,NA,NA,2019
"4197239",8369,258,395,9022,92.76,2.86,4.38,2019
"4197317",6728,172,858,7758,86.72,2.22,11.06,2019
"4197322",12007,483,1577,14067,85.36,3.43,11.21,2019
"4197369",92,0,0,92,100,0,0,2019
"4197373",0,0,0,0,NA,NA,NA,2019
"4197384",0,0,0,0,NA,NA,NA,2019
"4197388",351,0,14,365,96.16,0,3.84,2019
"4197471",10575,244,1807,12626,83.76,1.93,14.31,2019
"4197494",46,0,0,46,100,0,0,2019
"4197495",673,27,11,711,94.66,3.8,1.55,2019
"0695585",176,0,32,208,84.62,0,15.38,2019
"0695615",222,0,23,245,90.61,0,9.39,2019
"0695692",1656,28,226,1910,86.7,1.47,11.83,2019
"0695742",3530,34,81,3645,96.84,0.93,2.22,2019
"0695961",7619,289,1018,8926,85.36,3.24,11.4,2019
"0695121",9220,99,437,9756,94.51,1.01,4.48,2019
"0695461",869,50,171,1090,79.72,4.59,15.69,2019
"0695542",829,39,49,917,90.4,4.25,5.34,2019
"0695543",195,0,57,252,77.38,0,22.62,2019
"0695547",390,13,47,450,86.67,2.89,10.44,2019
"0695549",324,10,16,350,92.57,2.86,4.57,2019
"0695554",136,0,42,178,76.4,0,23.6,2019
"0695558",136,13,37,186,73.12,6.99,19.89,2019
"0695565",235,17,32,284,82.75,5.99,11.27,2019
"0695568",72,0,7,79,91.14,0,8.86,2019
"0695605",4132,87,708,4927,83.86,1.77,14.37,2019
"0695618",9071,200,421,9692,93.59,2.06,4.34,2019
"0695665",1543,51,85,1679,91.9,3.04,5.06,2019
"0695677",8545,92,726,9363,91.26,0.98,7.75,2019
"0695691",12186,270,1209,13665,89.18,1.98,8.85,2019
"0695625",32,0,35,67,47.76,0,52.24,2019
"2501364",2610,37,504,3151,82.83,1.17,15.99,2019
"2501379",247,0,123,370,66.76,0,33.24,2019
"2501440",6755,318,1155,8228,82.1,3.86,14.04,2019
"2501505",1673,9,117,1799,93,0.5,6.5,2019
"2501524",2026,35,392,2453,82.59,1.43,15.98,2019
"2501529",1095,24,122,1241,88.24,1.93,9.83,2019
"2501583",1942,36,322,2300,84.43,1.57,14,2019
"2501588",3071,74,430,3575,85.9,2.07,12.03,2019
"2501609",6088,246,1525,7859,77.47,3.13,19.4,2019
"2501721",6356,53,387,6796,93.53,0.78,5.69,2019
"2501731",560,0,0,560,100,0,0,2019
"2501740",1689,1,49,1739,97.12,0.06,2.82,2019
"2501741",1800,28,48,1876,95.95,1.49,2.56,2019
"2501770",1443,0,82,1525,94.62,0,5.38,2019
"0695831",16395,391,1657,18443,88.9,2.12,8.98,2019
"0695838",9287,206,1563,11056,84,1.86,14.14,2019
"0695910",6,25,22,53,11.32,47.17,41.51,2019
"0695930",18,0,16,34,52.94,0,47.06,2019
"0695947",647,0,179,826,78.33,0,21.67,2019
"0695968",347,22,65,434,79.95,5.07,14.98,2019
"0695978",27,0,54,81,33.33,0,66.67,2019
"0695982",1063,0,124,1187,89.55,0,10.45,2019
"0695984",31,0,96,127,24.41,0,75.59,2019
"5399154",11,0,0,11,100,0,0,2019
"5399208",19634,332,1870,21836,89.92,1.52,8.56,2019
"5399320",3103,148,488,3739,82.99,3.96,13.05,2019
"5399321",64,0,43,107,59.81,0,40.19,2019
"5399324",3259,116,384,3759,86.7,3.09,10.22,2019
"5399328",1315,46,274,1635,80.43,2.81,16.76,2019
"5399338",5261,138,181,5580,94.28,2.47,3.24,2019
"5399362",13221,640,1856,15717,84.12,4.07,11.81,2019
"5399401",140,0,36,176,79.55,0,20.45,2019
"5399402",482,10,116,608,79.28,1.64,19.08,2019
"0299504",13532,223,1117,14872,90.99,1.5,7.51,2019
"0299550",67,2,9,78,85.9,2.56,11.54,2019
"0299572",122,16,18,156,78.21,10.26,11.54,2019
"0299587",740,0,43,783,94.51,0,5.49,2019
"0299591",17,3,6,26,65.38,11.54,23.08,2019
"0299603",3387,126,534,4047,83.69,3.11,13.19,2019
"0299624",14,0,8,22,63.64,0,36.36,2019
"0299626",31,0,27,58,53.45,0,46.55,2019
"0299784",41,2,20,63,65.08,3.17,31.75,2019
"0299901",4587,220,590,5397,84.99,4.08,10.93,2019
"0299903",0,0,0,0,NA,NA,NA,2019
"0299925",188,1,128,317,59.31,0.32,40.38,2019
"0299589",36,0,8,44,81.82,0,18.18,2019
"0299602",40,2,29,71,56.34,2.82,40.85,2019
"0299611",4520,205,1114,5839,77.41,3.51,19.08,2019
"0299612",203,16,92,311,65.27,5.14,29.58,2019
"0299613",116,10,24,150,77.33,6.67,16,2019
"0299625",22,0,13,35,62.86,0,37.14,2019
"0299651",1,0,4,5,20,0,80,2019
"0299689",159,1,59,219,72.6,0.46,26.94,2019
"5399101",341,27,181,549,62.11,4.92,32.97,2019
"5399115",374,8,85,467,80.09,1.71,18.2,2019
"5399129",204,21,96,321,63.55,6.54,29.91,2019
"5399326",1032,22,280,1334,77.36,1.65,20.99,2019
"5399353",4932,171,239,5342,92.32,3.2,4.47,2019
"5399371",109,5,18,132,82.58,3.79,13.64,2019
"3303266",658,39,154,851,77.32,4.58,18.1,2019
"3303278",1062,28,75,1165,91.16,2.4,6.44,2019
"3303282",282,39,34,355,79.44,10.99,9.58,2019
"3303442",518,41,87,646,80.19,6.35,13.47,2019
"3303574",923,26,133,1082,85.3,2.4,12.29,2019
"3303576",1042,38,328,1408,74.01,2.7,23.3,2019
"3303584",1285,74,179,1538,83.55,4.81,11.64,2019
"0572855",1783,112,596,2491,71.58,4.5,23.93,2019
"0572856",89,0,49,138,64.49,0,35.51,2019
"0572952",721,36,284,1041,69.26,3.46,27.28,2019
"0572956",10207,592,2755,13554,75.31,4.37,20.33,2019
"0572959",613,10,458,1081,56.71,0.93,42.37,2019
"0572326",621,33,286,940,66.06,3.51,30.43,2019
"0572339",33,0,22,55,60,0,40,2019
"0572376",494,0,249,743,66.49,0,33.51,2019
"0572364",5014,81,694,5789,86.61,1.4,11.99,2019
"0572365",720,69,280,1069,67.35,6.45,26.19,2019
"0572367",0,0,6,6,0,0,100,2019
"0572395",312,5,71,388,80.41,1.29,18.3,2019
"0572410",116,7,63,186,62.37,3.76,33.87,2019
"0572519",665,303,242,1210,54.96,25.04,20,2019
"0572522",37,51,106,194,19.07,26.29,54.64,2019
"0572533",73,11,80,164,44.51,6.71,48.78,2019
"0572564",85,13,68,166,51.2,7.83,40.96,2019
"0572581",408,8,92,508,80.31,1.57,18.11,2019
"0572601",9925,201,2022,12148,81.7,1.65,16.64,2019
"0572633",530,0,143,673,78.75,0,21.25,2019
"0572635",1166,25,299,1490,78.26,1.68,20.07,2019
"0572644",884,11,145,1040,85,1.06,13.94,2019
"0572675",441,23,156,620,71.13,3.71,25.16,2019
"0572680",163,59,80,302,53.97,19.54,26.49,2019
"0572701",13978,1629,1451,17058,81.94,9.55,8.51,2019
"0572740",2338,244,911,3493,66.93,6.99,26.08,2019
"0572417",1838,12,371,2221,82.76,0.54,16.7,2019
"0572422",1330,122,495,1947,68.31,6.27,25.42,2019
"0572455",3680,278,1212,5170,71.18,5.38,23.44,2019
"0572462",89,12,60,161,55.28,7.45,37.27,2019
"0572478",27,14,120,161,16.77,8.7,74.53,2019
"0572482",290,84,167,541,53.6,15.53,30.87,2019
"0572515",0,0,0,0,NA,NA,NA,2019
"0572528",0,0,0,0,NA,NA,NA,2019
"0572531",179,16,144,339,52.8,4.72,42.48,2019
"0572534",278,36,284,598,46.49,6.02,47.49,2019
"0572632",1375,214,325,1914,71.84,11.18,16.98,2019
"0572638",1491,117,957,2565,58.13,4.56,37.31,2019
"0572662",930,25,140,1095,84.93,2.28,12.79,2019
"0572663",33,0,45,78,42.31,0,57.69,2019
"0572672",72,0,42,114,63.16,0,36.84,2019
"0572687",2057,28,612,2697,76.27,1.04,22.69,2019
"0572703",12212,787,1696,14695,83.1,5.36,11.54,2019
"0572715",5843,600,737,7180,81.38,8.36,10.26,2019
"0572734",1627,490,801,2918,55.76,16.79,27.45,2019
"5398580",3483,60,720,4263,81.7,1.41,16.89,2019
"5398584",11464,284,1948,13696,83.7,2.07,14.22,2019
"5398154",0,0,0,0,NA,NA,NA,2019
"5398028",8443,116,317,8876,95.12,1.31,3.57,2019
"5398037",10060,296,806,11162,90.13,2.65,7.22,2019
"5398039",1137,5,53,1195,95.15,0.42,4.44,2019
"5398059",13021,60,714,13795,94.39,0.43,5.18,2019
"5398105",15475,969,702,17146,90.25,5.65,4.09,2019
"5398109",16536,284,522,17342,95.35,1.64,3.01,2019
"5398146",9202,165,833,10200,90.22,1.62,8.17,2019
"5398647",107,20,59,186,57.53,10.75,31.72,2019
"5398621",77,6,55,138,55.8,4.35,39.86,2019
"5398625",2371,73,214,2658,89.2,2.75,8.05,2019
"5398626",7956,181,1254,9391,84.72,1.93,13.35,2019
"4215650",9002,262,1852,11116,80.98,2.36,16.66,2019
"4215660",101,0,95,196,51.53,0,48.47,2019
"4215675",221,17,81,319,69.28,5.33,25.39,2019
"4215679",891,56,220,1167,76.35,4.8,18.85,2019
"4215684",315,8,22,345,91.3,2.32,6.38,2019
"4215701",10255,453,1989,12697,80.77,3.57,15.67,2019
"4215716",249,12,68,329,75.68,3.65,20.67,2019
"4215717",3308,91,821,4220,78.39,2.16,19.45,2019
"4215729",429,0,171,600,71.5,0,28.5,2019
"4215736",298,0,46,344,86.63,0,13.37,2019
"4215380",193,5,49,247,78.14,2.02,19.84,2019
"4215448",43,0,26,69,62.32,0,37.68,2019
"4215451",351,0,98,449,78.17,0,21.83,2019
"4215454",51,0,14,65,78.46,0,21.54,2019
"4215473",1259,52,328,1639,76.82,3.17,20.01,2019
"4215477",305,8,65,378,80.69,2.12,17.2,2019
"4215482",105,16,40,161,65.22,9.94,24.84,2019
"4215490",95,0,76,171,55.56,0,44.44,2019
"4215533",468,6,146,620,75.48,0.97,23.55,2019
"4215542",335,11,103,449,74.61,2.45,22.94,2019
"4215557",1059,32,363,1454,72.83,2.2,24.97,2019
"4215558",505,7,273,785,64.33,0.89,34.78,2019
"4215559",654,13,125,792,82.58,1.64,15.78,2019
"4215615",137,0,18,155,88.39,0,11.61,2019
"4215632",3572,107,461,4140,86.28,2.58,11.14,2019
"4215637",471,30,93,594,79.29,5.05,15.66,2019
"4215640",156,0,51,207,75.36,0,24.64,2019
"4215644",6683,334,1568,8585,77.85,3.89,18.26,2019
"4215690",2893,133,907,3933,73.56,3.38,23.06,2019
"4215697",1020,42,335,1397,73.01,3.01,23.98,2019
"4215711",149,10,29,188,79.26,5.32,15.43,2019
"4215715",144,9,35,188,76.6,4.79,18.62,2019
"4215742",197,2,155,354,55.65,0.56,43.79,2019
"4215745",82,0,7,89,92.13,0,7.87,2019
"4215759",776,39,328,1143,67.89,3.41,28.7,2019
"4215778",45,0,10,55,81.82,0,18.18,2019
"4215840",714,22,106,842,84.8,2.61,12.59,2019
"4215845",1097,39,300,1436,76.39,2.72,20.89,2019
"4215443",66,0,0,66,100,0,0,2019
"4215446",81,0,33,114,71.05,0,28.95,2019
"4215470",236,12,60,308,76.62,3.9,19.48,2019
"4215475",380,9,142,531,71.56,1.69,26.74,2019
"4215484",43,0,0,43,100,0,0,2019
"4215539",91,0,62,153,59.48,0,40.52,2019
"4215551",228,11,73,312,73.08,3.53,23.4,2019
"0906069",978,30,94,1102,88.75,2.72,8.53,2019
"0906074",8775,187,821,9783,89.7,1.91,8.39,2019
"0906001",6609,165,359,7133,92.65,2.31,5.03,2019
"0906033",10325,147,775,11247,91.8,1.31,6.89,2019
"0906059",0,0,0,0,NA,NA,NA,2019
"0906076",4388,42,627,5057,86.77,0.83,12.4,2019
"0906078",3593,77,218,3888,92.41,1.98,5.61,2019
"0906091",35,0,4,39,89.74,0,10.26,2019
"0906111",10514,431,1421,12366,85.02,3.49,11.49,2019
"0906024",196,0,25,221,88.69,0,11.31,2019
"0906085",2597,67,253,2917,89.03,2.3,8.67,2019
"0906088",1934,68,215,2217,87.24,3.07,9.7,2019
"0906354",1954,29,250,2233,87.51,1.3,11.2,2019
"0906426",1607,0,49,1656,97.04,0,2.96,2019
"2501773",1937,74,158,2169,89.3,3.41,7.28,2019
"2501775",2442,0,116,2558,95.47,0,4.53,2019
"2501821",10752,113,696,11561,93,0.98,6.02,2019
"2501843",6741,183,1621,8545,78.89,2.14,18.97,2019
"2501863",3407,36,407,3850,88.49,0.94,10.57,2019
"2501864",5199,23,321,5543,93.79,0.41,5.79,2019
"2501876",10580,136,968,11684,90.55,1.16,8.28,2019
"2501880",9508,198,823,10529,90.3,1.88,7.82,2019
"2501906",9145,235,1051,10431,87.67,2.25,10.08,2019
"2501923",9402,212,1075,10689,87.96,1.98,10.06,2019
"2501929",1361,33,63,1457,93.41,2.26,4.32,2019
"2501940",4495,79,391,4965,90.53,1.59,7.88,2019
"2501028",4863,153,942,5958,81.62,2.57,15.81,2019
"2501033",2267,18,318,2603,87.09,0.69,12.22,2019
"2501037",200,17,21,238,84.03,7.14,8.82,2019
"2501005",1537,57,350,1944,79.06,2.93,18,2019
"2501027",7045,200,683,7928,88.86,2.52,8.62,2019
"2501038",1053,21,146,1220,86.31,1.72,11.97,2019
"2501054",711,15,40,766,92.82,1.96,5.22,2019
"2501084",56,4,15,75,74.67,5.33,20,2019
"2501092",371,0,90,461,80.48,0,19.52,2019
"2501103",905,209,367,1481,61.11,14.11,24.78,2019
"2501107",2825,96,928,3849,73.4,2.49,24.11,2019
"2501119",3806,172,922,4900,77.67,3.51,18.82,2019
"2501236",534,0,4,538,99.26,0,0.74,2019
"2501245",335,15,47,397,84.38,3.78,11.84,2019
"2501254",415,5,23,443,93.68,1.13,5.19,2019
"2501262",419,0,71,490,85.51,0,14.49,2019
"2501338",55,0,6,61,90.16,0,9.84,2019
"2501368",417,29,135,581,71.77,4.99,23.24,2019
"2501453",14643,462,1743,16848,86.91,2.74,10.35,2019
"2501460",3326,34,297,3657,90.95,0.93,8.12,2019
"2501462",3900,69,341,4310,90.49,1.6,7.91,2019
"2501475",3048,97,620,3765,80.96,2.58,16.47,2019
"2501519",2469,0,35,2504,98.6,0,1.4,2019
"2501532",5214,38,147,5399,96.57,0.7,2.72,2019
"2501534",2031,64,256,2351,86.39,2.72,10.89,2019
"2501535",1563,21,257,1841,84.9,1.14,13.96,2019
"2501585",1507,18,317,1842,81.81,0.98,17.21,2019
"2501050",958,48,61,1067,89.78,4.5,5.72,2019
"2501108",6852,435,2403,9690,70.71,4.49,24.8,2019
"2501128",883,67,135,1085,81.38,6.18,12.44,2019
"2501235",920,30,166,1116,82.44,2.69,14.87,2019
"2501001",6024,338,1051,7413,81.26,4.56,14.18,2019
"2501026",349,10,89,448,77.9,2.23,19.87,2019
"2502176",10156,90,1083,11329,89.65,0.79,9.56,2019
"2502322",1301,78,195,1574,82.66,4.96,12.39,2019
"2502338",2535,17,352,2904,87.29,0.59,12.12,2019
"2502356",4300,115,160,4575,93.99,2.51,3.5,2019
"2502367",899,39,72,1010,89.01,3.86,7.13,2019
"2502379",2219,99,181,2499,88.8,3.96,7.24,2019
"2502452",4186,185,353,4724,88.61,3.92,7.47,2019
"2502535",570,35,27,632,90.19,5.54,4.27,2019
"2502542",253,49,11,313,80.83,15.65,3.51,2019
"2502601",5186,187,989,6362,81.52,2.94,15.55,2019
"2502632",4098,67,245,4410,92.93,1.52,5.56,2019
"2502474",10746,101,736,11583,92.77,0.87,6.35,2019
"2502482",3567,112,210,3889,91.72,2.88,5.4,2019
"2502539",1121,148,184,1453,77.15,10.19,12.66,2019
"3303588",610,13,93,716,85.2,1.82,12.99,2019
"3303602",782,70,160,1012,77.27,6.92,15.81,2019
"3303801",9336,273,761,10370,90.03,2.63,7.34,2019
"3303810",723,26,55,804,89.93,3.23,6.84,2019
"3303833",8071,189,709,8969,89.99,2.11,7.91,2019
"3303841",2383,32,215,2630,90.61,1.22,8.17,2019
"3303844",865,12,28,905,95.58,1.33,3.09,2019
"3303862",1749,18,61,1828,95.68,0.98,3.34,2019
"3303883",101,0,0,101,100,0,0,2019
"3303034",1421,0,144,1565,90.8,0,9.2,2019
"3303036",1631,12,44,1687,96.68,0.71,2.61,2019
"3303054",9106,210,635,9951,91.51,2.11,6.38,2019
"3303055",5692,162,434,6288,90.52,2.58,6.9,2019
"3303063",6426,103,448,6977,92.1,1.48,6.42,2019
"3303077",3772,41,286,4099,92.02,1,6.98,2019
"3303084",448,12,27,487,91.99,2.46,5.54,2019
"3303216",868,22,28,918,94.55,2.4,3.05,2019
"3303240",458,8,74,540,84.81,1.48,13.7,2019
"3303241",291,14,46,351,82.91,3.99,13.11,2019
"3303244",2693,43,325,3061,87.98,1.4,10.62,2019
"3303279",220,41,48,309,71.2,13.27,15.53,2019
"3303280",412,35,90,537,76.72,6.52,16.76,2019
"3303281",2952,103,74,3129,94.34,3.29,2.36,2019
"3303284",284,31,26,341,83.28,9.09,7.62,2019
"3303290",1708,54,94,1856,92.03,2.91,5.06,2019
"3303307",1911,24,115,2050,93.22,1.17,5.61,2019
"3303443",153,0,0,153,100,0,0,2019
"3303580",489,20,73,582,84.02,3.44,12.54,2019
"3303582",835,40,170,1045,79.9,3.83,16.27,2019
"3303585",922,35,155,1112,82.91,3.15,13.94,2019
"3303592",448,16,100,564,79.43,2.84,17.73,2019
"3303753",1128,23,35,1186,95.11,1.94,2.95,2019
"3303781",683,48,58,789,86.57,6.08,7.35,2019
"3303784",1473,100,217,1790,82.29,5.59,12.12,2019
"3303785",643,53,142,838,76.73,6.32,16.95,2019
"3303812",276,33,84,393,70.23,8.4,21.37,2019
"3303819",1487,14,174,1675,88.78,0.84,10.39,2019
"3303825",2831,130,276,3237,87.46,4.02,8.53,2019
"3303840",1405,19,84,1508,93.17,1.26,5.57,2019
"3303867",7602,177,1241,9020,84.28,1.96,13.76,2019
"3303869",896,25,100,1021,87.76,2.45,9.79,2019
"3303872",1294,38,71,1403,92.23,2.71,5.06,2019
"3303043",522,20,87,629,82.99,3.18,13.83,2019
"3303051",8848,64,320,9232,95.84,0.69,3.47,2019
"3303052",2966,22,54,3042,97.5,0.72,1.78,2019
"5005739",388,52,82,522,74.33,9.96,15.71,2019
"5005747",92,6,22,120,76.67,5,18.33,2019
"5005772",253,8,46,307,82.41,2.61,14.98,2019
"5005775",115,17,63,195,58.97,8.72,32.31,2019
"5005824",398,3,90,491,81.06,0.61,18.33,2019
"5005843",740,58,366,1164,63.57,4.98,31.44,2019
"5005847",242,41,82,365,66.3,11.23,22.47,2019
"5005874",195,8,41,244,79.92,3.28,16.8,2019
"5005875",150,7,21,178,84.27,3.93,11.8,2019
"5005907",43,2,22,67,64.18,2.99,32.84,2019
"5005764",975,57,232,1264,77.14,4.51,18.35,2019
"5005766",228,0,45,273,83.52,0,16.48,2019
"5005776",234,2,41,277,84.48,0.72,14.8,2019
"5005777",1132,40,260,1432,79.05,2.79,18.16,2019
"5005150",168,80,77,325,51.69,24.62,23.69,2019
"5005152",112,15,22,149,75.17,10.07,14.77,2019
"5005254",73,0,0,73,100,0,0,2019
"5005255",1569,82,258,1909,82.19,4.3,13.51,2019
"5005458",764,48,87,899,84.98,5.34,9.68,2019
"5005471",233,0,15,248,93.95,0,6.05,2019
"5005473",576,7,41,624,92.31,1.12,6.57,2019
"5005474",345,12,48,405,85.19,2.96,11.85,2019
"5005482",2771,146,265,3182,87.08,4.59,8.33,2019
"5005494",628,31,63,722,86.98,4.29,8.73,2019
"5005647",398,0,74,472,84.32,0,15.68,2019
"5005657",26,6,0,32,81.25,18.75,0,2019
"5005658",442,14,124,580,76.21,2.41,21.38,2019
"5005660",663,3,81,747,88.76,0.4,10.84,2019
"5005661",2068,97,222,2387,86.64,4.06,9.3,2019
"5005680",793,10,95,898,88.31,1.11,10.58,2019
"5005154",173,0,10,183,94.54,0,5.46,2019
"5005161",228,11,24,263,86.69,4.18,9.13,2019
"5005201",4780,95,891,5766,82.9,1.65,15.45,2019
"5005252",105,0,15,120,87.5,0,12.5,2019
"5005253",233,25,5,263,88.59,9.51,1.9,2019
"5005257",688,66,177,931,73.9,7.09,19.01,2019
"5005343",226,26,77,329,68.69,7.9,23.4,2019
"5005492",231,14,33,278,83.09,5.04,11.87,2019
"5005640",65,0,3,68,95.59,0,4.41,2019
"5005443",2341,74,378,2793,83.82,2.65,13.53,2019
"5005478",4831,156,822,5809,83.16,2.69,14.15,2019
"5005669",243,3,50,296,82.09,1.01,16.89,2019
"5005675",405,3,89,497,81.49,0.6,17.91,2019
"5005679",1188,17,191,1396,85.1,1.22,13.68,2019
"5005733",2052,37,386,2475,82.91,1.49,15.6,2019
"5005760",386,6,96,488,79.1,1.23,19.67,2019
"5005761",360,26,42,428,84.11,6.07,9.81,2019
"5005765",634,9,78,721,87.93,1.25,10.82,2019
"5005774",372,33,32,437,85.13,7.55,7.32,2019
"5005819",3036,158,645,3839,79.08,4.12,16.8,2019
"5005822",522,30,148,700,74.57,4.29,21.14,2019
"5005828",688,9,175,872,78.9,1.03,20.07,2019
"5005845",346,53,130,529,65.41,10.02,24.57,2019
"5005855",2537,52,495,3084,82.26,1.69,16.05,2019
"5005858",139,4,52,195,71.28,2.05,26.67,2019
"5005859",586,16,143,745,78.66,2.15,19.19,2019
"5005866",209,8,52,269,77.7,2.97,19.33,2019
"5005905",265,16,68,349,75.93,4.58,19.48,2019
"5005001",3821,215,501,4537,84.22,4.74,11.04,2019
"0696009",111,3,49,163,68.1,1.84,30.06,2019
"0696027",840,2,92,934,89.94,0.21,9.85,2019
"0696035",812,14,436,1262,64.34,1.11,34.55,2019
"0696038",203,19,44,266,76.32,7.14,16.54,2019
"0696044",368,8,95,471,78.13,1.7,20.17,2019
"0696065",153,1,23,177,86.44,0.56,12.99,2019
"0696067",3142,51,269,3462,90.76,1.47,7.77,2019
"0696071",15,0,0,15,100,0,0,2019
"0696080",8864,334,1986,11184,79.26,2.99,17.76,2019
"0696085",17,0,2,19,89.47,0,10.53,2019
"0696094",2264,77,520,2861,79.13,2.69,18.18,2019
"0696107",428,7,62,497,86.12,1.41,12.47,2019
"0696118",573,5,160,738,77.64,0.68,21.68,2019
"0696126",50,0,0,50,100,0,0,2019
"0906510",1407,118,57,1582,88.94,7.46,3.6,2019
"0906840",6767,81,268,7116,95.1,1.14,3.77,2019
"0906473",8179,112,873,9164,89.25,1.22,9.53,2019
"0906762",2438,35,252,2725,89.47,1.28,9.25,2019
"0906880",9491,164,410,10065,94.3,1.63,4.07,2019
"0906380",713,77,454,1244,57.32,6.19,36.5,2019
"0906060",829,0,18,847,97.87,0,2.13,2019
"0906063",1063,62,57,1182,89.93,5.25,4.82,2019
"0906065",236,6,20,262,90.08,2.29,7.63,2019
"0906120",2946,308,1236,4490,65.61,6.86,27.53,2019
"0906357",4281,107,338,4726,90.58,2.26,7.15,2019
"0906029",6308,216,458,6982,90.35,3.09,6.56,2019
"0906095",9526,255,1005,10786,88.32,2.36,9.32,2019
"0906379",3316,91,389,3796,87.36,2.4,10.25,2019
"0906052",2619,107,443,3169,82.64,3.38,13.98,2019
"0906042",8846,150,636,9632,91.84,1.56,6.6,2019
"0906061",132,0,0,132,100,0,0,2019
"0906160",0,0,0,0,NA,NA,NA,2019
"0906243",28,0,44,72,38.89,0,61.11,2019
"0906263",93,0,16,109,85.32,0,14.68,2019
"0906332",166,0,22,188,88.3,0,11.7,2019
"0906350",19,0,5,24,79.17,0,20.83,2019
"0906353",34,0,57,91,37.36,0,62.64,2019
"0906387",110,10,38,158,69.62,6.33,24.05,2019
"0906389",0,0,0,0,NA,NA,NA,2019
"0906414",42,0,0,42,100,0,0,2019
"0906444",109,0,0,109,100,0,0,2019
"0906456",94,30,11,135,69.63,22.22,8.15,2019
"0906461",5163,111,521,5795,89.09,1.92,8.99,2019
"0906467",124,0,0,124,100,0,0,2019
"0906758",122,0,5,127,96.06,0,3.94,2019
"0906824",11075,82,555,11712,94.56,0.7,4.74,2019
"0906825",6568,78,621,7267,90.38,1.07,8.55,2019
"0906856",0,0,0,0,NA,NA,NA,2019
"0906890",1552,24,36,1612,96.28,1.49,2.23,2019
"0906757",725,21,112,858,84.5,2.45,13.05,2019
"0906092",1440,23,43,1506,95.62,1.53,2.86,2019
"0906266",215,0,43,258,83.33,0,16.67,2019
"0906359",1732,110,228,2070,83.67,5.31,11.01,2019
"0906478",4215,197,282,4694,89.8,4.2,6.01,2019
"0906498",2854,67,256,3177,89.83,2.11,8.06,2019
"0906479",3592,77,360,4029,89.15,1.91,8.94,2019
"0906482",3760,36,180,3976,94.57,0.91,4.53,2019
"0906515",5663,49,807,6519,86.87,0.75,12.38,2019
"0906525",2753,16,128,2897,95.03,0.55,4.42,2019
"3610597",330,0,0,330,100,0,0,2019
"3610913",1388,69,31,1488,93.28,4.64,2.08,2019
"3610919",297,10,32,339,87.61,2.95,9.44,2019
"3610924",3562,267,505,4334,82.19,6.16,11.65,2019
"3610950",7909,241,4213,12363,63.97,1.95,34.08,2019
"3610707",3553,35,376,3964,89.63,0.88,9.49,2019
"3610710",8237,205,1189,9631,85.53,2.13,12.35,2019
"3610925",1517,29,167,1713,88.56,1.69,9.75,2019
"3610941",4060,685,248,4993,81.31,13.72,4.97,2019
"3610964",426,0,53,479,88.94,0,11.06,2019
"3610968",1096,14,44,1154,94.97,1.21,3.81,2019
"3610987",1202,25,109,1336,89.97,1.87,8.16,2019
"3610958",773,55,109,937,82.5,5.87,11.63,2019
"3610989",3148,91,168,3407,92.4,2.67,4.93,2019
"2502558",526,45,167,738,71.27,6.1,22.63,2019
"2502645",3613,98,239,3950,91.47,2.48,6.05,2019
"2502648",2717,32,85,2834,95.87,1.13,3,2019
"2502652",297,0,41,338,87.87,0,12.13,2019
"2502667",1342,42,150,1534,87.48,2.74,9.78,2019
"2502672",136,0,0,136,100,0,0,2019
"2502777",5688,167,506,6361,89.42,2.63,7.95,2019
"4402815",123,0,0,123,100,0,0,2019
"4402831",1033,25,110,1168,88.44,2.14,9.42,2019
"4402859",2174,17,296,2487,87.41,0.68,11.9,2019
"4402860",14503,498,3542,18543,78.21,2.69,19.1,2019
"4402916",3095,129,483,3707,83.49,3.48,13.03,2019
"4402865",5719,143,635,6497,88.03,2.2,9.77,2019
"4402871",6313,161,605,7079,89.18,2.27,8.55,2019
"4402911",5568,63,990,6621,84.1,0.95,14.95,2019
"2502559",1502,11,300,1813,82.85,0.61,16.55,2019
"2502446",12300,198,618,13116,93.78,1.51,4.71,2019
"2502460",3336,23,298,3657,91.22,0.63,8.15,2019
"2502462",503,0,53,556,90.47,0,9.53,2019
"2502568",1413,67,356,1836,76.96,3.65,19.39,2019
"2502571",3581,56,548,4185,85.57,1.34,13.09,2019
"2502642",2165,70,153,2388,90.66,2.93,6.41,2019
"2502671",456,9,45,510,89.41,1.76,8.82,2019
"2502721",7094,594,2989,10677,66.44,5.56,27.99,2019
"2502726",5258,104,663,6025,87.27,1.73,11,2019
"2502747",5895,96,933,6924,85.14,1.39,13.47,2019
"2502764",1276,8,119,1403,90.95,0.57,8.48,2019
"2502771",5471,61,520,6052,90.4,1.01,8.59,2019
"4402809",7116,70,1145,8331,85.42,0.84,13.74,2019
"4402830",1920,22,331,2273,84.47,0.97,14.56,2019
"4402839",653,46,117,816,80.02,5.64,14.34,2019
"4402875",144,18,0,162,88.89,11.11,0,2019
"2502021",7912,455,697,9064,87.29,5.02,7.69,2019
"2502056",3052,17,117,3186,95.79,0.53,3.67,2019
"2502118",11373,245,1575,13193,86.2,1.86,11.94,2019
"2502121",7572,226,2868,10666,70.99,2.12,26.89,2019
"2502126",8073,432,1583,10088,80.03,4.28,15.69,2019
"2502127",15154,203,1778,17135,88.44,1.18,10.38,2019
"2502129",8001,124,1037,9162,87.33,1.35,11.32,2019
"2502163",247,259,0,506,48.81,51.19,0,2019
"2502180",8508,87,1071,9666,88.02,0.9,11.08,2019
"2502025",2847,39,201,3087,92.23,1.26,6.51,2019
"2502114",6936,185,378,7499,92.49,2.47,5.04,2019
"2502119",8447,396,2727,11570,73.01,3.42,23.57,2019
"2502130",14858,381,1585,16824,88.31,2.26,9.42,2019
"4197038",4630,316,687,5633,82.19,5.61,12.2,2019
"4197055",6343,158,526,7027,90.27,2.25,7.49,2019
"4197058",6405,449,1268,8122,78.86,5.53,15.61,2019
"4197064",1104,4,167,1275,86.59,0.31,13.1,2019
"4197106",1329,77,113,1519,87.49,5.07,7.44,2019
"4197107",641,23,86,750,85.47,3.07,11.47,2019
"4197109",150,6,39,195,76.92,3.08,20,2019
"4197112",585,10,193,788,74.24,1.27,24.49,2019
"4197115",1291,41,142,1474,87.58,2.78,9.63,2019
"4197140",8422,312,311,9045,93.11,3.45,3.44,2019
"4197148",1224,26,96,1346,90.94,1.93,7.13,2019
"4197219",15438,454,986,16878,91.47,2.69,5.84,2019
"4197230",12831,447,1869,15147,84.71,2.95,12.34,2019
"4197459",4640,133,613,5386,86.15,2.47,11.38,2019
"5005821",344,51,68,463,74.3,11.02,14.69,2019
"5005826",279,6,100,385,72.47,1.56,25.97,2019
"5005829",587,30,108,725,80.97,4.14,14.9,2019
"5005837",70,0,56,126,55.56,0,44.44,2019
"5005868",113,0,15,128,88.28,0,11.72,2019
"5005903",283,11,71,365,77.53,3.01,19.45,2019
"5005904",71,16,18,105,67.62,15.24,17.14,2019
"5005906",418,26,112,556,75.18,4.68,20.14,2019
"5005663",1629,84,393,2106,77.35,3.99,18.66,2019
"5005682",465,3,74,542,85.79,0.55,13.65,2019
"5005762",153,11,25,189,80.95,5.82,13.23,2019
"5005763",901,20,150,1071,84.13,1.87,14.01,2019
"5005701",7217,189,1711,9117,79.16,2.07,18.77,2019
"5005641",6012,353,907,7272,82.67,4.85,12.47,2019
"5005648",169,22,18,209,80.86,10.53,8.61,2019
"5005674",612,0,66,678,90.27,0,9.73,2019
"5005734",430,21,117,568,75.7,3.7,20.6,2019
"5005744",195,0,56,251,77.69,0,22.31,2019
"5005769",373,16,66,455,81.98,3.52,14.51,2019
"5005830",481,18,120,619,77.71,2.91,19.39,2019
"5005832",343,7,50,400,85.75,1.75,12.5,2019
"5005836",375,35,73,483,77.64,7.25,15.11,2019
"5005851",1867,82,488,2437,76.61,3.36,20.02,2019
"5005853",185,3,38,226,81.86,1.33,16.81,2019
"5005860",878,43,273,1194,73.53,3.6,22.86,2019
"5005871",427,47,103,577,74,8.15,17.85,2019
"5005033",881,56,178,1115,79.01,5.02,15.96,2019
"5005035",273,15,40,328,83.23,4.57,12.2,2019
"5005036",360,4,62,426,84.51,0.94,14.55,2019
"5005040",203,0,37,240,84.58,0,15.42,2019
"5005048",1120,59,104,1283,87.3,4.6,8.11,2019
"5005055",1172,28,38,1238,94.67,2.26,3.07,2019
"5005075",383,14,36,433,88.45,3.23,8.31,2019
"5005148",379,37,17,433,87.53,8.55,3.93,2019
"5005153",212,7,25,244,86.89,2.87,10.25,2019
"5005155",275,44,76,395,69.62,11.14,19.24,2019
"5005158",392,26,79,497,78.87,5.23,15.9,2019
"5005352",327,2,44,373,87.67,0.54,11.8,2019
"5005358",50,6,6,62,80.65,9.68,9.68,2019
"5005361",312,102,37,451,69.18,22.62,8.2,2019
"5005401",10567,804,1234,12605,83.83,6.38,9.79,2019
"5005404",2451,189,549,3189,76.86,5.93,17.22,2019
"5005445",1394,42,26,1462,95.35,2.87,1.78,2019
"5005454",1599,89,268,1956,81.75,4.55,13.7,2019
"5005455",335,24,46,405,82.72,5.93,11.36,2019
"5398136",7194,116,302,7612,94.51,1.52,3.97,2019
"5398116",12255,139,603,12997,94.29,1.07,4.64,2019
"5398118",15164,260,1894,17318,87.56,1.5,10.94,2019
"5398134",221,0,0,221,100,0,0,2019
"5398174",0,0,0,0,NA,NA,NA,2019
"5398222",48,0,0,48,100,0,0,2019
"5398233",5643,116,572,6331,89.13,1.83,9.03,2019
"5398243",230,33,14,277,83.03,11.91,5.05,2019
"5398279",310,21,8,339,91.45,6.19,2.36,2019
"5398280",194,56,8,258,75.19,21.71,3.1,2019
"5398311",9823,69,606,10498,93.57,0.66,5.77,2019
"5398326",255,7,86,348,73.28,2.01,24.71,2019
"5398332",6548,123,299,6970,93.95,1.76,4.29,2019
"5398357",377,14,86,477,79.04,2.94,18.03,2019
"3303262",326,10,77,413,78.93,2.42,18.64,2019
"3303264",1861,127,324,2312,80.49,5.49,14.01,2019
"3303597",92,0,61,153,60.13,0,39.87,2019
"3303604",58,0,0,58,100,0,0,2019
"3303740",262,8,35,305,85.9,2.62,11.48,2019
"3303746",84,0,16,100,84,0,16,2019
"3303754",14,0,0,14,100,0,0,2019
"3303823",563,6,27,596,94.46,1.01,4.53,2019
"3303847",219,0,0,219,100,0,0,2019
"3303850",104,0,17,121,85.95,0,14.05,2019
"3303851",1353,101,172,1626,83.21,6.21,10.58,2019
"3303861",1697,60,119,1876,90.46,3.2,6.34,2019
"3303871",104,0,0,104,100,0,0,2019
"3303890",53,0,0,53,100,0,0,2019
"2303910",175,0,0,175,100,0,0,2019
"2303911",28,0,0,28,100,0,0,2019
"2304217",1101,14,273,1388,79.32,1.01,19.67,2019
"2304105",4426,58,187,4671,94.75,1.24,4,2019
"2304110",531,14,13,558,95.16,2.51,2.33,2019
"2304222",1472,27,148,1647,89.37,1.64,8.99,2019
"2304228",0,0,0,0,NA,NA,NA,2019
"2304252",1688,15,159,1862,90.66,0.81,8.54,2019
"2304284",356,12,65,433,82.22,2.77,15.01,2019
"2304410",359,4,98,461,77.87,0.87,21.26,2019
"2304419",883,80,117,1080,81.76,7.41,10.83,2019
"2304427",851,27,135,1013,84.01,2.67,13.33,2019
"2304441",436,114,171,721,60.47,15.81,23.72,2019
"2304457",1959,209,269,2437,80.39,8.58,11.04,2019
"2304460",469,12,95,576,81.42,2.08,16.49,2019
"2304922",344,10,144,498,69.08,2.01,28.92,2019
"2304930",1311,79,428,1818,72.11,4.35,23.54,2019
"2304939",326,17,121,464,70.26,3.66,26.08,2019
"2304941",563,32,130,725,77.66,4.41,17.93,2019
"2304958",535,22,131,688,77.76,3.2,19.04,2019
"2304966",584,34,181,799,73.09,4.26,22.65,2019
"2304967",1236,64,321,1621,76.25,3.95,19.8,2019
"2304970",484,95,92,671,72.13,14.16,13.71,2019
"2304978",277,4,50,331,83.69,1.21,15.11,2019
"2304981",995,39,197,1231,80.83,3.17,16,2019
"2304342",622,16,79,717,86.75,2.23,11.02,2019
"2304347",881,29,194,1104,79.8,2.63,17.57,2019
"2304351",991,9,65,1065,93.05,0.85,6.1,2019
"2304357",1414,28,186,1628,86.86,1.72,11.43,2019
"2304406",228,25,54,307,74.27,8.14,17.59,2019
"2304001",897,29,115,1041,86.17,2.79,11.05,2019
"0572752",38,0,142,180,21.11,0,78.89,2019
"0572758",10654,2391,1862,14907,71.47,16.04,12.49,2019
"0572762",11869,1144,1511,14524,81.72,7.88,10.4,2019
"0572802",6390,196,1345,7931,80.57,2.47,16.96,2019
"0572827",8,8,98,114,7.02,7.02,85.96,2019
"0572834",2693,48,833,3574,75.35,1.34,23.31,2019
"0572845",281,45,84,410,68.54,10.98,20.49,2019
"0572860",34,0,74,108,31.48,0,68.52,2019
"0572901",6151,333,2653,9137,67.32,3.64,29.04,2019
"0572921",3926,219,1133,5278,74.38,4.15,21.47,2019
"0572923",1555,40,222,1817,85.58,2.2,12.22,2019
"0572940",828,7,185,1020,81.18,0.69,18.14,2019
"0572745",3436,938,552,4926,69.75,19.04,11.21,2019
"0572824",422,0,115,537,78.58,0,21.42,2019
"3610994",2446,93,91,2630,93,3.54,3.46,2019
"3610536",3508,35,50,3593,97.63,0.97,1.39,2019
"3610541",8376,177,507,9060,92.45,1.95,5.6,2019
"3610594",1415,0,137,1552,91.17,0,8.83,2019
"3610566",7307,232,1828,9367,78.01,2.48,19.52,2019
"3610573",10996,184,1303,12483,88.09,1.47,10.44,2019
"3610583",13297,109,517,13923,95.5,0.78,3.71,2019
"3610704",9995,938,1289,12222,81.78,7.67,10.55,2019
"3610706",2895,19,214,3128,92.55,0.61,6.84,2019
"3610920",2705,87,203,2995,90.32,2.9,6.78,2019
"3610921",1246,29,116,1391,89.58,2.08,8.34,2019
"3610930",2706,35,178,2919,92.7,1.2,6.1,2019
"3610954",7378,112,813,8303,88.86,1.35,9.79,2019
"3610962",1745,31,85,1861,93.77,1.67,4.57,2019
"3610973",772,10,13,795,97.11,1.26,1.64,2019
"3610975",92,0,9,101,91.09,0,8.91,2019
"3610976",523,0,189,712,73.46,0,26.54,2019
"3610996",865,10,0,875,98.86,1.14,0,2019
"3610535",71,51,0,122,58.2,41.8,0,2019
"3610007",2712,48,42,2802,96.79,1.71,1.5,2019
"3610019",23504,333,2321,26158,89.85,1.27,8.87,2019
"3610020",0,0,0,0,NA,NA,NA,2019
"3610021",22418,332,1185,23935,93.66,1.39,4.95,2019
"3610038",8485,151,1825,10461,81.11,1.44,17.45,2019
"3610039",9009,461,1898,11368,79.25,4.06,16.7,2019
"3610165",0,0,0,0,NA,NA,NA,2019
"3610167",0,0,0,0,NA,NA,NA,2019
"3610278",0,0,0,0,NA,NA,NA,2019
"3610280",4458,61,39,4558,97.81,1.34,0.86,2019
"3610302",4447,271,1372,6090,73.02,4.45,22.53,2019
"3610303",6114,306,1848,8268,73.95,3.7,22.35,2019
"3610457",16798,1279,6700,24777,67.8,5.16,27.04,2019
"3610464",1517,24,310,1851,81.96,1.3,16.75,2019
"3610986",484,29,38,551,87.84,5.26,6.9,2019
"3610992",2655,239,350,3244,81.84,7.37,10.79,2019
"3610507",1862,17,330,2209,84.29,0.77,14.94,2019
"3610003",23100,1069,1874,26043,88.7,4.1,7.2,2019
"3610009",21272,4248,4244,29764,71.47,14.27,14.26,2019
"3610011",26856,593,1640,29089,92.32,2.04,5.64,2019
"3610022",16682,261,1010,17953,92.92,1.45,5.63,2019
"3610028",23345,313,982,24640,94.74,1.27,3.99,2019
"3610119",0,0,0,0,NA,NA,NA,2019
"3610044",4193,221,360,4774,87.83,4.63,7.54,2019
"3610162",673,0,0,673,100,0,0,2019
"3610279",18,0,0,18,100,0,0,2019
"3613493",543,34,158,735,73.88,4.63,21.5,2019
"3613601",12268,400,2408,15076,81.37,2.65,15.97,2019
"3613620",588,31,143,762,77.17,4.07,18.77,2019
"3613116",1119,74,199,1392,80.39,5.32,14.3,2019
"3613141",216,3,48,267,80.9,1.12,17.98,2019
"3613148",3871,42,632,4545,85.17,0.92,13.91,2019
"3613224",2960,134,453,3547,83.45,3.78,12.77,2019
"3613315",386,21,137,544,70.96,3.86,25.18,2019
"3613328",558,9,68,635,87.87,1.42,10.71,2019
"3613334",312,6,66,384,81.25,1.56,17.19,2019
"3613338",388,8,167,563,68.92,1.42,29.66,2019
"3613341",63,0,0,63,100,0,0,2019
"3613346",1439,68,260,1767,81.44,3.85,14.71,2019
"3613357",3456,127,601,4184,82.6,3.04,14.36,2019
"4197470",7459,164,1207,8830,84.47,1.86,13.67,2019
"4197478",12646,338,1521,14505,87.18,2.33,10.49,2019
"4197480",114,4,49,167,68.26,2.4,29.34,2019
"4197489",296,20,30,346,85.55,5.78,8.67,2019
"4197492",213,9,21,243,87.65,3.7,8.64,2019
"4197502",9666,562,951,11179,86.47,5.03,8.51,2019
"4197520",10504,316,788,11608,90.49,2.72,6.79,2019
"4197524",4971,135,765,5871,84.67,2.3,13.03,2019
"4197527",12360,622,1949,14931,82.78,4.17,13.05,2019
"4197530",2749,78,337,3164,86.88,2.47,10.65,2019
"4197532",895,38,149,1082,82.72,3.51,13.77,2019
"4197535",1757,301,451,2509,70.03,12,17.98,2019
"4197625",94,0,8,102,92.16,0,7.84,2019
"4197626",29,0,16,45,64.44,0,35.56,2019
"4197637",39,0,15,54,72.22,0,27.78,2019
"4197640",60,2,10,72,83.33,2.78,13.89,2019
"4197736",39,5,2,46,84.78,10.87,4.35,2019
"4197738",665,11,68,744,89.38,1.48,9.14,2019
"4197739",3756,370,991,5117,73.4,7.23,19.37,2019
"4197759",2917,117,231,3265,89.34,3.58,7.08,2019
"4197812",289,13,54,356,81.18,3.65,15.17,2019
"4197813",449,4,77,530,84.72,0.75,14.53,2019
"4197836",704,8,125,837,84.11,0.96,14.93,2019
"4197481",197,30,30,257,76.65,11.67,11.67,2019
"4197504",16744,721,2004,19469,86,3.7,10.29,2019
"4197539",1108,60,405,1573,70.44,3.81,25.75,2019
"4197624",1103,60,497,1660,66.45,3.61,29.94,2019
"4197634",56,0,15,71,78.87,0,21.13,2019
"4197636",148,16,40,204,72.55,7.84,19.61,2019
"4197638",161,0,66,227,70.93,0,29.07,2019
"4197702",17623,442,1498,19563,90.08,2.26,7.66,2019
"4197751",24,0,19,43,55.81,0,44.19,2019
"4197761",597,44,360,1001,59.64,4.4,35.96,2019
"4197817",11,0,0,11,100,0,0,2019
"4197823",308,31,116,455,67.69,6.81,25.49,2019
"4197824",564,8,143,715,78.88,1.12,20,2019
"4197839",91,0,27,118,77.12,0,22.88,2019
"4197841",160,11,34,205,78.05,5.37,16.59,2019
"4197844",1101,74,183,1358,81.08,5.45,13.48,2019
"4197846",722,16,153,891,81.03,1.8,17.17,2019
"4197859",28,0,29,57,49.12,0,50.88,2019
"4197862",3310,49,936,4295,77.07,1.14,21.79,2019
"4197875",876,19,188,1083,80.89,1.75,17.36,2019
"4197882",1501,181,404,2086,71.96,8.68,19.37,2019
"4197904",61,0,44,105,58.1,0,41.9,2019
"0695626",1703,66,134,1903,89.49,3.47,7.04,2019
"0695627",1005,0,172,1177,85.39,0,14.61,2019
"0695632",8945,243,854,10042,89.08,2.42,8.5,2019
"0695651",191,21,7,219,87.21,9.59,3.2,2019
"0695653",133,27,33,193,68.91,13.99,17.1,2019
"0695655",1278,48,76,1402,91.16,3.42,5.42,2019
"0695448",6249,70,478,6797,91.94,1.03,7.03,2019
"0695148",11470,220,334,12024,95.39,1.83,2.78,2019
"0695073",3648,114,202,3964,92.03,2.88,5.1,2019
"0695139",2044,37,154,2235,91.45,1.66,6.89,2019
"0695322",2550,84,604,3238,78.75,2.59,18.65,2019
"0695372",643,3,77,723,88.93,0.41,10.65,2019
"0695421",672,19,96,787,85.39,2.41,12.2,2019
"0695442",1219,24,69,1312,92.91,1.83,5.26,2019
"5398362",8776,264,1458,10498,83.6,2.51,13.89,2019
"5398366",11838,188,1365,13391,88.4,1.4,10.19,2019
"5398371",7377,199,934,8510,86.69,2.34,10.98,2019
"5398383",8171,137,412,8720,93.7,1.57,4.72,2019
"5398533",190,0,8,198,95.96,0,4.04,2019
"5398542",168,21,26,215,78.14,9.77,12.09,2019
"5398548",975,8,124,1107,88.08,0.72,11.2,2019
"5398593",298,9,88,395,75.44,2.28,22.28,2019
"5398616",50,0,0,50,100,0,0,2019
"5398620",2647,44,526,3217,82.28,1.37,16.35,2019
"5398125",16947,520,1816,19283,87.89,2.7,9.42,2019
"5398260",2469,24,216,2709,91.14,0.89,7.97,2019
"5398333",1352,62,66,1480,91.35,4.19,4.46,2019
"5398421",0,0,0,0,NA,NA,NA,2019
"5398613",124,2,32,158,78.48,1.27,20.25,2019
"5398012",23174,405,667,24246,95.58,1.67,2.75,2019
"5398122",17451,590,1426,19467,89.64,3.03,7.33,2019
"5398198",13012,302,706,14020,92.81,2.15,5.04,2019
"5398257",1721,21,192,1934,88.99,1.09,9.93,2019
"5398315",1135,10,7,1152,98.52,0.87,0.61,2019
"5398377",599,35,277,911,65.75,3.84,30.41,2019
"5398404",9295,484,1913,11692,79.5,4.14,16.36,2019
"5398405",7738,595,1467,9800,78.96,6.07,14.97,2019
"5398443",1892,88,163,2143,88.29,4.11,7.61,2019
"5398555",115,0,89,204,56.37,0,43.63,2019
"5398577",2266,76,449,2791,81.19,2.72,16.09,2019
"5398582",98,0,0,98,100,0,0,2019
"5398585",323,0,107,430,75.12,0,24.88,2019
"5398043",7840,194,523,8557,91.62,2.27,6.11,2019
"5398052",26685,556,781,28022,95.23,1.98,2.79,2019
"5398092",15289,197,911,16397,93.24,1.2,5.56,2019
"5398102",14650,628,372,15650,93.61,4.01,2.38,2019
"5398108",7081,189,1221,8491,83.39,2.23,14.38,2019
"5398380",1522,97,101,1720,88.49,5.64,5.87,2019
"5398467",5516,148,380,6044,91.26,2.45,6.29,2019
"5398536",54,0,0,54,100,0,0,2019
"5398564",722,12,236,970,74.43,1.24,24.33,2019
"5398604",11358,256,696,12310,92.27,2.08,5.65,2019
"5398649",286,0,61,347,82.42,0,17.58,2019
"5398335",9563,195,342,10100,94.68,1.93,3.39,2019
"5398359",1767,45,89,1901,92.95,2.37,4.68,2019
"5398465",2471,125,530,3126,79.05,4,16.95,2019
"5398075",7717,94,49,7860,98.18,1.2,0.62,2019
"5398077",4395,41,130,4566,96.25,0.9,2.85,2019
"5398087",13367,595,715,14677,91.07,4.05,4.87,2019
"0299501",5970,389,1186,7545,79.13,5.16,15.72,2019
"0299502",8166,226,617,9009,90.64,2.51,6.85,2019
"0299513",0,0,0,0,NA,NA,NA,2019
"5399006",4101,41,666,4808,85.3,0.85,13.85,2019
"5399027",2196,37,224,2457,89.38,1.51,9.12,2019
"5399040",176,13,104,293,60.07,4.44,35.49,2019
"0299517",5987,74,733,6794,88.12,1.09,10.79,2019
"0299551",60,20,55,135,44.44,14.81,40.74,2019
"0299563",124,0,57,181,68.51,0,31.49,2019
"0299571",42,0,27,69,60.87,0,39.13,2019
"0299575",9,0,19,28,32.14,0,67.86,2019
"0299578",67,17,42,126,53.17,13.49,33.33,2019
"0299580",14,2,12,28,50,7.14,42.86,2019
"0299606",65,3,37,105,61.9,2.86,35.24,2019
"5398639",322,26,78,426,75.59,6.1,18.31,2019
"5398660",4550,253,788,5591,81.38,4.53,14.09,2019
"5398663",5420,59,651,6130,88.42,0.96,10.62,2019
"5398674",3858,181,620,4659,82.81,3.88,13.31,2019
"5398815",2027,105,514,2646,76.61,3.97,19.43,2019
"5398819",71,28,26,125,56.8,22.4,20.8,2019
"5398831",1116,8,217,1341,83.22,0.6,16.18,2019
"5398841",2998,89,827,3914,76.6,2.27,21.13,2019
"5398845",100,11,19,130,76.92,8.46,14.62,2019
"5398846",332,16,97,445,74.61,3.6,21.8,2019
"5398859",69,0,22,91,75.82,0,24.18,2019
"5398901",8126,324,2185,10635,76.41,3.05,20.55,2019
"5398902",12614,759,3091,16464,76.62,4.61,18.77,2019
"5398908",12572,461,1541,14574,86.26,3.16,10.57,2019
"5398944",5512,83,793,6388,86.29,1.3,12.41,2019
"5398948",2902,116,733,3751,77.37,3.09,19.54,2019
"5398950",23,0,0,23,100,0,0,2019
"5398952",442,7,112,561,78.79,1.25,19.96,2019
"5398248",8039,223,888,9150,87.86,2.44,9.7,2019
"5398166",8132,125,529,8786,92.56,1.42,6.02,2019
"5398237",1520,38,268,1826,83.24,2.08,14.68,2019
"5398251",1614,15,209,1838,87.81,0.82,11.37,2019
"5398252",3257,81,407,3745,86.97,2.16,10.87,2019
"5398256",117,13,29,159,73.58,8.18,18.24,2019
"5398284",8543,150,935,9628,88.73,1.56,9.71,2019
"5398286",76,4,2,82,92.68,4.88,2.44,2019
"5398560",63,0,3,66,95.45,0,4.55,2019
"5398569",2970,33,314,3317,89.54,0.99,9.47,2019
"5398572",248,4,28,280,88.57,1.43,10,2019
"5398575",40,0,25,65,61.54,0,38.46,2019
"5398579",4388,61,422,4871,90.08,1.25,8.66,2019
"5398606",2828,36,189,3053,92.63,1.18,6.19,2019
"5398611",3128,41,340,3509,89.14,1.17,9.69,2019
"5398624",501,3,133,637,78.65,0.47,20.88,2019
"5398632",17051,691,3221,20963,81.34,3.3,15.37,2019
"5398640",1893,17,290,2200,86.05,0.77,13.18,2019
"5398683",12136,346,1277,13759,88.2,2.51,9.28,2019
"5398684",9906,100,885,10891,90.96,0.92,8.13,2019
"5398816",1724,87,533,2344,73.55,3.71,22.74,2019
"5398833",63,0,0,63,100,0,0,2019
"5398836",244,0,76,320,76.25,0,23.75,2019
"1596822",15551,520,2209,18280,85.07,2.84,12.08,2019
"0696037",105,10,6,121,86.78,8.26,4.96,2019
"1596796",503,19,169,691,72.79,2.75,24.46,2019
"1596815",11208,708,1572,13488,83.1,5.25,11.65,2019
"4197443",754,8,70,832,90.62,0.96,8.41,2019
"4197446",1497,108,332,1937,77.28,5.58,17.14,2019
"4197447",179,12,56,247,72.47,4.86,22.67,2019
"4197450",168,0,79,247,68.02,0,31.98,2019
"4197451",133,0,5,138,96.38,0,3.62,2019
"4197479",3498,149,546,4193,83.42,3.55,13.02,2019
"4197498",682,19,79,780,87.44,2.44,10.13,2019
"4197525",1559,99,170,1828,85.28,5.42,9.3,2019
"0697635",70,0,15,85,82.35,0,17.65,2019
"4197641",272,123,261,656,41.46,18.75,39.79,2019
"4197701",25727,442,2236,28405,90.57,1.56,7.87,2019
"4197722",20,1,9,30,66.67,3.33,30,2019
"4197733",138,0,89,227,60.79,0,39.21,2019
"4197737",175,18,70,263,66.54,6.84,26.62,2019
"3613407",1600,70,370,2040,78.43,3.43,18.14,2019
"3613408",761,46,165,972,78.29,4.73,16.98,2019
"3613418",98,0,13,111,88.29,0,11.71,2019
"3613329",1218,70,342,1630,74.72,4.29,20.98,2019
"3613355",280,0,38,318,88.05,0,11.95,2019
"3613368",306,7,134,447,68.46,1.57,29.98,2019
"3613035",2460,136,384,2980,82.55,4.56,12.89,2019
"3613208",5480,568,2516,8564,63.99,6.63,29.38,2019
"3613302",507,23,139,669,75.78,3.44,20.78,2019
"3613652",516,30,73,619,83.36,4.85,11.79,2019
"3613662",5855,167,1187,7209,81.22,2.32,16.47,2019
"3613673",742,10,139,891,83.28,1.12,15.6,2019
"3613675",27,0,9,36,75,0,25,2019
"3613676",4571,116,715,5402,84.62,2.15,13.24,2019
"3613684",322,3,83,408,78.92,0.74,20.34,2019
"3613690",208,13,100,321,64.8,4.05,31.15,2019
"3613731",337,4,118,459,73.42,0.87,25.71,2019
"3613744",422,5,27,454,92.95,1.1,5.95,2019
"3613746",645,19,172,836,77.15,2.27,20.57,2019
"3613753",1519,57,247,1823,83.32,3.13,13.55,2019
"3613776",212,5,39,256,82.81,1.95,15.23,2019
"3613780",312,0,69,381,81.89,0,18.11,2019
"3613796",466,7,98,571,81.61,1.23,17.16,2019
"3613802",249,0,5,254,98.03,0,1.97,2019
"3613813",193,25,86,304,63.49,8.22,28.29,2019
"3613825",989,45,210,1244,79.5,3.62,16.88,2019
"3613865",2148,45,319,2512,85.51,1.79,12.7,2019
"3613901",6374,294,1440,8108,78.61,3.63,17.76,2019
"3613903",6518,209,922,7649,85.21,2.73,12.05,2019
"3613905",8730,283,2181,11194,77.99,2.53,19.48,2019
"3613026",483,20,79,582,82.99,3.44,13.57,2019
"3613028",374,17,95,486,76.95,3.5,19.55,2019
"3613034",683,8,119,810,84.32,0.99,14.69,2019
"3613036",3191,83,465,3739,85.34,2.22,12.44,2019
"3613041",3967,153,213,4333,91.55,3.53,4.92,2019
"3613057",4994,217,910,6121,81.59,3.55,14.87,2019
"3613061",345,24,51,420,82.14,5.71,12.14,2019
"3613066",4628,157,374,5159,89.71,3.04,7.25,2019
"3613082",1453,66,166,1685,86.23,3.92,9.85,2019
"3613111",551,25,60,636,86.64,3.93,9.43,2019
"3613752",260,14,27,301,86.38,4.65,8.97,2019
"3613755",395,19,76,490,80.61,3.88,15.51,2019
"3613777",116,0,21,137,84.67,0,15.33,2019
"3613786",138,9,40,187,73.8,4.81,21.39,2019
"3613787",1250,10,200,1460,85.62,0.68,13.7,2019
"4215563",921,35,287,1243,74.09,2.82,23.09,2019
"4215624",140,0,8,148,94.59,0,5.41,2019
"4215647",102,0,7,109,93.58,0,6.42,2019
"4215671",260,0,10,270,96.3,0,3.7,2019
"4215676",234,0,50,284,82.39,0,17.61,2019
"4215678",230,0,52,282,81.56,0,18.44,2019
"4215687",337,6,137,480,70.21,1.25,28.54,2019
"4215710",102,0,14,116,87.93,0,12.07,2019
"4215713",149,0,0,149,100,0,0,2019
"4215730",13,0,23,36,36.11,0,63.89,2019
"4215733",22,0,43,65,33.85,0,66.15,2019
"4215765",484,30,118,632,76.58,4.75,18.67,2019
"4215401",10049,354,2886,13289,75.62,2.66,21.72,2019
"4215410",330,0,136,466,70.82,0,29.18,2019
"0695635",371,20,50,441,84.13,4.54,11.34,2019
"0695351",10849,269,2267,13385,81.05,2.01,16.94,2019
"0695013",17,15,0,32,53.12,46.88,0,2019
"0695053",0,0,0,0,NA,NA,NA,2019
"0695075",121,2,21,144,84.03,1.39,14.58,2019
"0695645",423,0,195,618,68.45,0,31.55,2019
"0695458",916,23,264,1203,76.14,1.91,21.95,2019
"0695553",342,0,61,403,84.86,0,15.14,2019
"0695610",15463,462,2002,17927,86.26,2.58,11.17,2019
"0695361",10503,232,1471,12206,86.05,1.9,12.05,2019
"0695457",902,11,418,1331,67.77,0.83,31.4,2019
"0695545",3,0,35,38,7.89,0,92.11,2019
"0695616",15965,781,556,17302,92.27,4.51,3.21,2019
"0695211",0,0,0,0,NA,NA,NA,2019
"0695234",0,0,0,0,NA,NA,NA,2019
"0695248",45,0,11,56,80.36,0,19.64,2019
"0695304",3365,103,288,3756,89.59,2.74,7.67,2019
"0695314",0,0,0,0,NA,NA,NA,2019
"0695319",375,8,240,623,60.19,1.28,38.52,2019
"0695341",7193,191,1108,8492,84.7,2.25,13.05,2019
"0695375",0,0,0,0,NA,NA,NA,2019
"0695377",8551,106,194,8851,96.61,1.2,2.19,2019
"0695391",4857,15,172,5044,96.29,0.3,3.41,2019
"0695435",75,13,0,88,85.23,14.77,0,2019
"0695467",1957,25,72,2054,95.28,1.22,3.51,2019
"0695486",17,16,0,33,51.52,48.48,0,2019
"0695604",39,0,12,51,76.47,0,23.53,2019
"0695652",200,18,0,218,91.74,8.26,0,2019
"0695679",24,0,0,24,100,0,0,2019
"0695680",10,0,0,10,100,0,0,2019
"0695697",47,10,37,94,50,10.64,39.36,2019
"0695698",63,20,24,107,58.88,18.69,22.43,2019
"0695699",2,18,0,20,10,90,0,2019
"0695724",0,0,0,0,NA,NA,NA,2019
"0695757",13625,279,478,14382,94.74,1.94,3.32,2019
"5398188",8258,165,794,9217,89.6,1.79,8.61,2019
"5398203",12624,377,902,13903,90.8,2.71,6.49,2019
"5398224",69,7,45,121,57.02,5.79,37.19,2019
"5398225",18831,605,1793,21229,88.7,2.85,8.45,2019
"5398236",2392,64,94,2550,93.8,2.51,3.69,2019
"5398239",3014,121,298,3433,87.79,3.52,8.68,2019
"5398258",10561,222,715,11498,91.85,1.93,6.22,2019
"5398323",214,2,48,264,81.06,0.76,18.18,2019
"5398349",1480,17,203,1700,87.06,1,11.94,2019
"5398350",85,4,30,119,71.43,3.36,25.21,2019
"2501531",407,8,45,460,88.48,1.74,9.78,2019
"2501603",5937,144,1246,7327,81.03,1.97,17.01,2019
"2501607",2991,81,630,3702,80.79,2.19,17.02,2019
"2501702",13207,257,1748,15212,86.82,1.69,11.49,2019
"2501760",13220,269,941,14430,91.61,1.86,6.52,2019
"2501778",4624,50,175,4849,95.36,1.03,3.61,2019
"2501830",8377,312,1407,10096,82.97,3.09,13.94,2019
"2501852",10844,261,3150,14255,76.07,1.83,22.1,2019
"2501879",4130,61,248,4439,93.04,1.37,5.59,2019
"2501887",7453,74,430,7957,93.67,0.93,5.4,2019
"2501921",2726,48,65,2839,96.02,1.69,2.29,2019
"2501105",3083,548,1360,4991,61.77,10.98,27.25,2019
"2501201",16557,474,2989,20020,82.7,2.37,14.93,2019
"2501230",3104,52,355,3511,88.41,1.48,10.11,2019
"0299607",39,0,26,65,60,0,40,2019
"0299621",83,4,54,141,58.87,2.84,38.3,2019
"0299628",81,5,58,144,56.25,3.47,40.28,2019
"0299636",61,3,60,124,49.19,2.42,48.39,2019
"0299647",11,0,0,11,100,0,0,2019
"0299648",15,2,12,29,51.72,6.9,41.38,2019
"0299654",16340,431,1752,18523,88.21,2.33,9.46,2019
"0299669",4799,190,958,5947,80.7,3.19,16.11,2019
"0299677",16,0,0,16,100,0,0,2019
"0299724",3,0,26,29,10.34,0,89.66,2019
"0299752",793,11,145,949,83.56,1.16,15.28,2019
"0299757",2,0,15,17,11.76,0,88.24,2019
"0299770",79,1,75,155,50.97,0.65,48.39,2019
"0299774",0,0,8,8,0,0,100,2019
"0299786",39,3,17,59,66.1,5.08,28.81,2019
"0299791",29,2,11,42,69.05,4.76,26.19,2019
"0299918",61,5,36,102,59.8,4.9,35.29,2019
"0299632",133,0,35,168,79.17,0,20.83,2019
"0299649",15,3,15,33,45.45,9.09,45.45,2019
"0299650",97,0,30,127,76.38,0,23.62,2019
"0299652",969,18,188,1175,82.47,1.53,16,2019
"0299653",31,0,1,32,96.88,0,3.12,2019
"0299661",275,6,143,424,64.86,1.42,33.73,2019
"0299664",1330,0,123,1453,91.53,0,8.47,2019
"0299712",4690,220,896,5806,80.78,3.79,15.43,2019
"0299729",78,2,13,93,83.87,2.15,13.98,2019
"0299732",7,0,0,7,100,0,0,2019
"0299736",27,1,6,34,79.41,2.94,17.65,2019
"0299740",62,2,155,219,28.31,0.91,70.78,2019
"0299741",123,1,59,183,67.21,0.55,32.24,2019
"0299744",47,0,9,56,83.93,0,16.07,2019
"0299745",9,0,27,36,25,0,75,2019
"0299747",38,4,14,56,67.86,7.14,25,2019
"0299748",19,6,31,56,33.93,10.71,55.36,2019
"0299750",82,3,29,114,71.93,2.63,25.44,2019
"0299751",16,2,8,26,61.54,7.69,30.77,2019
"0299766",99,2,48,149,66.44,1.34,32.21,2019
"0299780",470,20,146,636,73.9,3.14,22.96,2019
"0299824",905,28,81,1014,89.25,2.76,7.99,2019
"0299826",134,6,56,196,68.37,3.06,28.57,2019
"0299841",39,0,28,67,58.21,0,41.79,2019
"0299919",199,11,83,293,67.92,3.75,28.33,2019
"0299922",60,2,55,117,51.28,1.71,47.01,2019
"0299746",44,7,49,100,44,7,49,2019
"0299764",38,0,52,90,42.22,0,57.78,2019
"3303242",1600,50,155,1805,88.64,2.77,8.59,2019
"3303253",2471,109,264,2844,86.88,3.83,9.28,2019
"3303257",1445,32,119,1596,90.54,2.01,7.46,2019
"3303275",3898,83,497,4478,87.05,1.85,11.1,2019
"3303287",623,14,33,670,92.99,2.09,4.93,2019
"3303440",889,76,123,1088,81.71,6.99,11.31,2019
"3303070",1775,51,124,1950,91.03,2.62,6.36,2019
"3303071",1667,104,95,1866,89.34,5.57,5.09,2019
"3303215",81,7,4,92,88.04,7.61,4.35,2019
"3303220",2576,164,297,3037,84.82,5.4,9.78,2019
"3303223",1048,119,218,1385,75.67,8.59,15.74,2019
"3303224",842,15,95,952,88.45,1.58,9.98,2019
"3303251",402,7,39,448,89.73,1.56,8.71,2019
"3303259",119,4,47,170,70,2.35,27.65,2019
"0696132",23,0,4,27,85.19,0,14.81,2019
"0696134",480,0,247,727,66.02,0,33.98,2019
"0696146",453,26,24,503,90.06,5.17,4.77,2019
"1596703",483,31,150,664,72.74,4.67,22.59,2019
"1596706",17958,566,1224,19748,90.94,2.87,6.2,2019
"1596714",279,18,61,358,77.93,5.03,17.04,2019
"1596717",1066,23,152,1241,85.9,1.85,12.25,2019
"1596722",752,32,30,814,92.38,3.93,3.69,2019
"1596727",1119,44,311,1474,75.92,2.99,21.1,2019
"1596730",396,13,70,479,82.67,2.71,14.61,2019
"1596731",680,21,90,791,85.97,2.65,11.38,2019
"1596740",12615,426,1398,14439,87.37,2.95,9.68,2019
"0696086",117,4,18,139,84.17,2.88,12.95,2019
"0696097",3428,110,798,4336,79.06,2.54,18.4,2019
"0696101",1487,76,619,2182,68.15,3.48,28.37,2019
"0696120",267,14,35,316,84.49,4.43,11.08,2019
"0696122",1151,13,354,1518,75.82,0.86,23.32,2019
"0696123",9,0,0,9,100,0,0,2019
"0696128",252,8,42,302,83.44,2.65,13.91,2019
"1596701",11959,212,1105,13276,90.08,1.6,8.32,2019
"1596705",649,7,156,812,79.93,0.86,19.21,2019
"1596742",26,2,11,39,66.67,5.13,28.21,2019
"1596746",5929,124,627,6680,88.76,1.86,9.39,2019
"1596751",57,0,0,57,100,0,0,2019
"1596752",882,56,213,1151,76.63,4.87,18.51,2019
"1596753",9615,497,668,10780,89.19,4.61,6.2,2019
"1596795",1783,127,316,2226,80.1,5.71,14.2,2019
"1596814",8521,524,1566,10611,80.3,4.94,14.76,2019
"5398057",5144,173,706,6023,85.41,2.87,11.72,2019
"5398074",9251,103,101,9455,97.84,1.09,1.07,2019
"5398670",15,0,7,22,68.18,0,31.82,2019
"5398847",639,0,96,735,86.94,0,13.06,2019
"5398940",122,14,0,136,89.71,10.29,0,2019
"5398586",544,0,81,625,87.04,0,12.96,2019
"5398661",16371,695,1731,18797,87.09,3.7,9.21,2019
"5398828",633,0,248,881,71.85,0,28.15,2019
"5398932",1092,10,307,1409,77.5,0.71,21.79,2019
"5398010",1978,25,132,2135,92.65,1.17,6.18,2019
"5398126",9224,167,971,10362,89.02,1.61,9.37,2019
"5398230",6467,189,767,7423,87.12,2.55,10.33,2019
"5398563",2647,42,356,3045,86.93,1.38,11.69,2019
"5398537",745,1,109,855,87.13,0.12,12.75,2019
"5398541",3307,137,634,4078,81.09,3.36,15.55,2019
"5398546",1144,70,124,1338,85.5,5.23,9.27,2019
"5398571",89,0,0,89,100,0,0,2019
"0695527",164,0,112,276,59.42,0,40.58,2019
"4197024",3715,42,491,4248,87.45,0.99,11.56,2019
"4197028",75,0,30,105,71.43,0,28.57,2019
"4197041",677,12,128,817,82.86,1.47,15.67,2019
"4197060",6459,70,569,7098,91,0.99,8.02,2019
"4197111",1060,22,220,1302,81.41,1.69,16.9,2019
"4197119",1150,66,295,1511,76.11,4.37,19.52,2019
"4197145",156,0,0,156,100,0,0,2019
"4197203",11212,169,868,12249,91.53,1.38,7.09,2019
"4197206",18372,434,1812,20618,89.11,2.1,8.79,2019
"4197209",10846,898,1328,13072,82.97,6.87,10.16,2019
"4197211",12292,277,1051,13620,90.25,2.03,7.72,2019
"4197214",11882,308,959,13149,90.36,2.34,7.29,2019
"4197231",1403,46,129,1578,88.91,2.92,8.17,2019
"4215412",196,7,30,233,84.12,3,12.88,2019
"4215413",103,18,56,177,58.19,10.17,31.64,2019
"4215417",2784,161,588,3533,78.8,4.56,16.64,2019
"4215420",90,0,11,101,89.11,0,10.89,2019
"4215618",766,32,234,1032,74.22,3.1,22.67,2019
"4215010",9242,240,1790,11272,81.99,2.13,15.88,2019
"4215017",5878,195,1071,7144,82.28,2.73,14.99,2019
"4215020",44,0,10,54,81.48,0,18.52,2019
"4215025",5932,135,890,6957,85.27,1.94,12.79,2019
"4215033",1457,21,523,2001,72.81,1.05,26.14,2019
"4215071",4215,233,406,4854,86.84,4.8,8.36,2019
"4215458",559,38,347,944,59.22,4.03,36.76,2019
"4215411",200,0,55,255,78.43,0,21.57,2019
"4215437",730,8,138,876,83.33,0.91,15.75,2019
"4215447",18,0,15,33,54.55,0,45.45,2019
"4215459",447,0,177,624,71.63,0,28.37,2019
"4215461",1295,36,452,1783,72.63,2.02,25.35,2019
"4215464",425,29,142,596,71.31,4.87,23.83,2019
"4215532",58,0,7,65,89.23,0,10.77,2019
"4215535",680,14,185,879,77.36,1.59,21.05,2019
"4215544",43,0,14,57,75.44,0,24.56,2019
"4215545",845,8,264,1117,75.65,0.72,23.63,2019
"4215560",48,5,20,73,65.75,6.85,27.4,2019
"4215562",47,0,14,61,77.05,0,22.95,2019
"4215613",4634,215,947,5796,79.95,3.71,16.34,2019
"4215639",752,13,140,905,83.09,1.44,15.47,2019
"4215006",170,0,0,170,100,0,0,2019
"4215012",5317,112,1214,6643,80.04,1.69,18.27,2019
"4215019",558,7,76,641,87.05,1.09,11.86,2019
"4215024",2936,127,617,3680,79.78,3.45,16.77,2019
"4215044",9412,101,820,10333,91.09,0.98,7.94,2019
"4215046",902,0,143,1045,86.32,0,13.68,2019
"4215050",794,32,192,1018,78,3.14,18.86,2019
"4215081",131,4,30,165,79.39,2.42,18.18,2019
"4215219",3719,297,1405,5421,68.6,5.48,25.92,2019
"4215145",2528,72,553,3153,80.18,2.28,17.54,2019
"4215146",10846,228,1132,12206,88.86,1.87,9.27,2019
"4215212",10637,401,2432,13470,78.97,2.98,18.05,2019
"4215220",7081,132,798,8011,88.39,1.65,9.96,2019
"4215228",6682,74,439,7195,92.87,1.03,6.1,2019
"4215331",255,6,66,327,77.98,1.83,20.18,2019
"4215345",431,14,135,580,74.31,2.41,23.28,2019
"4215351",304,0,62,366,83.06,0,16.94,2019
"4215928",675,18,177,870,77.59,2.07,20.34,2019
"4215942",544,24,251,819,66.42,2.93,30.65,2019
"0906606",13346,434,2204,15984,83.5,2.72,13.79,2019
"0906610",6744,254,1653,8651,77.96,2.94,19.11,2019
"0906706",3682,215,1140,5037,73.1,4.27,22.63,2019
"0906708",9184,307,1710,11201,81.99,2.74,15.27,2019
"0906763",683,20,24,727,93.95,2.75,3.3,2019
"0906784",1392,37,66,1495,93.11,2.47,4.41,2019
"0906793",553,9,18,580,95.34,1.55,3.1,2019
"0906798",3730,64,335,4129,90.34,1.55,8.11,2019
"0906801",6648,71,431,7150,92.98,0.99,6.03,2019
"0906830",8557,155,798,9510,89.98,1.63,8.39,2019
"0906870",2453,16,70,2539,96.61,0.63,2.76,2019
"0906902",22901,530,2787,26218,87.35,2.02,10.63,2019
"0906905",6761,168,488,7417,91.16,2.27,6.58,2019
"0906023",510,30,77,617,82.66,4.86,12.48,2019
"2501238",2082,64,162,2308,90.21,2.77,7.02,2019
"2501257",729,24,165,918,79.41,2.61,17.97,2019
"2501367",157,29,51,237,66.24,12.24,21.52,2019
"2501430",1918,39,90,2047,93.7,1.91,4.4,2019
"2501432",2905,162,375,3442,84.4,4.71,10.89,2019
"2501436",1119,0,176,1295,86.41,0,13.59,2019
"2501463",3984,75,385,4444,89.65,1.69,8.66,2019
"2501468",1723,8,93,1824,94.46,0.44,5.1,2019
"2501516",2852,74,308,3234,88.19,2.29,9.52,2019
"2501523",2218,21,191,2430,91.28,0.86,7.86,2019
"2501541",1165,13,93,1271,91.66,1.02,7.32,2019
"2501560",1588,10,152,1750,90.74,0.57,8.69,2019
"2501570",5633,309,1004,6946,81.1,4.45,14.45,2019
"2501608",1354,73,489,1916,70.67,3.81,25.52,2019
"2501966",2859,53,412,3324,86.01,1.59,12.39,2019
"2501970",16233,264,1874,18371,88.36,1.44,10.2,2019
"2501985",1593,19,66,1678,94.93,1.13,3.93,2019
"2501754",4059,60,143,4262,95.24,1.41,3.36,2019
"2501745",203,9,18,230,88.26,3.91,7.83,2019
"2501746",4875,110,285,5270,92.5,2.09,5.41,2019
"2501749",6974,134,769,7877,88.54,1.7,9.76,2019
"2501827",1141,5,32,1178,96.86,0.42,2.72,2019
"2501833",3091,56,148,3295,93.81,1.7,4.49,2019
"2501844",15915,286,1706,17907,88.88,1.6,9.53,2019
"2501845",10088,135,889,11112,90.78,1.21,8,2019
"2501850",4362,144,954,5460,79.89,2.64,17.47,2019
"2501915",14438,348,1657,16443,87.81,2.12,10.08,2019
"2501944",1886,46,143,2075,90.89,2.22,6.89,2019
"7200906",115,0,0,115,100,0,0,2019
"7200968",1367,30,400,1797,76.07,1.67,22.26,2019
"7200982",3974,110,1826,5910,67.24,1.86,30.9,2019
"7200783",5394,16,4965,10375,51.99,0.15,47.86,2019
"7200723",3705,231,2226,6162,60.13,3.75,36.12,2019
"7200735",2719,202,1382,4303,63.19,4.69,32.12,2019
"7200739",6717,87,4989,11793,56.96,0.74,42.3,2019
"7200757",4787,88,2492,7367,64.98,1.19,33.83,2019
"7200911",2619,61,911,3591,72.93,1.7,25.37,2019
"7200952",1269,101,1426,2796,45.39,3.61,51,2019
"7200961",8767,122,2389,11278,77.74,1.08,21.18,2019
"7200617",4404,185,3321,7910,55.68,2.34,41.98,2019
"7200637",3620,202,3211,7033,51.47,2.87,45.66,2019
"7200641",4853,94,3998,8945,54.25,1.05,44.7,2019
"7200650",2619,311,2206,5136,50.99,6.06,42.95,2019
"7200669",5022,127,4448,9597,52.33,1.32,46.35,2019
"7200703",5305,64,3106,8475,62.6,0.76,36.65,2019
"2502131",11014,246,1432,12692,86.78,1.94,11.28,2019
"2502134",7811,91,680,8582,91.02,1.06,7.92,2019
"2502136",10220,196,1584,12000,85.17,1.63,13.2,2019
"2502138",12513,917,758,14188,88.19,6.46,5.34,2019
"2502142",1691,0,70,1761,96.02,0,3.98,2019
"2502145",9592,192,1131,10915,87.88,1.76,10.36,2019
"2502171",6893,139,817,7849,87.82,1.77,10.41,2019
"2502341",3508,64,335,3907,89.79,1.64,8.57,2019
"2502343",3493,91,510,4094,85.32,2.22,12.46,2019
"2502451",6788,94,423,7305,92.92,1.29,5.79,2019
"2502458",4532,7,351,4890,92.68,0.14,7.18,2019
"2502481",4263,112,177,4552,93.65,2.46,3.89,2019
"2502494",3344,129,135,3608,92.68,3.58,3.74,2019
"2502532",5190,91,470,5751,90.25,1.58,8.17,2019
"3303260",285,6,22,313,91.05,1.92,7.03,2019
"3303053",8691,94,426,9211,94.35,1.02,4.62,2019
"3303104",12100,355,1199,13654,88.62,2.6,8.78,2019
"3303222",1924,60,350,2334,82.43,2.57,15,2019
"3303226",371,6,42,419,88.54,1.43,10.02,2019
"3303064",5303,225,356,5884,90.13,3.82,6.05,2019
"3303101",1414,36,337,1787,79.13,2.01,18.86,2019
"3303217",604,57,181,842,71.73,6.77,21.5,2019
"3303218",385,12,12,409,94.13,2.93,2.93,2019
"3303221",750,20,93,863,86.91,2.32,10.78,2019
"3303230",434,6,75,515,84.27,1.17,14.56,2019
"3303233",53,0,0,53,100,0,0,2019
"3303246",5839,231,847,6917,84.42,3.34,12.25,2019
"3303256",814,21,86,921,88.38,2.28,9.34,2019
"3303273",110,0,0,110,100,0,0,2019
"3303431",8596,343,1226,10165,84.56,3.37,12.06,2019
"3303445",245,4,42,291,84.19,1.37,14.43,2019
"3303447",877,22,127,1026,85.48,2.14,12.38,2019
"3303451",1443,29,171,1643,87.83,1.77,10.41,2019
"3303452",1642,73,392,2107,77.93,3.46,18.6,2019
"3303455",737,5,186,928,79.42,0.54,20.04,2019
"3303605",300,58,38,396,75.76,14.65,9.6,2019
"3303751",147,40,46,233,63.09,17.17,19.74,2019
"3303752",211,32,34,277,76.17,11.55,12.27,2019
"3303768",621,7,56,684,90.79,1.02,8.19,2019
"3303777",452,5,27,484,93.39,1.03,5.58,2019
"3303809",1160,0,111,1271,91.27,0,8.73,2019
"3303811",2647,0,98,2745,96.43,0,3.57,2019
"3303818",1557,3,185,1745,89.23,0.17,10.6,2019
"3303827",1092,27,55,1174,93.02,2.3,4.68,2019
"3303839",1237,5,234,1476,83.81,0.34,15.85,2019
"3303857",3639,108,288,4035,90.19,2.68,7.14,2019
"3303860",1603,16,222,1841,87.07,0.87,12.06,2019
"3303886",620,36,82,738,84.01,4.88,11.11,2019
"2303901",2571,56,558,3185,80.72,1.76,17.52,2019
"2303902",930,16,14,960,96.88,1.67,1.46,2019
"3303868",2059,0,225,2284,90.15,0,9.85,2019
"3303874",3407,105,365,3877,87.88,2.71,9.41,2019
"3303875",414,0,15,429,96.5,0,3.5,2019
"3303878",4343,123,680,5146,84.4,2.39,13.21,2019
"2303906",1608,82,178,1868,86.08,4.39,9.53,2019
"2303908",2479,33,273,2785,89.01,1.18,9.8,2019
"3303835",2340,135,393,2868,81.59,4.71,13.7,2019
"3303836",557,4,50,611,91.16,0.65,8.18,2019
"3303845",552,33,28,613,90.05,5.38,4.57,2019
"5005034",103,12,28,143,72.03,8.39,19.58,2019
"5005061",394,19,84,497,79.28,3.82,16.9,2019
"5005065",362,17,44,423,85.58,4.02,10.4,2019
"5005071",92,0,0,92,100,0,0,2019
"5005081",148,9,49,206,71.84,4.37,23.79,2019
"5005083",81,0,34,115,70.43,0,29.57,2019
"5005086",228,8,59,295,77.29,2.71,20,2019
"5005149",720,64,112,896,80.36,7.14,12.5,2019
"5005301",5588,1036,837,7461,74.9,13.89,11.22,2019
"5005342",147,59,58,264,55.68,22.35,21.97,2019
"5005353",247,66,59,372,66.4,17.74,15.86,2019
"5005354",722,62,68,852,84.74,7.28,7.98,2019
"5005753",3104,208,372,3684,84.26,5.65,10.1,2019
"5005045",688,17,166,871,78.99,1.95,19.06,2019
"4216748",782,46,200,1028,76.07,4.47,19.46,2019
"4216841",1693,100,433,2226,76.06,4.49,19.45,2019
"4216335",9542,259,1801,11602,82.24,2.23,15.52,2019
"4216245",68,3,26,97,70.1,3.09,26.8,2019
"4216313",586,43,152,781,75.03,5.51,19.46,2019
"4216322",22,0,7,29,75.86,0,24.14,2019
"4216344",134,2,42,178,75.28,1.12,23.6,2019
"4216347",719,65,139,923,77.9,7.04,15.06,2019
"4216351",510,10,168,688,74.13,1.45,24.42,2019
"4216352",61,8,13,82,74.39,9.76,15.85,2019
"4216370",103,0,24,127,81.1,0,18.9,2019
"4216411",547,25,63,635,86.14,3.94,9.92,2019
"4216426",1214,70,201,1485,81.75,4.71,13.54,2019
"4216436",183,11,81,275,66.55,4,29.45,2019
"4216443",368,0,136,504,73.02,0,26.98,2019
"4216501",658,62,613,1333,49.36,4.65,45.99,2019
"4216505",6202,240,1050,7492,82.78,3.2,14.01,2019
"4216633",83,7,4,94,88.3,7.45,4.26,2019
"4216637",805,17,121,943,85.37,1.8,12.83,2019
"4216652",4318,160,1154,5632,76.67,2.84,20.49,2019
"4216659",83,0,13,96,86.46,0,13.54,2019
"4216661",280,13,59,352,79.55,3.69,16.76,2019
"4216670",15,0,11,26,57.69,0,42.31,2019
"4216672",68,0,5,73,93.15,0,6.85,2019
"4216685",58,0,11,69,84.06,0,15.94,2019
"4216686",4393,167,993,5553,79.11,3.01,17.88,2019
"4216731",792,26,177,995,79.6,2.61,17.79,2019
"4216732",90,0,46,136,66.18,0,33.82,2019
"4216822",585,43,183,811,72.13,5.3,22.56,2019
"4216823",8904,466,1536,10906,81.64,4.27,14.08,2019
"4216826",157,0,57,214,73.36,0,26.64,2019
"4216830",4248,209,1409,5866,72.42,3.56,24.02,2019
"4216839",196,17,23,236,83.05,7.2,9.75,2019
"4216854",187,9,76,272,68.75,3.31,27.94,2019
"4216870",2379,66,205,2650,89.77,2.49,7.74,2019
"4216872",199,7,258,464,42.89,1.51,55.6,2019
"4216912",674,29,142,845,79.76,3.43,16.8,2019
"4216920",585,6,194,785,74.52,0.76,24.71,2019
"4216930",366,8,118,492,74.39,1.63,23.98,2019
"4216936",602,27,160,789,76.3,3.42,20.28,2019
"4216948",363,27,176,566,64.13,4.77,31.1,2019
"4216725",81,0,7,88,92.05,0,7.95,2019
"4216874",405,6,107,518,78.19,1.16,20.66,2019
"4216942",248,6,49,303,81.85,1.98,16.17,2019
"4216212",123,7,25,155,79.35,4.52,16.13,2019
"3408550",6453,74,130,6657,96.94,1.11,1.95,2019
"3408558",2362,28,188,2578,91.62,1.09,7.29,2019
"3408559",1943,37,138,2118,91.74,1.75,6.52,2019
"3408562",1549,21,198,1768,87.61,1.19,11.2,2019
"3408618",9481,801,2779,13061,72.59,6.13,21.28,2019
"3408641",1158,0,4,1162,99.66,0,0.34,2019
"3408732",566,7,25,598,94.65,1.17,4.18,2019
"3408738",583,6,29,618,94.34,0.97,4.69,2019
"3408741",870,20,105,995,87.44,2.01,10.55,2019
"3408801",2454,0,110,2564,95.71,0,4.29,2019
"3408807",12171,271,741,13183,92.32,2.06,5.62,2019
"3408825",1464,11,230,1705,85.87,0.65,13.49,2019
"3408835",3067,140,554,3761,81.55,3.72,14.73,2019
"3408858",35,0,0,35,100,0,0,2019
"0906019",3564,52,367,3983,89.48,1.31,9.21,2019
"0906020",0,0,0,0,NA,NA,NA,2019
"0906021",116,20,0,136,85.29,14.71,0,2019
"0906040",12064,298,1651,14013,86.09,2.13,11.78,2019
"0906053",10115,410,2707,13232,76.44,3.1,20.46,2019
"0906058",617,12,82,711,86.78,1.69,11.53,2019
"0906062",6301,136,1200,7637,82.51,1.78,15.71,2019
"0906068",655,0,43,698,93.84,0,6.16,2019
"0906070",5801,46,291,6138,94.51,0.75,4.74,2019
"0906110",4368,100,555,5023,86.96,1.99,11.05,2019
"0906112",5216,524,1760,7500,69.55,6.99,23.47,2019
"0906232",1160,0,56,1216,95.39,0,4.61,2019
"0906237",1964,39,166,2169,90.55,1.8,7.65,2019
"0906241",2357,37,161,2555,92.25,1.45,6.3,2019
"0906027",518,4,29,551,94.01,0.73,5.26,2019
"0906031",498,0,69,567,87.83,0,12.17,2019
"0906066",10797,662,1598,13057,82.69,5.07,12.24,2019
"0906106",9672,777,3601,14050,68.84,5.53,25.63,2019
"0906117",4931,99,457,5487,89.87,1.8,8.33,2019
"0906231",1356,16,37,1409,96.24,1.14,2.63,2019
"0906235",880,4,91,975,90.26,0.41,9.33,2019
"0906238",4367,44,224,4635,94.22,0.95,4.83,2019
"0906248",1890,24,205,2119,89.19,1.13,9.67,2019
"0906250",1628,34,84,1746,93.24,1.95,4.81,2019
"0906254",601,30,86,717,83.82,4.18,11.99,2019
"0906259",1560,49,163,1772,88.04,2.77,9.2,2019
"0906277",1300,0,145,1445,89.97,0,10.03,2019
"0906280",1100,34,98,1232,89.29,2.76,7.95,2019
"0906340",10522,418,1381,12321,85.4,3.39,11.21,2019
"0906355",4913,81,527,5521,88.99,1.47,9.55,2019
"0906360",12171,368,2314,14853,81.94,2.48,15.58,2019
"0906370",2441,62,280,2783,87.71,2.23,10.06,2019
"0906384",976,0,116,1092,89.38,0,10.62,2019
"0906405",10837,153,1312,12302,88.09,1.24,10.66,2019
"0906412",1606,73,93,1772,90.63,4.12,5.25,2019
"0906419",2057,26,221,2304,89.28,1.13,9.59,2019
"0906471",2650,39,317,3006,88.16,1.3,10.55,2019
"0906489",11289,240,1341,12870,87.72,1.86,10.42,2019
"0906518",5800,190,665,6655,87.15,2.85,9.99,2019
"0906519",3728,135,1277,5140,72.53,2.63,24.84,2019
"0906776",9168,261,736,10165,90.19,2.57,7.24,2019
"0906778",405,31,94,530,76.42,5.85,17.74,2019
"0906877",8434,111,478,9023,93.47,1.23,5.3,2019
"0906093",1210,0,60,1270,95.28,0,4.72,2019
"0906107",6952,107,375,7434,93.52,1.44,5.04,2019
"3610282",2217,74,0,2291,96.77,3.23,0,2019
"3610301",11054,508,2905,14467,76.41,3.51,20.08,2019
"3610307",4456,94,721,5271,84.54,1.78,13.68,2019
"3610460",14666,651,5461,20778,70.58,3.13,26.28,2019
"3610465",13140,431,2260,15831,83,2.72,14.28,2019
"3610470",4829,393,976,6198,77.91,6.34,15.75,2019
"3610471",7487,367,963,8817,84.92,4.16,10.92,2019
"3610503",93,0,18,111,83.78,0,16.22,2019
"3610522",3459,68,143,3670,94.25,1.85,3.9,2019
"3610543",6805,127,661,7593,89.62,1.67,8.71,2019
"3610006",1703,26,0,1729,98.5,1.5,0,2019
"3610012",10804,254,1123,12181,88.7,2.09,9.22,2019
"3610013",9832,138,2056,12026,81.76,1.15,17.1,2019
"3610014",16976,350,687,18013,94.24,1.94,3.81,2019
"2502536",7198,270,767,8235,87.41,3.28,9.31,2019
"2502537",2283,24,114,2421,94.3,0.99,4.71,2019
"2502554",3354,70,223,3647,91.97,1.92,6.11,2019
"2502556",1115,15,43,1173,95.06,1.28,3.67,2019
"2502650",303,53,17,373,81.23,14.21,4.56,2019
"2502659",430,0,18,448,95.98,0,4.02,2019
"2502660",2516,96,320,2932,85.81,3.27,10.91,2019
"2502720",9693,559,2561,12813,75.65,4.36,19.99,2019
"2502738",1758,36,148,1942,90.53,1.85,7.62,2019
"2502743",3293,210,591,4094,80.43,5.13,14.44,2019
"2502790",5494,130,764,6388,86.01,2.04,11.96,2019
"4402807",396,11,33,440,90,2.5,7.5,2019
"4402852",8177,71,757,9005,90.81,0.79,8.41,2019
"4402879",7560,147,673,8380,90.21,1.75,8.03,2019
"4402886",10701,267,1530,12498,85.62,2.14,12.24,2019
"4402889",10173,215,1062,11450,88.85,1.88,9.28,2019
"2502351",5886,109,401,6396,92.03,1.7,6.27,2019
"2502210",2303,0,21,2324,99.1,0,0.9,2019
"2502215",7095,415,335,7845,90.44,5.29,4.27,2019
"2502347",3775,78,242,4095,92.19,1.9,5.91,2019
"2502364",4556,100,293,4949,92.06,2.02,5.92,2019
"2502459",6161,48,179,6388,96.45,0.75,2.8,2019
"2502478",9160,69,583,9812,93.36,0.7,5.94,2019
"2502492",6792,94,307,7193,94.43,1.31,4.27,2019
"2502540",3231,209,613,4053,79.72,5.16,15.12,2019
"2502543",318,8,34,360,88.33,2.22,9.44,2019
"2502563",3646,130,222,3998,91.2,3.25,5.55,2019
"2502635",1277,24,94,1395,91.54,1.72,6.74,2019
"2502644",1288,33,113,1434,89.82,2.3,7.88,2019
"2502653",2453,26,270,2749,89.23,0.95,9.82,2019
"2502664",3382,139,465,3986,84.85,3.49,11.67,2019
"2502668",1076,15,67,1158,92.92,1.3,5.79,2019
"2502669",19,0,0,19,100,0,0,2019
"2502713",20,0,6,26,76.92,0,23.08,2019
"2502715",1172,96,164,1432,81.84,6.7,11.45,2019
"2502717",1481,107,148,1736,85.31,6.16,8.53,2019
"4402874",2046,29,81,2156,94.9,1.35,3.76,2019
"4402885",3989,172,696,4857,82.13,3.54,14.33,2019
"4402888",6892,344,957,8193,84.12,4.2,11.68,2019
"4402894",181,0,60,241,75.1,0,24.9,2019
"4402903",3384,122,1195,4701,71.98,2.6,25.42,2019
"4402908",10202,245,1632,12079,84.46,2.03,13.51,2019
"4402920",11777,297,2027,14101,83.52,2.11,14.37,2019
"2502111",3078,33,341,3452,89.17,0.96,9.88,2019
"2502382",4650,254,562,5466,85.07,4.65,10.28,2019
"4197908",9,0,10,19,47.37,0,52.63,2019
"4197810",297,17,95,409,72.62,4.16,23.23,2019
"4197819",6,0,4,10,60,0,40,2019
"4197820",333,8,59,400,83.25,2,14.75,2019
"4197830",228,16,72,316,72.15,5.06,22.78,2019
"4197834",383,5,72,460,83.26,1.09,15.65,2019
"4197911",30,0,16,46,65.22,0,34.78,2019
"4197840",62,0,0,62,100,0,0,2019
"4197868",533,49,121,703,75.82,6.97,17.21,2019
"4197330",16446,442,1207,18095,90.89,2.44,6.67,2019
"4197342",39,0,12,51,76.47,0,23.53,2019
"4197345",174,14,16,204,85.29,6.86,7.84,2019
"4197352",1881,41,183,2105,89.36,1.95,8.69,2019
"4197361",3480,106,461,4047,85.99,2.62,11.39,2019
"5005062",178,18,35,231,77.06,7.79,15.15,2019
"5005068",1179,72,138,1389,84.88,5.18,9.94,2019
"5005076",110,0,57,167,65.87,0,34.13,2019
"5005084",47,0,0,47,100,0,0,2019
"5005091",1214,75,157,1446,83.96,5.19,10.86,2019
"5005758",268,11,24,303,88.45,3.63,7.92,2019
"5005759",583,0,118,701,83.17,0,16.83,2019
"5005770",329,15,101,445,73.93,3.37,22.7,2019
"5005773",784,41,96,921,85.12,4.45,10.42,2019
"5005839",241,9,46,296,81.42,3.04,15.54,2019
"5005842",181,4,30,215,84.19,1.86,13.95,2019
"5005032",797,64,134,995,80.1,6.43,13.47,2019
"5005037",221,28,11,260,85,10.77,4.23,2019
"5005039",390,13,117,520,75,2.5,22.5,2019
"5005041",72,0,29,101,71.29,0,28.71,2019
"5005043",441,12,12,465,94.84,2.58,2.58,2019
"5005046",326,53,73,452,72.12,11.73,16.15,2019
"5005056",199,5,31,235,84.68,2.13,13.19,2019
"5005060",1554,20,322,1896,81.96,1.05,16.98,2019
"5005067",84,0,3,87,96.55,0,3.45,2019
"5005079",235,9,42,286,82.17,3.15,14.69,2019
"5005143",1450,58,299,1807,80.24,3.21,16.55,2019
"5005156",3358,114,559,4031,83.3,2.83,13.87,2019
"5005260",125,0,54,179,69.83,0,30.17,2019
"5005261",769,40,121,930,82.69,4.3,13.01,2019
"5005446",6050,191,608,6849,88.33,2.79,8.88,2019
"5005350",211,7,56,274,77.01,2.55,20.44,2019
"5005359",234,15,9,258,90.7,5.81,3.49,2019
"5005441",267,10,52,329,81.16,3.04,15.81,2019
"5005459",530,114,217,861,61.56,13.24,25.2,2019
"5005468",4185,430,666,5281,79.25,8.14,12.61,2019
"5005476",893,63,311,1267,70.48,4.97,24.55,2019
"5005650",432,36,47,515,83.88,6.99,9.13,2019
"5005649",136,8,41,185,73.51,4.32,22.16,2019
"5005653",194,6,52,252,76.98,2.38,20.63,2019
"5005664",68,0,0,68,100,0,0,2019
"5005672",1734,139,232,2105,82.38,6.6,11.02,2019
"5005673",980,60,85,1125,87.11,5.33,7.56,2019
"5005732",260,0,70,330,78.79,0,21.21,2019
"5005038",427,24,106,557,76.66,4.31,19.03,2019
"5005051",561,26,126,713,78.68,3.65,17.67,2019
"5005069",141,9,26,176,80.11,5.11,14.77,2019
"5005142",263,0,18,281,93.59,0,6.41,2019
"5005250",1352,67,95,1514,89.3,4.43,6.27,2019
"5005251",445,47,40,532,83.65,8.83,7.52,2019
"5398158",0,0,0,0,NA,NA,NA,2019
"5398195",0,0,0,0,NA,NA,NA,2019
"5398207",0,0,0,0,NA,NA,NA,2019
"5398229",12339,216,577,13132,93.96,1.64,4.39,2019
"5398255",64,0,9,73,87.67,0,12.33,2019
"5398263",34,0,0,34,100,0,0,2019
"5398266",1081,67,372,1520,71.12,4.41,24.47,2019
"5398276",190,0,4,194,97.94,0,2.06,2019
"5398278",0,0,0,0,NA,NA,NA,2019
"5398282",6680,101,451,7232,92.37,1.4,6.24,2019
"5398314",16,0,0,16,100,0,0,2019
"5398391",16662,283,783,17728,93.99,1.6,4.42,2019
"5398416",0,0,0,0,NA,NA,NA,2019
"5398418",3061,304,463,3828,79.96,7.94,12.1,2019
"3408859",7693,208,545,8446,91.08,2.46,6.45,2019
"3408869",2644,47,304,2995,88.28,1.57,10.15,2019
"3408873",18984,259,1176,20419,92.97,1.27,5.76,2019
"3408608",232,50,257,539,43.04,9.28,47.68,2019
"3408609",2603,183,1377,4163,62.53,4.4,33.08,2019
"3408610",9353,355,1437,11145,83.92,3.19,12.89,2019
"3408638",6109,335,1587,8031,76.07,4.17,19.76,2019
"3408722",3405,53,282,3740,91.04,1.42,7.54,2019
"3408733",808,5,114,927,87.16,0.54,12.3,2019
"3408742",9050,141,616,9807,92.28,1.44,6.28,2019
"3408837",5652,90,358,6100,92.66,1.48,5.87,2019
"3408846",4417,23,428,4868,90.74,0.47,8.79,2019
"3408901",11586,798,2944,15328,75.59,5.21,19.21,2019
"3408902",13196,192,1100,14488,91.08,1.33,7.59,2019
"3408041",287,4,39,330,86.97,1.21,11.82,2019
"3408049",1792,37,204,2033,88.15,1.82,10.03,2019
"3408051",3753,38,385,4176,89.87,0.91,9.22,2019
"3408052",7243,153,889,8285,87.42,1.85,10.73,2019
"3408054",15836,196,1270,17302,91.53,1.13,7.34,2019
"3408057",6506,244,477,7227,90.02,3.38,6.6,2019
"3408060",8084,123,678,8885,90.98,1.38,7.63,2019
"3408062",5057,30,257,5344,94.63,0.56,4.81,2019
"3408068",2395,65,352,2812,85.17,2.31,12.52,2019
"3408075",9434,222,1291,10947,86.18,2.03,11.79,2019
"3408079",2862,146,862,3870,73.95,3.77,22.27,2019
"3408092",1159,38,180,1377,84.17,2.76,13.07,2019
"3408108",7011,137,483,7631,91.88,1.8,6.33,2019
"3408232",4921,122,1207,6250,78.74,1.95,19.31,2019
"3408248",55,0,0,55,100,0,0,2019
"3408302",10407,555,2965,13927,74.73,3.99,21.29,2019
"3408324",87,0,21,108,80.56,0,19.44,2019
"3408329",137,0,15,152,90.13,0,9.87,2019
"3408350",219,0,13,232,94.4,0,5.6,2019
"3408501",2149,61,145,2355,91.25,2.59,6.16,2019
"3408510",1685,40,87,1812,92.99,2.21,4.8,2019
"3408520",7955,306,1020,9281,85.71,3.3,10.99,2019
"3408341",724,0,308,1032,70.16,0,29.84,2019
"3408345",158,20,53,231,68.4,8.66,22.94,2019
"3408360",11324,727,2580,14631,77.4,4.97,17.63,2019
"3408540",16077,695,713,17485,91.95,3.97,4.08,2019
"3408554",1311,0,183,1494,87.75,0,12.25,2019
"3408619",7501,197,1011,8709,86.13,2.26,11.61,2019
"3408620",3709,28,318,4055,91.47,0.69,7.84,2019
"3408628",3305,207,274,3786,87.3,5.47,7.24,2019
"3408701",14586,762,8433,23781,61.33,3.2,35.46,2019
"3612466",933,8,57,998,93.49,0.8,5.71,2019
"3612468",240,18,111,369,65.04,4.88,30.08,2019
"3612469",212,5,69,286,74.13,1.75,24.13,2019
"3612474",320,20,108,448,71.43,4.46,24.11,2019
"3612480",172,0,91,263,65.4,0,34.6,2019
"3612487",1146,45,82,1273,90.02,3.53,6.44,2019
"3612496",427,22,112,561,76.11,3.92,19.96,2019
"3612501",764,23,185,972,78.6,2.37,19.03,2019
"3612502",365,7,65,437,83.52,1.6,14.87,2019
"3612543",1162,78,122,1362,85.32,5.73,8.96,2019
"3612548",473,0,48,521,90.79,0,9.21,2019
"3612550",15263,714,3707,19684,77.54,3.63,18.83,2019
"3612561",5664,124,654,6442,87.92,1.92,10.15,2019
"3612566",3405,200,394,3999,85.15,5,9.85,2019
"3610023",31438,508,2343,34289,91.69,1.48,6.83,2019
"3610024",25761,711,1693,28165,91.46,2.52,6.01,2019
"3610032",16667,434,4125,21226,78.52,2.04,19.43,2019
"3610112",0,0,0,0,NA,NA,NA,2019
"3610152",0,0,0,0,NA,NA,NA,2019
"3610177",0,0,0,0,NA,NA,NA,2019
"3610306",16854,539,2796,20189,83.48,2.67,13.85,2019
"3610461",15343,671,2848,18862,81.34,3.56,15.1,2019
"3610504",2538,73,137,2748,92.36,2.66,4.99,2019
"3610511",661,27,58,746,88.61,3.62,7.77,2019
"3610512",8407,254,689,9350,89.91,2.72,7.37,2019
"3610528",4406,12,365,4783,92.12,0.25,7.63,2019
"3610530",5340,43,311,5694,93.78,0.76,5.46,2019
"3610598",9489,244,797,10530,90.11,2.32,7.57,2019
"3610705",10623,606,2812,14041,75.66,4.32,20.03,2019
"3610709",3163,65,424,3652,86.61,1.78,11.61,2019
"3610931",278,0,25,303,91.75,0,8.25,2019
"3610963",878,13,80,971,90.42,1.34,8.24,2019
"3610970",3305,6,253,3564,92.73,0.17,7.1,2019
"3610985",49,0,0,49,100,0,0,2019
"3610990",6410,212,847,7469,85.82,2.84,11.34,2019
"3610588",1022,16,144,1182,86.46,1.35,12.18,2019
"3610703",5912,266,1123,7301,80.98,3.64,15.38,2019
"3610708",8100,121,647,8868,91.34,1.36,7.3,2019
"3610923",2502,40,217,2759,90.69,1.45,7.87,2019
"3610926",1156,11,168,1335,86.59,0.82,12.58,2019
"3610956",9701,160,541,10402,93.26,1.54,5.2,2019
"3610965",4618,143,571,5332,86.61,2.68,10.71,2019
"3610993",1388,27,168,1583,87.68,1.71,10.61,2019
"3610172",0,0,0,0,NA,NA,NA,2019
"3610305",12115,362,2088,14565,83.18,2.49,14.34,2019
"3610314",26897,696,3289,30882,87.1,2.25,10.65,2019
"3610451",13941,636,4945,19522,71.41,3.26,25.33,2019
"3610463",24195,572,3985,28752,84.15,1.99,13.86,2019
"3610475",14224,716,3962,18902,75.25,3.79,20.96,2019
"3610502",1738,48,176,1962,88.58,2.45,8.97,2019
"3610562",9662,261,1363,11286,85.61,2.31,12.08,2019
"3610510",3422,52,248,3722,91.94,1.4,6.66,2019
"3610524",1407,12,16,1435,98.05,0.84,1.11,2019
"3610532",1497,32,210,1739,86.08,1.84,12.08,2019
"3610579",2853,15,165,3033,94.07,0.49,5.44,2019
"3610453",20813,845,6116,27774,74.94,3.04,22.02,2019
"3610454",8701,210,4518,13429,64.79,1.56,33.64,2019
"3610455",10284,621,3522,14427,71.28,4.3,24.41,2019
"3610458",22161,1477,3943,27581,80.35,5.36,14.3,2019
"3613790",6109,380,1130,7619,80.18,4.99,14.83,2019
"3613797",717,16,103,836,85.77,1.91,12.32,2019
"3613849",1473,25,354,1852,79.54,1.35,19.11,2019
"3613859",82,0,0,82,100,0,0,2019
"3613456",1534,28,93,1655,92.69,1.69,5.62,2019
"3613468",160,0,28,188,85.11,0,14.89,2019
"3613630",355,20,158,533,66.6,3.75,29.64,2019
"3613501",10630,537,2608,13775,77.17,3.9,18.93,2019
"3613603",3092,36,94,3222,95.97,1.12,2.92,2019
"3613668",1128,40,216,1384,81.5,2.89,15.61,2019
"3613670",158,3,36,197,80.2,1.52,18.27,2019
"3613691",982,39,207,1228,79.97,3.18,16.86,2019
"3613693",157,5,29,191,82.2,2.62,15.18,2019
"3613748",1281,158,171,1610,79.57,9.81,10.62,2019
"4197365",4242,115,555,4912,86.36,2.34,11.3,2019
"4197386",4444,247,847,5538,80.25,4.46,15.29,2019
"4197401",17235,1929,1891,21055,81.86,9.16,8.98,2019
"4197402",18311,717,2307,21335,85.83,3.36,10.81,2019
"4197417",699,77,287,1063,65.76,7.24,27,2019
"4197419",419,7,53,479,87.47,1.46,11.06,2019
"4197437",924,8,146,1078,85.71,0.74,13.54,2019
"4197438",361,35,44,440,82.05,7.95,10,2019
"4197223",17728,607,1358,19693,90.02,3.08,6.9,2019
"4197224",13243,314,1206,14763,89.7,2.13,8.17,2019
"4197302",14068,418,1308,15794,89.07,2.65,8.28,2019
"4197346",324,28,36,388,83.51,7.22,9.28,2019
"4197355",9702,313,1744,11759,82.51,2.66,14.83,2019
"4197374",1365,143,169,1677,81.4,8.53,10.08,2019
"4197381",5032,110,565,5707,88.17,1.93,9.9,2019
"4197412",178,3,23,204,87.25,1.47,11.27,2019
"4197431",770,0,38,808,95.3,0,4.7,2019
"4197436",279,4,35,318,87.74,1.26,11.01,2019
"4197455",846,29,60,935,90.48,3.1,6.42,2019
"4197463",1237,79,369,1685,73.41,4.69,21.9,2019
"4197473",119,3,3,125,95.2,2.4,2.4,2019
"4197536",331,10,125,466,71.03,2.15,26.82,2019
"4197540",3411,81,410,3902,87.42,2.08,10.51,2019
"4197601",8103,245,1378,9726,83.31,2.52,14.17,2019
"4197818",1129,70,323,1522,74.18,4.6,21.22,2019
"4197639",193,0,50,243,79.42,0,20.58,2019
"4197712",7,21,0,28,25,75,0,2019
"4197753",890,25,12,927,96.01,2.7,1.29,2019
"4197869",291,21,98,410,70.98,5.12,23.9,2019
"4197877",126,13,47,186,67.74,6.99,25.27,2019
"4197870",275,10,92,377,72.94,2.65,24.4,2019
"5398925",204,6,75,285,71.58,2.11,26.32,2019
"5398930",3782,90,553,4425,85.47,2.03,12.5,2019
"4197222",13221,759,1811,15791,83.72,4.81,11.47,2019
"4197229",24004,439,718,25161,95.4,1.74,2.85,2019
"4197266",10621,232,1800,12653,83.94,1.83,14.23,2019
"4197338",7095,190,874,8159,86.96,2.33,10.71,2019
"4197344",438,33,41,512,85.55,6.45,8.01,2019
"4197368",1160,76,225,1461,79.4,5.2,15.4,2019
"4197376",444,0,106,550,80.73,0,19.27,2019
"4197383",3145,69,353,3567,88.17,1.93,9.9,2019
"4197391",1892,117,248,2257,83.83,5.18,10.99,2019
"4197411",2326,163,905,3394,68.53,4.8,26.66,2019
"4197444",2109,134,304,2547,82.8,5.26,11.94,2019
"4197448",4235,110,746,5091,83.19,2.16,14.65,2019
"5398351",391,87,79,557,70.2,15.62,14.18,2019
"5398354",2389,160,433,2982,80.11,5.37,14.52,2019
"5398355",251,0,101,352,71.31,0,28.69,2019
"5398361",325,65,50,440,73.86,14.77,11.36,2019
"5398363",4960,84,742,5786,85.72,1.45,12.82,2019
"5398364",44,0,0,44,100,0,0,2019
"5398367",10314,235,513,11062,93.24,2.12,4.64,2019
"5398370",11510,136,747,12393,92.88,1.1,6.03,2019
"5398374",13152,270,1093,14515,90.61,1.86,7.53,2019
"5398403",3736,116,326,4178,89.42,2.78,7.8,2019
"5398407",8191,227,880,9298,88.09,2.44,9.46,2019
"5398433",3838,107,304,4249,90.33,2.52,7.15,2019
"5398439",1765,13,280,2058,85.76,0.63,13.61,2019
"5398466",10839,228,848,11915,90.97,1.91,7.12,2019
"5398430",0,0,0,0,NA,NA,NA,2019
"5398438",4,0,0,4,100,0,0,2019
"5398447",0,0,0,0,NA,NA,NA,2019
"5398544",21,0,0,21,100,0,0,2019
"5398558",90,0,0,90,100,0,0,2019
"5398583",48,13,3,64,75,20.31,4.69,2019
"5398824",83,0,18,101,82.18,0,17.82,2019
"5398921",0,0,59,59,0,0,100,2019
"5398929",0,0,0,0,NA,NA,NA,2019
"5398939",18,0,26,44,40.91,0,59.09,2019
"5398672",2319,84,401,2804,82.7,3,14.3,2019
"5398848",2890,70,457,3417,84.58,2.05,13.37,2019
"5398946",208,0,43,251,82.87,0,17.13,2019
"5398030",11330,331,954,12615,89.81,2.62,7.56,2019
"5398050",155,0,0,155,100,0,0,2019
"5398261",1257,26,126,1409,89.21,1.85,8.94,2019
"5398267",94,0,47,141,66.67,0,33.33,2019
"5398270",16352,305,1134,17791,91.91,1.71,6.37,2019
"5398274",6116,117,563,6796,89.99,1.72,8.28,2019
"5398288",75,11,24,110,68.18,10,21.82,2019
"5398304",371,0,88,459,80.83,0,19.17,2019
"5398312",11455,327,1028,12810,89.42,2.55,8.02,2019
"5398321",4885,116,590,5591,87.37,2.07,10.55,2019
"5398327",3571,47,213,3831,93.21,1.23,5.56,2019
"5398329",3600,70,191,3861,93.24,1.81,4.95,2019
"5398353",18,0,0,18,100,0,0,2019
"5398360",4237,113,338,4688,90.38,2.41,7.21,2019
"5398390",3858,101,497,4456,86.58,2.27,11.15,2019
"5398531",8374,309,1500,10183,82.24,3.03,14.73,2019
"5398675",1756,155,205,2116,82.99,7.33,9.69,2019
"5398814",387,0,40,427,90.63,0,9.37,2019
"5398829",157,0,24,181,86.74,0,13.26,2019
"1596748",808,43,528,1379,58.59,3.12,38.29,2019
"1596782",9996,289,1150,11435,87.42,2.53,10.06,2019
"1596789",16174,342,1153,17669,91.54,1.94,6.53,2019
"1596813",8814,392,1422,10628,82.93,3.69,13.38,2019
"1596825",9325,247,682,10254,90.94,2.41,6.65,2019
"0696008",404,5,55,464,87.07,1.08,11.85,2019
"0696014",63,0,26,89,70.79,0,29.21,2019
"0696016",112,0,77,189,59.26,0,40.74,2019
"0696017",53,8,16,77,68.83,10.39,20.78,2019
"0696020",939,41,144,1124,83.54,3.65,12.81,2019
"0696031",30,0,30,60,50,0,50,2019
"0696056",509,41,146,696,73.13,5.89,20.98,2019
"0696057",430,18,163,611,70.38,2.95,26.68,2019
"0299775",54,75,0,129,41.86,58.14,0,2019
"5399201",5511,255,1217,6983,78.92,3.65,17.43,2019
"0299825",23,6,4,33,69.7,18.18,12.12,2019
"0299827",880,13,146,1039,84.7,1.25,14.05,2019
"0299929",760,51,216,1027,74,4.97,21.03,2019
"5399344",3732,195,1014,4941,75.53,3.95,20.52,2019
"5399347",763,23,205,991,76.99,2.32,20.69,2019
"5399350",3573,407,917,4897,72.96,8.31,18.73,2019
"5399004",6892,267,774,7933,86.88,3.37,9.76,2019
"5399022",2931,16,177,3124,93.82,0.51,5.67,2019
"5399037",5517,154,307,5978,92.29,2.58,5.14,2019
"5399109",1475,84,496,2055,71.78,4.09,24.14,2019
"0299835",2999,87,461,3547,84.55,2.45,13,2019
"0299840",316,12,47,375,84.27,3.2,12.53,2019
"3612580",1475,16,178,1669,88.38,0.96,10.67,2019
"3612603",14473,217,1018,15708,92.14,1.38,6.48,2019
"3612067",457,10,140,607,75.29,1.65,23.06,2019
"3612134",1145,70,295,1510,75.83,4.64,19.54,2019
"3612455",591,15,209,815,72.52,1.84,25.64,2019
"3612416",136,0,8,144,94.44,0,5.56,2019
"3612062",529,8,67,604,87.58,1.32,11.09,2019
"3612094",736,32,85,853,86.28,3.75,9.96,2019
"3612130",212,0,59,271,78.23,0,21.77,2019
"3612209",3521,116,517,4154,84.76,2.79,12.45,2019
"3612007",0,0,9,9,0,0,100,2019
"3612024",0,0,0,0,NA,NA,NA,2019
"3612040",42,9,4,55,76.36,16.36,7.27,2019
"3612069",79,0,24,103,76.7,0,23.3,2019
"3612085",160,0,29,189,84.66,0,15.34,2019
"3612089",28,0,7,35,80,0,20,2019
"3612124",192,0,0,192,100,0,0,2019
"3612132",110,0,24,134,82.09,0,17.91,2019
"3612161",77,0,0,77,100,0,0,2019
"3612172",64,0,20,84,76.19,0,23.81,2019
"3612174",126,0,15,141,89.36,0,10.64,2019
"3612177",146,17,0,163,89.57,10.43,0,2019
"3612195",65,0,0,65,100,0,0,2019
"3612222",15,0,0,15,100,0,0,2019
"3612417",122,0,22,144,84.72,0,15.28,2019
"3612432",88,0,18,106,83.02,0,16.98,2019
"3612436",75,0,19,94,79.79,0,20.21,2019
"3612438",8,0,0,8,100,0,0,2019
"3612441",6,0,36,42,14.29,0,85.71,2019
"3612452",58,17,26,101,57.43,16.83,25.74,2019
"3612453",83,0,8,91,91.21,0,8.79,2019
"3612465",90,0,18,108,83.33,0,16.67,2019
"3612475",79,0,25,104,75.96,0,24.04,2019
"3612483",101,0,40,141,71.63,0,28.37,2019
"3612490",14,0,0,14,100,0,0,2019
"3612504",41,0,0,41,100,0,0,2019
"3612512",58,0,0,58,100,0,0,2019
"3612527",0,0,0,0,NA,NA,NA,2019
"3612530",40,0,0,40,100,0,0,2019
"3612574",102,0,0,102,100,0,0,2019
"3612604",7,0,0,7,100,0,0,2019
"3612722",30,0,28,58,51.72,0,48.28,2019
"3612745",65,0,11,76,85.53,0,14.47,2019
"3612750",73,0,0,73,100,0,0,2019
"3612767",53,0,13,66,80.3,0,19.7,2019
"4215546",75,30,26,131,57.25,22.9,19.85,2019
"4215631",374,2,92,468,79.91,0.43,19.66,2019
"4215450",81,0,15,96,84.38,0,15.62,2019
"4215455",160,0,12,172,93.02,0,6.98,2019
"4215771",237,8,135,380,62.37,2.11,35.53,2019
"4215801",6156,257,1243,7656,80.41,3.36,16.24,2019
"4215825",2945,81,633,3659,80.49,2.21,17.3,2019
"4215828",75,12,30,117,64.1,10.26,25.64,2019
"4215834",1430,36,491,1957,73.07,1.84,25.09,2019
"4215856",322,6,53,381,84.51,1.57,13.91,2019
"4215861",61,7,17,85,71.76,8.24,20,2019
"4215866",48,4,40,92,52.17,4.35,43.48,2019
"4215905",7283,253,1359,8895,81.88,2.84,15.28,2019
"4215924",328,20,99,447,73.38,4.47,22.15,2019
"3613844",243,11,30,284,85.56,3.87,10.56,2019
"3613827",4146,76,861,5083,81.57,1.5,16.94,2019
"3613841",187,6,61,254,73.62,2.36,24.02,2019
"3613842",167,0,45,212,78.77,0,21.23,2019
"3613863",184,8,46,238,77.31,3.36,19.33,2019
"3613040",701,53,226,980,71.53,5.41,23.06,2019
"3613054",566,0,77,643,88.02,0,11.98,2019
"3613060",742,154,311,1207,61.47,12.76,25.77,2019
"3613071",285,0,80,365,78.08,0,21.92,2019
"3613073",2101,85,435,2621,80.16,3.24,16.6,2019
"3613074",1414,9,165,1588,89.04,0.57,10.39,2019
"3613081",351,6,81,438,80.14,1.37,18.49,2019
"3613219",5067,235,922,6224,81.41,3.78,14.81,2019
"3613084",1368,6,202,1576,86.8,0.38,12.82,2019
"3613136",143,4,45,192,74.48,2.08,23.44,2019
"3613214",2399,162,319,2880,83.3,5.62,11.08,2019
"3613339",1723,77,415,2215,77.79,3.48,18.74,2019
"3613363",806,40,139,985,81.83,4.06,14.11,2019
"3613638",83,0,47,130,63.85,0,36.15,2019
"3613667",883,87,293,1263,69.91,6.89,23.2,2019
"3613788",291,3,87,381,76.38,0.79,22.83,2019
"3613685",972,75,71,1118,86.94,6.71,6.35,2019
"3613815",4389,351,875,5615,78.17,6.25,15.58,2019
"3613020",28,4,5,37,75.68,10.81,13.51,2019
"3613024",0,0,0,0,NA,NA,NA,2019
"3613051",88,0,0,88,100,0,0,2019
"3613064",80,0,0,80,100,0,0,2019
"3613087",42,0,10,52,80.77,0,19.23,2019
"3613102",20,0,9,29,68.97,0,31.03,2019
"3613103",79,0,40,119,66.39,0,33.61,2019
"3613113",84,0,15,99,84.85,0,15.15,2019
"3613115",89,0,21,110,80.91,0,19.09,2019
"3613117",68,6,41,115,59.13,5.22,35.65,2019
"3613123",60,20,0,80,75,25,0,2019
"3613134",52,0,13,65,80,0,20,2019
"3613138",19,0,0,19,100,0,0,2019
"3613153",107,36,30,173,61.85,20.81,17.34,2019
"3613157",267,18,30,315,84.76,5.71,9.52,2019
"3613162",88,0,44,132,66.67,0,33.33,2019
"3613163",102,14,23,139,73.38,10.07,16.55,2019
"3613305",96,0,0,96,100,0,0,2019
"3613321",356,24,61,441,80.73,5.44,13.83,2019
"3613345",47,0,7,54,87.04,0,12.96,2019
"3613352",11,0,0,11,100,0,0,2019
"3613362",35,15,0,50,70,30,0,2019
"2501886",8047,80,444,8571,93.89,0.93,5.18,2019
"2501002",8975,268,555,9798,91.6,2.74,5.66,2019
"2501011",445,40,79,564,78.9,7.09,14.01,2019
"2501080",722,42,154,918,78.65,4.58,16.78,2019
"2501109",6645,582,2077,9304,71.42,6.26,22.32,2019
"2501151",2366,96,968,3430,68.98,2.8,28.22,2019
"2501222",281,0,62,343,81.92,0,18.08,2019
"2501225",1179,29,240,1448,81.42,2,16.57,2019
"2501337",907,16,150,1073,84.53,1.49,13.98,2019
"2501341",685,11,82,778,88.05,1.41,10.54,2019
"2501346",127,0,56,183,69.4,0,30.6,2019
"2501351",850,17,107,974,87.27,1.75,10.99,2019
"2501366",359,12,102,473,75.9,2.54,21.56,2019
"2501373",1652,112,282,2046,80.74,5.47,13.78,2019
"5398499",10942,460,1771,13173,83.06,3.49,13.44,2019
"5398501",15268,765,1380,17413,87.68,4.39,7.93,2019
"5398502",12469,514,1307,14290,87.26,3.6,9.15,2019
"5398512",10749,684,883,12316,87.28,5.55,7.17,2019
"5398520",6647,252,1294,8193,81.13,3.08,15.79,2019
"5398568",827,4,182,1013,81.64,0.39,17.97,2019
"5398588",879,0,13,892,98.54,0,1.46,2019
"5398592",702,34,44,780,90,4.36,5.64,2019
"5398811",57,0,7,64,89.06,0,10.94,2019
"5398827",158,0,33,191,82.72,0,17.28,2019
"5398832",82,3,0,85,96.47,3.53,0,2019
"5398840",1556,60,365,1981,78.55,3.03,18.43,2019
"5398852",4,0,3,7,57.14,0,42.86,2019
"5398857",855,31,291,1177,72.64,2.63,24.72,2019
"5398903",4199,209,979,5387,77.95,3.88,18.17,2019
"0695811",3011,156,282,3449,87.3,4.52,8.18,2019
"0695915",0,0,0,0,NA,NA,NA,2019
"0695054",8160,42,362,8564,95.28,0.49,4.23,2019
"0695219",9918,175,718,10811,91.74,1.62,6.64,2019
"5399216",9004,495,1387,10886,82.71,4.55,12.74,2019
"5399224",8030,191,743,8964,89.58,2.13,8.29,2019
"5399322",77,6,20,103,74.76,5.83,19.42,2019
"5399323",1209,21,73,1303,92.79,1.61,5.6,2019
"0299829",183,2,92,277,66.06,0.72,33.21,2019
"0299833",976,26,185,1187,82.22,2.19,15.59,2019
"0299927",0,0,0,0,NA,NA,NA,2019
"0299830",121,3,70,194,62.37,1.55,36.08,2019
"5399008",181,26,26,233,77.68,11.16,11.16,2019
"5399025",1831,57,141,2029,90.24,2.81,6.95,2019
"5399026",2956,11,346,3313,89.22,0.33,10.44,2019
"5399031",489,16,48,553,88.43,2.89,8.68,2019
"5399032",237,10,67,314,75.48,3.18,21.34,2019
"5399102",208,9,13,230,90.43,3.91,5.65,2019
"5399105",17,1,1,19,89.47,5.26,5.26,2019
"5399116",564,0,154,718,78.55,0,21.45,2019
"5399121",73,0,18,91,80.22,0,19.78,2019
"5399122",1455,48,160,1663,87.49,2.89,9.62,2019
"5399134",211,0,37,248,85.08,0,14.92,2019
"5399138",257,23,156,436,58.94,5.28,35.78,2019
"0695070",10616,189,378,11183,94.93,1.69,3.38,2019
"0695113",1203,36,70,1309,91.9,2.75,5.35,2019
"0695116",12130,243,1854,14227,85.26,1.71,13.03,2019
"0695206",12603,440,4184,17227,73.16,2.55,24.29,2019
"0695207",15520,387,2507,18414,84.28,2.1,13.61,2019
"0695220",2298,28,244,2570,89.42,1.09,9.49,2019
"7200715",486,52,494,1032,47.09,5.04,47.87,2019
"7200717",3933,173,2653,6759,58.19,2.56,39.25,2019
"7200767",6733,590,4218,11541,58.34,5.11,36.55,2019
"7200603",13222,339,5667,19228,68.76,1.76,29.47,2019
"7200622",473,8,1586,2067,22.88,0.39,76.73,2019
"7200647",861,123,935,1919,44.87,6.41,48.72,2019
"7200664",2423,101,2354,4878,49.67,2.07,48.26,2019
"7200667",1859,60,5862,7781,23.89,0.77,75.34,2019
"7200690",1768,24,615,2407,73.45,1,25.55,2019
"7200698",5723,358,4845,10926,52.38,3.28,44.34,2019
"7200728",9008,159,3972,13139,68.56,1.21,30.23,2019
"7200729",12781,71,3629,16481,77.55,0.43,22.02,2019
"7200751",4628,123,2858,7609,60.82,1.62,37.56,2019
"7200769",7549,289,5202,13040,57.89,2.22,39.89,2019
"0299921",547,24,243,814,67.2,2.95,29.85,2019
"0299631",94,0,12,106,88.68,0,11.32,2019
"0299546",36,0,22,58,62.07,0,37.93,2019
"5399356",40,0,20,60,66.67,0,33.33,2019
"5399363",77,10,0,87,88.51,11.49,0,2019
"0299515",7398,122,419,7939,93.19,1.54,5.28,2019
"0299547",5,4,3,12,41.67,33.33,25,2019
"0299558",21,2,15,38,55.26,5.26,39.47,2019
"0299566",4,0,8,12,33.33,0,66.67,2019
"0299568",105,0,57,162,64.81,0,35.19,2019
"0299574",773,19,43,835,92.57,2.28,5.15,2019
"0299577",9235,33,241,9509,97.12,0.35,2.53,2019
"0299615",3403,119,479,4001,85.05,2.97,11.97,2019
"0299633",130,6,28,164,79.27,3.66,17.07,2019
"0299643",42,0,46,88,47.73,0,52.27,2019
"0299655",117,7,39,163,71.78,4.29,23.93,2019
"0299666",19,4,12,35,54.29,11.43,34.29,2019
"0299676",488,17,95,600,81.33,2.83,15.83,2019
"0299720",11,8,50,69,15.94,11.59,72.46,2019
"0299727",90,2,22,114,78.95,1.75,19.3,2019
"0695988",2298,239,667,3204,71.72,7.46,20.82,2019
"0695631",2295,68,336,2699,85.03,2.52,12.45,2019
"0695638",632,28,81,741,85.29,3.78,10.93,2019
"0695640",2821,96,300,3217,87.69,2.98,9.33,2019
"0695658",2381,18,300,2699,88.22,0.67,11.12,2019
"0695666",1983,55,319,2357,84.13,2.33,13.53,2019
"0695681",311,40,53,404,76.98,9.9,13.12,2019
"0695686",302,8,62,372,81.18,2.15,16.67,2019
"0695690",535,21,192,748,71.52,2.81,25.67,2019
"0695693",2264,69,177,2510,90.2,2.75,7.05,2019
"0695695",12218,298,2233,14749,82.84,2.02,15.14,2019
"0695709",1738,53,299,2090,83.16,2.54,14.31,2019
"0695726",2832,115,370,3317,85.38,3.47,11.15,2019
"0695728",92,0,9,101,91.09,0,8.91,2019
"0695816",9011,327,623,9961,90.46,3.28,6.25,2019
"0695829",7831,215,397,8443,92.75,2.55,4.7,2019
"0695833",13462,228,966,14656,91.85,1.56,6.59,2019
"0695835",13233,229,256,13718,96.46,1.67,1.87,2019
"0695864",8616,136,607,9359,92.06,1.45,6.49,2019
"0695914",170,31,119,320,53.12,9.69,37.19,2019
"0695923",16,0,0,16,100,0,0,2019
"0695934",75,0,22,97,77.32,0,22.68,2019
"0695936",57,0,12,69,82.61,0,17.39,2019
"0695949",7103,219,1086,8408,84.48,2.6,12.92,2019
"0695963",4080,144,1249,5473,74.55,2.63,22.82,2019
"3303855",883,7,63,953,92.65,0.73,6.61,2019
"3303856",580,3,17,600,96.67,0.5,2.83,2019
"3303865",2826,57,236,3119,90.61,1.83,7.57,2019
"3303870",2169,17,74,2260,95.97,0.75,3.27,2019
"3303887",655,27,83,765,85.62,3.53,10.85,2019
"3303894",2574,0,429,3003,85.71,0,14.29,2019
"2303903",2503,42,131,2676,93.54,1.57,4.9,2019
"3303462",505,18,6,529,95.46,3.4,1.13,2019
"3303467",613,7,43,663,92.46,1.06,6.49,2019
"3303570",2948,195,834,3977,74.13,4.9,20.97,2019
"3303579",122,1,42,165,73.94,0.61,25.45,2019
"3303590",284,8,112,404,70.3,1.98,27.72,2019
"3303595",277,11,29,317,87.38,3.47,9.15,2019
"3303603",1655,128,413,2196,75.36,5.83,18.81,2019
"4215927",316,0,184,500,63.2,0,36.8,2019
"4215930",29,0,56,85,34.12,0,65.88,2019
"4215938",704,32,220,956,73.64,3.35,23.01,2019
"4215949",159,0,52,211,75.36,0,24.64,2019
"4215857",4680,90,1078,5848,80.03,1.54,18.43,2019
"4215863",73,0,29,102,71.57,0,28.43,2019
"4215864",553,8,108,669,82.66,1.2,16.14,2019
"4215929",8,0,16,24,33.33,0,66.67,2019
"4215931",2991,92,639,3722,80.36,2.47,17.17,2019
"4215673",429,41,114,584,73.46,7.02,19.52,2019
"4215086",143,52,12,207,69.08,25.12,5.8,2019
"4215090",8379,99,363,8841,94.77,1.12,4.11,2019
"4215104",2856,161,1042,4059,70.36,3.97,25.67,2019
"4215110",1528,107,612,2247,68,4.76,27.24,2019
"4215122",7061,238,1497,8796,80.28,2.71,17.02,2019
"4215147",6830,220,1350,8400,81.31,2.62,16.07,2019
"4215148",839,22,271,1132,74.12,1.94,23.94,2019
"4215234",5465,92,741,6298,86.77,1.46,11.77,2019
"4215236",11015,149,1410,12574,87.6,1.18,11.21,2019
"4215547",169,9,32,210,80.48,4.29,15.24,2019
"4215552",1573,77,650,2300,68.39,3.35,28.26,2019
"4215612",152,9,17,178,85.39,5.06,9.55,2019
"4215626",2060,219,224,2503,82.3,8.75,8.95,2019
"4215627",2177,67,466,2710,80.33,2.47,17.2,2019
"4215629",230,27,55,312,73.72,8.65,17.63,2019
"4215003",4157,89,775,5021,82.79,1.77,15.44,2019
"4215027",818,44,198,1060,77.17,4.15,18.68,2019
"4215030",360,17,167,544,66.18,3.12,30.7,2019
"4215061",4328,123,849,5300,81.66,2.32,16.02,2019
"4215689",83,0,0,83,100,0,0,2019
"4215698",224,0,94,318,70.44,0,29.56,2019
"4215721",58,1,24,83,69.88,1.2,28.92,2019
"4215724",546,25,315,886,61.63,2.82,35.55,2019
"4215747",478,33,281,792,60.35,4.17,35.48,2019
"4215748",2201,69,568,2838,77.55,2.43,20.01,2019
"4215756",53,11,31,95,55.79,11.58,32.63,2019
"4215352",307,8,80,395,77.72,2.03,20.25,2019
"4215239",7487,102,963,8552,87.55,1.19,11.26,2019
"4215310",61,5,53,119,51.26,4.2,44.54,2019
"4215338",511,22,127,660,77.42,3.33,19.24,2019
"4215848",236,13,151,400,59,3.25,37.75,2019
"4215853",2249,244,409,2902,77.5,8.41,14.09,2019
"4215764",69,0,23,92,75,0,25,2019
"4215779",133,0,69,202,65.84,0,34.16,2019
"4215781",41,3,4,48,85.42,6.25,8.33,2019
"5005262",645,148,68,861,74.91,17.19,7.9,2019
"5005340",243,64,40,347,70.03,18.44,11.53,2019
"5005345",673,155,143,971,69.31,15.96,14.73,2019
"5005452",7855,308,708,8871,88.55,3.47,7.98,2019
"5005362",33,0,0,33,100,0,0,2019
"5005403",7422,354,852,8628,86.02,4.1,9.87,2019
"5005448",275,4,59,338,81.36,1.18,17.46,2019
"5005477",1670,95,48,1813,92.11,5.24,2.65,2019
"5005483",460,6,74,540,85.19,1.11,13.7,2019
"5005495",3783,82,288,4153,91.09,1.97,6.93,2019
"5005442",142,1,34,177,80.23,0.56,19.21,2019
"5005730",105,3,9,117,89.74,2.56,7.69,2019
"5005736",206,0,40,246,83.74,0,16.26,2019
"5005737",330,7,39,376,87.77,1.86,10.37,2019
"2501376",1801,69,519,2389,75.39,2.89,21.72,2019
"2501378",284,16,45,345,82.32,4.64,13.04,2019
"2501772",3178,15,119,3312,95.95,0.45,3.59,2019
"2501854",6918,388,2192,9498,72.84,4.09,23.08,2019
"2501515",696,6,93,795,87.55,0.75,11.7,2019
"2501562",4040,130,713,4883,82.74,2.66,14.6,2019
"2501564",2589,42,146,2777,93.23,1.51,5.26,2019
"2501568",2461,98,157,2716,90.61,3.61,5.78,2019
"2501571",3551,44,310,3905,90.93,1.13,7.94,2019
"2501590",3148,47,222,3417,92.13,1.38,6.5,2019
"2501605",8210,399,2064,10673,76.92,3.74,19.34,2019
"2501606",6882,172,1105,8159,84.35,2.11,13.54,2019
"2501719",2192,10,64,2266,96.73,0.44,2.82,2019
"2501008",353,13,124,490,72.04,2.65,25.31,2019
"2501012",220,24,28,272,80.88,8.82,10.29,2019
"2501013",7526,253,1361,9140,82.34,2.77,14.89,2019
"2501029",203,16,19,238,85.29,6.72,7.98,2019
"2501031",393,43,101,537,73.18,8.01,18.81,2019
"2501032",199,20,15,234,85.04,8.55,6.41,2019
"2501056",6358,218,1349,7925,80.23,2.75,17.02,2019
"2501060",5724,229,603,6556,87.31,3.49,9.2,2019
"2501069",2980,146,382,3508,84.95,4.16,10.89,2019
"2501070",241,25,30,296,81.42,8.45,10.14,2019
"2501077",3056,90,658,3804,80.34,2.37,17.3,2019
"2501083",835,46,185,1066,78.33,4.32,17.35,2019
"2501095",4629,170,454,5253,88.12,3.24,8.64,2019
"2501098",491,12,81,584,84.08,2.05,13.87,2019
"2501129",2249,94,521,2864,78.53,3.28,18.19,2019
"2501237",856,81,99,1036,82.63,7.82,9.56,2019
"2501244",35,0,23,58,60.34,0,39.66,2019
"2501247",5047,240,1275,6562,76.91,3.66,19.43,2019
"2501253",329,15,62,406,81.03,3.69,15.27,2019
"2501266",517,25,30,572,90.38,4.37,5.24,2019
"2501330",468,3,103,574,81.53,0.52,17.94,2019
"2501331",4354,151,766,5271,82.6,2.86,14.53,2019
"2501340",589,15,152,756,77.91,1.98,20.11,2019
"2501350",26,7,16,49,53.06,14.29,32.65,2019
"2501438",198,0,0,198,100,0,0,2019
"2501902",12752,632,3701,17085,74.64,3.7,21.66,2019
"2501913",6341,175,699,7215,87.89,2.43,9.69,2019
"2501922",1181,0,42,1223,96.57,0,3.43,2019
"2501930",11321,286,1503,13110,86.35,2.18,11.46,2019
"2501701",12223,53,778,13054,93.63,0.41,5.96,2019
"2501602",8232,424,842,9498,86.67,4.46,8.87,2019
"2501611",670,58,60,788,85.03,7.36,7.61,2019
"2304614",1007,12,154,1173,85.85,1.02,13.13,2019
"2304624",67,0,7,74,90.54,0,9.46,2019
"2304631",487,53,89,629,77.42,8.43,14.15,2019
"2304635",5,0,1,6,83.33,0,16.67,2019
"2304649",427,11,140,578,73.88,1.9,24.22,2019
"2304681",365,40,76,481,75.88,8.32,15.8,2019
"2304693",167,7,36,210,79.52,3.33,17.14,2019
"2304743",1341,144,378,1863,71.98,7.73,20.29,2019
"2304750",564,54,143,761,74.11,7.1,18.79,2019
"2304760",213,20,84,317,67.19,6.31,26.5,2019
"2304766",97,10,56,163,59.51,6.13,34.36,2019
"2304776",256,20,114,390,65.64,5.13,29.23,2019
"2304841",2918,124,444,3486,83.71,3.56,12.74,2019
"2304847",550,20,64,634,86.75,3.15,10.09,2019
"7200795",10809,188,3785,14782,73.12,1.27,25.61,2019
"7200925",1336,39,1814,3189,41.89,1.22,56.88,2019
"7200979",6633,270,1294,8197,80.92,3.29,15.79,2019
"7200983",10222,122,2940,13284,76.95,0.92,22.13,2019
"7200624",4924,62,2425,7411,66.44,0.84,32.72,2019
"7200656",4388,74,2040,6502,67.49,1.14,31.37,2019
"7200660",4034,125,2096,6255,64.49,2,33.51,2019
"7200662",5646,1322,6881,13849,40.77,9.55,49.69,2019
"7200674",6902,359,7597,14858,46.45,2.42,51.13,2019
"7200683",4207,167,6693,11067,38.01,1.51,60.48,2019
"7200718",5709,351,1919,7979,71.55,4.4,24.05,2019
"7200921",7929,913,4703,13545,58.54,6.74,34.72,2019
"7200772",4534,21,1883,6438,70.43,0.33,29.25,2019
"7200913",2154,20,1136,3310,65.08,0.6,34.32,2019
"7200923",3341,390,6308,10039,33.28,3.88,62.83,2019
"7200949",14704,505,10419,25628,57.37,1.97,40.65,2019
"7200969",11929,202,2212,14343,83.17,1.41,15.42,2019
"7200985",9154,110,2902,12166,75.24,0.9,23.85,2019
"7200602",7077,466,5197,12740,55.55,3.66,40.79,2019
"7200676",9007,234,4184,13425,67.09,1.74,31.17,2019
"7200682",8373,286,3209,11868,70.55,2.41,27.04,2019
"7200704",1737,0,987,2724,63.77,0,36.23,2019
"7200707",2100,192,1523,3815,55.05,5.03,39.92,2019
"7200765",1453,0,757,2210,65.75,0,34.25,2019
"7200730",6192,496,4870,11558,53.57,4.29,42.14,2019
"7200738",8273,122,3163,11558,71.58,1.06,27.37,2019
"7200754",7092,874,5684,13650,51.96,6.4,41.64,2019
"7200782",2042,60,3105,5207,39.22,1.15,59.63,2019
"7200791",10139,823,5329,16291,62.24,5.05,32.71,2019
"7200794",4476,70,4195,8741,51.21,0.8,47.99,2019
"7200907",5617,408,2018,8043,69.84,5.07,25.09,2019
"7200909",1361,69,813,2243,60.68,3.08,36.25,2019
"7200912",1803,43,732,2578,69.94,1.67,28.39,2019
"7200918",4438,321,3296,8055,55.1,3.99,40.92,2019
"7200927",4040,55,1868,5963,67.75,0.92,31.33,2019
"7200953",11425,247,10057,21729,52.58,1.14,46.28,2019
"7200956",17444,513,6650,24607,70.89,2.08,27.02,2019
"7200957",10507,195,3598,14300,73.48,1.36,25.16,2019
"7200612",14733,589,7487,22809,64.59,2.58,32.82,2019
"7200623",4098,63,9245,13406,30.57,0.47,68.96,2019
"7200652",758,42,519,1319,57.47,3.18,39.35,2019
"7200677",2825,215,1989,5029,56.17,4.28,39.55,2019
"7200692",6248,242,4840,11330,55.15,2.14,42.72,2019
"7200678",5314,478,3019,8811,60.31,5.43,34.26,2019
"7200685",5433,761,7189,13383,40.6,5.69,53.72,2019
"2502638",1391,22,160,1573,88.43,1.4,10.17,2019
"2502035",6405,83,317,6805,94.12,1.22,4.66,2019
"2502333",4322,134,372,4828,89.52,2.78,7.71,2019
"2502666",227,0,36,263,86.31,0,13.69,2019
"2502763",569,22,0,591,96.28,3.72,0,2019
"2502339",4472,119,322,4913,91.02,2.42,6.55,2019
"2502464",1176,7,48,1231,95.53,0.57,3.9,2019
"2502633",1775,92,187,2054,86.42,4.48,9.1,2019
"2502703",15137,674,1821,17632,85.85,3.82,10.33,2019
"4402833",427,0,16,443,96.39,0,3.61,2019
"2502631",3747,176,219,4142,90.46,4.25,5.29,2019
"2502745",8476,197,1394,10067,84.2,1.96,13.85,2019
"4402863",4195,244,1664,6103,68.74,4,27.27,2019
"4402896",3980,49,559,4588,86.75,1.07,12.18,2019
"5425559",319,132,133,584,54.62,22.6,22.77,2019
"5425611",261,0,0,261,100,0,0,2019
"5425624",50,0,41,91,54.95,0,45.05,2019
"5425625",287,13,128,428,67.06,3.04,29.91,2019
"5425634",97,8,64,169,57.4,4.73,37.87,2019
"5425674",871,33,215,1119,77.84,2.95,19.21,2019
"5425676",450,0,33,483,93.17,0,6.83,2019
"5425702",1806,299,949,3054,59.14,9.79,31.07,2019
"5425832",1504,43,103,1650,91.15,2.61,6.24,2019
"5425845",181,0,51,232,78.02,0,21.98,2019
"5425846",84,0,53,137,61.31,0,38.69,2019
"5425704",4584,419,1519,6522,70.29,6.42,23.29,2019
"5425826",79,0,0,79,100,0,0,2019
"5425849",85,24,0,109,77.98,22.02,0,2019
"5425864",86,0,42,128,67.19,0,32.81,2019
"5425904",133,0,37,170,78.24,0,21.76,2019
"5425958",209,6,111,326,64.11,1.84,34.05,2019
"5425882",677,5,132,814,83.17,0.61,16.22,2019
"5425907",12,0,9,21,57.14,0,42.86,2019
"5425920",54,0,0,54,100,0,0,2019
"5425951",1757,74,1031,2862,61.39,2.59,36.02,2019
"5425962",992,55,392,1439,68.94,3.82,27.24,2019
"5425045",1285,43,600,1928,66.65,2.23,31.12,2019
"5425063",519,11,272,802,64.71,1.37,33.92,2019
"5425081",357,4,36,397,89.92,1.01,9.07,2019
"5425083",190,0,35,225,84.44,0,15.56,2019
"5425984",374,9,129,512,73.05,1.76,25.2,2019
"5425985",144,0,47,191,75.39,0,24.61,2019
"5425021",102,6,0,108,94.44,5.56,0,2019
"5425043",354,25,173,552,64.13,4.53,31.34,2019
"5425048",13,0,19,32,40.62,0,59.38,2019
"5425053",1499,22,198,1719,87.2,1.28,11.52,2019
"5425075",126,41,141,308,40.91,13.31,45.78,2019
"5425076",58,18,38,114,50.88,15.79,33.33,2019
"5425085",266,13,151,430,61.86,3.02,35.12,2019
"5425090",45,0,13,58,77.59,0,22.41,2019
"5425102",51,4,7,62,82.26,6.45,11.29,2019
"5425103",82,0,25,107,76.64,0,23.36,2019
"5425126",23,0,13,36,63.89,0,36.11,2019
"5425130",990,48,278,1316,75.23,3.65,21.12,2019
"5425141",55,0,9,64,85.94,0,14.06,2019
"5425164",283,30,104,417,67.87,7.19,24.94,2019
"5425165",277,0,49,326,84.97,0,15.03,2019
"5425169",176,0,31,207,85.02,0,14.98,2019
"5425174",139,44,25,208,66.83,21.15,12.02,2019
"5425177",7548,344,1431,9323,80.96,3.69,15.35,2019
"5425193",251,0,32,283,88.69,0,11.31,2019
"5425025",53,0,0,53,100,0,0,2019
"5425054",107,0,24,131,81.68,0,18.32,2019
"5425214",190,0,20,210,90.48,0,9.52,2019
"5425241",544,6,64,614,88.6,0.98,10.42,2019
"5425306",2331,132,678,3141,74.21,4.2,21.59,2019
"5425422",580,16,153,749,77.44,2.14,20.43,2019
"5425427",4729,120,901,5750,82.24,2.09,15.67,2019
"3728369",384,11,548,943,40.72,1.17,58.11,2019
"3728371",1936,30,488,2454,78.89,1.22,19.89,2019
"3728392",461,0,132,593,77.74,0,22.26,2019
"3728428",2583,231,218,3032,85.19,7.62,7.19,2019
"3728433",1122,113,666,1901,59.02,5.94,35.03,2019
"2304346",683,38,137,858,79.6,4.43,15.97,2019
"2304256",953,0,260,1213,78.57,0,21.43,2019
"2304041",455,42,121,618,73.62,6.8,19.58,2019
"2304085",732,20,16,768,95.31,2.6,2.08,2019
"2304276",1866,100,423,2389,78.11,4.19,17.71,2019
"2304280",2335,199,211,2745,85.06,7.25,7.69,2019
"2304282",1984,125,199,2308,85.96,5.42,8.62,2019
"2304290",479,19,62,560,85.54,3.39,11.07,2019
"2304345",3857,124,597,4578,84.25,2.71,13.04,2019
"2304360",179,2,22,203,88.18,0.99,10.84,2019
"2304414",398,25,97,520,76.54,4.81,18.65,2019
"2304422",331,39,112,482,68.67,8.09,23.24,2019
"2304443",519,112,290,921,56.35,12.16,31.49,2019
"2304453",250,5,83,338,73.96,1.48,24.56,2019
"2304464",161,24,60,245,65.71,9.8,24.49,2019
"2304473",2602,202,345,3149,82.63,6.41,10.96,2019
"2304478",169,18,3,190,88.95,9.47,1.58,2019
"2304493",635,18,125,778,81.62,2.31,16.07,2019
"2304535",295,3,50,348,84.77,0.86,14.37,2019
"2304539",397,20,86,503,78.93,3.98,17.1,2019
"2304563",508,9,110,627,81.02,1.44,17.54,2019
"2304568",179,0,50,229,78.17,0,21.83,2019
"2304578",1498,31,340,1869,80.15,1.66,18.19,2019
"2304650",129,0,23,152,84.87,0,15.13,2019
"2304662",160,13,30,203,78.82,6.4,14.78,2019
"2304666",445,10,105,560,79.46,1.79,18.75,2019
"2304667",435,19,119,573,75.92,3.32,20.77,2019
"2304679",558,30,85,673,82.91,4.46,12.63,2019
"2304684",707,10,54,771,91.7,1.3,7,2019
"2304006",87,7,0,94,92.55,7.45,0,2019
"2304056",103,0,16,119,86.55,0,13.45,2019
"2304057",38,0,0,38,100,0,0,2019
"2304090",3969,79,545,4593,86.41,1.72,11.87,2019
"2304289",511,56,141,708,72.18,7.91,19.92,2019
"2304429",1762,55,187,2004,87.92,2.74,9.33,2019
"2304495",155,0,30,185,83.78,0,16.22,2019
"2304627",513,25,112,650,78.92,3.85,17.23,2019
"2304673",57,0,6,63,90.48,0,9.52,2019
"2304063",266,0,32,298,89.26,0,10.74,2019
"2304109",43,0,0,43,100,0,0,2019
"2304227",38,0,17,55,69.09,0,30.91,2019
"2304234",27,0,0,27,100,0,0,2019
"2304267",29,0,4,33,87.88,0,12.12,2019
"2304271",0,0,0,0,NA,NA,NA,2019
"2304286",15,0,0,15,100,0,0,2019
"0572347",145,15,117,277,52.35,5.42,42.24,2019
"0572348",680,58,376,1114,61.04,5.21,33.75,2019
"0572350",285,46,104,435,65.52,10.57,23.91,2019
"0572377",0,0,22,22,0,0,100,2019
"0572384",252,17,113,382,65.97,4.45,29.58,2019
"0572401",18198,1374,3121,22693,80.19,6.05,13.75,2019
"0572414",132,4,5,141,93.62,2.84,3.55,2019
"0572416",1668,94,370,2132,78.24,4.41,17.35,2019
"0572427",73,0,21,94,77.66,0,22.34,2019
"0572126",988,28,279,1295,76.29,2.16,21.54,2019
"0572123",90,0,117,207,43.48,0,56.52,2019
"0572131",1533,88,327,1948,78.7,4.52,16.79,2019
"0572166",33,0,15,48,68.75,0,31.25,2019
"0572167",317,8,294,619,51.21,1.29,47.5,2019
"3728538",605,7,212,824,73.42,0.85,25.73,2019
"3728543",1834,59,31,1924,95.32,3.07,1.61,2019
"3728577",68,6,36,110,61.82,5.45,32.73,2019
"3728580",3072,99,945,4116,74.64,2.41,22.96,2019
"3728581",98,0,46,144,68.06,0,31.94,2019
"3728602",8935,242,2406,11583,77.14,2.09,20.77,2019
"3728616",30,1,2,33,90.91,3.03,6.06,2019
"3728626",963,0,220,1183,81.4,0,18.6,2019
"3728642",1494,394,485,2373,62.96,16.6,20.44,2019
"3728655",15814,432,5301,21547,73.39,2,24.6,2019
"3728681",7312,249,2366,9927,73.66,2.51,23.83,2019
"3728685",471,32,312,815,57.79,3.93,38.28,2019
"3728692",1363,54,178,1595,85.45,3.39,11.16,2019
"3728697",4343,130,1226,5699,76.21,2.28,21.51,2019
"3728701",1000,98,251,1349,74.13,7.26,18.61,2019
"3728719",1699,110,1083,2892,58.75,3.8,37.45,2019
"3728726",1070,80,225,1375,77.82,5.82,16.36,2019
"3728731",2931,95,463,3489,84.01,2.72,13.27,2019
"3728774",298,43,125,466,63.95,9.23,26.82,2019
"3728801",5198,98,1310,6606,78.69,1.48,19.83,2019
"3728803",13601,461,1658,15720,86.52,2.93,10.55,2019
"3728511",219,0,66,285,76.84,0,23.16,2019
"3728513",3333,110,675,4118,80.94,2.67,16.39,2019
"3728525",874,52,226,1152,75.87,4.51,19.62,2019
"3728531",446,6,98,550,81.09,1.09,17.82,2019
"3728546",15260,446,1420,17126,89.1,2.6,8.29,2019
"3728554",107,0,23,130,82.31,0,17.69,2019
"3728605",1411,33,138,1582,89.19,2.09,8.72,2019
"3728611",295,0,186,481,61.33,0,38.67,2019
"3728612",3308,140,1380,4828,68.52,2.9,28.58,2019
"3728619",465,25,177,667,69.72,3.75,26.54,2019
"3728624",575,0,184,759,75.76,0,24.24,2019
"3728625",11685,702,2620,15007,77.86,4.68,17.46,2019
"3728638",3909,120,906,4935,79.21,2.43,18.36,2019
"3728643",1157,16,360,1533,75.47,1.04,23.48,2019
"3728659",6626,301,2029,8956,73.98,3.36,22.66,2019
"3728665",857,5,154,1016,84.35,0.49,15.16,2019
"3728669",899,0,320,1219,73.75,0,26.25,2019
"3728677",10719,512,2371,13602,78.8,3.76,17.43,2019
"3728679",525,32,135,692,75.87,4.62,19.51,2019
"3728702",109,0,70,179,60.89,0,39.11,2019
"3728704",6630,197,1071,7898,83.95,2.49,13.56,2019
"3728174",2485,26,264,2775,89.55,0.94,9.51,2019
"3728019",0,0,0,0,NA,NA,NA,2019
"3728033",1013,22,144,1179,85.92,1.87,12.21,2019
"3728043",5596,370,2321,8287,67.53,4.46,28.01,2019
"3728086",6752,426,2333,9511,70.99,4.48,24.53,2019
"3728092",12755,566,2795,16116,79.14,3.51,17.34,2019
"3728135",1513,56,316,1885,80.27,2.97,16.76,2019
"3728138",3178,67,630,3875,82.01,1.73,16.26,2019
"3728152",5903,628,2066,8597,68.66,7.3,24.03,2019
"3728159",863,37,166,1066,80.96,3.47,15.57,2019
"3728520",145,0,16,161,90.06,0,9.94,2019
"3728539",5192,88,640,5920,87.7,1.49,10.81,2019
"3728551",4603,168,865,5636,81.67,2.98,15.35,2019
"3728555",1298,26,521,1845,70.35,1.41,28.24,2019
"3728572",1891,87,525,2503,75.55,3.48,20.97,2019
"3728615",594,11,248,853,69.64,1.29,29.07,2019
"3728623",503,21,149,673,74.74,3.12,22.14,2019
"3728435",596,37,235,868,68.66,4.26,27.07,2019
"3728450",775,34,196,1005,77.11,3.38,19.5,2019
"3728461",8080,129,685,8894,90.85,1.45,7.7,2019
"3728462",4429,187,877,5493,80.63,3.4,15.97,2019
"3728537",30,0,0,30,100,0,0,2019
"3728547",1930,41,14,1985,97.23,2.07,0.71,2019
"3728552",29,0,20,49,59.18,0,40.82,2019
"3728557",5837,215,872,6924,84.3,3.11,12.59,2019
"3728560",9263,197,2121,11581,79.98,1.7,18.31,2019
"3728562",13710,215,2429,16354,83.83,1.31,14.85,2019
"3728570",7347,310,975,8632,85.11,3.59,11.3,2019
"3728574",5271,256,777,6304,83.61,4.06,12.33,2019
"3728579",245,0,11,256,95.7,0,4.3,2019
"3728373",913,9,167,1089,83.84,0.83,15.34,2019
"3728364",2770,154,2215,5139,53.9,3,43.1,2019
"3728366",1332,112,800,2244,59.36,4.99,35.65,2019
"3728377",2638,73,1424,4135,63.8,1.77,34.44,2019
"3728698",668,10,304,982,68.02,1.02,30.96,2019
"3728725",10,0,0,10,100,0,0,2019
"3728734",9489,324,2685,12498,75.92,2.59,21.48,2019
"3728735",127,0,45,172,73.84,0,26.16,2019
"3728741",1530,79,306,1915,79.9,4.13,15.98,2019
"3728753",2884,172,961,4017,71.79,4.28,23.92,2019
"3728756",1306,133,277,1716,76.11,7.75,16.14,2019
"3728762",2144,44,807,2995,71.59,1.47,26.94,2019
"3728777",2782,80,713,3575,77.82,2.24,19.94,2019
"3728778",2848,113,792,3753,75.89,3.01,21.1,2019
"3728902",480,0,86,566,84.81,0,15.19,2019
"3728909",375,0,103,478,78.45,0,21.55,2019
"3728104",10038,80,438,10556,95.09,0.76,4.15,2019
"3728109",20,7,18,45,44.44,15.56,40,2019
"3728117",14411,578,682,15671,91.96,3.69,4.35,2019
"3728125",705,0,215,920,76.63,0,23.37,2019
"3728128",2426,24,471,2921,83.05,0.82,16.12,2019
"3728166",3092,146,448,3686,83.88,3.96,12.15,2019
"3728203",7983,188,535,8706,91.7,2.16,6.15,2019
"3728215",17882,335,2738,20955,85.34,1.6,13.07,2019
"3728305",2282,47,485,2814,81.09,1.67,17.24,2019
"3728326",6651,205,604,7460,89.16,2.75,8.1,2019
"3728332",141,5,4,150,94,3.33,2.67,2019
"3728339",2160,47,632,2839,76.08,1.66,22.26,2019
"3728341",1020,107,368,1495,68.23,7.16,24.62,2019
"3728348",10893,283,1286,12462,87.41,2.27,10.32,2019
"3728352",5561,225,3339,9125,60.94,2.47,36.59,2019
"3728358",8421,304,4712,13437,62.67,2.26,35.07,2019
"3728409",12403,71,838,13312,93.17,0.53,6.3,2019
"3728420",1183,60,281,1524,77.62,3.94,18.44,2019
"3728390",7348,498,832,8678,84.67,5.74,9.59,2019
"3728344",787,18,279,1084,72.6,1.66,25.74,2019
"3728360",2849,132,1796,4777,59.64,2.76,37.6,2019
"3728391",1823,67,277,2167,84.13,3.09,12.78,2019
"3728401",7516,595,2563,10674,70.41,5.57,24.01,2019
"3728708",108,0,24,132,81.82,0,18.18,2019
"3728712",7066,234,1540,8840,79.93,2.65,17.42,2019
"4219153",4121,62,1165,5348,77.06,1.16,21.78,2019
"4219154",10833,226,1335,12394,87.41,1.82,10.77,2019
"4219355",9339,175,575,10089,92.57,1.73,5.7,2019
"4219362",1650,44,389,2083,79.21,2.11,18.67,2019
"4219365",2127,49,408,2584,82.31,1.9,15.79,2019
"0572207",4635,202,323,5160,89.83,3.91,6.26,2019
"0572211",8504,266,1085,9855,86.29,2.7,11.01,2019
"0572223",8780,332,470,9582,91.63,3.46,4.91,2019
"0572301",7121,306,2334,9761,72.95,3.13,23.91,2019
"0572429",105,2,37,144,72.92,1.39,25.69,2019
"0572441",12,1,17,30,40,3.33,56.67,2019
"0572442",1126,49,521,1696,66.39,2.89,30.72,2019
"0572443",892,53,240,1185,75.27,4.47,20.25,2019
"0572447",562,29,233,824,68.2,3.52,28.28,2019
"0572457",36,5,31,72,50,6.94,43.06,2019
"0572470",56,4,23,83,67.47,4.82,27.71,2019
"0572471",319,18,119,456,69.96,3.95,26.1,2019
"0572536",93,49,30,172,54.07,28.49,17.44,2019
"0572556",658,337,313,1308,50.31,25.76,23.93,2019
"0572566",100,49,79,228,43.86,21.49,34.65,2019
"0572569",195,0,60,255,76.47,0,23.53,2019
"0572571",80,0,52,132,60.61,0,39.39,2019
"0572572",28,0,36,64,43.75,0,56.25,2019
"0572573",43,27,12,82,52.44,32.93,14.63,2019
"0572577",150,54,41,245,61.22,22.04,16.73,2019
"0572624",102,32,25,159,64.15,20.13,15.72,2019
"0572641",682,62,430,1174,58.09,5.28,36.63,2019
"0572650",939,105,630,1674,56.09,6.27,37.63,2019
"0572658",322,47,235,604,53.31,7.78,38.91,2019
"0572660",172,1,87,260,66.15,0.38,33.46,2019
"0572669",13,0,27,40,32.5,0,67.5,2019
"0572677",99,5,45,149,66.44,3.36,30.2,2019
"0572714",4709,432,341,5482,85.9,7.88,6.22,2019
"0572718",911,159,56,1126,80.91,14.12,4.97,2019
"0572727",1475,121,633,2229,66.17,5.43,28.4,2019
"0572756",10299,2492,3091,15882,64.85,15.69,19.46,2019
"0572774",1877,68,363,2308,81.33,2.95,15.73,2019
"0572333",139,0,84,223,62.33,0,37.67,2019
"0572338",7,0,0,7,100,0,0,2019
"0572366",475,18,382,875,54.29,2.06,43.66,2019
"0572379",0,0,6,6,0,0,100,2019
"0572389",126,0,6,132,95.45,0,4.55,2019
"0572392",155,0,74,229,67.69,0,32.31,2019
"0572425",33,7,99,139,23.74,5.04,71.22,2019
"0572430",115,25,30,170,67.65,14.71,17.65,2019
"0572438",712,98,229,1039,68.53,9.43,22.04,2019
"0572458",204,0,38,242,84.3,0,15.7,2019
"0572460",238,4,101,343,69.39,1.17,29.45,2019
"0572464",5,4,19,28,17.86,14.29,67.86,2019
"0572473",674,12,370,1056,63.83,1.14,35.04,2019
"0696145",877,53,102,1032,84.98,5.14,9.88,2019
"1596707",12602,176,630,13408,93.99,1.31,4.7,2019
"1596741",1938,26,87,2051,94.49,1.27,4.24,2019
"1596743",4065,13,406,4484,90.66,0.29,9.05,2019
"1596760",834,39,240,1113,74.93,3.5,21.56,2019
"1596768",5475,234,847,6556,83.51,3.57,12.92,2019
"1596770",176,0,92,268,65.67,0,34.33,2019
"1596771",1811,151,900,2862,63.28,5.28,31.45,2019
"1596772",689,10,304,1003,68.69,1,30.31,2019
"1596777",302,27,159,488,61.89,5.53,32.58,2019
"1596793",8814,265,1193,10272,85.81,2.58,11.61,2019
"0696021",4170,182,1446,5798,71.92,3.14,24.94,2019
"0696074",31,4,22,57,54.39,7.02,38.6,2019
"1596750",951,41,281,1273,74.71,3.22,22.07,2019
"3728634",1244,108,340,1692,73.52,6.38,20.09,2019
"3728657",2628,197,1140,3965,66.28,4.97,28.75,2019
"3728671",95,39,79,213,44.6,18.31,37.09,2019
"3728713",2258,162,1177,3597,62.77,4.5,32.72,2019
"3728766",440,17,19,476,92.44,3.57,3.99,2019
"3728779",6063,219,1533,7815,77.58,2.8,19.62,2019
"3728783",392,0,322,714,54.9,0,45.1,2019
"3728540",14967,526,2291,17784,84.16,2.96,12.88,2019
"3728521",746,28,204,978,76.28,2.86,20.86,2019
"3728526",624,1,568,1193,52.31,0.08,47.61,2019
"3728571",971,48,226,1245,77.99,3.86,18.15,2019
"3728575",202,22,0,224,90.18,9.82,0,2019
"3728578",1625,0,629,2254,72.09,0,27.91,2019
"3728585",880,77,607,1564,56.27,4.92,38.81,2019
"3728589",51,0,8,59,86.44,0,13.56,2019
"3728590",8671,145,872,9688,89.5,1.5,9,2019
"3728606",462,0,142,604,76.49,0,23.51,2019
"3728609",1833,42,352,2227,82.31,1.89,15.81,2019
"3728610",3239,142,600,3981,81.36,3.57,15.07,2019
"3728031",10807,278,660,11745,92.01,2.37,5.62,2019
"3728040",2117,116,874,3107,68.14,3.73,28.13,2019
"3728054",12147,537,2766,15450,78.62,3.48,17.9,2019
"3728091",630,31,196,857,73.51,3.62,22.87,2019
"3728102",30,0,9,39,76.92,0,23.08,2019
"3728630",6653,160,1135,7948,83.71,2.01,14.28,2019
"3728635",932,40,341,1313,70.98,3.05,25.97,2019
"3728645",14189,407,3997,18593,76.31,2.19,21.5,2019
"3728650",3672,173,551,4396,83.53,3.94,12.53,2019
"3728660",654,55,120,829,78.89,6.63,14.48,2019
"3728690",2587,54,925,3566,72.55,1.51,25.94,2019
"3728693",548,22,260,830,66.02,2.65,31.33,2019
"5123359",195,15,76,286,68.18,5.24,26.57,2019
"5123416",19,55,52,126,15.08,43.65,41.27,2019
"5123418",317,4,67,388,81.7,1.03,17.27,2019
"5123420",698,29,334,1061,65.79,2.73,31.48,2019
"5123432",509,34,67,610,83.44,5.57,10.98,2019
"5123437",1244,72,374,1690,73.61,4.26,22.13,2019
"5123438",521,0,141,662,78.7,0,21.3,2019
"5123423",166,0,20,186,89.25,0,10.75,2019
"5123433",493,0,45,538,91.64,0,8.36,2019
"5123442",335,54,74,463,72.35,11.66,15.98,2019
"5123455",17500,416,1997,19913,87.88,2.09,10.03,2019
"5123461",0,0,0,0,NA,NA,NA,2019
"5123488",105,0,80,185,56.76,0,43.24,2019
"5123504",5615,383,1759,7757,72.39,4.94,22.68,2019
"5123517",2039,70,266,2375,85.85,2.95,11.2,2019
"5123669",12717,823,2276,15816,80.41,5.2,14.39,2019
"5123692",6718,179,572,7469,89.95,2.4,7.66,2019
"5123703",8535,75,1055,9665,88.31,0.78,10.92,2019
"5123832",11308,90,1013,12411,91.11,0.73,8.16,2019
"5123840",681,0,164,845,80.59,0,19.41,2019
"5123845",198,27,45,270,73.33,10,16.67,2019
"5123847",3310,233,1605,5148,64.3,4.53,31.18,2019
"5123856",273,7,153,433,63.05,1.62,35.33,2019
"5123874",281,3,152,436,64.45,0.69,34.86,2019
"5123893",159,0,10,169,94.08,0,5.92,2019
"5123897",144,16,130,290,49.66,5.52,44.83,2019
"5123899",92,4,58,154,59.74,2.6,37.66,2019
"5123917",642,87,314,1043,61.55,8.34,30.11,2019
"4219440",6545,167,720,7432,88.07,2.25,9.69,2019
"4219152",10471,495,2068,13034,80.34,3.8,15.87,2019
"4219138",8736,376,2726,11838,73.8,3.18,23.03,2019
"4219139",11579,962,4787,17328,66.82,5.55,27.63,2019
"4219146",13687,636,2877,17200,79.58,3.7,16.73,2019
"4219312",4013,13,304,4330,92.68,0.3,7.02,2019
"4219335",16559,220,1196,17975,92.12,1.22,6.65,2019
"4219382",18651,702,858,20211,92.28,3.47,4.25,2019
"4219438",8501,184,747,9432,90.13,1.95,7.92,2019
"4219460",14830,308,1321,16459,90.1,1.87,8.03,2019
"4219504",1805,31,143,1979,91.21,1.57,7.23,2019
"4219511",43,0,0,43,100,0,0,2019
"4219512",5655,88,1128,6871,82.3,1.28,16.42,2019
"4219518",4996,58,549,5603,89.17,1.04,9.8,2019
"4219525",5397,22,243,5662,95.32,0.39,4.29,2019
"4219112",0,0,0,0,NA,NA,NA,2019
"4219124",17136,720,4753,22609,75.79,3.18,21.02,2019
"4219529",1059,30,124,1213,87.3,2.47,10.22,2019
"4219543",1908,8,241,2157,88.46,0.37,11.17,2019
"4219545",251,0,21,272,92.28,0,7.72,2019
"4219006",7129,179,562,7870,90.58,2.27,7.14,2019
"4219018",8336,107,1207,9650,86.38,1.11,12.51,2019
"4219025",1929,106,105,2140,90.14,4.95,4.91,2019
"4219043",871,17,97,985,88.43,1.73,9.85,2019
"4219061",6386,210,1186,7782,82.06,2.7,15.24,2019
"4219066",1665,9,46,1720,96.8,0.52,2.67,2019
"4219079",2706,69,721,3496,77.4,1.97,20.62,2019
"4219082",11866,474,2264,14604,81.25,3.25,15.5,2019
"4219103",13782,316,1079,15177,90.81,2.08,7.11,2019
"4219104",12310,669,3361,16340,75.34,4.09,20.57,2019
"1019939",2465,16,276,2757,89.41,0.58,10.01,2019
"1019946",1635,66,251,1952,83.76,3.38,12.86,2019
"1019947",5004,169,1606,6779,73.82,2.49,23.69,2019
"4219041",2458,25,129,2612,94.1,0.96,4.94,2019
"4219114",11081,469,1414,12964,85.48,3.62,10.91,2019
"4219119",10142,276,1367,11785,86.06,2.34,11.6,2019
"4219125",9058,270,1228,10556,85.81,2.56,11.63,2019
"4219127",2450,73,119,2642,92.73,2.76,4.5,2019
"1019973",7207,322,2007,9536,75.58,3.38,21.05,2019
"4219372",654,0,15,669,97.76,0,2.24,2019
"4219310",696,24,240,960,72.5,2.5,25,2019
"4219311",2411,40,459,2910,82.85,1.37,15.77,2019
"4219358",173,3,49,225,76.89,1.33,21.78,2019
"4219390",4085,177,798,5060,80.73,3.5,15.77,2019
"4219422",6825,184,293,7302,93.47,2.52,4.01,2019
"4219426",12002,80,346,12428,96.57,0.64,2.78,2019
"4219096",5328,39,275,5642,94.43,0.69,4.87,2019
"4219107",6683,277,715,7675,87.07,3.61,9.32,2019
"4219126",4386,214,1227,5827,75.27,3.67,21.06,2019
"4219132",7762,376,5949,14087,55.1,2.67,42.23,2019
"4219134",15240,507,4651,20398,74.71,2.49,22.8,2019
"4219533",2024,24,343,2391,84.65,1,14.35,2019
"4219602",4383,150,1724,6257,70.05,2.4,27.55,2019
"1019707",5696,65,208,5969,95.43,1.09,3.48,2019
"5122150",7402,859,854,9115,81.21,9.42,9.37,2019
"5122152",10012,146,246,10404,96.23,1.4,2.36,2019
"5122172",2792,67,409,3268,85.43,2.05,12.52,2019
"5122191",21411,441,986,22838,93.75,1.93,4.32,2019
"5122204",19425,513,2801,22739,85.43,2.26,12.32,2019
"1596819",9985,179,1799,11963,83.47,1.5,15.04,2019
"1596863",0,0,0,0,NA,NA,NA,2019
"0696121",149,0,0,149,100,0,0,2019
"1596766",4105,104,680,4889,83.96,2.13,13.91,2019
"0696112",58,2,25,85,68.24,2.35,29.41,2019
"1596719",325,0,154,479,67.85,0,32.15,2019
"1596791",1930,81,269,2280,84.65,3.55,11.8,2019
"1596744",14426,393,1395,16214,88.97,2.42,8.6,2019
"1596817",15245,309,3469,19023,80.14,1.62,18.24,2019
"0696049",13,0,14,27,48.15,0,51.85,2019
"0696111",51,0,0,51,100,0,0,2019
"0696129",138,0,0,138,100,0,0,2019
"0696135",75,0,50,125,60,0,40,2019
"0696155",0,0,0,0,NA,NA,NA,2019
"1596726",89,0,38,127,70.08,0,29.92,2019
"1596765",85,0,28,113,75.22,0,24.78,2019
"1596850",0,0,0,0,NA,NA,NA,2019
"1596853",0,0,0,0,NA,NA,NA,2019
"1596857",0,0,0,0,NA,NA,NA,2019
"1596859",0,0,0,0,NA,NA,NA,2019
"1596860",0,0,0,0,NA,NA,NA,2019
"0299695",0,0,0,0,NA,NA,NA,2019
"0299703",1961,0,100,2061,95.15,0,4.85,2019
"0299704",0,0,0,0,NA,NA,NA,2019
"0299723",984,44,328,1356,72.57,3.24,24.19,2019
"0299726",4,0,6,10,40,0,60,2019
"0299758",22,6,35,63,34.92,9.52,55.56,2019
"0299788",7,0,25,32,21.88,0,78.12,2019
"0299772",80,5,51,136,58.82,3.68,37.5,2019
"0299783",35,1,19,55,63.64,1.82,34.55,2019
"0299785",57,0,39,96,59.38,0,40.62,2019
"0299789",63,5,40,108,58.33,4.63,37.04,2019
"4197114",1343,29,234,1606,83.62,1.81,14.57,2019
"4197122",128,0,40,168,76.19,0,23.81,2019
"4197210",6225,115,370,6710,92.77,1.71,5.51,2019
"4197225",10342,257,789,11388,90.81,2.26,6.93,2019
"4197453",320,15,76,411,77.86,3.65,18.49,2019
"0299701",5477,211,965,6653,82.32,3.17,14.5,2019
"5399131",78,2,13,93,83.87,2.15,13.98,2019
"5399136",9,0,2,11,81.82,0,18.18,2019
"5399139",388,12,98,498,77.91,2.41,19.68,2019
"5399152",29,5,13,47,61.7,10.64,27.66,2019
"5399155",218,23,166,407,53.56,5.65,40.79,2019
"5399157",238,20,80,338,70.41,5.92,23.67,2019
"5399169",856,39,196,1091,78.46,3.57,17.97,2019
"5399170",316,5,85,406,77.83,1.23,20.94,2019
"5123920",834,29,408,1271,65.62,2.28,32.1,2019
"5123923",800,8,409,1217,65.74,0.66,33.61,2019
"5123950",877,13,504,1394,62.91,0.93,36.15,2019
"5123430",5666,150,1179,6995,81,2.14,16.85,2019
"5123436",310,10,53,373,83.11,2.68,14.21,2019
"5123451",18036,553,1628,20217,89.21,2.74,8.05,2019
"5123505",9760,470,1415,11645,83.81,4.04,12.15,2019
"5123523",2029,137,438,2604,77.92,5.26,16.82,2019
"5123702",3317,133,803,4253,77.99,3.13,18.88,2019
"5123803",10852,592,3679,15123,71.76,3.91,24.33,2019
"5123829",302,20,70,392,77.04,5.1,17.86,2019
"5123836",4488,142,333,4963,90.43,2.86,6.71,2019
"5123839",225,21,81,327,68.81,6.42,24.77,2019
"5123841",894,52,401,1347,66.37,3.86,29.77,2019
"5123860",8298,277,2217,10792,76.89,2.57,20.54,2019
"5123401",43,0,24,67,64.18,0,35.82,2019
"5123405",357,15,73,445,80.22,3.37,16.4,2019
"5123421",778,76,748,1602,48.56,4.74,46.69,2019
"5123426",27,0,19,46,58.7,0,41.3,2019
"5123487",1570,22,611,2203,71.27,1,27.73,2019
"5123502",6709,290,1126,8125,82.57,3.57,13.86,2019
"5123509",4286,84,807,5177,82.79,1.62,15.59,2019
"5123510",3485,194,395,4074,85.54,4.76,9.7,2019
"5123602",13288,1287,1734,16309,81.48,7.89,10.63,2019
"5123608",12408,1825,1712,15945,77.82,11.45,10.74,2019
"5123666",18104,1293,2522,21919,82.6,5.9,11.51,2019
"5123824",1676,114,671,2461,68.1,4.63,27.27,2019
"5123834",8265,332,1654,10251,80.63,3.24,16.14,2019
"5123843",141,0,65,206,68.45,0,31.55,2019
"5123866",642,14,167,823,78.01,1.7,20.29,2019
"5123872",648,14,422,1084,59.78,1.29,38.93,2019
"3727502",13760,151,606,14517,94.79,1.04,4.17,2019
"3727503",1147,16,242,1405,81.64,1.14,17.22,2019
"3727509",1283,21,296,1600,80.19,1.31,18.5,2019
"3727557",2038,8,661,2707,75.29,0.3,24.42,2019
"3727559",615,238,180,1033,59.54,23.04,17.42,2019
"3727571",2085,9,94,2188,95.29,0.41,4.3,2019
"3727701",7606,353,1739,9698,78.43,3.64,17.93,2019
"3727806",677,39,350,1066,63.51,3.66,32.83,2019
"3727810",1246,3,721,1970,63.25,0.15,36.6,2019
"3727813",207,16,47,270,76.67,5.93,17.41,2019
"3727248",1143,63,123,1329,86,4.74,9.26,2019
"3727282",5961,340,447,6748,88.34,5.04,6.62,2019
"3727305",561,9,99,669,83.86,1.35,14.8,2019
"3727315",568,23,250,841,67.54,2.73,29.73,2019
"3727325",1957,147,710,2814,69.55,5.22,25.23,2019
"3727344",4747,487,1574,6808,69.73,7.15,23.12,2019
"3727355",665,95,151,911,73,10.43,16.58,2019
"3727360",14534,542,3671,18747,77.53,2.89,19.58,2019
"3727377",2731,321,408,3460,78.93,9.28,11.79,2019
"3727401",4563,656,2177,7396,61.7,8.87,29.43,2019
"3727405",11755,1037,6143,18935,62.08,5.48,32.44,2019
"3727410",19821,2706,2033,24560,80.7,11.02,8.28,2019
"3727505",1786,189,636,2611,68.4,7.24,24.36,2019
"3727511",12632,284,738,13654,92.52,2.08,5.41,2019
"3727545",9081,308,951,10340,87.82,2.98,9.2,2019
"3727549",7723,233,2277,10233,75.47,2.28,22.25,2019
"3727555",113,24,120,257,43.97,9.34,46.69,2019
"3727568",129,27,104,260,49.62,10.38,40,2019
"5122041",9169,483,1277,10929,83.9,4.42,11.68,2019
"5122046",6373,97,337,6807,93.62,1.43,4.95,2019
"5122066",5700,48,38,5786,98.51,0.83,0.66,2019
"5122125",403,8,10,421,95.72,1.9,2.38,2019
"5122193",22271,369,849,23489,94.81,1.57,3.61,2019
"5122209",7455,207,309,7971,93.53,2.6,3.88,2019
"5122213",1335,9,45,1389,96.11,0.65,3.24,2019
"5122305",6276,305,612,7193,87.25,4.24,8.51,2019
"5122308",4434,61,117,4612,96.14,1.32,2.54,2019
"5122435",794,7,224,1025,77.46,0.68,21.85,2019
"5122438",100,0,71,171,58.48,0,41.52,2019
"5122511",341,22,124,487,70.02,4.52,25.46,2019
"5122027",597,0,0,597,100,0,0,2019
"5122151",5183,154,200,5537,93.61,2.78,3.61,2019
"5122401",9155,520,1087,10762,85.07,4.83,10.1,2019
"5122482",968,132,333,1433,67.55,9.21,23.24,2019
"5122504",107,0,19,126,84.92,0,15.08,2019
"5122538",47,0,15,62,75.81,0,24.19,2019
"5122539",843,0,197,1040,81.06,0,18.94,2019
"5122723",62,0,9,71,87.32,0,12.68,2019
"5122827",2778,269,1110,4157,66.83,6.47,26.7,2019
"5122843",601,33,337,971,61.89,3.4,34.71,2019
"5122938",366,94,95,555,65.95,16.94,17.12,2019
"5122026",4471,108,420,4999,89.44,2.16,8.4,2019
"5122030",18626,295,559,19480,95.62,1.51,2.87,2019
"5122101",9889,237,315,10441,94.71,2.27,3.02,2019
"5122102",10861,87,236,11184,97.11,0.78,2.11,2019
"5122181",5090,26,159,5275,96.49,0.49,3.01,2019
"5122182",8536,110,268,8914,95.76,1.23,3.01,2019
"5122201",19042,169,603,19814,96.1,0.85,3.04,2019
"5122306",10509,309,998,11816,88.94,2.62,8.45,2019
"5122311",6680,292,867,7839,85.21,3.72,11.06,2019
"5122312",10620,131,651,11402,93.14,1.15,5.71,2019
"5122405",9784,124,626,10534,92.88,1.18,5.94,2019
"5122971",438,68,204,710,61.69,9.58,28.73,2019
"5122942",3195,111,606,3912,81.67,2.84,15.49,2019
"5122946",36,0,8,44,81.82,0,18.18,2019
"5122949",206,0,341,547,37.66,0,62.34,2019
"5122989",0,17,0,17,0,100,0,2019
"5122043",8349,118,427,8894,93.87,1.33,4.8,2019
"5122180",7827,127,303,8257,94.79,1.54,3.67,2019
"5122202",13222,270,582,14074,93.95,1.92,4.14,2019
"5122940",367,17,131,515,71.26,3.3,25.44,2019
"5122952",562,0,138,700,80.29,0,19.71,2019
"5122974",1220,49,200,1469,83.05,3.34,13.61,2019
"5122937",554,34,198,786,70.48,4.33,25.19,2019
"5122920",1224,76,374,1674,73.12,4.54,22.34,2019
"5122740",295,0,132,427,69.09,0,30.91,2019
"5122801",11189,1395,1154,13738,81.45,10.15,8.4,2019
"5122834",311,16,40,367,84.74,4.36,10.9,2019
"5122841",828,58,193,1079,76.74,5.38,17.89,2019
"5122922",636,0,158,794,80.1,0,19.9,2019
"5122406",8562,160,474,9196,93.11,1.74,5.15,2019
"5122302",7624,90,299,8013,95.15,1.12,3.73,2019
"5425437",49,0,51,100,49,0,51,2019
"5425512",166,53,160,379,43.8,13.98,42.22,2019
"5425521",289,0,74,363,79.61,0,20.39,2019
"5425526",6557,330,1507,8394,78.12,3.93,17.95,2019
"5425545",1256,174,213,1643,76.45,10.59,12.96,2019
"5399185",477,6,55,538,88.66,1.12,10.22,2019
"5399212",7401,194,1134,8729,84.79,2.22,12.99,2019
"5399329",52,0,7,59,88.14,0,11.86,2019
"5399346",88,48,83,219,40.18,21.92,37.9,2019
"0299503",4572,260,991,5823,78.52,4.47,17.02,2019
"0299506",2145,7,29,2181,98.35,0.32,1.33,2019
"0299552",44,13,21,78,56.41,16.67,26.92,2019
"0299554",83,8,69,160,51.88,5,43.12,2019
"0299555",53,0,7,60,88.33,0,11.67,2019
"0299557",143,6,55,204,70.1,2.94,26.96,2019
"0299585",43,0,18,61,70.49,0,29.51,2019
"0299588",197,0,65,262,75.19,0,24.81,2019
"0299614",90,2,37,129,69.77,1.55,28.68,2019
"0299620",60,9,108,177,33.9,5.08,61.02,2019
"0299622",61,0,21,82,74.39,0,25.61,2019
"0299627",93,1,40,134,69.4,0.75,29.85,2019
"0299638",4,0,5,9,44.44,0,55.56,2019
"0299644",43,7,22,72,59.72,9.72,30.56,2019
"0299645",7674,220,723,8617,89.06,2.55,8.39,2019
"0299657",31,0,14,45,68.89,0,31.11,2019
"0299662",97,0,24,121,80.17,0,19.83,2019
"0299665",8,2,14,24,33.33,8.33,58.33,2019
"0299667",33,0,19,52,63.46,0,36.54,2019
"0299668",10,0,22,32,31.25,0,68.75,2019
"0299670",14,1,5,20,70,5,25,2019
"0299678",166,9,61,236,70.34,3.81,25.85,2019
"5399020",0,0,0,0,NA,NA,NA,2019
"5399029",383,0,86,469,81.66,0,18.34,2019
"5399030",337,11,91,439,76.77,2.51,20.73,2019
"5399117",170,7,34,211,80.57,3.32,16.11,2019
"5399125",210,8,23,241,87.14,3.32,9.54,2019
"0299753",55,3,31,89,61.8,3.37,34.83,2019
"0299714",374,0,75,449,83.3,0,16.7,2019
"0299738",32,0,34,66,48.48,0,51.52,2019
"0299749",56,2,19,77,72.73,2.6,24.68,2019
"0299755",72,14,0,86,83.72,16.28,0,2019
"0299760",121,8,78,207,58.45,3.86,37.68,2019
"0299762",1218,50,185,1453,83.83,3.44,12.73,2019
"0299769",126,0,73,199,63.32,0,36.68,2019
"0299778",35,2,23,60,58.33,3.33,38.33,2019
"0299782",98,5,32,135,72.59,3.7,23.7,2019
"0299801",10605,270,787,11662,90.94,2.32,6.75,2019
"0299832",30,0,22,52,57.69,0,42.31,2019
"5399203",8288,153,610,9051,91.57,1.69,6.74,2019
"0299569",10,2,5,17,58.82,11.76,29.41,2019
"2304343",0,0,0,0,NA,NA,NA,2019
"2304359",141,0,38,179,78.77,0,21.23,2019
"2304415",92,8,24,124,74.19,6.45,19.35,2019
"2304454",5,0,7,12,41.67,0,58.33,2019
"2304469",0,0,0,0,NA,NA,NA,2019
"2304481",140,18,46,204,68.63,8.82,22.55,2019
"2304485",37,10,34,81,45.68,12.35,41.98,2019
"2304489",35,26,33,94,37.23,27.66,35.11,2019
"2304491",59,0,13,72,81.94,0,18.06,2019
"2304492",34,4,12,50,68,8,24,2019
"2304570",0,0,0,0,NA,NA,NA,2019
"2304571",167,0,0,167,100,0,0,2019
"2304575",39,0,0,39,100,0,0,2019
"2304637",63,1,26,90,70,1.11,28.89,2019
"3727573",3456,96,1094,4646,74.39,2.07,23.55,2019
"3727576",4374,169,1914,6457,67.74,2.62,29.64,2019
"3727582",96,0,75,171,56.14,0,43.86,2019
"3727603",18036,903,1518,20457,88.17,4.41,7.42,2019
"3727604",16655,633,1534,18822,88.49,3.36,8.15,2019
"3727605",3245,9,285,3539,91.69,0.25,8.05,2019
"3727938",424,11,142,577,73.48,1.91,24.61,2019
"3727943",207,0,0,207,100,0,0,2019
"3727948",4508,24,413,4945,91.16,0.49,8.35,2019
"3727019",1100,46,448,1594,69.01,2.89,28.11,2019
"3727055",3958,86,1372,5416,73.08,1.59,25.33,2019
"3727107",13465,353,3585,17403,77.37,2.03,20.6,2019
"3727207",1010,35,297,1342,75.26,2.61,22.13,2019
"3727979",383,40,194,617,62.07,6.48,31.44,2019
"3727013",1781,101,372,2254,79.02,4.48,16.5,2019
"3727021",5660,282,1454,7396,76.53,3.81,19.66,2019
"3727025",3362,209,948,4519,74.4,4.62,20.98,2019
"3727239",2856,72,966,3894,73.34,1.85,24.81,2019
"3727243",1418,19,316,1753,80.89,1.08,18.03,2019
"3727253",10063,283,2260,12606,79.83,2.24,17.93,2019
"3727262",6832,357,1460,8649,78.99,4.13,16.88,2019
"3727284",19115,473,2525,22113,86.44,2.14,11.42,2019
"3727292",12385,305,3076,15766,78.56,1.93,19.51,2019
"3727316",1940,167,761,2868,67.64,5.82,26.53,2019
"3727317",5098,187,1303,6588,77.38,2.84,19.78,2019
"3727341",1387,73,510,1970,70.41,3.71,25.89,2019
"3727349",1850,44,426,2320,79.74,1.9,18.36,2019
"3727371",1948,101,1118,3167,61.51,3.19,35.3,2019
"3727516",14089,825,883,15797,89.19,5.22,5.59,2019
"3727524",3433,178,1117,4728,72.61,3.76,23.63,2019
"3727529",16516,681,1302,18499,89.28,3.68,7.04,2019
"4218013",5661,247,884,6792,83.35,3.64,13.02,2019
"4218030",224,0,69,293,76.45,0,23.55,2019
"4218035",15,0,0,15,100,0,0,2019
"4218041",1674,30,196,1900,88.11,1.58,10.32,2019
"4218052",9258,305,1577,11140,83.11,2.74,14.16,2019
"4218053",694,30,122,846,82.03,3.55,14.42,2019
"4218055",3964,97,647,4708,84.2,2.06,13.74,2019
"4218064",8231,246,1100,9577,85.95,2.57,11.49,2019
"4218079",186,0,40,226,82.3,0,17.7,2019
"4218104",14169,310,1956,16435,86.21,1.89,11.9,2019
"4218419",1426,30,308,1764,80.84,1.7,17.46,2019
"4218426",1494,85,298,1877,79.6,4.53,15.88,2019
"4218460",65,0,22,87,74.71,0,25.29,2019
"4218510",3693,154,851,4698,78.61,3.28,18.11,2019
"4218518",2970,44,603,3617,82.11,1.22,16.67,2019
"4218619",77,12,28,117,65.81,10.26,23.93,2019
"4218631",435,11,98,544,79.96,2.02,18.01,2019
"4218706",5363,158,1451,6972,76.92,2.27,20.81,2019
"4218709",1034,126,383,1543,67.01,8.17,24.82,2019
"4218831",390,8,102,500,78,1.6,20.4,2019
"4218962",132,1,10,143,92.31,0.7,6.99,2019
"4218017",13369,575,1900,15844,84.38,3.63,11.99,2019
"4218067",5826,361,1195,7382,78.92,4.89,16.19,2019
"4218080",3546,144,805,4495,78.89,3.2,17.91,2019
"4218435",345,0,7,352,98.01,0,1.99,2019
"4218443",159,0,19,178,89.33,0,10.67,2019
"4218455",34,0,7,41,82.93,0,17.07,2019
"4218464",518,4,67,589,87.95,0.68,11.38,2019
"5123181",1520,49,400,1969,77.2,2.49,20.31,2019
"5123919",673,85,274,1032,65.21,8.24,26.55,2019
"5123922",698,3,269,970,71.96,0.31,27.73,2019
"5123952",82,0,27,109,75.23,0,24.77,2019
"5123966",481,83,221,785,61.27,10.57,28.15,2019
"5123968",136,13,91,240,56.67,5.42,37.92,2019
"5123021",66,0,65,131,50.38,0,49.62,2019
"5123043",551,15,314,880,62.61,1.7,35.68,2019
"5123047",510,28,199,737,69.2,3.8,27,2019
"5123072",4201,114,501,4816,87.23,2.37,10.4,2019
"5123083",636,57,130,823,77.28,6.93,15.8,2019
"5123086",815,59,382,1256,64.89,4.7,30.41,2019
"5123089",1764,51,353,2168,81.37,2.35,16.28,2019
"5123124",1319,52,344,1715,76.91,3.03,20.06,2019
"5123125",134,0,0,134,100,0,0,2019
"5123138",234,9,110,353,66.29,2.55,31.16,2019
"5123148",352,78,301,731,48.15,10.67,41.18,2019
"5123175",478,68,308,854,55.97,7.96,36.07,2019
"5123395",100,43,39,182,54.95,23.63,21.43,2019
"5123407",186,0,49,235,79.15,0,20.85,2019
"5123050",229,0,71,300,76.33,0,23.67,2019
"5123023",187,10,42,239,78.24,4.18,17.57,2019
"5123035",462,25,77,564,81.91,4.43,13.65,2019
"5123045",0,0,70,70,0,0,100,2019
"5123055",235,0,45,280,83.93,0,16.07,2019
"5123059",12258,228,567,13053,93.91,1.75,4.34,2019
"5123060",12861,180,679,13720,93.74,1.31,4.95,2019
"5123076",176,38,143,357,49.3,10.64,40.06,2019
"5123093",4057,147,1052,5256,77.19,2.8,20.02,2019
"5123126",139,0,31,170,81.76,0,18.24,2019
"5123128",221,0,129,350,63.14,0,36.86,2019
"5123130",66,0,52,118,55.93,0,44.07,2019
"5123140",1733,134,380,2247,77.13,5.96,16.91,2019
"5123168",2226,77,320,2623,84.86,2.94,12.2,2019
"5123180",168,4,56,228,73.68,1.75,24.56,2019
"5123221",6607,59,537,7203,91.73,0.82,7.46,2019
"5123056",159,0,33,192,82.81,0,17.19,2019
"5123062",1015,21,62,1098,92.44,1.91,5.65,2019
"5123064",69,0,56,125,55.2,0,44.8,2019
"5123085",165,0,18,183,90.16,0,9.84,2019
"5123111",12368,364,1633,14365,86.1,2.53,11.37,2019
"5123117",2866,150,645,3661,78.28,4.1,17.62,2019
"5123119",151,0,0,151,100,0,0,2019
"5123120",3107,36,221,3364,92.36,1.07,6.57,2019
"5123139",8385,213,835,9433,88.89,2.26,8.85,2019
"5123149",894,9,272,1175,76.09,0.77,23.15,2019
"5123163",19,0,0,19,100,0,0,2019
"5123226",6486,55,534,7075,91.67,0.78,7.55,2019
"5123236",8772,90,635,9497,92.37,0.95,6.69,2019
"5123219",1921,468,491,2880,66.7,16.25,17.05,2019
"5123223",14194,1384,5807,21385,66.37,6.47,27.15,2019
"5123225",15122,411,2667,18200,83.09,2.26,14.65,2019
"5123314",2948,151,430,3529,83.54,4.28,12.18,2019
"5123315",433,0,104,537,80.63,0,19.37,2019
"3727565",7001,244,2455,9700,72.18,2.52,25.31,2019
"3727569",2190,93,796,3079,71.13,3.02,25.85,2019
"3727583",2471,19,305,2795,88.41,0.68,10.91,2019
"3727592",4762,77,803,5642,84.4,1.36,14.23,2019
"3727606",16662,698,1087,18447,90.32,3.78,5.89,2019
"5425637",329,14,77,420,78.33,3.33,18.33,2019
"5425638",338,0,34,372,90.86,0,9.14,2019
"5425647",303,0,0,303,100,0,0,2019
"5425651",198,27,125,350,56.57,7.71,35.71,2019
"5425678",422,62,259,743,56.8,8.34,34.86,2019
"5425119",62,0,0,62,100,0,0,2019
"5425121",187,0,86,273,68.5,0,31.5,2019
"5425132",29,0,0,29,100,0,0,2019
"5425133",299,0,95,394,75.89,0,24.11,2019
"5425243",146,12,65,223,65.47,5.38,29.15,2019
"5425252",382,0,152,534,71.54,0,28.46,2019
"5425259",97,0,118,215,45.12,0,54.88,2019
"5425265",476,18,227,721,66.02,2.5,31.48,2019
"5425285",109,14,30,153,71.24,9.15,19.61,2019
"5425287",120,32,90,242,49.59,13.22,37.19,2019
"5425059",154,0,36,190,81.05,0,18.95,2019
"5425060",127,0,40,167,76.05,0,23.95,2019
"5425123",1002,29,357,1388,72.19,2.09,25.72,2019
"5425932",99,0,43,142,69.72,0,30.28,2019
"5425848",101,0,18,119,84.87,0,15.13,2019
"5425653",127,0,0,127,100,0,0,2019
"5425654",59,0,0,59,100,0,0,2019
"5425669",220,71,186,477,46.12,14.88,38.99,2019
"5425688",81,0,42,123,65.85,0,34.15,2019
"5425701",6611,580,2216,9407,70.28,6.17,23.56,2019
"5425813",2089,58,566,2713,77,2.14,20.86,2019
"5425837",106,0,28,134,79.1,0,20.9,2019
"5425033",502,18,235,755,66.49,2.38,31.13,2019
"5425039",269,7,84,360,74.72,1.94,23.33,2019
"5425051",85,0,10,95,89.47,0,10.53,2019
"5425002",0,0,0,0,NA,NA,NA,2019
"5425022",136,0,22,158,86.08,0,13.92,2019
"5425030",96,9,31,136,70.59,6.62,22.79,2019
"5425057",113,0,0,113,100,0,0,2019
"5425067",407,8,26,441,92.29,1.81,5.9,2019
"5425108",118,14,15,147,80.27,9.52,10.2,2019
"5425109",171,0,75,246,69.51,0,30.49,2019
"5425110",108,0,73,181,59.67,0,40.33,2019
"5425143",2694,100,614,3408,79.05,2.93,18.02,2019
"5425183",0,0,17,17,0,0,100,2019
"5425206",101,25,28,154,65.58,16.23,18.18,2019
"5425261",34,0,34,68,50,0,50,2019
"5425262",353,0,71,424,83.25,0,16.75,2019
"5425266",184,16,32,232,79.31,6.9,13.79,2019
"5425270",215,0,91,306,70.26,0,29.74,2019
"5425271",3219,76,756,4051,79.46,1.88,18.66,2019
"5425302",5005,420,1125,6550,76.41,6.41,17.18,2019
"5425312",4488,399,1410,6297,71.27,6.34,22.39,2019
"5425315",1094,29,333,1456,75.14,1.99,22.87,2019
"5425320",1601,103,787,2491,64.27,4.13,31.59,2019
"5425411",3960,172,1126,5258,75.31,3.27,21.41,2019
"5425413",2762,194,418,3374,81.86,5.75,12.39,2019
"5425428",3932,235,688,4855,80.99,4.84,14.17,2019
"5425438",1953,171,304,2428,80.44,7.04,12.52,2019
"3728209",9678,164,1005,10847,89.22,1.51,9.27,2019
"3728689",659,20,153,832,79.21,2.4,18.39,2019
"3728736",206,19,134,359,57.38,5.29,37.33,2019
"3728107",2429,96,161,2686,90.43,3.57,5.99,2019
"3728163",1636,50,201,1887,86.7,2.65,10.65,2019
"2304644",0,0,0,0,NA,NA,NA,2019
"2304686",43,0,19,62,69.35,0,30.65,2019
"2304734",174,46,96,316,55.06,14.56,30.38,2019
"2304741",4,0,0,4,100,0,0,2019
"2304761",169,10,35,214,78.97,4.67,16.36,2019
"2304855",106,0,23,129,82.17,0,17.83,2019
"2304918",122,0,30,152,80.26,0,19.74,2019
"2304926",43,0,0,43,100,0,0,2019
"2304933",29,0,0,29,100,0,0,2019
"2304940",0,0,0,0,NA,NA,NA,2019
"2304944",20,0,0,20,100,0,0,2019
"2304975",14,0,0,14,100,0,0,2019
"2304992",0,29,0,29,0,100,0,2019
"2304257",764,24,263,1051,72.69,2.28,25.02,2019
"2304985",20,3,8,31,64.52,9.68,25.81,2019
"2304964",33,0,23,56,58.93,0,41.07,2019
"2304010",461,30,105,596,77.35,5.03,17.62,2019
"2304011",7257,247,951,8455,85.83,2.92,11.25,2019
"2304043",4401,81,501,4983,88.32,1.63,10.05,2019
"2304073",5481,239,1153,6873,79.75,3.48,16.78,2019
"2304083",1553,175,299,2027,76.62,8.63,14.75,2019
"2304086",3297,209,364,3870,85.19,5.4,9.41,2019
"2304092",6912,221,940,8073,85.62,2.74,11.64,2019
"2304226",51,0,14,65,78.46,0,21.54,2019
"2304258",824,40,68,932,88.41,4.29,7.3,2019
"2304268",1370,52,312,1734,79.01,3,17.99,2019
"2304275",142,8,37,187,75.94,4.28,19.79,2019
"2304287",1121,27,266,1414,79.28,1.91,18.81,2019
"2304349",422,18,40,480,87.92,3.75,8.33,2019
"2304353",728,39,192,959,75.91,4.07,20.02,2019
"2304843",2140,65,226,2431,88.03,2.67,9.3,2019
"2304860",607,12,115,734,82.7,1.63,15.67,2019
"2304864",1306,102,83,1491,87.59,6.84,5.57,2019
"2304901",8851,459,1942,11252,78.66,4.08,17.26,2019
"2304928",692,63,123,878,78.82,7.18,14.01,2019
"2304938",2842,79,662,3583,79.32,2.2,18.48,2019
"2304953",1160,17,218,1395,83.15,1.22,15.63,2019
"2304955",517,32,72,621,83.25,5.15,11.59,2019
"2304982",174,10,68,252,69.05,3.97,26.98,2019
"2304988",667,7,187,861,77.47,0.81,21.72,2019
"2304989",1493,55,263,1811,82.44,3.04,14.52,2019
"2304355",925,5,80,1010,91.58,0.5,7.92,2019
"2304424",253,15,86,354,71.47,4.24,24.29,2019
"2304431",23,0,0,23,100,0,0,2019
"2304448",434,21,114,569,76.27,3.69,20.04,2019
"0572479",477,14,113,604,78.97,2.32,18.71,2019
"0572520",52,0,53,105,49.52,0,50.48,2019
"0572523",250,0,150,400,62.5,0,37.5,2019
"0572524",38,0,80,118,32.2,0,67.8,2019
"0572526",50,8,31,89,56.18,8.99,34.83,2019
"0572532",217,101,230,548,39.6,18.43,41.97,2019
"0572550",116,46,140,302,38.41,15.23,46.36,2019
"0572562",506,134,316,956,52.93,14.02,33.05,2019
"0572585",112,14,35,161,69.57,8.7,21.74,2019
"0572611",500,17,109,626,79.87,2.72,17.41,2019
"0572640",54,0,84,138,39.13,0,60.87,2019
"0572651",384,30,63,477,80.5,6.29,13.21,2019
"0572655",67,5,52,124,54.03,4.03,41.94,2019
"0572686",45,0,0,45,100,0,0,2019
"4218473",229,0,13,242,94.63,0,5.37,2019
"4218616",217,2,30,249,87.15,0.8,12.05,2019
"4218625",166,0,11,177,93.79,0,6.21,2019
"4218626",158,9,17,184,85.87,4.89,9.24,2019
"4218636",378,12,99,489,77.3,2.45,20.25,2019
"4218644",2543,69,647,3259,78.03,2.12,19.85,2019
"4218651",2780,66,826,3672,75.71,1.8,22.49,2019
"4218456",123,0,45,168,73.21,0,26.79,2019
"4218461",115,0,34,149,77.18,0,22.82,2019
"4218462",112,0,18,130,86.15,0,13.85,2019
"4218469",97,0,0,97,100,0,0,2019
"4218471",222,8,11,241,92.12,3.32,4.56,2019
"4218623",868,5,186,1059,81.96,0.47,17.56,2019
"4218624",81,0,68,149,54.36,0,45.64,2019
"4218634",4054,193,1379,5626,72.06,3.43,24.51,2019
"4218653",58,0,6,64,90.62,0,9.38,2019
"4218708",2861,14,451,3326,86.02,0.42,13.56,2019
"4218825",35,0,3,38,92.11,0,7.89,2019
"4218826",480,3,115,598,80.27,0.5,19.23,2019
"4218031",3731,23,293,4047,92.19,0.57,7.24,2019
"4218036",4740,117,443,5300,89.43,2.21,8.36,2019
"4218040",5582,103,486,6171,90.46,1.67,7.88,2019
"4218059",303,20,49,372,81.45,5.38,13.17,2019
"4218071",3261,74,661,3996,81.61,1.85,16.54,2019
"4218085",384,2,63,449,85.52,0.45,14.03,2019
"4218210",2424,15,367,2806,86.39,0.53,13.08,2019
"4218216",384,15,160,559,68.69,2.68,28.62,2019
"4218248",169,0,45,214,78.97,0,21.03,2019
"4218323",53,0,0,53,100,0,0,2019
"4218328",2284,135,301,2720,83.97,4.96,11.07,2019
"4218070",229,25,101,355,64.51,7.04,28.45,2019
"2421738",1140,13,51,1204,94.68,1.08,4.24,2019
"2421629",3001,65,351,3417,87.83,1.9,10.27,2019
"2421636",281,0,140,421,66.75,0,33.25,2019
"2421640",437,2,139,578,75.61,0.35,24.05,2019
"2421641",28,0,5,33,84.85,0,15.15,2019
"2421643",1871,68,400,2339,79.99,2.91,17.1,2019
"2421647",92,0,36,128,71.88,0,28.12,2019
"2421649",407,28,107,542,75.09,5.17,19.74,2019
"2421655",1595,52,218,1865,85.52,2.79,11.69,2019
"2421657",258,0,62,320,80.62,0,19.38,2019
"2421658",1313,50,146,1509,87.01,3.31,9.68,2019
"2421663",1494,21,166,1681,88.88,1.25,9.88,2019
"2421667",98,0,10,108,90.74,0,9.26,2019
"2421668",551,15,139,705,78.16,2.13,19.72,2019
"2421713",2983,188,801,3972,75.1,4.73,20.17,2019
"2421718",56,3,10,69,81.16,4.35,14.49,2019
"2421750",1064,53,389,1506,70.65,3.52,25.83,2019
"2421756",1043,16,115,1174,88.84,1.36,9.8,2019
"2421758",1449,74,451,1974,73.4,3.75,22.85,2019
"2421766",193,0,74,267,72.28,0,27.72,2019
"2421822",546,22,166,734,74.39,3,22.62,2019
"2421830",1114,9,266,1389,80.2,0.65,19.15,2019
"2421861",230,2,21,253,90.91,0.79,8.3,2019
"2421866",15,0,4,19,78.95,0,21.05,2019
"2421902",21,0,0,21,100,0,0,2019
"2421540",33,1,4,38,86.84,2.63,10.53,2019
"2421557",561,0,93,654,85.78,0,14.22,2019
"2421617",3105,114,340,3559,87.24,3.2,9.55,2019
"3727817",2388,97,544,3029,78.84,3.2,17.96,2019
"3727819",47,3,56,106,44.34,2.83,52.83,2019
"3727820",527,87,358,972,54.22,8.95,36.83,2019
"3727826",77,0,113,190,40.53,0,59.47,2019
"3727827",6,0,18,24,25,0,75,2019
"3727849",415,55,253,723,57.4,7.61,34.99,2019
"3727043",1807,350,599,2756,65.57,12.7,21.73,2019
"3727047",314,90,120,524,59.92,17.18,22.9,2019
"3727203",6545,331,1986,8862,73.85,3.74,22.41,2019
"3727212",430,0,179,609,70.61,0,29.39,2019
"3727229",848,19,244,1111,76.33,1.71,21.96,2019
"3727231",667,5,130,802,83.17,0.62,16.21,2019
"3727258",2130,55,582,2767,76.98,1.99,21.03,2019
"3727298",3015,251,989,4255,70.86,5.9,23.24,2019
"3727051",2280,157,627,3064,74.41,5.12,20.46,2019
"3727233",1145,115,319,1579,72.51,7.28,20.2,2019
"3727046",612,32,239,883,69.31,3.62,27.07,2019
"3727252",494,7,178,679,72.75,1.03,26.22,2019
"3727407",15058,2430,2776,20264,74.31,11.99,13.7,2019
"3727553",468,21,471,960,48.75,2.19,49.06,2019
"3727812",640,24,408,1072,59.7,2.24,38.06,2019
"3727837",2034,43,399,2476,82.15,1.74,16.11,2019
"3727843",153,83,172,408,37.5,20.34,42.16,2019
"3727888",590,46,236,872,67.66,5.28,27.06,2019
"3727856",5090,118,1141,6349,80.17,1.86,17.97,2019
"3727942",194,27,65,286,67.83,9.44,22.73,2019
"3727809",1347,3,624,1974,68.24,0.15,31.61,2019
"3727609",14032,406,1300,15738,89.16,2.58,8.26,2019
"3727614",12052,53,379,12484,96.54,0.42,3.04,2019
"3727616",18152,420,842,19414,93.5,2.16,4.34,2019
"3727816",624,16,188,828,75.36,1.93,22.71,2019
"3727839",504,177,516,1197,42.11,14.79,43.11,2019
"3727842",519,23,177,719,72.18,3.2,24.62,2019
"3727844",606,52,501,1159,52.29,4.49,43.23,2019
"3727853",78,0,112,190,41.05,0,58.95,2019
"3727869",383,27,446,856,44.74,3.15,52.1,2019
"3727615",17232,335,1018,18585,92.72,1.8,5.48,2019
"3727807",1866,19,622,2507,74.43,0.76,24.81,2019
"3727007",697,55,144,896,77.79,6.14,16.07,2019
"3727022",292,0,177,469,62.26,0,37.74,2019
"3727023",4744,81,334,5159,91.96,1.57,6.47,2019
"3727024",744,106,286,1136,65.49,9.33,25.18,2019
"3727042",126,51,113,290,43.45,17.59,38.97,2019
"3727103",12654,382,2569,15605,81.09,2.45,16.46,2019
"3727209",1123,72,235,1430,78.53,5.03,16.43,2019
"3727265",17838,876,1481,20195,88.33,4.34,7.33,2019
"3727306",1835,25,786,2646,69.35,0.94,29.71,2019
"3727311",897,49,533,1479,60.65,3.31,36.04,2019
"3727330",10274,1676,2604,14554,70.59,11.52,17.89,2019
"3727406",16960,1545,5730,24235,69.98,6.38,23.64,2019
"3727409",5927,1273,813,8013,73.97,15.89,10.15,2019
"3727501",5960,187,1159,7306,81.58,2.56,15.86,2019
"3727927",426,13,28,467,91.22,2.78,6,2019
"3727929",646,48,64,758,85.22,6.33,8.44,2019
"4218337",4872,48,541,5461,89.21,0.88,9.91,2019
"4218340",49,0,0,49,100,0,0,2019
"4218349",159,0,0,159,100,0,0,2019
"4218411",7660,116,1002,8778,87.26,1.32,11.41,2019
"4218414",1852,16,252,2120,87.36,0.75,11.89,2019
"3728342",61,0,4,65,93.85,0,6.15,2019
"3728629",0,0,0,0,NA,NA,NA,2019
"3728673",2217,50,319,2586,85.73,1.93,12.34,2019
"3728721",3017,152,1251,4420,68.26,3.44,28.3,2019
"3728039",4,14,14,32,12.5,43.75,43.75,2019
"3728108",47,0,0,47,100,0,0,2019
"3728244",0,0,0,0,NA,NA,NA,2019
"3728280",0,0,0,0,NA,NA,NA,2019
"3728282",0,0,0,0,NA,NA,NA,2019
"3728308",26,0,0,26,100,0,0,2019
"3728310",0,0,0,0,NA,NA,NA,2019
"3728312",5624,228,1572,7424,75.75,3.07,21.17,2019
"3728375",23,2,65,90,25.56,2.22,72.22,2019
"3728424",18,0,10,28,64.29,0,35.71,2019
"3728533",18,0,0,18,100,0,0,2019
"3728583",102,0,49,151,67.55,0,32.45,2019
"3728587",83,7,28,118,70.34,5.93,23.73,2019
"3728628",119,0,39,158,75.32,0,24.68,2019
"3728647",9,0,0,9,100,0,0,2019
"3728652",0,0,0,0,NA,NA,NA,2019
"3728667",102,0,65,167,61.08,0,38.92,2019
"3728672",0,0,15,15,0,0,100,2019
"3728720",75,0,6,81,92.59,0,7.41,2019
"3728759",2710,103,363,3176,85.33,3.24,11.43,2019
"3728775",47,0,63,110,42.73,0,57.27,2019
"3728785",2477,147,600,3224,76.83,4.56,18.61,2019
"3728553",150,22,15,187,80.21,11.76,8.02,2019
"3728663",205,0,49,254,80.71,0,19.29,2019
"3728379",7670,190,2485,10345,74.14,1.84,24.02,2019
"3728456",1027,88,432,1547,66.39,5.69,27.93,2019
"3728383",1647,49,1363,3059,53.84,1.6,44.56,2019
"3728386",1195,59,754,2008,59.51,2.94,37.55,2019
"3728398",1756,161,1040,2957,59.38,5.44,35.17,2019
"3728425",2775,65,1139,3979,69.74,1.63,28.63,2019
"3728429",2416,23,419,2858,84.53,0.8,14.66,2019
"3728544",1774,154,306,2234,79.41,6.89,13.7,2019
"3728470",4095,205,879,5179,79.07,3.96,16.97,2019
"3728524",113,0,11,124,91.13,0,8.87,2019
"3728530",1952,192,712,2856,68.35,6.72,24.93,2019
"3728556",343,0,102,445,77.08,0,22.92,2019
"3728573",515,30,267,812,63.42,3.69,32.88,2019
"3728621",2927,341,875,4143,70.65,8.23,21.12,2019
"3728631",276,0,83,359,76.88,0,23.12,2019
"3728644",373,0,176,549,67.94,0,32.06,2019
"3728675",2226,66,670,2962,75.15,2.23,22.62,2019
"3728684",670,33,213,916,73.14,3.6,23.25,2019
"3728405",12378,452,1211,14041,88.16,3.22,8.62,2019
"3728442",479,16,143,638,75.08,2.51,22.41,2019
"3728444",815,15,175,1005,81.09,1.49,17.41,2019
"3728466",2700,131,1041,3872,69.73,3.38,26.89,2019
"3728718",149,0,18,167,89.22,0,10.78,2019
"3728722",2050,168,663,2881,71.16,5.83,23.01,2019
"3728073",1493,111,674,2278,65.54,4.87,29.59,2019
"3728098",1167,38,116,1321,88.34,2.88,8.78,2019
"1019902",0,0,0,0,NA,NA,NA,2019
"1019904",11814,150,1682,13646,86.57,1.1,12.33,2019
"1019933",2751,111,868,3730,73.75,2.98,23.27,2019
"4219508",5289,9,881,6179,85.6,0.15,14.26,2019
"4219560",2744,57,459,3260,84.17,1.75,14.08,2019
"0572712",15055,3492,2148,20695,72.75,16.87,10.38,2019
"0572717",203,33,47,283,71.73,11.66,16.61,2019
"0572730",2748,178,318,3244,84.71,5.49,9.8,2019
"0572047",235,0,56,291,80.76,0,19.24,2019
"0572021",1007,39,603,1649,61.07,2.37,36.57,2019
"0572025",171,0,108,279,61.29,0,38.71,2019
"0572036",121,14,186,321,37.69,4.36,57.94,2019
"0572044",291,25,25,341,85.34,7.33,7.33,2019
"0572512",692,105,259,1056,65.53,9.94,24.53,2019
"0572539",47,0,16,63,74.6,0,25.4,2019
"0572543",4025,238,989,5252,76.64,4.53,18.83,2019
"0572544",230,40,46,316,72.78,12.66,14.56,2019
"0572567",50,0,41,91,54.95,0,45.05,2019
"0572568",344,41,79,464,74.14,8.84,17.03,2019
"0572619",832,0,119,951,87.49,0,12.51,2019
"0572645",611,58,240,909,67.22,6.38,26.4,2019
"0572648",99,28,17,144,68.75,19.44,11.81,2019
"0572666",39,0,25,64,60.94,0,39.06,2019
"0572682",98,0,21,119,82.35,0,17.65,2019
"0572685",326,0,157,483,67.49,0,32.51,2019
"0572719",3343,741,435,4519,73.98,16.4,9.63,2019
"0572732",1196,276,518,1990,60.1,13.87,26.03,2019
"0572739",210,26,71,307,68.4,8.47,23.13,2019
"0572742",196,8,53,257,76.26,3.11,20.62,2019
"0572751",1920,224,502,2646,72.56,8.47,18.97,2019
"0572764",12692,1728,4252,18672,67.97,9.25,22.77,2019
"0572833",1023,21,335,1379,74.18,1.52,24.29,2019
"0572840",453,50,348,851,53.23,5.88,40.89,2019
"0572842",322,14,114,450,71.56,3.11,25.33,2019
"0572048",22,0,12,34,64.71,0,35.29,2019
"0572061",59,1,5,65,90.77,1.54,7.69,2019
"0572068",133,2,11,146,91.1,1.37,7.53,2019
"0572076",10980,372,3141,14493,75.76,2.57,21.67,2019
"0572082",599,39,167,805,74.41,4.84,20.75,2019
"0572104",5547,388,2691,8626,64.31,4.5,31.2,2019
"0572106",1358,48,516,1922,70.66,2.5,26.85,2019
"0572112",2335,195,1082,3612,64.65,5.4,29.96,2019
"0572011",1100,76,250,1426,77.14,5.33,17.53,2019
"0572023",11410,330,1862,13602,83.88,2.43,13.69,2019
"0572030",141,0,160,301,46.84,0,53.16,2019
"0572031",1851,171,894,2916,63.48,5.86,30.66,2019
"0572040",758,86,381,1225,61.88,7.02,31.1,2019
"0572103",3518,80,945,4543,77.44,1.76,20.8,2019
"0572107",25,2,18,45,55.56,4.44,40,2019
"0572001",183,0,146,329,55.62,0,44.38,2019
"5399009",1237,96,286,1619,76.41,5.93,17.67,2019
"5399011",782,17,5,804,97.26,2.11,0.62,2019
"5399013",437,11,238,686,63.7,1.6,34.69,2019
"5399018",74,0,24,98,75.51,0,24.49,2019
"5399019",4453,150,316,4919,90.53,3.05,6.42,2019
"5399033",267,20,27,314,85.03,6.37,8.6,2019
"5399034",16,0,0,16,100,0,0,2019
"5399036",564,36,44,644,87.58,5.59,6.83,2019
"5399114",4112,147,868,5127,80.2,2.87,16.93,2019
"5399118",249,4,66,319,78.06,1.25,20.69,2019
"5399124",103,0,35,138,74.64,0,25.36,2019
"5399126",294,18,63,375,78.4,4.8,16.8,2019
"5399130",285,30,54,369,77.24,8.13,14.63,2019
"5399133",589,16,208,813,72.45,1.97,25.58,2019
"2421623",521,16,105,642,81.15,2.49,16.36,2019
"2421930",64,0,0,64,100,0,0,2019
"2421864",156,0,71,227,68.72,0,31.28,2019
"2421865",201,0,0,201,100,0,0,2019
"2421869",312,4,125,441,70.75,0.91,28.34,2019
"2421874",540,6,208,754,71.62,0.8,27.59,2019
"2421231",6452,122,934,7508,85.94,1.62,12.44,2019
"2421156",121,0,7,128,94.53,0,5.47,2019
"2421208",12829,301,1687,14817,86.58,2.03,11.39,2019
"2421215",13063,2260,6753,22076,59.17,10.24,30.59,2019
"2421221",12966,307,2854,16127,80.4,1.9,17.7,2019
"2421236",13728,416,1394,15538,88.35,2.68,8.97,2019
"2421401",14728,333,1395,16456,89.5,2.02,8.48,2019
"2421774",4445,11,188,4644,95.71,0.24,4.05,2019
"2421787",3403,56,572,4031,84.42,1.39,14.19,2019
"2421801",8517,342,1868,10727,79.4,3.19,17.41,2019
"2421842",4370,162,652,5184,84.3,3.12,12.58,2019
"2421856",243,13,14,270,90,4.81,5.19,2019
"2421915",1073,31,71,1175,91.32,2.64,6.04,2019
"2421917",682,0,86,768,88.8,0,11.2,2019
"2421624",64,0,0,64,100,0,0,2019
"2421632",1661,116,574,2351,70.65,4.93,24.42,2019
"2421638",1779,84,147,2010,88.51,4.18,7.31,2019
"2421644",31,0,0,31,100,0,0,2019
"2421671",368,0,43,411,89.54,0,10.46,2019
"2421672",56,0,45,101,55.45,0,44.55,2019
"2421811",8954,232,1042,10228,87.54,2.27,10.19,2019
"2421849",1249,11,130,1390,89.86,0.79,9.35,2019
"2421851",2028,132,692,2852,71.11,4.63,24.26,2019
"2421862",15,0,0,15,100,0,0,2019
"2421875",2162,27,548,2737,78.99,0.99,20.02,2019
"5123883",508,59,271,838,60.62,7.04,32.34,2019
"5123888",645,70,287,1002,64.37,6.99,28.64,2019
"5123894",174,0,22,196,88.78,0,11.22,2019
"5123898",658,0,170,828,79.47,0,20.53,2019
"5123308",588,5,260,853,68.93,0.59,30.48,2019
"5123323",12402,335,945,13682,90.64,2.45,6.91,2019
"5123325",5647,62,688,6397,88.28,0.97,10.76,2019
"5123350",1057,70,384,1511,69.95,4.63,25.41,2019
"5123410",469,4,113,586,80.03,0.68,19.28,2019
"5123415",320,37,275,632,50.63,5.85,43.51,2019
"5123427",67,2,42,111,60.36,1.8,37.84,2019
"5123441",20,11,19,50,40,22,38,2019
"5123452",20314,329,1838,22481,90.36,1.46,8.18,2019
"5123457",1293,37,266,1596,81.02,2.32,16.67,2019
"5123651",164,8,47,219,74.89,3.65,21.46,2019
"5123693",8415,147,299,8861,94.97,1.66,3.37,2019
"5123801",1304,20,15,1339,97.39,1.49,1.12,2019
"5123004",212,13,128,353,60.06,3.68,36.26,2019
"5123440",108,0,106,214,50.47,0,49.53,2019
"5123456",16874,319,677,17870,94.43,1.79,3.79,2019
"5123459",281,0,10,291,96.56,0,3.44,2019
"5123601",8675,585,1422,10682,81.21,5.48,13.31,2019
"5123606",9228,1001,1127,11356,81.26,8.81,9.92,2019
"5123690",1133,33,195,1361,83.25,2.42,14.33,2019
"5123704",5433,347,1677,7457,72.86,4.65,22.49,2019
"5123708",6,0,0,6,100,0,0,2019
"5123844",105,42,93,240,43.75,17.5,38.75,2019
"5123846",244,0,108,352,69.32,0,30.68,2019
"4218437",73,0,16,89,82.02,0,17.98,2019
"4218326",1170,35,283,1488,78.63,2.35,19.02,2019
"4218045",9661,125,717,10503,91.98,1.19,6.83,2019
"4218221",98,0,8,106,92.45,0,7.55,2019
"4218334",1266,78,181,1525,83.02,5.11,11.87,2019
"4218072",2020,74,449,2543,79.43,2.91,17.66,2019
"4218106",2502,96,506,3104,80.61,3.09,16.3,2019
"4218232",1209,35,408,1652,73.18,2.12,24.7,2019
"4218073",3590,38,270,3898,92.1,0.97,6.93,2019
"4218241",267,0,127,394,67.77,0,32.23,2019
"4218353",3694,93,484,4271,86.49,2.18,11.33,2019
"4218421",1676,27,298,2001,83.76,1.35,14.89,2019
"4218816",43,0,12,55,78.18,0,21.82,2019
"4218954",3050,41,121,3212,94.96,1.28,3.77,2019
"4218016",0,0,0,0,NA,NA,NA,2019
"4218046",0,0,0,0,NA,NA,NA,2019
"4218068",0,0,0,0,NA,NA,NA,2019
"4218105",0,0,0,0,NA,NA,NA,2019
"4218109",5444,255,1050,6749,80.66,3.78,15.56,2019
"4218195",0,0,0,0,NA,NA,NA,2019
"4218202",3501,193,1026,4720,74.17,4.09,21.74,2019
"4218212",60,0,0,60,100,0,0,2019
"4218223",93,0,0,93,100,0,0,2019
"4218302",5237,256,521,6014,87.08,4.26,8.66,2019
"4218335",187,0,16,203,92.12,0,7.88,2019
"4218342",262,0,47,309,84.79,0,15.21,2019
"4218352",271,0,23,294,92.18,0,7.82,2019
"4218371",248,15,0,263,94.3,5.7,0,2019
"4218427",29,0,0,29,100,0,0,2019
"4218454",10,0,0,10,100,0,0,2019
"4218463",60,4,9,73,82.19,5.48,12.33,2019
"4218843",93,0,0,93,100,0,0,2019
"4218902",7432,46,257,7735,96.08,0.59,3.32,2019
"4218912",50,0,0,50,100,0,0,2019
"4218913",17,0,0,17,100,0,0,2019
"4218935",20,0,0,20,100,0,0,2019
"4218950",75,0,10,85,88.24,0,11.76,2019
"4218225",31,0,0,31,100,0,0,2019
"4218229",3057,104,498,3659,83.55,2.84,13.61,2019
"4218947",2177,9,190,2376,91.62,0.38,8,2019
"4218976",6726,64,555,7345,91.57,0.87,7.56,2019
"4218980",198,20,0,218,90.83,9.17,0,2019
"4218251",0,0,17,17,0,0,100,2019
"4218324",3226,53,246,3525,91.52,1.5,6.98,2019
"4218331",146,0,50,196,74.49,0,25.51,2019
"4218346",747,43,64,854,87.47,5.04,7.49,2019
"4218445",768,59,93,920,83.48,6.41,10.11,2019
"4218446",1039,14,254,1307,79.5,1.07,19.43,2019
"4218457",51,0,13,64,79.69,0,20.31,2019
"4218466",4733,101,642,5476,86.43,1.84,11.72,2019
"4218470",813,8,103,924,87.99,0.87,11.15,2019
"4218507",1848,60,248,2156,85.71,2.78,11.5,2019
"4218614",789,46,250,1085,72.72,4.24,23.04,2019
"4218615",657,13,89,759,86.56,1.71,11.73,2019
"2421921",14177,362,2068,16607,85.37,2.18,12.45,2019
"2421675",31,0,15,46,67.39,0,32.61,2019
"2421719",365,5,44,414,88.16,1.21,10.63,2019
"2421723",277,0,0,277,100,0,0,2019
"2421762",81,0,0,81,100,0,0,2019
"5122314",16964,288,852,18104,93.7,1.59,4.71,2019
"5122408",9405,128,777,10310,91.22,1.24,7.54,2019
"5122433",98,0,33,131,74.81,0,25.19,2019
"5122437",191,40,63,294,64.97,13.61,21.43,2019
"5122488",265,0,141,406,65.27,0,34.73,2019
"5122554",17477,120,551,18148,96.3,0.66,3.04,2019
"5122601",8317,674,1964,10955,75.92,6.15,17.93,2019
"5122931",123,0,12,135,91.11,0,8.89,2019
"5122943",118,0,49,167,70.66,0,29.34,2019
"5122948",61,0,23,84,72.62,0,27.38,2019
"5122963",5837,157,498,6492,89.91,2.42,7.67,2019
"5122972",39,27,42,108,36.11,25,38.89,2019
"5122711",12,0,0,12,100,0,0,2019
"5122722",71,0,48,119,59.66,0,40.34,2019
"5122815",2778,121,714,3613,76.89,3.35,19.76,2019
"5122820",72,10,35,117,61.54,8.55,29.91,2019
"5122830",385,54,244,683,56.37,7.91,35.72,2019
"5122832",327,62,60,449,72.83,13.81,13.36,2019
"5122835",3202,95,1179,4476,71.54,2.12,26.34,2019
"5122844",1506,51,458,2015,74.74,2.53,22.73,2019
"5122849",1446,102,506,2054,70.4,4.97,24.63,2019
"5122968",3617,74,285,3976,90.97,1.86,7.17,2019
"5122303",6617,53,254,6924,95.57,0.77,3.67,2019
"5122307",4008,106,287,4401,91.07,2.41,6.52,2019
"5122427",862,36,423,1321,65.25,2.73,32.02,2019
"5122460",449,16,112,577,77.82,2.77,19.41,2019
"5122503",1146,30,470,1646,69.62,1.82,28.55,2019
"5122508",4550,258,605,5413,84.06,4.77,11.18,2019
"5122578",984,12,276,1272,77.36,0.94,21.7,2019
"5122603",4235,403,1127,5765,73.46,6.99,19.55,2019
"5122630",9949,301,1730,11980,83.05,2.51,14.44,2019
"5122645",1210,76,321,1607,75.3,4.73,19.98,2019
"5122657",3188,186,922,4296,74.21,4.33,21.46,2019
"5122664",2802,93,831,3726,75.2,2.5,22.3,2019
"5122715",375,23,21,419,89.5,5.49,5.01,2019
"5122719",27,28,23,78,34.62,35.9,29.49,2019
"5122726",254,0,52,306,83.01,0,16.99,2019
"5122727",1777,16,621,2414,73.61,0.66,25.72,2019
"5122730",29,0,46,75,38.67,0,61.33,2019
"5122716",204,0,61,265,76.98,0,23.02,2019
"5122732",11,33,29,73,15.07,45.21,39.73,2019
"5122734",956,46,151,1153,82.91,3.99,13.1,2019
"5122810",211,0,69,280,75.36,0,24.64,2019
"5122821",1417,57,529,2003,70.74,2.85,26.41,2019
"5122850",273,0,82,355,76.9,0,23.1,2019
"5122851",1396,80,939,2415,57.81,3.31,38.88,2019
"5122901",13300,316,1587,15203,87.48,2.08,10.44,2019
"5122903",12423,995,1193,14611,85.02,6.81,8.17,2019
"5122015",14154,195,265,14614,96.85,1.33,1.81,2019
"5122031",12329,77,623,13029,94.63,0.59,4.78,2019
"5122042",11857,247,754,12858,92.21,1.92,5.86,2019
"5122079",11237,135,248,11620,96.7,1.16,2.13,2019
"5122153",9913,51,212,10176,97.42,0.5,2.08,2019
"5122203",10393,401,1465,12259,84.78,3.27,11.95,2019
"5122205",6354,58,295,6707,94.74,0.86,4.4,2019
"5122207",11306,86,521,11913,94.9,0.72,4.37,2019
"5122211",41,0,4,45,91.11,0,8.89,2019
"5122407",18143,377,1280,19800,91.63,1.9,6.46,2019
"5425901",3662,98,1002,4762,76.9,2.06,21.04,2019
"5399137",125,3,36,164,76.22,1.83,21.95,2019
"5399140",84,7,79,170,49.41,4.12,46.47,2019
"5399143",261,16,46,323,80.8,4.95,14.24,2019
"5399159",507,5,141,653,77.64,0.77,21.59,2019
"5399160",33,0,37,70,47.14,0,52.86,2019
"5399161",599,12,45,656,91.31,1.83,6.86,2019
"5399173",435,1,206,642,67.76,0.16,32.09,2019
"5399202",6139,347,1048,7534,81.48,4.61,13.91,2019
"5399217",5946,130,729,6805,87.38,1.91,10.71,2019
"5399335",77,2,23,102,75.49,1.96,22.55,2019
"5399341",236,1,58,295,80,0.34,19.66,2019
"5399345",33,2,9,44,75,4.55,20.45,2019
"5399360",532,6,17,555,95.86,1.08,3.06,2019
"0299516",6760,186,195,7141,94.66,2.6,2.73,2019
"0299548",11,0,12,23,47.83,0,52.17,2019
"0299553",30,11,24,65,46.15,16.92,36.92,2019
"0299565",23,2,0,25,92,8,0,2019
"0299583",5,3,13,21,23.81,14.29,61.9,2019
"0299685",720,38,142,900,80,4.22,15.78,2019
"0299686",1211,36,312,1559,77.68,2.31,20.01,2019
"0299733",8,3,10,21,38.1,14.29,47.62,2019
"0299756",18,3,4,25,72,12,16,2019
"0299763",80,4,32,116,68.97,3.45,27.59,2019
"0299773",39,0,19,58,67.24,0,32.76,2019
"0299781",12,2,34,48,25,4.17,70.83,2019
"0299820",79,2,53,134,58.96,1.49,39.55,2019
"0299705",7189,107,904,8200,87.67,1.3,11.02,2019
"0299721",34,6,21,61,55.74,9.84,34.43,2019
"0299722",10,3,41,54,18.52,5.56,75.93,2019
"0299739",48,0,19,67,71.64,0,28.36,2019
"0299742",88,1,63,152,57.89,0.66,41.45,2019
"0299759",32,5,15,52,61.54,9.62,28.85,2019
"0299761",75,3,15,93,80.65,3.23,16.13,2019
"0299765",39,6,29,74,52.7,8.11,39.19,2019
"0299767",0,0,16,16,0,0,100,2019
"0299771",73,4,8,85,85.88,4.71,9.41,2019
"5399005",2885,20,127,3032,95.15,0.66,4.19,2019
"5399023",234,0,0,234,100,0,0,2019
"5399119",322,84,147,553,58.23,15.19,26.58,2019
"5399128",115,0,29,144,79.86,0,20.14,2019
"5399141",1464,102,561,2127,68.83,4.8,26.38,2019
"5399149",90,3,20,113,79.65,2.65,17.7,2019
"5399153",173,24,38,235,73.62,10.21,16.17,2019
"5399156",2707,217,738,3662,73.92,5.93,20.15,2019
"5399171",417,2,89,508,82.09,0.39,17.52,2019
"0299581",124,2,83,209,59.33,0.96,39.71,2019
"0299610",680,24,108,812,83.74,2.96,13.3,2019
"0299634",55,13,53,121,45.45,10.74,43.8,2019
"0299639",342,5,89,436,78.44,1.15,20.41,2019
"0299640",31,0,21,52,59.62,0,40.38,2019
"0299641",80,7,48,135,59.26,5.19,35.56,2019
"0299656",3,0,5,8,37.5,0,62.5,2019
"0299659",58,9,22,89,65.17,10.11,24.72,2019
"0299660",89,7,23,119,74.79,5.88,19.33,2019
"0299680",88,12,41,141,62.41,8.51,29.08,2019
"0299682",68,2,40,110,61.82,1.82,36.36,2019
"0299690",22,2,11,35,62.86,5.71,31.43,2019
"0299692",48,0,15,63,76.19,0,23.81,2019
"0299693",107,1,16,124,86.29,0.81,12.9,2019
"5123927",1230,66,456,1752,70.21,3.77,26.03,2019
"5123934",119,0,50,169,70.41,0,29.59,2019
"5123936",1520,84,663,2267,67.05,3.71,29.25,2019
"5123947",959,63,398,1420,67.54,4.44,28.03,2019
"5123958",684,50,336,1070,63.93,4.67,31.4,2019
"5123974",875,52,685,1612,54.28,3.23,42.49,2019
"5123009",1983,11,368,2362,83.95,0.47,15.58,2019
"5123228",12760,248,1856,14864,85.84,1.67,12.49,2019
"5123229",11774,137,1061,12972,90.76,1.06,8.18,2019
"5123070",115,8,45,168,68.45,4.76,26.79,2019
"5123868",1343,75,489,1907,70.42,3.93,25.64,2019
"5123901",4194,210,1495,5899,71.1,3.56,25.34,2019
"5123976",10,0,24,34,29.41,0,70.59,2019
"5123921",503,45,81,629,79.97,7.15,12.88,2019
"5123876",56,5,79,140,40,3.57,56.43,2019
"5123882",617,13,224,854,72.25,1.52,26.23,2019
"5123889",209,21,100,330,63.33,6.36,30.3,2019
"5123930",1373,86,740,2199,62.44,3.91,33.65,2019
"5123943",13,0,0,13,100,0,0,2019
"5123944",748,46,508,1302,57.45,3.53,39.02,2019
"5123954",367,36,205,608,60.36,5.92,33.72,2019
"5123513",8931,415,1970,11316,78.92,3.67,17.41,2019
"5123607",5482,947,2306,8735,62.76,10.84,26.4,2019
"5123838",5560,82,290,5932,93.73,1.38,4.89,2019
"5123065",449,0,207,656,68.45,0,31.55,2019
"5123015",1168,10,218,1396,83.67,0.72,15.62,2019
"5123030",1260,112,649,2021,62.35,5.54,32.11,2019
"5123063",1070,13,549,1632,65.56,0.8,33.64,2019
"5123066",74,0,11,85,87.06,0,12.94,2019
"5123068",101,0,0,101,100,0,0,2019
"5123069",838,31,218,1087,77.09,2.85,20.06,2019
"3727542",2194,175,1093,3462,63.37,5.05,31.57,2019
"3727831",873,49,606,1528,57.13,3.21,39.66,2019
"3727832",566,85,614,1265,44.74,6.72,48.54,2019
"3727841",6,5,0,11,54.55,45.45,0,2019
"3727860",390,71,177,638,61.13,11.13,27.74,2019
"3727862",172,52,127,351,49,14.81,36.18,2019
"3727865",544,9,200,753,72.24,1.2,26.56,2019
"3727872",105,55,71,231,45.45,23.81,30.74,2019
"3727884",376,0,103,479,78.5,0,21.5,2019
"3727893",10501,569,4361,15431,68.05,3.69,28.26,2019
"3727915",250,25,53,328,76.22,7.62,16.16,2019
"3727921",1457,89,216,1762,82.69,5.05,12.26,2019
"3727829",510,5,250,765,66.67,0.65,32.68,2019
"3727830",1399,95,453,1947,71.85,4.88,23.27,2019
"3727845",532,160,350,1042,51.06,15.36,33.59,2019
"3727847",203,9,105,317,64.04,2.84,33.12,2019
"3727858",18639,1849,1938,22426,83.11,8.24,8.64,2019
"3727876",295,30,218,543,54.33,5.52,40.15,2019
"3727882",2070,64,780,2914,71.04,2.2,26.77,2019
"3727889",7782,287,3086,11155,69.76,2.57,27.66,2019
"3727923",299,6,16,321,93.15,1.87,4.98,2019
"3727040",4052,75,519,4646,87.21,1.61,11.17,2019
"3727591",6859,56,624,7539,90.98,0.74,8.28,2019
"3727544",1428,28,499,1955,73.04,1.43,25.52,2019
"3727562",600,125,149,874,68.65,14.3,17.05,2019
"3727581",916,0,283,1199,76.4,0,23.6,2019
"3727041",2150,287,759,3196,67.27,8.98,23.75,2019
"3727050",1377,38,209,1624,84.79,2.34,12.87,2019
"2421767",168,0,180,348,48.28,0,51.72,2019
"2421773",1700,25,209,1934,87.9,1.29,10.81,2019
"2421777",571,10,18,599,95.33,1.67,3.01,2019
"2421778",280,24,78,382,73.3,6.28,20.42,2019
"2421228",15502,822,2054,18378,84.35,4.47,11.18,2019
"2421522",82,0,11,93,88.17,0,11.83,2019
"2421010",115,7,7,129,89.15,5.43,5.43,2019
"2421090",3430,67,254,3751,91.44,1.79,6.77,2019
"2421102",3583,45,472,4100,87.39,1.1,11.51,2019
"2421078",6482,83,987,7552,85.83,1.1,13.07,2019
"2421085",5487,50,599,6136,89.42,0.81,9.76,2019
"2421117",20846,423,1528,22797,91.44,1.86,6.7,2019
"2421131",2459,12,60,2531,97.16,0.47,2.37,2019
"2421132",777,16,141,934,83.19,1.71,15.1,2019
"2421211",6674,209,765,7648,87.26,2.73,10,2019
"2421229",12888,610,4077,17575,73.33,3.47,23.2,2019
"2421244",11976,346,1124,13446,89.07,2.57,8.36,2019
"2421538",142,1,49,192,73.96,0.52,25.52,2019
"2421114",9464,178,170,9812,96.45,1.81,1.73,2019
"2421133",10327,172,1037,11536,89.52,1.49,8.99,2019
"2421561",896,0,207,1103,81.23,0,18.77,2019
"2421607",172,2,42,216,79.63,0.93,19.44,2019
"2421654",500,20,36,556,89.93,3.6,6.47,2019
"2421661",772,23,298,1093,70.63,2.1,27.26,2019
"2421669",81,0,17,98,82.65,0,17.35,2019
"2421213",8119,220,2745,11084,73.25,1.98,24.77,2019
"2421217",8743,761,4111,13615,64.22,5.59,30.19,2019
"2421219",2950,82,544,3576,82.49,2.29,15.21,2019
"2421220",13090,467,1674,15231,85.94,3.07,10.99,2019
"2421234",23528,1541,3256,28325,83.06,5.44,11.5,2019
"2421502",12137,632,3354,16123,75.28,3.92,20.8,2019
"2421660",1239,66,267,1572,78.82,4.2,16.98,2019
"2421625",850,31,125,1006,84.49,3.08,12.43,2019
"2421627",0,0,0,0,NA,NA,NA,2019
"2421631",818,16,207,1041,78.58,1.54,19.88,2019
"2421666",4356,201,330,4887,89.13,4.11,6.75,2019
"2421711",352,0,82,434,81.11,0,18.89,2019
"2421734",283,29,122,434,65.21,6.68,28.11,2019
"2421770",1796,29,27,1852,96.98,1.57,1.46,2019
"2421790",36,50,6,92,39.13,54.35,6.52,2019
"2421798",611,69,126,806,75.81,8.56,15.63,2019
"2421813",948,12,90,1050,90.29,1.14,8.57,2019
"2421817",1468,51,500,2019,72.71,2.53,24.76,2019
"2421821",273,17,129,419,65.16,4.06,30.79,2019
"2421824",31,5,11,47,65.96,10.64,23.4,2019
"2421838",513,8,230,751,68.31,1.07,30.63,2019
"2421841",406,14,67,487,83.37,2.87,13.76,2019
"2421872",148,0,26,174,85.06,0,14.94,2019
"2421901",5160,184,667,6011,85.84,3.06,11.1,2019
"2421871",627,12,200,839,74.73,1.43,23.84,2019
"2421779",299,16,25,340,87.94,4.71,7.35,2019
"2421920",85,0,19,104,81.73,0,18.27,2019
"2421031",0,0,0,0,NA,NA,NA,2019
"2421120",2288,16,146,2450,93.39,0.65,5.96,2019
"5123389",57,0,0,57,100,0,0,2019
"5123114",6910,10,277,7197,96.01,0.14,3.85,2019
"5123160",0,0,0,0,NA,NA,NA,2019
"5123173",0,0,0,0,NA,NA,NA,2019
"5123187",0,0,0,0,NA,NA,NA,2019
"3728137",900,40,172,1112,80.94,3.6,15.47,2019
"3728139",6299,266,1635,8200,76.82,3.24,19.94,2019
"3728212",13255,356,2732,16343,81.11,2.18,16.72,2019
"3728217",8644,85,1944,10673,80.99,0.8,18.21,2019
"3728227",18439,243,1361,20043,92,1.21,6.79,2019
"3728338",1456,18,506,1980,73.54,0.91,25.56,2019
"3728078",20270,331,1398,21999,92.14,1.5,6.35,2019
"3728083",7814,150,1270,9234,84.62,1.62,13.75,2019
"3728088",816,26,13,855,95.44,3.04,1.52,2019
"3728101",340,2,30,372,91.4,0.54,8.06,2019
"3728112",7890,87,1464,9441,83.57,0.92,15.51,2019
"3728133",834,21,112,967,86.25,2.17,11.58,2019
"3728147",7052,135,1627,8814,80.01,1.53,18.46,2019
"3728160",811,97,499,1407,57.64,6.89,35.47,2019
"3728164",5229,181,762,6172,84.72,2.93,12.35,2019
"3728617",614,105,169,888,69.14,11.82,19.03,2019
"3728636",1391,103,375,1869,74.42,5.51,20.06,2019
"3728637",480,11,278,769,62.42,1.43,36.15,2019
"3728651",2136,106,697,2939,72.68,3.61,23.72,2019
"3728170",3238,86,1162,4486,72.18,1.92,25.9,2019
"3728210",18224,412,1694,20330,89.64,2.03,8.33,2019
"3728262",14683,790,953,16426,89.39,4.81,5.8,2019
"3728204",3583,93,250,3926,91.26,2.37,6.37,2019
"3728208",10335,330,4106,14771,69.97,2.23,27.8,2019
"3728226",14863,347,901,16111,92.25,2.15,5.59,2019
"3728304",12322,556,1561,14439,85.34,3.85,10.81,2019
"3728306",13169,340,1965,15474,85.1,2.2,12.7,2019
"3728327",5212,170,1374,6756,77.15,2.52,20.34,2019
"3728334",6284,279,2829,9392,66.91,2.97,30.12,2019
"3728337",3119,63,1056,4238,73.6,1.49,24.92,2019
"3728343",341,6,199,546,62.45,1.1,36.45,2019
"3728363",326,23,118,467,69.81,4.93,25.27,2019
"3728374",7256,205,401,7862,92.29,2.61,5.1,2019
"3728376",12407,304,2148,14859,83.5,2.05,14.46,2019
"3728393",487,0,288,775,62.84,0,37.16,2019
"3728396",645,25,316,986,65.42,2.54,32.05,2019
"3728412",15368,358,1813,17539,87.62,2.04,10.34,2019
"3728453",762,72,320,1154,66.03,6.24,27.73,2019
"3728469",2671,83,213,2967,90.02,2.8,7.18,2019
"3728658",8393,216,1831,10440,80.39,2.07,17.54,2019
"3728662",114,0,0,114,100,0,0,2019
"3728668",171,0,18,189,90.48,0,9.52,2019
"3728676",1119,132,325,1576,71,8.38,20.62,2019
"3728705",1896,48,895,2839,66.78,1.69,31.53,2019
"3728723",2253,590,394,3237,69.6,18.23,12.17,2019
"3728740",194,5,216,415,46.75,1.2,52.05,2019
"3728743",566,63,241,870,65.06,7.24,27.7,2019
"3728749",11,0,47,58,18.97,0,81.03,2019
"3728757",34,9,0,43,79.07,20.93,0,2019
"3728761",2131,167,812,3110,68.52,5.37,26.11,2019
"3728771",1836,205,1180,3221,57,6.36,36.63,2019
"3728772",405,0,65,470,86.17,0,13.83,2019
"3728773",1130,28,138,1296,87.19,2.16,10.65,2019
"3728782",2653,138,456,3247,81.71,4.25,14.04,2019
"3728789",1607,172,635,2414,66.57,7.13,26.3,2019
"3728790",1069,42,198,1309,81.67,3.21,15.13,2019
"3728791",5843,179,718,6740,86.69,2.66,10.65,2019
"3728804",7854,241,792,8887,88.38,2.71,8.91,2019
"4219150",7768,219,1847,9834,78.99,2.23,18.78,2019
"0299709",10613,312,965,11890,89.26,2.62,8.12,2019
"5399357",870,9,152,1031,84.38,0.87,14.74,2019
"5399205",15838,375,2008,18221,86.92,2.06,11.02,2019
"5399218",5264,249,676,6189,85.05,4.02,10.92,2019
"5399348",337,3,128,468,72.01,0.64,27.35,2019
"5399359",35,4,55,94,37.23,4.26,58.51,2019
"5399403",6843,177,1318,8338,82.07,2.12,15.81,2019
"0299507",12809,402,585,13796,92.85,2.91,4.24,2019
"0299567",2781,41,214,3036,91.6,1.35,7.05,2019
"0299923",14,0,0,14,100,0,0,2019
"5399301",20334,789,2815,23938,84.94,3.3,11.76,2019
"0299505",1105,0,34,1139,97.01,0,2.99,2019
"5399207",10541,205,1458,12204,86.37,1.68,11.95,2019
"5399113",299,3,22,324,92.28,0.93,6.79,2019
"5399148",703,28,161,892,78.81,3.14,18.05,2019
"5399336",15000,1055,2760,18815,79.72,5.61,14.67,2019
"0299518",3939,63,278,4280,92.03,1.47,6.5,2019
"0299609",83,0,13,96,86.46,0,13.54,2019
"0299605",42,0,0,42,100,0,0,2019
"0299672",1030,61,241,1332,77.33,4.58,18.09,2019
"0299549",24,0,5,29,82.76,0,17.24,2019
"0299586",47,23,32,102,46.08,22.55,31.37,2019
"0299674",438,8,107,553,79.2,1.45,19.35,2019
"0299768",29,2,28,59,49.15,3.39,47.46,2019
"0299926",343,42,102,487,70.43,8.62,20.94,2019
"5399361",653,15,82,750,87.07,2,10.93,2019
"0299579",2,0,7,9,22.22,0,77.78,2019
"0299754",6,1,30,37,16.22,2.7,81.08,2019
"5399039",27,0,5,32,84.38,0,15.62,2019
"5399144",11,0,0,11,100,0,0,2019
"5399147",64,0,9,73,87.67,0,12.33,2019
"5399164",0,0,0,0,NA,NA,NA,2019
"5399174",20,2,2,24,83.33,8.33,8.33,2019
"5399333",14,3,0,17,82.35,17.65,0,2019
"5399354",8188,507,480,9175,89.24,5.53,5.23,2019
"0299510",0,0,0,0,NA,NA,NA,2019
"0299519",0,0,0,0,NA,NA,NA,2019
"0299706",1,0,2,3,33.33,0,66.67,2019
"0299734",0,0,0,0,NA,NA,NA,2019
"0299790",11,0,4,15,73.33,0,26.67,2019
"0299836",27,3,3,33,81.82,9.09,9.09,2019
"0299508",10704,481,1273,12458,85.92,3.86,10.22,2019
"0299540",196,0,5,201,97.51,0,2.49,2019
"0299556",776,34,206,1016,76.38,3.35,20.28,2019
"0299559",1899,22,301,2222,85.46,0.99,13.55,2019
"2304451",86,4,26,116,74.14,3.45,22.41,2019
"2304455",206,17,43,266,77.44,6.39,16.17,2019
"2304923",161,6,49,216,74.54,2.78,22.69,2019
"2304924",617,68,188,873,70.68,7.79,21.53,2019
"2304929",256,9,62,327,78.29,2.75,18.96,2019
"2304943",529,17,201,747,70.82,2.28,26.91,2019
"2304956",267,5,72,344,77.62,1.45,20.93,2019
"2304976",3279,191,800,4270,76.79,4.47,18.74,2019
"2304984",153,14,66,233,65.67,6.01,28.33,2019
"2304046",3032,46,259,3337,90.86,1.38,7.76,2019
"2304002",2634,45,210,2889,91.17,1.56,7.27,2019
"2304017",178,7,47,232,76.72,3.02,20.26,2019
"2304042",1800,72,210,2082,86.46,3.46,10.09,2019
"2304047",634,46,140,820,77.32,5.61,17.07,2019
"3727052",3319,59,1098,4476,74.15,1.32,24.53,2019
"3727105",9784,550,4329,14663,66.73,3.75,29.52,2019
"3727109",0,0,0,0,NA,NA,NA,2019
"3727242",308,0,284,592,52.03,0,47.97,2019
"3727249",3439,264,904,4607,74.65,5.73,19.62,2019
"3727260",6120,458,2371,8949,68.39,5.12,26.49,2019
"3727281",1057,12,360,1429,73.97,0.84,25.19,2019
"3727295",11635,415,3281,15331,75.89,2.71,21.4,2019
"3727314",259,24,86,369,70.19,6.5,23.31,2019
"3727357",2427,296,387,3110,78.04,9.52,12.44,2019
"3727508",360,0,133,493,73.02,0,26.98,2019
"3727522",4397,92,566,5055,86.98,1.82,11.2,2019
"3727526",14918,513,1344,16775,88.93,3.06,8.01,2019
"3727563",983,134,856,1973,49.82,6.79,43.39,2019
"3727589",1645,114,1083,2842,57.88,4.01,38.11,2019
"3727596",6044,68,661,6773,89.24,1,9.76,2019
"3727705",17336,653,1973,19962,86.85,3.27,9.88,2019
"3727713",21555,700,980,23235,92.77,3.01,4.22,2019
"3727821",58,0,75,133,43.61,0,56.39,2019
"3727824",339,63,244,646,52.48,9.75,37.77,2019
"3727846",982,12,227,1221,80.43,0.98,18.59,2019
"3727855",1551,37,769,2357,65.8,1.57,32.63,2019
"3727310",2049,268,85,2402,85.3,11.16,3.54,2019
"3727358",4556,209,487,5252,86.75,3.98,9.27,2019
"3727376",3366,74,479,3919,85.89,1.89,12.22,2019
"3727403",6090,645,927,7662,79.48,8.42,12.1,2019
"3727455",9960,659,1399,12018,82.88,5.48,11.64,2019
"3727510",6473,99,515,7087,91.34,1.4,7.27,2019
"3727521",1587,201,531,2319,68.43,8.67,22.9,2019
"3727546",5275,240,1121,6636,79.49,3.62,16.89,2019
"3727551",444,22,229,695,63.88,3.17,32.95,2019
"4218076",935,14,253,1202,77.79,1.16,21.05,2019
"4218078",2498,82,385,2965,84.25,2.77,12.98,2019
"4218081",96,0,38,134,71.64,0,28.36,2019
"4218087",270,0,22,292,92.47,0,7.53,2019
"4218092",1093,64,143,1300,84.08,4.92,11,2019
"4218201",7237,277,2540,10054,71.98,2.76,25.26,2019
"4218211",470,0,23,493,95.33,0,4.67,2019
"4218357",55,0,0,55,100,0,0,2019
"4218428",4073,108,697,4878,83.5,2.21,14.29,2019
"4218431",3798,104,805,4707,80.69,2.21,17.1,2019
"4218447",3645,58,803,4506,80.89,1.29,17.82,2019
"4218451",244,0,42,286,85.31,0,14.69,2019
"4218465",492,5,56,553,88.97,0.9,10.13,2019
"4218508",4017,107,1201,5325,75.44,2.01,22.55,2019
"4218519",1673,46,324,2043,81.89,2.25,15.86,2019
"4218602",82,2,15,99,82.83,2.02,15.15,2019
"4218441",101,5,10,116,87.07,4.31,8.62,2019
"4218444",4592,108,667,5367,85.56,2.01,12.43,2019
"4218452",1683,70,570,2323,72.45,3.01,24.54,2019
"4218472",1185,50,348,1583,74.86,3.16,21.98,2019
"4218504",6806,103,1990,8899,76.48,1.16,22.36,2019
"4218505",7123,222,1596,8941,79.67,2.48,17.85,2019
"4218612",4933,212,1041,6186,79.74,3.43,16.83,2019
"4218628",74,9,24,107,69.16,8.41,22.43,2019
"4218632",143,4,83,230,62.17,1.74,36.09,2019
"4218656",682,39,183,904,75.44,4.31,20.24,2019
"4218704",10833,241,2533,13607,79.61,1.77,18.62,2019
"4218801",2813,54,577,3444,81.68,1.57,16.75,2019
"5123238",9364,304,1177,10845,86.34,2.8,10.85,2019
"5123250",0,0,0,0,NA,NA,NA,2019
"5123313",40,0,58,98,40.82,0,59.18,2019
"5123398",17,0,8,25,68,0,32,2019
"5123408",49,0,0,49,100,0,0,2019
"5123414",95,0,0,95,100,0,0,2019
"5123422",34,0,19,53,64.15,0,35.85,2019
"5123453",11176,165,860,12201,91.6,1.35,7.05,2019
"5123460",0,0,0,0,NA,NA,NA,2019
"5123486",23,0,0,23,100,0,0,2019
"5123511",132,11,0,143,92.31,7.69,0,2019
"5123551",0,0,0,0,NA,NA,NA,2019
"5123709",0,0,0,0,NA,NA,NA,2019
"5123806",0,0,0,0,NA,NA,NA,2019
"5123884",0,0,0,0,NA,NA,NA,2019
"5123891",0,0,0,0,NA,NA,NA,2019
"5123909",0,0,0,0,NA,NA,NA,2019
"5123875",3749,302,318,4369,85.81,6.91,7.28,2019
"5123970",2151,146,1008,3305,65.08,4.42,30.5,2019
"5123454",20619,459,1697,22775,90.53,2.02,7.45,2019
"5123831",12065,467,996,13528,89.19,3.45,7.36,2019
"5123937",342,19,259,620,55.16,3.06,41.77,2019
"5123040",1005,153,650,1808,55.59,8.46,35.95,2019
"5123071",518,0,174,692,74.86,0,25.14,2019
"5123156",417,0,229,646,64.55,0,35.45,2019
"5123002",2929,53,1053,4035,72.59,1.31,26.1,2019
"5123322",19458,274,831,20563,94.63,1.33,4.04,2019
"5124084",3372,195,957,4524,74.54,4.31,21.15,2019
"5124185",205,0,13,218,94.04,0,5.96,2019
"5124382",4469,179,1395,6043,73.95,2.96,23.08,2019
"5124058",77,0,13,90,85.56,0,14.44,2019
"5124112",9177,325,3149,12651,72.54,2.57,24.89,2019
"5124175",2755,38,427,3220,85.56,1.18,13.26,2019
"5124280",213,19,82,314,67.83,6.05,26.11,2019
"5124413",89,7,7,103,86.41,6.8,6.8,2019
"5124474",165,29,52,246,67.07,11.79,21.14,2019
"5124083",1018,167,61,1246,81.7,13.4,4.9,2019
"5424916",141,9,88,238,59.24,3.78,36.97,2019
"5124578",353,0,66,419,84.25,0,15.75,2019
"5124637",1224,61,188,1473,83.1,4.14,12.76,2019
"5424843",35,0,14,49,71.43,0,28.57,2019
"5124460",310,13,153,476,65.13,2.73,32.14,2019
"5124527",859,51,303,1213,70.82,4.2,24.98,2019
"5425173",169,0,3,172,98.26,0,1.74,2019
"5425187",105,22,247,374,28.07,5.88,66.04,2019
"5425234",258,13,101,372,69.35,3.49,27.15,2019
"5425239",500,15,175,690,72.46,2.17,25.36,2019
"5425247",183,11,45,239,76.57,4.6,18.83,2019
"5425251",76,0,43,119,63.87,0,36.13,2019
"5425253",740,4,245,989,74.82,0.4,24.77,2019
"5425260",492,4,189,685,71.82,0.58,27.59,2019
"5425267",109,0,130,239,45.61,0,54.39,2019
"5425314",5541,105,491,6137,90.29,1.71,8,2019
"5425420",1309,20,233,1562,83.8,1.28,14.92,2019
"3727944",3837,238,1167,5242,73.2,4.54,22.26,2019
"3727946",307,62,122,491,62.53,12.63,24.85,2019
"3727953",350,0,26,376,93.09,0,6.91,2019
"3727956",170,0,7,177,96.05,0,3.95,2019
"3727957",298,17,168,483,61.7,3.52,34.78,2019
"1019804",5589,282,1000,6871,81.34,4.1,14.55,2019
"1019975",3662,118,618,4398,83.27,2.68,14.05,2019
"4219022",1032,0,218,1250,82.56,0,17.44,2019
"4219067",18878,264,1172,20314,92.93,1.3,5.77,2019
"4219116",10378,353,1912,12643,82.08,2.79,15.12,2019
"4219555",1188,18,225,1431,83.02,1.26,15.72,2019
"4219565",2872,124,532,3528,81.41,3.51,15.08,2019
"4219601",8467,243,2623,11333,74.71,2.14,23.14,2019
"4219608",7492,77,669,8238,90.94,0.93,8.12,2019
"1019706",544,41,78,663,82.05,6.18,11.76,2019
"4219020",18398,471,2930,21799,84.4,2.16,13.44,2019
"1019943",4175,117,715,5007,83.38,2.34,14.28,2019
"4219115",10914,386,2233,13533,80.65,2.85,16.5,2019
"4219120",17236,877,5332,23445,73.52,3.74,22.74,2019
"4219501",366,18,87,471,77.71,3.82,18.47,2019
"4219074",1741,163,175,2079,83.74,7.84,8.42,2019
"4219017",49,0,21,70,70,0,30,2019
"4219060",3401,132,191,3724,91.33,3.54,5.13,2019
"4219109",0,0,0,0,NA,NA,NA,2019
"4219375",0,0,0,0,NA,NA,NA,2019
"4219383",0,0,0,0,NA,NA,NA,2019
"4219442",0,0,0,0,NA,NA,NA,2019
"4219456",250,0,0,250,100,0,0,2019
"4219477",0,0,0,0,NA,NA,NA,2019
"4219535",5,0,0,5,100,0,0,2019
"4219538",16,0,7,23,69.57,0,30.43,2019
"4219542",25,0,0,25,100,0,0,2019
"4219564",61,0,0,61,100,0,0,2019
"1019716",0,0,0,0,NA,NA,NA,2019
"1019717",0,0,0,0,NA,NA,NA,2019
"1019735",0,9,0,9,0,100,0,2019
"1019936",70,0,55,125,56,0,44,2019
"1019951",669,20,153,842,79.45,2.38,18.17,2019
"1019952",2813,138,942,3893,72.26,3.54,24.2,2019
"1019953",1383,39,236,1658,83.41,2.35,14.23,2019
"1019955",9,0,6,15,60,0,40,2019
"1019968",4044,103,780,4927,82.08,2.09,15.83,2019
"4219547",1585,3,224,1812,87.47,0.17,12.36,2019
"4219559",104,10,29,143,72.73,6.99,20.28,2019
"4219567",1482,78,479,2039,72.68,3.83,23.49,2019
"4219611",2884,81,777,3742,77.07,2.16,20.76,2019
"1019736",26,0,0,26,100,0,0,2019
"1019808",13495,424,1233,15152,89.06,2.8,8.14,2019
"1019901",12279,203,1672,14154,86.75,1.43,11.81,2019
"1019944",322,3,39,364,88.46,0.82,10.71,2019
"1019956",4229,159,1305,5693,74.28,2.79,22.92,2019
"1019963",6455,160,1534,8149,79.21,1.96,18.82,2019
"1019964",228,28,95,351,64.96,7.98,27.07,2019
"4219317",3650,26,59,3735,97.72,0.7,1.58,2019
"4219320",16826,624,2731,20181,83.38,3.09,13.53,2019
"4219330",1615,54,237,1906,84.73,2.83,12.43,2019
"4219342",6271,341,882,7494,83.68,4.55,11.77,2019
"4219343",2518,38,69,2625,95.92,1.45,2.63,2019
"4219348",7258,388,1039,8685,83.57,4.47,11.96,2019
"5122309",10502,204,949,11655,90.11,1.75,8.14,2019
"2304050",112,6,22,140,80,4.29,15.71,2019
"2304055",1499,69,148,1716,87.35,4.02,8.62,2019
"2304062",6129,214,511,6854,89.42,3.12,7.46,2019
"2304074",7285,142,557,7984,91.24,1.78,6.98,2019
"2304102",6795,318,750,7863,86.42,4.04,9.54,2019
"2304103",11486,382,1118,12986,88.45,2.94,8.61,2019
"2304106",9715,375,919,11009,88.25,3.41,8.35,2019
"2304107",3440,66,208,3714,92.62,1.78,5.6,2019
"2304210",8558,397,1487,10442,81.96,3.8,14.24,2019
"2304221",226,3,79,308,73.38,0.97,25.65,2019
"2304231",91,2,18,111,81.98,1.8,16.22,2019
"2304281",1550,106,276,1932,80.23,5.49,14.29,2019
"2304292",294,4,60,358,82.12,1.12,16.76,2019
"2304352",511,12,104,627,81.5,1.91,16.59,2019
"2304354",519,12,89,620,83.71,1.94,14.35,2019
"2304421",193,22,10,225,85.78,9.78,4.44,2019
"2304430",630,38,145,813,77.49,4.67,17.84,2019
"2304442",9,0,0,9,100,0,0,2019
"2304450",450,14,42,506,88.93,2.77,8.3,2019
"2304462",1885,47,532,2464,76.5,1.91,21.59,2019
"2304463",894,64,309,1267,70.56,5.05,24.39,2019
"2304468",3333,124,462,3919,85.05,3.16,11.79,2019
"2304487",257,22,101,380,67.63,5.79,26.58,2019
"2304547",366,15,55,436,83.94,3.44,12.61,2019
"2304556",474,17,70,561,84.49,3.03,12.48,2019
"2304562",861,9,120,990,86.97,0.91,12.12,2019
"2304564",207,25,20,252,82.14,9.92,7.94,2019
"2304576",210,9,59,278,75.54,3.24,21.22,2019
"2304613",33,0,0,33,100,0,0,2019
"2304616",248,12,59,319,77.74,3.76,18.5,2019
"2304617",276,3,63,342,80.7,0.88,18.42,2019
"2304626",164,29,21,214,76.64,13.55,9.81,2019
"2304628",210,13,33,256,82.03,5.08,12.89,2019
"2304640",876,0,144,1020,85.88,0,14.12,2019
"2304657",122,18,23,163,74.85,11.04,14.11,2019
"2304664",411,5,73,489,84.05,1.02,14.93,2019
"2304676",340,24,98,462,73.59,5.19,21.21,2019
"2304730",3058,52,940,4050,75.51,1.28,23.21,2019
"2304762",145,16,64,225,64.44,7.11,28.44,2019
"2304763",209,6,90,305,68.52,1.97,29.51,2019
"2304773",174,26,100,300,58,8.67,33.33,2019
"2304853",190,0,19,209,90.91,0,9.09,2019
"2304856",1272,59,25,1356,93.81,4.35,1.84,2019
"2304920",562,18,174,754,74.54,2.39,23.08,2019
"2304927",1158,90,223,1471,78.72,6.12,15.16,2019
"0572022",6026,132,819,6977,86.37,1.89,11.74,2019
"0572024",888,104,439,1431,62.05,7.27,30.68,2019
"0572026",60,0,48,108,55.56,0,44.44,2019
"0572041",314,71,199,584,53.77,12.16,34.08,2019
"0572046",1022,56,538,1616,63.24,3.47,33.29,2019
"0572055",255,5,155,415,61.45,1.2,37.35,2019
"0572063",420,37,307,764,54.97,4.84,40.18,2019
"0572072",109,19,87,215,50.7,8.84,40.47,2019
"0572079",101,0,154,255,39.61,0,60.39,2019
"0572085",65,0,18,83,78.31,0,21.69,2019
"0572087",635,0,89,724,87.71,0,12.29,2019
"0572101",711,18,527,1256,56.61,1.43,41.96,2019
"0572120",11259,244,1292,12795,88,1.91,10.1,2019
"0572121",887,29,315,1231,72.06,2.36,25.59,2019
"4218824",496,10,87,593,83.64,1.69,14.67,2019
"4218640",5695,239,1465,7399,76.97,3.23,19.8,2019
"4218964",4579,22,750,5351,85.57,0.41,14.02,2019
"4218083",142,2,13,157,90.45,1.27,8.28,2019
"4218254",331,16,92,439,75.4,3.64,20.96,2019
"4218621",1691,34,335,2060,82.09,1.65,16.26,2019
"4218817",97,4,5,106,91.51,3.77,4.72,2019
"4218834",1201,32,170,1403,85.6,2.28,12.12,2019
"4218901",9423,288,838,10549,89.33,2.73,7.94,2019
"4218011",1916,16,116,2048,93.55,0.78,5.66,2019
"4218037",2602,36,400,3038,85.65,1.18,13.17,2019
"4218038",939,38,206,1183,79.37,3.21,17.41,2019
"4218042",11861,331,2811,15003,79.06,2.21,18.74,2019
"4218049",6451,163,748,7362,87.63,2.21,10.16,2019
"4218015",8898,331,1831,11060,80.45,2.99,16.56,2019
"4218014",3438,164,851,4453,77.21,3.68,19.11,2019
"4218018",10968,358,1907,13233,82.88,2.71,14.41,2019
"4218020",6691,207,665,7563,88.47,2.74,8.79,2019
"4218032",3219,71,483,3773,85.32,1.88,12.8,2019
"4218051",1288,32,74,1394,92.4,2.3,5.31,2019
"4218056",325,0,97,422,77.01,0,22.99,2019
"4218086",246,0,25,271,90.77,0,9.23,2019
"4218088",2716,79,465,3260,83.31,2.42,14.26,2019
"4218102",12058,721,3437,16216,74.36,4.45,21.2,2019
"4218224",1882,52,693,2627,71.64,1.98,26.38,2019
"4218242",60,0,21,81,74.07,0,25.93,2019
"4218245",98,0,54,152,64.47,0,35.53,2019
"4218249",1301,49,117,1467,88.68,3.34,7.98,2019
"4218250",972,64,183,1219,79.74,5.25,15.01,2019
"4218325",746,12,42,800,93.25,1.5,5.25,2019
"4218430",3,0,0,3,100,0,0,2019
"2421904",2075,4,335,2414,85.96,0.17,13.88,2019
"2421542",198,1,57,256,77.34,0.39,22.27,2019
"2421543",108,0,10,118,91.53,0,8.47,2019
"2421562",981,34,345,1360,72.13,2.5,25.37,2019
"2421622",238,6,72,316,75.32,1.9,22.78,2019
"2421639",1394,14,283,1691,82.44,0.83,16.74,2019
"2421662",207,10,3,220,94.09,4.55,1.36,2019
"2421677",183,0,14,197,92.89,0,7.11,2019
"2421679",134,0,0,134,100,0,0,2019
"2421717",30,0,0,30,100,0,0,2019
"2421733",306,0,50,356,85.96,0,14.04,2019
"2421769",3893,37,200,4130,94.26,0.9,4.84,2019
"2421755",1816,24,180,2020,89.9,1.19,8.91,2019
"2421788",3947,100,680,4727,83.5,2.12,14.39,2019
"2421791",1496,103,385,1984,75.4,5.19,19.41,2019
"2421814",98,0,14,112,87.5,0,12.5,2019
"2421826",1661,0,305,1966,84.49,0,15.51,2019
"2421837",822,62,226,1110,74.05,5.59,20.36,2019
"2421771",9183,151,623,9957,92.23,1.52,6.26,2019
"2421782",1510,12,237,1759,85.84,0.68,13.47,2019
"2421784",12360,233,806,13399,92.25,1.74,6.02,2019
"2421793",3218,110,429,3757,85.65,2.93,11.42,2019
"2421829",103,0,98,201,51.24,0,48.76,2019
"2421835",130,0,27,157,82.8,0,17.2,2019
"2421840",153,0,19,172,88.95,0,11.05,2019
"2421850",861,39,147,1047,82.23,3.72,14.04,2019
"2421853",2966,193,621,3780,78.47,5.11,16.43,2019
"2421867",23,0,0,23,100,0,0,2019
"3727964",289,0,35,324,89.2,0,10.8,2019
"3727968",77,4,0,81,95.06,4.94,0,2019
"3727980",618,0,304,922,67.03,0,32.97,2019
"3727981",572,7,104,683,83.75,1.02,15.23,2019
"3727983",1990,98,1199,3287,60.54,2.98,36.48,2019
"3727607",7992,187,510,8689,91.98,2.15,5.87,2019
"3727610",22009,1179,2687,25875,85.06,4.56,10.38,2019
"3727704",12417,474,2410,15301,81.15,3.1,15.75,2019
"3727712",7636,104,587,8327,91.7,1.25,7.05,2019
"3727803",5809,112,1740,7661,75.83,1.46,22.71,2019
"3727804",9604,237,1982,11823,81.23,2,16.76,2019
"3727851",1542,39,473,2054,75.07,1.9,23.03,2019
"3727857",290,31,139,460,63.04,6.74,30.22,2019
"3727863",3946,66,653,4665,84.59,1.41,14,2019
"3727875",57,0,167,224,25.45,0,74.55,2019
"3727880",1110,51,152,1313,84.54,3.88,11.58,2019
"3727916",305,0,61,366,83.33,0,16.67,2019
"3727919",360,0,84,444,81.08,0,18.92,2019
"3727920",536,32,28,596,89.93,5.37,4.7,2019
"3727897",460,44,205,709,64.88,6.21,28.91,2019
"3727910",3024,146,1368,4538,66.64,3.22,30.15,2019
"3727917",132,28,58,218,60.55,12.84,26.61,2019
"3727949",3164,19,146,3329,95.04,0.57,4.39,2019
"3727966",274,0,78,352,77.84,0,22.16,2019
"3727982",13,0,11,24,54.17,0,45.83,2019
"3727986",326,32,136,494,65.99,6.48,27.53,2019
"3727507",648,8,58,714,90.76,1.12,8.12,2019
"3727514",8662,970,333,9965,86.92,9.73,3.34,2019
"3727541",1241,50,242,1533,80.95,3.26,15.79,2019
"3727572",2495,65,395,2955,84.43,2.2,13.37,2019
"3727597",7350,115,1480,8945,82.17,1.29,16.55,2019
"3727601",3138,355,634,4127,76.04,8.6,15.36,2019
"3727703",18364,501,1971,20836,88.14,2.4,9.46,2019
"3727805",1037,56,556,1649,62.89,3.4,33.72,2019
"3727808",771,17,137,925,83.35,1.84,14.81,2019
"3727828",2950,50,616,3616,81.58,1.38,17.04,2019
"3727006",5265,82,462,5809,90.64,1.41,7.95,2019
"3727018",2429,35,686,3150,77.11,1.11,21.78,2019
"3727299",1657,103,337,2097,79.02,4.91,16.07,2019
"3727312",7087,594,1257,8938,79.29,6.65,14.06,2019
"3727320",10544,795,4695,16034,65.76,4.96,29.28,2019
"3727608",4569,73,277,4919,92.88,1.48,5.63,2019
"3727612",16664,543,1050,18257,91.27,2.97,5.75,2019
"3727613",16454,323,411,17188,95.73,1.88,2.39,2019
"3727707",17316,570,2431,20317,85.23,2.81,11.97,2019
"3727801",5147,304,2516,7967,64.6,3.82,31.58,2019
"3727823",1376,166,1575,3117,44.15,5.33,50.53,2019
"3727840",102,16,51,169,60.36,9.47,30.18,2019
"3727852",805,24,353,1182,68.1,2.03,29.86,2019
"3727864",1328,29,586,1943,68.35,1.49,30.16,2019
"3727886",5408,301,2605,8314,65.05,3.62,31.33,2019
"3727891",1330,28,606,1964,67.72,1.43,30.86,2019
"3727896",7354,159,809,8322,88.37,1.91,9.72,2019
"3728009",428,0,78,506,84.58,0,15.42,2019
"4218617",525,0,232,757,69.35,0,30.65,2019
"4218635",1092,36,376,1504,72.61,2.39,25,2019
"4218641",2435,63,404,2902,83.91,2.17,13.92,2019
"4218344",1222,20,349,1591,76.81,1.26,21.94,2019
"4218351",195,0,30,225,86.67,0,13.33,2019
"5425928",125,0,98,223,56.05,0,43.95,2019
"5425971",303,8,95,406,74.63,1.97,23.4,2019
"5425977",31,31,0,62,50,50,0,2019
"5425981",117,0,136,253,46.25,0,53.75,2019
"5425118",242,0,89,331,73.11,0,26.89,2019
"5425086",216,10,50,276,78.26,3.62,18.12,2019
"5425111",204,9,44,257,79.38,3.5,17.12,2019
"5425114",92,0,44,136,67.65,0,32.35,2019
"5425148",140,0,30,170,82.35,0,17.65,2019
"5425149",38,12,42,92,41.3,13.04,45.65,2019
"5425154",264,0,10,274,96.35,0,3.65,2019
"5425160",42,0,21,63,66.67,0,33.33,2019
"5425168",762,55,257,1074,70.95,5.12,23.93,2019
"5425181",266,0,144,410,64.88,0,35.12,2019
"5425186",359,17,58,434,82.72,3.92,13.36,2019
"5425205",45,0,128,173,26.01,0,73.99,2019
"5425211",40,0,0,40,100,0,0,2019
"5425301",1054,79,428,1561,67.52,5.06,27.42,2019
"5425304",2925,65,507,3497,83.64,1.86,14.5,2019
"5425401",4777,378,1010,6165,77.49,6.13,16.38,2019
"5425444",76,0,11,87,87.36,0,12.64,2019
"5425503",272,58,182,512,53.12,11.33,35.55,2019
"5425510",1556,11,325,1892,82.24,0.58,17.18,2019
"5425511",143,7,193,343,41.69,2.04,56.27,2019
"5425547",294,0,137,431,68.21,0,31.79,2019
"5425646",338,15,66,419,80.67,3.58,15.75,2019
"5425661",1896,37,548,2481,76.42,1.49,22.09,2019
"5425672",71,0,99,170,41.76,0,58.24,2019
"5425801",10757,340,2688,13785,78.03,2.47,19.5,2019
"5425825",669,27,166,862,77.61,3.13,19.26,2019
"5425839",153,0,48,201,76.12,0,23.88,2019
"5425853",14,0,0,14,100,0,0,2019
"5425560",2627,83,346,3056,85.96,2.72,11.32,2019
"5425570",1264,244,787,2295,55.08,10.63,34.29,2019
"5425571",671,0,242,913,73.49,0,26.51,2019
"5425635",579,10,55,644,89.91,1.55,8.54,2019
"5425639",157,0,46,203,77.34,0,22.66,2019
"5425699",8,0,33,41,19.51,0,80.49,2019
"5425703",1513,148,467,2128,71.1,6.95,21.95,2019
"5425812",468,21,150,639,73.24,3.29,23.47,2019
"5425125",298,35,42,375,79.47,9.33,11.2,2019
"5425136",467,15,239,721,64.77,2.08,33.15,2019
"5425139",100,0,33,133,75.19,0,24.81,2019
"5425159",1478,31,503,2012,73.46,1.54,25,2019
"5425870",13,0,0,13,100,0,0,2019
"5425902",63,0,17,80,78.75,0,21.25,2019
"5425916",30,12,30,72,41.67,16.67,41.67,2019
"5425313",3890,226,920,5036,77.24,4.49,18.27,2019
"5425443",2437,94,226,2757,88.39,3.41,8.2,2019
"5425504",4204,93,1009,5306,79.23,1.75,19.02,2019
"5425505",48,11,34,93,51.61,11.83,36.56,2019
"5425506",1549,61,520,2130,72.72,2.86,24.41,2019
"5425517",283,47,288,618,45.79,7.61,46.6,2019
"5425972",37,0,58,95,38.95,0,61.05,2019
"5425976",724,56,326,1106,65.46,5.06,29.48,2019
"5425152",87,0,52,139,62.59,0,37.41,2019
"5425244",114,11,65,190,60,5.79,34.21,2019
"5425275",551,0,164,715,77.06,0,22.94,2019
"3728127",2224,86,402,2712,82.01,3.17,14.82,2019
"0572122",151,13,68,232,65.09,5.6,29.31,2019
"0572139",73,2,47,122,59.84,1.64,38.52,2019
"0572152",52,15,134,201,25.87,7.46,66.67,2019
"0572156",123,10,100,233,52.79,4.29,42.92,2019
"0572165",35,0,18,53,66.04,0,33.96,2019
"0572173",2496,33,630,3159,79.01,1.04,19.94,2019
"0572212",4374,147,202,4723,92.61,3.11,4.28,2019
"0572320",10,0,0,10,100,0,0,2019
"0572328",19,0,0,19,100,0,0,2019
"0572830",3933,59,1602,5594,70.31,1.05,28.64,2019
"0572631",1483,97,321,1901,78.01,5.1,16.89,2019
"0572642",808,70,139,1017,79.45,6.88,13.67,2019
"0572729",71,0,28,99,71.72,0,28.28,2019
"0572769",230,67,165,462,49.78,14.5,35.71,2019
"0572821",393,30,360,783,50.19,3.83,45.98,2019
"0572832",222,12,167,401,55.36,2.99,41.65,2019
"0572835",276,0,73,349,79.08,0,20.92,2019
"0572854",145,8,185,338,42.9,2.37,54.73,2019
"0572944",940,20,308,1268,74.13,1.58,24.29,2019
"0572947",1072,88,413,1573,68.15,5.59,26.26,2019
"0572461",1050,61,436,1547,67.87,3.94,28.18,2019
"0572434",495,59,227,781,63.38,7.55,29.07,2019
"0572435",83,19,79,181,45.86,10.5,43.65,2019
"0572444",498,44,207,749,66.49,5.87,27.64,2019
"0572111",390,0,81,471,82.8,0,17.2,2019
"0572125",179,9,89,277,64.62,3.25,32.13,2019
"0572130",226,0,49,275,82.18,0,17.82,2019
"0572141",198,16,54,268,73.88,5.97,20.15,2019
"0572501",6471,1109,2411,9991,64.77,11.1,24.13,2019
"0572513",531,128,307,966,54.97,13.25,31.78,2019
"0572521",1193,232,675,2100,56.81,11.05,32.14,2019
"0572527",99,0,0,99,100,0,0,2019
"0572419",378,89,168,635,59.53,14.02,26.46,2019
"0572426",55,1,18,74,74.32,1.35,24.32,2019
"0572437",1115,46,261,1422,78.41,3.23,18.35,2019
"0572555",23,32,11,66,34.85,48.48,16.67,2019
"0572583",433,67,273,773,56.02,8.67,35.32,2019
"0572587",7,9,10,26,26.92,34.62,38.46,2019
"0572623",253,37,85,375,67.47,9.87,22.67,2019
"0572394",93,19,93,205,45.37,9.27,45.37,2019
"0572415",362,2,110,474,76.37,0.42,23.21,2019
"0572431",94,8,44,146,64.38,5.48,30.14,2019
"0572432",1985,59,514,2558,77.6,2.31,20.09,2019
"0572436",302,49,33,384,78.65,12.76,8.59,2019
"0572445",13,0,7,20,65,0,35,2019
"5399223",11851,397,1269,13517,87.67,2.94,9.39,2019
"5399330",232,52,36,320,72.5,16.25,11.25,2019
"5399337",9855,316,1089,11260,87.52,2.81,9.67,2019
"5399349",1829,41,346,2216,82.54,1.85,15.61,2019
"5399352",11483,640,754,12877,89.17,4.97,5.86,2019
"0299777",38,2,41,81,46.91,2.47,50.62,2019
"5399001",1434,16,156,1606,89.29,1,9.71,2019
"5399017",29,1,22,52,55.77,1.92,42.31,2019
"5399021",3290,96,323,3709,88.7,2.59,8.71,2019
"5399110",398,24,250,672,59.23,3.57,37.2,2019
"5399111",1266,48,375,1689,74.96,2.84,22.2,2019
"5399123",351,10,31,392,89.54,2.55,7.91,2019
"5399135",100,2,11,113,88.5,1.77,9.73,2019
"5399146",3,5,13,21,14.29,23.81,61.9,2019
"2421911",3339,115,474,3928,85.01,2.93,12.07,2019
"2421913",266,5,115,386,68.91,1.3,29.79,2019
"2421914",283,16,58,357,79.27,4.48,16.25,2019
"2421919",984,66,134,1184,83.11,5.57,11.32,2019
"2421040",6974,345,1173,8492,82.12,4.06,13.81,2019
"2421042",13381,167,514,14062,95.16,1.19,3.66,2019
"2421051",107,0,0,107,100,0,0,2019
"2421054",3809,87,289,4185,91.02,2.08,6.91,2019
"2421061",17834,575,2539,20948,85.13,2.74,12.12,2019
"2421087",1721,27,156,1904,90.39,1.42,8.19,2019
"2421034",1105,19,174,1298,85.13,1.46,13.41,2019
"2421047",4001,64,295,4360,91.77,1.47,6.77,2019
"2421050",5991,42,454,6487,92.35,0.65,7,2019
"2421626",13,0,32,45,28.89,0,71.11,2019
"2421628",127,0,51,178,71.35,0,28.65,2019
"2421678",578,31,188,797,72.52,3.89,23.59,2019
"2421703",12533,219,843,13595,92.19,1.61,6.2,2019
"2421740",17539,728,4626,22893,76.61,3.18,20.21,2019
"2421754",2207,50,121,2378,92.81,2.1,5.09,2019
"2421757",793,52,242,1087,72.95,4.78,22.26,2019
"2421776",1727,46,197,1970,87.66,2.34,10,2019
"2421780",476,5,90,571,83.36,0.88,15.76,2019
"2421783",2703,85,384,3172,85.21,2.68,12.11,2019
"2421794",752,55,0,807,93.18,6.82,0,2019
"2421795",3010,93,625,3728,80.74,2.49,16.77,2019
"2421797",2726,76,138,2940,92.72,2.59,4.69,2019
"2421804",12310,675,2270,15255,80.69,4.42,14.88,2019
"2421810",237,0,0,237,100,0,0,2019
"2421863",1304,68,415,1787,72.97,3.81,23.22,2019
"2421903",1825,119,353,2297,79.45,5.18,15.37,2019
"2421912",298,0,125,423,70.45,0,29.55,2019
"5123102",1036,5,146,1187,87.28,0.42,12.3,2019
"5123106",182,88,143,413,44.07,21.31,34.62,2019
"5123112",18537,277,722,19536,94.89,1.42,3.7,2019
"5123153",448,12,51,511,87.67,2.35,9.98,2019
"5123161",32,0,32,64,50,0,50,2019
"4218356",51,0,0,51,100,0,0,2019
"4218407",4493,119,1145,5757,78.04,2.07,19.89,2019
"4218420",17,0,0,17,100,0,0,2019
"4218425",478,19,51,548,87.23,3.47,9.31,2019
"4218433",2155,67,395,2617,82.35,2.56,15.09,2019
"4218360",7569,168,1615,9352,80.93,1.8,17.27,2019
"4218372",1009,13,22,1044,96.65,1.25,2.11,2019
"4218403",2267,32,499,2798,81.02,1.14,17.83,2019
"4218413",106,0,0,106,100,0,0,2019
"4218218",770,65,171,1006,76.54,6.46,17,2019
"4218220",74,0,49,123,60.16,0,39.84,2019
"4218101",1217,41,447,1705,71.38,2.4,26.22,2019
"4218321",486,0,72,558,87.1,0,12.9,2019
"4218327",235,10,30,275,85.45,3.64,10.91,2019
"4218034",2737,153,259,3149,86.92,4.86,8.22,2019
"4218054",1536,22,108,1666,92.2,1.32,6.48,2019
"4218846",319,5,76,400,79.75,1.25,19,2019
"4218848",2852,72,781,3705,76.98,1.94,21.08,2019
"4218853",1465,12,224,1701,86.13,0.71,13.17,2019
"4218923",356,0,5,361,98.61,0,1.39,2019
"4218930",990,28,159,1177,84.11,2.38,13.51,2019
"4218951",11543,187,1675,13405,86.11,1.4,12.5,2019
"4218970",258,11,17,286,90.21,3.85,5.94,2019
"4218812",621,3,72,696,89.22,0.43,10.34,2019
"4218823",51,4,37,92,55.43,4.35,40.22,2019
"4218837",966,33,214,1213,79.64,2.72,17.64,2019
"4218844",643,9,96,748,85.96,1.2,12.83,2019
"4218925",2238,23,79,2340,95.64,0.98,3.38,2019
"4218932",162,0,18,180,90,0,10,2019
"4218955",489,31,83,603,81.09,5.14,13.76,2019
"4218972",1394,21,172,1587,87.84,1.32,10.84,2019
"4218977",1569,16,31,1616,97.09,0.99,1.92,2019
"4218058",2757,141,494,3392,81.28,4.16,14.56,2019
"4218062",9228,223,786,10237,90.14,2.18,7.68,2019
"4218063",158,0,65,223,70.85,0,29.15,2019
"4218077",829,24,94,947,87.54,2.53,9.93,2019
"4218219",556,0,102,658,84.5,0,15.5,2019
"4218222",3265,9,373,3647,89.53,0.25,10.23,2019
"4218235",6283,98,1428,7809,80.46,1.25,18.29,2019
"4218239",102,0,114,216,47.22,0,52.78,2019
"4218246",78,0,16,94,82.98,0,17.02,2019
"4218252",3535,80,1142,4757,74.31,1.68,24.01,2019
"4218256",123,0,33,156,78.85,0,21.15,2019
"4218336",1329,30,328,1687,78.78,1.78,19.44,2019
"4218347",1190,0,133,1323,89.95,0,10.05,2019
"4218354",319,0,21,340,93.82,0,6.18,2019
"4218231",137,8,54,199,68.84,4.02,27.14,2019
"4218234",78,0,17,95,82.11,0,17.89,2019
"4218240",1248,105,257,1610,77.52,6.52,15.96,2019
"4218255",1367,22,336,1725,79.25,1.28,19.48,2019
"4218301",8032,206,1456,9694,82.86,2.13,15.02,2019
"4218332",755,9,50,814,92.75,1.11,6.14,2019
"4218343",1310,28,277,1615,81.11,1.73,17.15,2019
"4218439",150,3,35,188,79.79,1.6,18.62,2019
"2421610",137,14,34,185,74.05,7.57,18.38,2019
"2421645",344,34,85,463,74.3,7.34,18.36,2019
"2421014",12587,241,1349,14177,88.78,1.7,9.52,2019
"2421035",2522,0,131,2653,95.06,0,4.94,2019
"2421052",65,0,11,76,85.53,0,14.47,2019
"4219345",0,0,0,0,NA,NA,NA,2019
"4219373",856,11,12,879,97.38,1.25,1.37,2019
"4219380",19141,169,1339,20649,92.7,0.82,6.48,2019
"4219405",2134,32,202,2368,90.12,1.35,8.53,2019
"4219428",7318,151,601,8070,90.68,1.87,7.45,2019
"4219436",249,74,84,407,61.18,18.18,20.64,2019
"4219475",3626,88,542,4256,85.2,2.07,12.73,2019
"4219492",72,9,163,244,29.51,3.69,66.8,2019
"4219008",6411,178,680,7269,88.2,2.45,9.35,2019
"4219021",3294,51,508,3853,85.49,1.32,13.18,2019
"4219027",7811,124,568,8503,91.86,1.46,6.68,2019
"4219029",1253,4,165,1422,88.12,0.28,11.6,2019
"4219031",1479,47,132,1658,89.2,2.83,7.96,2019
"4219050",9167,364,1643,11174,82.04,3.26,14.7,2019
"4219057",5245,68,914,6227,84.23,1.09,14.68,2019
"4219083",11825,146,882,12853,92,1.14,6.86,2019
"4219085",1796,21,7,1824,98.46,1.15,0.38,2019
"4219094",1432,0,175,1607,89.11,0,10.89,2019
"4219055",4224,138,546,4908,86.06,2.81,11.12,2019
"4219056",4752,160,596,5508,86.27,2.9,10.82,2019
"4219078",3842,72,662,4576,83.96,1.57,14.47,2019
"4219090",6357,114,578,7049,90.18,1.62,8.2,2019
"4219001",5601,104,503,6208,90.22,1.68,8.1,2019
"4219004",3604,48,249,3901,92.39,1.23,6.38,2019
"4219007",6628,290,1294,8212,80.71,3.53,15.76,2019
"4219009",206,16,17,239,86.19,6.69,7.11,2019
"4219013",8931,339,2946,12216,73.11,2.78,24.12,2019
"4219023",5819,402,1146,7367,78.99,5.46,15.56,2019
"4219032",2055,40,250,2345,87.63,1.71,10.66,2019
"4219036",4489,70,768,5327,84.27,1.31,14.42,2019
"4219044",6190,46,472,6708,92.28,0.69,7.04,2019
"4219054",5287,147,519,5953,88.81,2.47,8.72,2019
"4219070",2563,91,212,2866,89.43,3.18,7.4,2019
"4219072",3803,32,241,4076,93.3,0.79,5.91,2019
"4219073",7243,114,661,8018,90.33,1.42,8.24,2019
"4219087",11284,136,423,11843,95.28,1.15,3.57,2019
"4219111",20090,506,3655,24251,82.84,2.09,15.07,2019
"4219123",6589,417,1015,8021,82.15,5.2,12.65,2019
"4219142",6276,680,2873,9829,63.85,6.92,29.23,2019
"4219143",16325,2403,6374,25102,65.03,9.57,25.39,2019
"4219148",15327,864,3070,19261,79.58,4.49,15.94,2019
"4219149",14999,682,3165,18846,79.59,3.62,16.79,2019
"4219151",8897,550,2333,11780,75.53,4.67,19.8,2019
"1019805",11548,887,2421,14856,77.73,5.97,16.3,2019
"1019970",3448,100,348,3896,88.5,2.57,8.93,2019
"1019977",7838,66,720,8624,90.89,0.77,8.35,2019
"4219406",10203,114,681,10998,92.77,1.04,6.19,2019
"4219425",5143,11,127,5281,97.39,0.21,2.4,2019
"4219520",2103,45,167,2315,90.84,1.94,7.21,2019
"4219523",126,0,14,140,90,0,10,2019
"4219541",1459,1,238,1698,85.92,0.06,14.02,2019
"4219544",42,0,3,45,93.33,0,6.67,2019
"4219549",100,14,20,134,74.63,10.45,14.93,2019
"4219550",95,0,23,118,80.51,0,19.49,2019
"1019941",757,27,276,1060,71.42,2.55,26.04,2019
"1019734",3778,83,349,4210,89.74,1.97,8.29,2019
"1019801",4041,677,1675,6393,63.21,10.59,26.2,2019
"1019803",7713,216,613,8542,90.3,2.53,7.18,2019
"5122448",158,0,8,166,95.18,0,4.82,2019
"5399150",114,0,32,146,78.08,0,21.92,2019
"5399151",14,0,35,49,28.57,0,71.43,2019
"5399158",172,13,39,224,76.79,5.8,17.41,2019
"5399167",185,4,62,251,73.71,1.59,24.7,2019
"5399180",301,14,151,466,64.59,3,32.4,2019
"5399181",529,28,155,712,74.3,3.93,21.77,2019
"5399204",3092,92,298,3482,88.8,2.64,8.56,2019
"5399206",13560,167,1647,15374,88.2,1.09,10.71,2019
"0695355",19030,451,1913,21394,88.95,2.11,8.94,2019
"0695450",95,0,32,127,74.8,0,25.2,2019
"0695589",465,0,70,535,86.92,0,13.08,2019
"5398851",1273,52,418,1743,73.03,2.98,23.98,2019
"5398860",85,0,31,116,73.28,0,26.72,2019
"5398935",790,59,212,1061,74.46,5.56,19.98,2019
"5398936",1828,31,122,1981,92.28,1.56,6.16,2019
"5398937",1356,23,279,1658,81.79,1.39,16.83,2019
"5398943",325,28,40,393,82.7,7.12,10.18,2019
"5398947",745,42,180,967,77.04,4.34,18.61,2019
"5398002",11490,376,1609,13475,85.27,2.79,11.94,2019
"5398008",8557,137,584,9278,92.23,1.48,6.29,2019
"5398014",2456,30,170,2656,92.47,1.13,6.4,2019
"5398020",8002,150,450,8602,93.02,1.74,5.23,2019
"5398042",15734,334,618,16686,94.29,2,3.7,2019
"5398047",1964,79,273,2316,84.8,3.41,11.79,2019
"5398115",21280,742,900,22922,92.84,3.24,3.93,2019
"5398295",774,21,159,954,81.13,2.2,16.67,2019
"5398297",15,0,10,25,60,0,40,2019
"5398303",581,0,47,628,92.52,0,7.48,2019
"5398310",7866,160,955,8981,87.58,1.78,10.63,2019
"5398342",554,13,17,584,94.86,2.23,2.91,2019
"5398381",129,0,11,140,92.14,0,7.86,2019
"5398382",11930,248,1383,13561,87.97,1.83,10.2,2019
"5398394",492,49,19,560,87.86,8.75,3.39,2019
"5398406",8281,391,1081,9753,84.91,4.01,11.08,2019
"5398424",3573,67,546,4186,85.36,1.6,13.04,2019
"5398503",13805,420,1585,15810,87.32,2.66,10.03,2019
"5398526",43,3,30,76,56.58,3.95,39.47,2019
"5398528",3483,91,535,4109,84.77,2.21,13.02,2019
"5398532",7750,224,1160,9134,84.85,2.45,12.7,2019
"5398552",133,0,50,183,72.68,0,27.32,2019
"5398570",1249,8,298,1555,80.32,0.51,19.16,2019
"5398595",987,0,108,1095,90.14,0,9.86,2019
"5398596",2195,100,444,2739,80.14,3.65,16.21,2019
"5398605",333,18,103,454,73.35,3.96,22.69,2019
"5398597",7691,90,726,8507,90.41,1.06,8.53,2019
"0299561",48,12,23,83,57.83,14.46,27.71,2019
"0299564",13,1,4,18,72.22,5.56,22.22,2019
"0299573",163,3,40,206,79.13,1.46,19.42,2019
"0299576",698,2,118,818,85.33,0.24,14.43,2019
"0299590",27,0,31,58,46.55,0,53.45,2019
"0299604",142,0,62,204,69.61,0,30.39,2019
"0299702",996,7,0,1003,99.3,0.7,0,2019
"0299743",341,8,16,365,93.42,2.19,4.38,2019
"0299776",13,0,19,32,40.62,0,59.38,2019
"5399103",181,4,31,216,83.8,1.85,14.35,2019
"5399163",10424,975,769,12168,85.67,8.01,6.32,2019
"5399343",781,5,53,839,93.09,0.6,6.32,2019
"5399003",1523,103,191,1817,83.82,5.67,10.51,2019
"0299730",10,2,22,34,29.41,5.88,64.71,2019
"2421075",11567,280,458,12305,94,2.28,3.72,2019
"2421077",109,18,0,127,85.83,14.17,0,2019
"2421082",230,7,8,245,93.88,2.86,3.27,2019
"2421093",13830,351,1219,15400,89.81,2.28,7.92,2019
"2421108",6074,50,404,6528,93.05,0.77,6.19,2019
"2421158",6637,157,798,7592,87.42,2.07,10.51,2019
"2421202",7414,472,1490,9376,79.07,5.03,15.89,2019
"2421207",13541,2085,3110,18736,72.27,11.13,16.6,2019
"2421222",16573,450,3714,20737,79.92,2.17,17.91,2019
"2421225",8657,580,2974,12211,70.9,4.75,24.36,2019
"2421918",1103,51,165,1319,83.62,3.87,12.51,2019
"2421071",189,0,0,189,100,0,0,2019
"2421140",1262,0,70,1332,94.74,0,5.26,2019
"2421286",7100,216,710,8026,88.46,2.69,8.85,2019
"2421153",114,0,55,169,67.46,0,32.54,2019
"2421240",0,0,0,0,NA,NA,NA,2019
"2421250",0,0,0,0,NA,NA,NA,2019
"2421251",0,0,0,0,NA,NA,NA,2019
"2421252",0,0,0,0,NA,NA,NA,2019
"2421409",7139,62,227,7428,96.11,0.83,3.06,2019
"2421652",68,0,0,68,100,0,0,2019
"2421705",0,0,0,0,NA,NA,NA,2019
"2421714",62,0,0,62,100,0,0,2019
"2421746",0,0,0,0,NA,NA,NA,2019
"2421781",16,0,0,16,100,0,0,2019
"2421802",0,0,0,0,NA,NA,NA,2019
"2421890",0,0,0,0,NA,NA,NA,2019
"2421916",0,0,0,0,NA,NA,NA,2019
"2421104",1786,34,88,1908,93.61,1.78,4.61,2019
"2421204",7002,261,479,7742,90.44,3.37,6.19,2019
"2421521",384,14,153,551,69.69,2.54,27.77,2019
"2421074",4805,116,606,5527,86.94,2.1,10.96,2019
"2421205",3659,231,1454,5344,68.47,4.32,27.21,2019
"2421227",9908,410,1928,12246,80.91,3.35,15.74,2019
"2421037",7492,104,362,7958,94.14,1.31,4.55,2019
"2421201",7044,609,1741,9394,74.98,6.48,18.53,2019
"2421550",4577,154,1223,5954,76.87,2.59,20.54,2019
"5122643",106,0,0,106,100,0,0,2019
"5122624",794,121,138,1053,75.4,11.49,13.11,2019
"5122627",255,0,39,294,86.73,0,13.27,2019
"5122644",780,0,181,961,81.17,0,18.83,2019
"5122701",10191,304,1638,12133,83.99,2.51,13.5,2019
"5122718",112,0,45,157,71.34,0,28.66,2019
"5122720",301,13,22,336,89.58,3.87,6.55,2019
"5122731",11,0,0,11,100,0,0,2019
"5122735",750,0,59,809,92.71,0,7.29,2019
"5122736",138,9,137,284,48.59,3.17,48.24,2019
"5122742",554,10,60,624,88.78,1.6,9.62,2019
"5122743",25,0,45,70,35.71,0,64.29,2019
"5122713",441,13,114,568,77.64,2.29,20.07,2019
"5122812",2593,54,661,3308,78.39,1.63,19.98,2019
"5122936",1792,60,46,1898,94.42,3.16,2.42,2019
"5122939",2001,31,297,2329,85.92,1.33,12.75,2019
"5122958",1004,0,46,1050,95.62,0,4.38,2019
"5425425",4215,246,558,5019,83.98,4.9,11.12,2019
"5425431",74,0,22,96,77.08,0,22.92,2019
"5425534",38,16,66,120,31.67,13.33,55,2019
"5425541",2920,204,1058,4182,69.82,4.88,25.3,2019
"5425841",135,24,21,180,75,13.33,11.67,2019
"4197741",3547,72,787,4406,80.5,1.63,17.86,2019
"4197750",114,3,36,153,74.51,1.96,23.53,2019
"4197756",13568,323,1078,14969,90.64,2.16,7.2,2019
"4197760",2520,40,337,2897,86.99,1.38,11.63,2019
"4197906",82,1,23,106,77.36,0.94,21.7,2019
"4197913",1333,31,414,1778,74.97,1.74,23.28,2019
"4197015",7872,327,704,8903,88.42,3.67,7.91,2019
"4197037",370,0,61,431,85.85,0,14.15,2019
"4197065",227,3,44,274,82.85,1.09,16.06,2019
"4197113",3839,199,427,4465,85.98,4.46,9.56,2019
"4197123",14453,746,1073,16272,88.82,4.58,6.59,2019
"4197133",1570,45,151,1766,88.9,2.55,8.55,2019
"4197138",3471,212,685,4368,79.46,4.85,15.68,2019
"4197326",400,0,46,446,89.69,0,10.31,2019
"4197204",257,10,117,384,66.93,2.6,30.47,2019
"4197212",10172,171,565,10908,93.25,1.57,5.18,2019
"4197215",7212,159,479,7850,91.87,2.03,6.1,2019
"4197321",9526,221,846,10593,89.93,2.09,7.99,2019
"4197350",53,0,29,82,64.63,0,35.37,2019
"4197814",3970,243,937,5150,77.09,4.72,18.19,2019
"4197835",116,3,2,121,95.87,2.48,1.65,2019
"4197867",196,18,81,295,66.44,6.1,27.46,2019
"4197874",161,6,26,193,83.42,3.11,13.47,2019
"4197905",45,0,0,45,100,0,0,2019
"4197907",147,20,68,235,62.55,8.51,28.94,2019
"4197918",1219,64,272,1555,78.39,4.12,17.49,2019
"4197850",5830,233,950,7013,83.13,3.32,13.55,2019
"4197864",78,0,34,112,69.64,0,30.36,2019
"4197910",145,9,53,207,70.05,4.35,25.6,2019
"4197004",1434,9,264,1707,84.01,0.53,15.47,2019
"4197017",961,25,78,1064,90.32,2.35,7.33,2019
"4197021",352,34,76,462,76.19,7.36,16.45,2019
"4197845",1077,7,253,1337,80.55,0.52,18.92,2019
"4197825",97,3,16,116,83.62,2.59,13.79,2019
"4197838",7556,322,1398,9276,81.46,3.47,15.07,2019
"4197842",52,0,13,65,80,0,20,2019
"4197848",63,2,11,76,82.89,2.63,14.47,2019
"4197883",844,28,150,1022,82.58,2.74,14.68,2019
"4197885",421,23,154,598,70.4,3.85,25.75,2019
"4197914",4324,232,1392,5948,72.7,3.9,23.4,2019
"4197029",97,5,3,105,92.38,4.76,2.86,2019
"4197001",59,0,10,69,85.51,0,14.49,2019
"4197013",7468,299,951,8718,85.66,3.43,10.91,2019
"4197022",1065,0,276,1341,79.42,0,20.58,2019
"4197002",2171,63,179,2413,89.97,2.61,7.42,2019
"2304411",604,4,70,678,89.09,0.59,10.32,2019
"2304239",1656,29,195,1880,88.09,1.54,10.37,2019
"2304490",95,10,7,112,84.82,8.93,6.25,2019
"2304747",441,32,112,585,75.38,5.47,19.15,2019
"2304027",1928,39,175,2142,90.01,1.82,8.17,2019
"2304087",721,0,95,816,88.36,0,11.64,2019
"2304769",2894,225,939,4058,71.32,5.54,23.14,2019
"2304253",731,19,87,837,87.34,2.27,10.39,2019
"2304219",438,21,94,553,79.2,3.8,17,2019
"2304236",1364,10,218,1592,85.68,0.63,13.69,2019
"2304238",418,20,38,476,87.82,4.2,7.98,2019
"2304255",174,21,42,237,73.42,8.86,17.72,2019
"2304270",1748,84,385,2217,78.85,3.79,17.37,2019
"2304285",132,4,43,179,73.74,2.23,24.02,2019
"0299737",1038,80,289,1407,73.77,5.69,20.54,2019
"5399012",281,3,51,335,83.88,0.9,15.22,2019
"5399016",5540,203,464,6207,89.25,3.27,7.48,2019
"0299683",139,5,44,188,73.94,2.66,23.4,2019
"0299691",15,4,31,50,30,8,62,2019
"5399166",987,29,343,1359,72.63,2.13,25.24,2019
"5399176",46,0,31,77,59.74,0,40.26,2019
"5399179",161,0,17,178,90.45,0,9.55,2019
"0299663",142,2,28,172,82.56,1.16,16.28,2019
"0299630",58,0,29,87,66.67,0,33.33,2019
"0299637",89,0,32,121,73.55,0,26.45,2019
"0299658",173,0,63,236,73.31,0,26.69,2019
"0299671",81,8,41,130,62.31,6.15,31.54,2019
"0299679",13,6,47,66,19.7,9.09,71.21,2019
"0299681",63,0,19,82,76.83,0,23.17,2019
"0299684",113,2,55,170,66.47,1.18,32.35,2019
"0299688",704,53,224,981,71.76,5.4,22.83,2019
"0299694",405,21,87,513,78.95,4.09,16.96,2019
"2501007",5186,63,314,5563,93.22,1.13,5.64,2019
"2501020",10506,308,1984,12798,82.09,2.41,15.5,2019
"2501030",3953,70,393,4416,89.52,1.59,8.9,2019
"2501034",712,32,111,855,83.27,3.74,12.98,2019
"2501035",2045,42,207,2294,89.15,1.83,9.02,2019
"2501053",488,46,31,565,86.37,8.14,5.49,2019
"2501057",3073,48,405,3526,87.15,1.36,11.49,2019
"2501082",3893,72,622,4587,84.87,1.57,13.56,2019
"2501085",13272,522,1757,15551,85.34,3.36,11.3,2019
"2501088",172,0,70,242,71.07,0,28.93,2019
"2501104",5895,906,2109,8910,66.16,10.17,23.67,2019
"2501106",5302,125,342,5769,91.91,2.17,5.93,2019
"2501226",2673,82,333,3088,86.56,2.66,10.78,2019
"2501255",290,2,61,353,82.15,0.57,17.28,2019
"2501258",175,3,36,214,81.78,1.4,16.82,2019
"2501301",6797,286,1081,8164,83.26,3.5,13.24,2019
"2501339",444,9,94,547,81.17,1.65,17.18,2019
"2501370",1488,48,275,1811,82.16,2.65,15.18,2019
"2501375",1475,128,74,1677,87.95,7.63,4.41,2019
"2501452",1573,0,124,1697,92.69,0,7.31,2019
"2501464",2224,12,213,2449,90.81,0.49,8.7,2019
"2501474",670,7,30,707,94.77,0.99,4.24,2019
"2501501",5533,244,857,6634,83.4,3.68,12.92,2019
"2501503",1021,57,101,1179,86.6,4.83,8.57,2019
"2501504",3212,61,253,3526,91.09,1.73,7.18,2019
"2501510",4843,161,590,5594,86.57,2.88,10.55,2019
"2501003",4,38,0,42,9.52,90.48,0,2019
"2304936",69,11,22,102,67.65,10.78,21.57,2019
"2304942",406,13,151,570,71.23,2.28,26.49,2019
"2304945",330,46,105,481,68.61,9.56,21.83,2019
"2304957",1362,19,285,1666,81.75,1.14,17.11,2019
"2304963",2562,73,448,3083,83.1,2.37,14.53,2019
"2304543",706,81,108,895,78.88,9.05,12.07,2019
"2304579",1168,22,89,1279,91.32,1.72,6.96,2019
"2304642",47,0,11,58,81.03,0,18.97,2019
"2304652",654,13,169,836,78.23,1.56,20.22,2019
"2304654",1033,92,264,1389,74.37,6.62,19.01,2019
"2304660",473,19,40,532,88.91,3.57,7.52,2019
"2304669",64,0,8,72,88.89,0,11.11,2019
"2304758",359,41,151,551,65.15,7.44,27.4,2019
"2304765",268,4,196,468,57.26,0.85,41.88,2019
"5425696",37,0,58,95,38.95,0,61.05,2019
"5425705",7119,700,1395,9214,77.26,7.6,15.14,2019
"5425820",136,18,32,186,73.12,9.68,17.2,2019
"5425855",10,0,39,49,20.41,0,79.59,2019
"5425865",417,7,109,533,78.24,1.31,20.45,2019
"5425875",227,0,22,249,91.16,0,8.84,2019
"5425878",255,28,45,328,77.74,8.54,13.72,2019
"5425555",400,28,225,653,61.26,4.29,34.46,2019
"5425607",350,0,89,439,79.73,0,20.27,2019
"5425630",129,0,110,239,53.97,0,46.03,2019
"5425649",412,0,26,438,94.06,0,5.94,2019
"5425879",86,0,14,100,86,0,14,2019
"5425880",2191,159,464,2814,77.86,5.65,16.49,2019
"5425908",49,0,0,49,100,0,0,2019
"5425921",519,88,352,959,54.12,9.18,36.7,2019
"5425936",0,2,11,13,0,15.38,84.62,2019
"5425942",61,0,0,61,100,0,0,2019
"5425007",160,14,7,181,88.4,7.73,3.87,2019
"5425008",64,0,17,81,79.01,0,20.99,2019
"5425011",146,3,105,254,57.48,1.18,41.34,2019
"5425015",1348,24,214,1586,84.99,1.51,13.49,2019
"5425024",141,33,63,237,59.49,13.92,26.58,2019
"5425031",275,18,21,314,87.58,5.73,6.69,2019
"5425040",208,0,44,252,82.54,0,17.46,2019
"5425047",33,43,10,86,38.37,50,11.63,2019
"5425064",3544,106,650,4300,82.42,2.47,15.12,2019
"5425070",433,6,224,663,65.31,0.9,33.79,2019
"5425508",3176,128,767,4071,78.02,3.14,18.84,2019
"5425523",790,13,315,1118,70.66,1.16,28.18,2019
"5425530",1590,54,546,2190,72.6,2.47,24.93,2019
"5425537",476,40,181,697,68.29,5.74,25.97,2019
"5425540",93,0,35,128,72.66,0,27.34,2019
"5425550",2561,237,752,3550,72.14,6.68,21.18,2019
"5425557",454,63,134,651,69.74,9.68,20.58,2019
"5425567",160,17,68,245,65.31,6.94,27.76,2019
"5425573",211,27,66,304,69.41,8.88,21.71,2019
"5425652",470,43,76,589,79.8,7.3,12.9,2019
"5425670",1755,25,613,2393,73.34,1.04,25.62,2019
"5425692",271,14,150,435,62.3,3.22,34.48,2019
"5425049",124,0,22,146,84.93,0,15.07,2019
"5425071",3693,180,994,4867,75.88,3.7,20.42,2019
"5425088",82,0,28,110,74.55,0,25.45,2019
"5425107",177,0,108,285,62.11,0,37.89,2019
"5425113",152,31,82,265,57.36,11.7,30.94,2019
"5425124",291,0,225,516,56.4,0,43.6,2019
"5425003",933,42,193,1168,79.88,3.6,16.52,2019
"5425019",166,0,41,207,80.19,0,19.81,2019
"5425134",80,0,93,173,46.24,0,53.76,2019
"5425140",264,10,223,497,53.12,2.01,44.87,2019
"5425161",115,0,39,154,74.68,0,25.32,2019
"5425204",39,0,12,51,76.47,0,23.53,2019
"5425208",216,4,81,301,71.76,1.33,26.91,2019
"5425209",345,24,88,457,75.49,5.25,19.26,2019
"5425248",787,58,411,1256,62.66,4.62,32.72,2019
"3728016",3744,204,1044,4992,75,4.09,20.91,2019
"3728034",4944,179,1280,6403,77.21,2.8,19.99,2019
"3728037",7695,130,588,8413,91.47,1.55,6.99,2019
"3728056",11237,219,1514,12970,86.64,1.69,11.67,2019
"3728071",776,6,285,1067,72.73,0.56,26.71,2019
"2304330",9358,283,2078,11719,79.85,2.41,17.73,2019
"2304401",15885,755,2146,18786,84.56,4.02,11.42,2019
"2304417",111,3,61,175,63.43,1.71,34.86,2019
"2304438",354,15,97,466,75.97,3.22,20.82,2019
"2304471",255,0,54,309,82.52,0,17.48,2019
"2304476",425,11,139,575,73.91,1.91,24.17,2019
"2304479",403,31,151,585,68.89,5.3,25.81,2019
"2304538",703,24,224,951,73.92,2.52,23.55,2019
"2304548",415,13,30,458,90.61,2.84,6.55,2019
"2304553",676,41,79,796,84.92,5.15,9.92,2019
"2304558",88,0,7,95,92.63,0,7.37,2019
"2304574",475,40,78,593,80.1,6.75,13.15,2019
"2304607",410,35,60,505,81.19,6.93,11.88,2019
"2304630",424,26,131,581,72.98,4.48,22.55,2019
"2304646",30,8,0,38,78.95,21.05,0,2019
"2304658",479,8,120,607,78.91,1.32,19.77,2019
"2304668",460,18,149,627,73.37,2.87,23.76,2019
"2304683",51,0,0,51,100,0,0,2019
"2304691",123,0,17,140,87.86,0,12.14,2019
"2304732",441,46,258,745,59.19,6.17,34.63,2019
"2304739",213,35,76,324,65.74,10.8,23.46,2019
"2304742",985,118,349,1452,67.84,8.13,24.04,2019
"2304973",445,0,87,532,83.65,0,16.35,2019
"2304619",1088,126,325,1539,70.7,8.19,21.12,2019
"2304685",147,11,31,189,77.78,5.82,16.4,2019
"2304932",441,3,86,530,83.21,0.57,16.23,2019
"2304071",1922,54,156,2132,90.15,2.53,7.32,2019
"2304237",81,0,8,89,91.01,0,8.99,2019
"2304348",958,34,256,1248,76.76,2.72,20.51,2019
"2304461",1100,88,89,1277,86.14,6.89,6.97,2019
"2304472",770,54,88,912,84.43,5.92,9.65,2019
"2304474",1325,37,104,1466,90.38,2.52,7.09,2019
"2304497",109,10,40,159,68.55,6.29,25.16,2019
"2304541",23,0,0,23,100,0,0,2019
"2304551",262,16,46,324,80.86,4.94,14.2,2019
"2304554",299,0,69,368,81.25,0,18.75,2019
"2304609",1980,81,275,2336,84.76,3.47,11.77,2019
"2304611",129,0,51,180,71.67,0,28.33,2019
"2304622",348,21,166,535,65.05,3.93,31.03,2019
"2304643",302,11,83,396,76.26,2.78,20.96,2019
"2304645",11,3,0,14,78.57,21.43,0,2019
"2304655",300,6,33,339,88.5,1.77,9.73,2019
"2304675",55,0,9,64,85.94,0,14.06,2019
"2304677",98,0,14,112,87.5,0,12.5,2019
"2304680",363,34,161,558,65.05,6.09,28.85,2019
"0572738",552,50,264,866,63.74,5.77,30.48,2019
"0572749",10,0,30,40,25,0,75,2019
"0572760",107,1,20,128,83.59,0.78,15.62,2019
"0572761",4844,1257,1432,7533,64.3,16.69,19.01,2019
"0572773",343,30,136,509,67.39,5.89,26.72,2019
"0572776",223,46,59,328,67.99,14.02,17.99,2019
"0572823",1495,92,732,2319,64.47,3.97,31.57,2019
"0572826",11,0,5,16,68.75,0,31.25,2019
"0572838",47,0,9,56,83.93,0,16.07,2019
"0572851",168,11,12,191,87.96,5.76,6.28,2019
"0572852",8,15,15,38,21.05,39.47,39.47,2019
"0572853",570,44,332,946,60.25,4.65,35.1,2019
"0572865",406,10,88,504,80.56,1.98,17.46,2019
"0572908",4863,99,538,5500,88.42,1.8,9.78,2019
"2304848",239,14,40,293,81.57,4.78,13.65,2019
"2304849",1512,51,160,1723,87.75,2.96,9.29,2019
"2304911",625,23,301,949,65.86,2.42,31.72,2019
"2304947",562,9,79,650,86.46,1.38,12.15,2019
"2304961",312,14,80,406,76.85,3.45,19.7,2019
"2304779",129,8,20,157,82.17,5.1,12.74,2019
"2304008",1032,83,128,1243,83.02,6.68,10.3,2019
"2304022",382,29,34,445,85.84,6.52,7.64,2019
"2304048",954,90,168,1212,78.71,7.43,13.86,2019
"2304220",959,60,142,1161,82.6,5.17,12.23,2019
"2304240",12197,548,2872,15617,78.1,3.51,18.39,2019
"2304250",1605,47,214,1866,86.01,2.52,11.47,2019
"2304259",1218,21,132,1371,88.84,1.53,9.63,2019
"2304260",1887,84,78,2049,92.09,4.1,3.81,2019
"2304261",111,5,38,154,72.08,3.25,24.68,2019
"2304274",1853,106,275,2234,82.95,4.74,12.31,2019
"2304363",848,33,171,1052,80.61,3.14,16.25,2019
"2304061",1044,64,0,1108,94.22,5.78,0,2019
"2304037",952,51,192,1195,79.67,4.27,16.07,2019
"2304051",292,36,86,414,70.53,8.7,20.77,2019
"2304072",7058,198,697,7953,88.75,2.49,8.76,2019
"2304095",391,0,89,480,81.46,0,18.54,2019
"2304108",393,12,21,426,92.25,2.82,4.93,2019
"2304224",678,20,217,915,74.1,2.19,23.72,2019
"2304263",739,32,64,835,88.5,3.83,7.66,2019
"2304265",378,0,42,420,90,0,10,2019
"2304344",1198,11,133,1342,89.27,0.82,9.91,2019
"2304350",1324,32,161,1517,87.28,2.11,10.61,2019
"2304358",1455,43,240,1738,83.72,2.47,13.81,2019
"2304408",67,0,14,81,82.72,0,17.28,2019
"2304416",1946,18,378,2342,83.09,0.77,16.14,2019
"2304418",510,34,126,670,76.12,5.07,18.81,2019
"2304428",945,98,162,1205,78.42,8.13,13.44,2019
"2304434",347,8,47,402,86.32,1.99,11.69,2019
"2304444",3290,16,293,3599,91.41,0.44,8.14,2019
"2304456",943,22,109,1074,87.8,2.05,10.15,2019
"2304475",169,10,54,233,72.53,4.29,23.18,2019
"2304488",469,5,81,555,84.5,0.9,14.59,2019
"2304496",1454,0,172,1626,89.42,0,10.58,2019
"2304530",4106,74,906,5086,80.73,1.45,17.81,2019
"2304537",893,32,64,989,90.29,3.24,6.47,2019
"2304555",647,22,92,761,85.02,2.89,12.09,2019
"2304572",1898,116,387,2401,79.05,4.83,16.12,2019
"2304606",386,14,94,494,78.14,2.83,19.03,2019
"2304612",213,0,24,237,89.87,0,10.13,2019
"0572456",150,9,65,224,66.96,4.02,29.02,2019
"0572459",371,6,181,558,66.49,1.08,32.44,2019
"0572466",341,34,187,562,60.68,6.05,33.27,2019
"0572530",476,8,213,697,68.29,1.15,30.56,2019
"0572540",31,13,4,48,64.58,27.08,8.33,2019
"0572542",982,219,495,1696,57.9,12.91,29.19,2019
"0572004",141,18,216,375,37.6,4.8,57.6,2019
"0572005",27,0,24,51,52.94,0,47.06,2019
"0572014",9,0,13,22,40.91,0,59.09,2019
"0572015",8282,318,1912,10512,78.79,3.03,18.19,2019
"0572032",10114,591,1851,12556,80.55,4.71,14.74,2019
"0572042",1434,84,595,2113,67.87,3.98,28.16,2019
"0572051",173,13,19,205,84.39,6.34,9.27,2019
"0572081",1894,141,800,2835,66.81,4.97,28.22,2019
"3728075",5930,97,120,6147,96.47,1.58,1.95,2019
"3728079",12097,160,691,12948,93.43,1.24,5.34,2019
"3728080",2263,92,588,2943,76.89,3.13,19.98,2019
"3728089",19,0,12,31,61.29,0,38.71,2019
"3728115",11541,508,1588,13637,84.63,3.73,11.64,2019
"3728120",7151,101,1030,8282,86.34,1.22,12.44,2019
"3728169",25,13,33,71,35.21,18.31,46.48,2019
"3728202",6395,378,485,7258,88.11,5.21,6.68,2019
"3728206",3458,141,1412,5011,69.01,2.81,28.18,2019
"3728207",3660,46,154,3860,94.82,1.19,3.99,2019
"3728270",12744,139,466,13349,95.47,1.04,3.49,2019
"3728301",4561,173,2040,6774,67.33,2.55,30.12,2019
"3728311",12438,416,1718,14572,85.36,2.85,11.79,2019
"3728385",613,8,316,937,65.42,0.85,33.72,2019
"3728323",1217,25,186,1428,85.22,1.75,13.03,2019
"3728325",171,15,65,251,68.13,5.98,25.9,2019
"3728372",2675,230,1648,4553,58.75,5.05,36.2,2019
"3728387",5666,257,925,6848,82.74,3.75,13.51,2019
"3728399",542,26,290,858,63.17,3.03,33.8,2019
"3728447",490,0,75,565,86.73,0,13.27,2019
"3728454",750,17,86,853,87.92,1.99,10.08,2019
"3728455",674,17,272,963,69.99,1.77,28.25,2019
"3728457",3011,126,754,3891,77.38,3.24,19.38,2019
"3728460",4083,181,200,4464,91.47,4.05,4.48,2019
"3728465",3171,89,251,3511,90.32,2.53,7.15,2019
"3728467",4398,67,458,4923,89.34,1.36,9.3,2019
"3728707",73,0,17,90,81.11,0,18.89,2019
"3728709",707,55,114,876,80.71,6.28,13.01,2019
"3728464",544,14,633,1191,45.68,1.18,53.15,2019
"3728519",110,6,57,173,63.58,3.47,32.95,2019
"3728527",252,0,180,432,58.33,0,41.67,2019
"3728528",209,0,5,214,97.66,0,2.34,2019
"3728529",664,11,158,833,79.71,1.32,18.97,2019
"3728012",7778,195,1066,9039,86.05,2.16,11.79,2019
"3728027",21495,472,1827,23794,90.34,1.98,7.68,2019
"3728032",1009,44,153,1206,83.67,3.65,12.69,2019
"3728052",9272,422,3016,12710,72.95,3.32,23.73,2019
"3728076",83,20,50,153,54.25,13.07,32.68,2019
"3728081",8495,241,1385,10121,83.93,2.38,13.68,2019
"3728090",1871,155,1036,3062,61.1,5.06,33.83,2019
"3728129",1752,14,389,2155,81.3,0.65,18.05,2019
"3728146",9220,119,1657,10996,83.85,1.08,15.07,2019
"3728167",713,0,273,986,72.31,0,27.69,2019
"3728211",11469,243,969,12681,90.44,1.92,7.64,2019
"3728213",13490,359,2547,16396,82.28,2.19,15.53,2019
"3728216",16568,466,2905,19939,83.09,2.34,14.57,2019
"3728277",26287,161,753,27201,96.64,0.59,2.77,2019
"3728278",9343,121,284,9748,95.85,1.24,2.91,2019
"3728303",11044,371,2132,13547,81.52,2.74,15.74,2019
"3728314",21105,418,1831,23354,90.37,1.79,7.84,2019
"3728330",158,0,36,194,81.44,0,18.56,2019
"3728347",341,7,118,466,73.18,1.5,25.32,2019
"3728351",1187,108,538,1833,64.76,5.89,29.35,2019
"3728357",774,39,249,1062,72.88,3.67,23.45,2019
"4218458",933,23,95,1051,88.77,2.19,9.04,2019
"4218459",3,0,0,3,100,0,0,2019
"4218503",394,34,174,602,65.45,5.65,28.9,2019
"4218509",4071,155,717,4943,82.36,3.14,14.51,2019
"4218512",4200,101,969,5270,79.7,1.92,18.39,2019
"0572927",2162,98,869,3129,69.1,3.13,27.77,2019
"0572933",1410,128,404,1942,72.61,6.59,20.8,2019
"0572934",143,4,193,340,42.06,1.18,56.76,2019
"0572937",1035,52,309,1396,74.14,3.72,22.13,2019
"0572949",2415,162,1134,3711,65.08,4.37,30.56,2019
"0572358",244,22,158,424,57.55,5.19,37.26,2019
"0572467",0,0,0,0,NA,NA,NA,2019
"0572413",165,18,47,230,71.74,7.83,20.43,2019
"0572421",123,2,51,176,69.89,1.14,28.98,2019
"0572450",11616,703,2601,14920,77.86,4.71,17.43,2019
"0572469",256,13,143,412,62.14,3.16,34.71,2019
"0572010",1642,92,726,2460,66.75,3.74,29.51,2019
"0572020",956,62,497,1515,63.1,4.09,32.81,2019
"0572045",486,0,61,547,88.85,0,11.15,2019
"0572057",285,0,75,360,79.17,0,20.83,2019
"0572064",581,17,460,1058,54.91,1.61,43.48,2019
"0572069",354,23,264,641,55.23,3.59,41.19,2019
"0572083",40,3,24,67,59.7,4.48,35.82,2019
"0572088",909,52,264,1225,74.2,4.24,21.55,2019
"0572108",24,0,14,38,63.16,0,36.84,2019
"0572114",2329,377,2039,4745,49.08,7.95,42.97,2019
"0572116",7870,262,1200,9332,84.33,2.81,12.86,2019
"0572127",551,20,321,892,61.77,2.24,35.99,2019
"0572150",3718,247,917,4882,76.16,5.06,18.78,2019
"0572160",2854,171,1052,4077,70,4.19,25.8,2019
"0572176",2805,34,376,3215,87.25,1.06,11.7,2019
"0572201",541,25,102,668,80.99,3.74,15.27,2019
"0572202",3355,264,1068,4687,71.58,5.63,22.79,2019
"0572321",55,0,6,61,90.16,0,9.84,2019
"0572351",193,17,62,272,70.96,6.25,22.79,2019
"0572353",49,0,0,49,100,0,0,2019
"0572368",351,17,219,587,59.8,2.9,37.31,2019
"0572372",365,73,272,710,51.41,10.28,38.31,2019
"0572383",11,0,31,42,26.19,0,73.81,2019
"0572411",662,69,150,881,75.14,7.83,17.03,2019
"0572801",4945,210,1323,6478,76.34,3.24,20.42,2019
"0572828",16,0,9,25,64,0,36,2019
"0572837",1964,107,780,2851,68.89,3.75,27.36,2019
"0572839",41,11,76,128,32.03,8.59,59.38,2019
"0572903",8465,613,1899,10977,77.12,5.58,17.3,2019
"0572916",3027,156,407,3590,84.32,4.35,11.34,2019
"0572936",4390,227,1047,5664,77.51,4.01,18.49,2019
"0572938",353,0,106,459,76.91,0,23.09,2019
"0572941",1607,79,393,2079,77.3,3.8,18.9,2019
"0572753",2766,102,616,3484,79.39,2.93,17.68,2019
"0696002",10490,370,1767,12627,83.08,2.93,13.99,2019
"0696019",3225,89,577,3891,82.88,2.29,14.83,2019
"0696023",331,30,142,503,65.81,5.96,28.23,2019
"0696039",323,10,106,439,73.58,2.28,24.15,2019
"0696048",243,0,125,368,66.03,0,33.97,2019
"0696050",134,0,77,211,63.51,0,36.49,2019
"0696051",471,4,95,570,82.63,0.7,16.67,2019
"0696001",11639,579,1774,13992,83.18,4.14,12.68,2019
"0696010",37,8,5,50,74,16,10,2019
"0696011",39,5,35,79,49.37,6.33,44.3,2019
"0696029",41,6,14,61,67.21,9.84,22.95,2019
"0696041",900,56,315,1271,70.81,4.41,24.78,2019
"0696046",57,0,0,57,100,0,0,2019
"0696061",11,0,0,11,100,0,0,2019
"0572102",822,15,191,1028,79.96,1.46,18.58,2019
"0572110",3228,158,1136,4522,71.38,3.49,25.12,2019
"0572117",3614,318,1326,5258,68.73,6.05,25.22,2019
"0572118",6223,382,1961,8566,72.65,4.46,22.89,2019
"0572128",220,11,87,318,69.18,3.46,27.36,2019
"0572137",571,33,273,877,65.11,3.76,31.13,2019
"0572153",543,52,324,919,59.09,5.66,35.26,2019
"0572168",39,11,98,148,26.35,7.43,66.22,2019
"0572169",27,3,11,41,65.85,7.32,26.83,2019
"0572175",52,0,82,134,38.81,0,61.19,2019
"0572330",113,24,44,181,62.43,13.26,24.31,2019
"0572331",842,52,279,1173,71.78,4.43,23.79,2019
"0572341",62,0,30,92,67.39,0,32.61,2019
"0572342",1174,42,602,1818,64.58,2.31,33.11,2019
"0572346",149,0,93,242,61.57,0,38.43,2019
"0572529",1675,155,555,2385,70.23,6.5,23.27,2019
"0572453",60,13,25,98,61.22,13.27,25.51,2019
"0572472",2749,92,814,3655,75.21,2.52,22.27,2019
"0572476",1770,154,459,2383,74.28,6.46,19.26,2019
"0572846",1052,25,535,1612,65.26,1.55,33.19,2019
"0572904",5638,402,2212,8252,68.32,4.87,26.81,2019
"0572926",151,6,112,269,56.13,2.23,41.64,2019
"0572935",107,5,54,166,64.46,3.01,32.53,2019
"0572946",1064,49,382,1495,71.17,3.28,25.55,2019
"0572948",120,0,14,134,89.55,0,10.45,2019
"0572322",20,0,48,68,29.41,0,70.59,2019
"0572329",37,0,0,37,100,0,0,2019
"0572355",725,3,248,976,74.28,0.31,25.41,2019
"0572370",1953,227,853,3033,64.39,7.48,28.12,2019
"0572373",229,4,178,411,55.72,0.97,43.31,2019
"0572386",608,14,136,758,80.21,1.85,17.94,2019
"0572538",120,0,39,159,75.47,0,24.53,2019
"0572007",2832,91,213,3136,90.31,2.9,6.79,2019
"0572002",5536,169,626,6331,87.44,2.67,9.89,2019
"0572058",4606,396,1122,6124,75.21,6.47,18.32,2019
"0572067",828,22,314,1164,71.13,1.89,26.98,2019
"0572070",420,10,214,644,65.22,1.55,33.23,2019
"0572074",38,0,34,72,52.78,0,47.22,2019
"0572086",3135,103,887,4125,76,2.5,21.5,2019
"0572099",0,0,0,0,NA,NA,NA,2019
"0572129",287,22,119,428,67.06,5.14,27.8,2019
"0572553",13,1,6,20,65,5,30,2019
"0572561",113,30,105,248,45.56,12.1,42.34,2019
"0572565",132,58,77,267,49.44,21.72,28.84,2019
"0572579",296,60,133,489,60.53,12.27,27.2,2019
"5398603",370,27,106,503,73.56,5.37,21.07,2019
"5398614",57,0,29,86,66.28,0,33.72,2019
"5398628",100,5,30,135,74.07,3.7,22.22,2019
"5398629",2884,72,157,3113,92.64,2.31,5.04,2019
"5398662",10852,434,1076,12362,87.79,3.51,8.7,2019
"5398685",10328,180,252,10760,95.99,1.67,2.34,2019
"5398801",13278,314,2406,15998,83,1.96,15.04,2019
"5398813",508,29,280,817,62.18,3.55,34.27,2019
"5398817",87,0,0,87,100,0,0,2019
"5398830",185,24,76,285,64.91,8.42,26.67,2019
"5398844",1586,67,441,2094,75.74,3.2,21.06,2019
"5398849",436,28,64,528,82.58,5.3,12.12,2019
"5398934",337,24,99,460,73.26,5.22,21.52,2019
"5398226",15186,464,1934,17584,86.36,2.64,11,2019
"4218657",4125,44,617,4786,86.19,0.92,12.89,2019
"4218702",12128,379,3299,15806,76.73,2.4,20.87,2019
"4218705",5014,163,1144,6321,79.32,2.58,18.1,2019
"4218814",71,5,3,79,89.87,6.33,3.8,2019
"4218821",440,29,107,576,76.39,5.03,18.58,2019
"4218822",1106,54,279,1439,76.86,3.75,19.39,2019
"4218828",117,4,34,155,75.48,2.58,21.94,2019
"4218832",556,25,151,732,75.96,3.42,20.63,2019
"4218842",97,6,0,103,94.17,5.83,0,2019
"4218845",121,0,12,133,90.98,0,9.02,2019
"4218847",1777,31,491,2299,77.29,1.35,21.36,2019
"4218854",493,0,119,612,80.56,0,19.44,2019
"4218942",1077,66,96,1239,86.92,5.33,7.75,2019
"4218944",8515,179,488,9182,92.74,1.95,5.31,2019
"4218974",14250,345,1899,16494,86.4,2.09,11.51,2019
"4218938",5692,104,413,6209,91.67,1.67,6.65,2019
"4218940",10691,200,486,11377,93.97,1.76,4.27,2019
"4218642",1479,58,305,1842,80.29,3.15,16.56,2019
"4218655",1905,69,435,2409,79.08,2.86,18.06,2019
"4218660",1212,39,274,1525,79.48,2.56,17.97,2019
"4218618",1323,39,243,1605,82.43,2.43,15.14,2019
"4218517",1784,0,409,2193,81.35,0,18.65,2019
"4218603",6179,357,1855,8391,73.64,4.25,22.11,2019
"4218610",1531,0,134,1665,91.95,0,8.05,2019
"4218622",45,0,19,64,70.31,0,29.69,2019
"4218629",573,29,93,695,82.45,4.17,13.38,2019
"4218630",1017,49,142,1208,84.19,4.06,11.75,2019
"4218661",1756,41,368,2165,81.11,1.89,17,2019
"4218707",5099,57,595,5751,88.66,0.99,10.35,2019
"4218829",235,0,64,299,78.6,0,21.4,2019
"4218840",3801,39,724,4564,83.28,0.85,15.86,2019
"4218850",747,36,143,926,80.67,3.89,15.44,2019
"4218851",248,2,39,289,85.81,0.69,13.49,2019
"4218917",810,7,67,884,91.63,0.79,7.58,2019
"4218936",0,0,0,0,NA,NA,NA,2019
"4218969",5036,218,605,5859,85.95,3.72,10.33,2019
"4218830",225,3,50,278,80.94,1.08,17.99,2019
"4218833",651,18,162,831,78.34,2.17,19.49,2019
"4218914",7216,62,468,7746,93.16,0.8,6.04,2019
"4218091",1763,69,441,2273,77.56,3.04,19.4,2019
"4218066",2093,63,199,2355,88.87,2.68,8.45,2019
"4218069",2599,87,287,2973,87.42,2.93,9.65,2019
"4218074",2110,46,64,2220,95.05,2.07,2.88,2019
"4218103",14579,583,2655,17817,81.83,3.27,14.9,2019
"4218214",651,79,71,801,81.27,9.86,8.86,2019
"4218230",32,0,10,42,76.19,0,23.81,2019
"4218237",1075,22,352,1449,74.19,1.52,24.29,2019
"4218244",65,14,32,111,58.56,12.61,28.83,2019
"4218322",736,0,189,925,79.57,0,20.43,2019
"4218330",2568,79,145,2792,91.98,2.83,5.19,2019
"4218333",100,0,31,131,76.34,0,23.66,2019
"4218355",417,0,10,427,97.66,0,2.34,2019
"4218370",334,0,45,379,88.13,0,11.87,2019
"4218405",837,0,140,977,85.67,0,14.33,2019
"5122960",2912,186,528,3626,80.31,5.13,14.56,2019
"5122967",522,58,242,822,63.5,7.06,29.44,2019
"5122973",1841,36,472,2349,78.37,1.53,20.09,2019
"5122976",120,11,32,163,73.62,6.75,19.63,2019
"5122206",9616,134,562,10312,93.25,1.3,5.45,2019
"0696075",90,0,69,159,56.6,0,43.4,2019
"0696084",161,13,15,189,85.19,6.88,7.94,2019
"0696013",1265,92,409,1766,71.63,5.21,23.16,2019
"0696022",5155,103,985,6243,82.57,1.65,15.78,2019
"0696032",944,17,130,1091,86.53,1.56,11.92,2019
"0696047",251,0,99,350,71.71,0,28.29,2019
"0696052",506,16,118,640,79.06,2.5,18.44,2019
"0696054",106,10,28,144,73.61,6.94,19.44,2019
"0696076",93,0,42,135,68.89,0,31.11,2019
"0696103",589,59,42,690,85.36,8.55,6.09,2019
"0696104",277,6,65,348,79.6,1.72,18.68,2019
"0696106",97,0,25,122,79.51,0,20.49,2019
"0696109",240,0,114,354,67.8,0,32.2,2019
"0696113",336,0,55,391,85.93,0,14.07,2019
"0696125",51,0,9,60,85,0,15,2019
"0696133",46,0,24,70,65.71,0,34.29,2019
"0696137",1302,13,320,1635,79.63,0.8,19.57,2019
"1596712",2111,188,182,2481,85.09,7.58,7.34,2019
"1596728",136,29,29,194,70.1,14.95,14.95,2019
"1596738",2442,61,196,2699,90.48,2.26,7.26,2019
"1596754",944,23,52,1019,92.64,2.26,5.1,2019
"1596761",6425,290,667,7382,87.04,3.93,9.04,2019
"1596763",663,36,482,1181,56.14,3.05,40.81,2019
"1596776",332,35,135,502,66.14,6.97,26.89,2019
"1596781",285,32,91,408,69.85,7.84,22.3,2019
"1596785",1180,165,148,1493,79.04,11.05,9.91,2019
"1596818",17053,293,1027,18373,92.82,1.59,5.59,2019
"1596821",5925,121,477,6523,90.83,1.85,7.31,2019
"0696091",257,2,96,355,72.39,0.56,27.04,2019
"0696096",219,13,54,286,76.57,4.55,18.88,2019
"0696105",80,0,124,204,39.22,0,60.78,2019
"0696119",5,0,14,19,26.32,0,73.68,2019
"0696148",172,14,28,214,80.37,6.54,13.08,2019
"0696006",128,0,63,191,67.02,0,32.98,2019
"0696007",6888,417,1805,9110,75.61,4.58,19.81,2019
"0696062",337,27,70,434,77.65,6.22,16.13,2019
"0696063",123,0,14,137,89.78,0,10.22,2019
"0696088",1705,16,371,2092,81.5,0.76,17.73,2019
"0696090",153,6,60,219,69.86,2.74,27.4,2019
"0696093",1055,0,589,1644,64.17,0,35.83,2019
"0696108",31,0,24,55,56.36,0,43.64,2019
"0696110",31,0,22,53,58.49,0,41.51,2019
"0696115",59,0,16,75,78.67,0,21.33,2019
"0696116",37,0,72,109,33.94,0,66.06,2019
"0696117",129,5,20,154,83.77,3.25,12.99,2019
"4197005",9510,377,1399,11286,84.26,3.34,12.4,2019
"4197011",273,59,50,382,71.47,15.45,13.09,2019
"4197018",675,12,76,763,88.47,1.57,9.96,2019
"4197456",877,34,188,1099,79.8,3.09,17.11,2019
"4197632",425,14,126,565,75.22,2.48,22.3,2019
"4197865",439,11,84,534,82.21,2.06,15.73,2019
"4197873",120,0,24,144,83.33,0,16.67,2019
"4197876",314,9,36,359,87.47,2.51,10.03,2019
"4197880",82,6,38,126,65.08,4.76,30.16,2019
"4197886",342,10,67,419,81.62,2.39,15.99,2019
"4197901",200,5,81,286,69.93,1.75,28.32,2019
"4197903",25,0,0,25,100,0,0,2019
"4197420",9258,372,2001,11631,79.6,3.2,17.2,2019
"4197040",498,23,71,592,84.12,3.89,11.99,2019
"5398244",916,61,144,1121,81.71,5.44,12.85,2019
"5398271",9836,245,909,10990,89.5,2.23,8.27,2019
"5398325",554,53,61,668,82.93,7.93,9.13,2019
"5398345",239,0,0,239,100,0,0,2019
"5398337",3099,63,349,3511,88.27,1.79,9.94,2019
"5398338",8878,245,766,9889,89.78,2.48,7.75,2019
"5398340",1331,14,89,1434,92.82,0.98,6.21,2019
"5398346",3546,54,298,3898,90.97,1.39,7.64,2019
"5398376",791,15,80,886,89.28,1.69,9.03,2019
"5398385",146,0,29,175,83.43,0,16.57,2019
"5398408",6457,354,914,7725,83.59,4.58,11.83,2019
"5398409",8620,500,1147,10267,83.96,4.87,11.17,2019
"5398444",10425,762,1763,12950,80.5,5.88,13.61,2019
"5398445",10073,172,992,11237,89.64,1.53,8.83,2019
"5398506",6282,416,968,7666,81.95,5.43,12.63,2019
"5398513",12475,269,637,13381,93.23,2.01,4.76,2019
"5398530",194,4,36,234,82.91,1.71,15.38,2019
"5398538",104,7,33,144,72.22,4.86,22.92,2019
"5398834",70,0,17,87,80.46,0,19.54,2019
"5398853",7,0,0,7,100,0,0,2019
"5398855",2047,18,527,2592,78.97,0.69,20.33,2019
"5398856",860,50,194,1104,77.9,4.53,17.57,2019
"5398922",2465,168,395,3028,81.41,5.55,13.04,2019
"5398926",11598,662,1067,13327,87.03,4.97,8.01,2019
"5398643",176,0,16,192,91.67,0,8.33,2019
"5398645",478,6,76,560,85.36,1.07,13.57,2019
"5398648",1035,44,221,1300,79.62,3.38,17,2019
"5398664",8294,240,654,9188,90.27,2.61,7.12,2019
"5398665",8989,163,909,10061,89.34,1.62,9.03,2019
"5398682",19491,403,960,20854,93.46,1.93,4.6,2019
"5398686",7262,183,467,7912,91.78,2.31,5.9,2019
"5398821",71,25,0,96,73.96,26.04,0,2019
"5398822",582,37,130,749,77.7,4.94,17.36,2019
"5398837",12855,471,1761,15087,85.21,3.12,11.67,2019
"5398942",5434,339,832,6605,82.27,5.13,12.6,2019
"5398055",8928,175,515,9618,92.83,1.82,5.35,2019
"5398065",5033,58,98,5189,96.99,1.12,1.89,2019
"5398103",23446,687,861,24994,93.81,2.75,3.44,2019
"5398112",10894,434,320,11648,93.53,3.73,2.75,2019
"5398144",12143,387,1417,13947,87.07,2.77,10.16,2019
"5398208",18559,654,1477,20690,89.7,3.16,7.14,2019
"5398220",240,0,0,240,100,0,0,2019
"5398221",8348,301,942,9591,87.04,3.14,9.82,2019
"5398004",16401,221,448,17070,96.08,1.29,2.62,2019
"5398005",7577,104,327,8008,94.62,1.3,4.08,2019
"2501009",103,0,11,114,90.35,0,9.65,2019
"2501063",0,0,0,0,NA,NA,NA,2019
"2501066",0,31,0,31,0,100,0,2019
"2501074",95,0,0,95,100,0,0,2019
"2501079",249,12,81,342,72.81,3.51,23.68,2019
"2501086",0,0,0,0,NA,NA,NA,2019
"2501093",99,15,3,117,84.62,12.82,2.56,2019
"2501094",148,25,32,205,72.2,12.2,15.61,2019
"2501097",20,0,0,20,100,0,0,2019
"2501199",0,0,0,0,NA,NA,NA,2019
"2501224",64,0,0,64,100,0,0,2019
"2501229",30,0,18,48,62.5,0,37.5,2019
"2501243",115,22,7,144,79.86,15.28,4.86,2019
"2501260",130,0,10,140,92.86,0,7.14,2019
"5122509",33,0,0,33,100,0,0,2019
"5122301",5490,52,171,5713,96.1,0.91,2.99,2019
"5122485",8168,194,686,9048,90.27,2.14,7.58,2019
"5122654",310,20,64,394,78.68,5.08,16.24,2019
"5122469",547,0,275,822,66.55,0,33.45,2019
"5122646",36,0,0,36,100,0,0,2019
"5122580",1413,35,504,1952,72.39,1.79,25.82,2019
"5122729",39,0,64,103,37.86,0,62.14,2019
"5122847",273,37,52,362,75.41,10.22,14.36,2019
"5122969",383,0,214,597,64.15,0,35.85,2019
"5122747",472,8,84,564,83.69,1.42,14.89,2019
"5122436",143,0,129,272,52.57,0,47.43,2019
"5122192",18923,221,532,19676,96.17,1.12,2.7,2019
"5122610",570,44,127,741,76.92,5.94,17.14,2019
"5122025",6261,37,109,6407,97.72,0.58,1.7,2019
"5122035",0,0,0,0,NA,NA,NA,2019
"5122185",0,0,0,0,NA,NA,NA,2019
"5122214",0,0,0,0,NA,NA,NA,2019
"5122530",91,0,0,91,100,0,0,2019
"5122551",5553,172,750,6475,85.76,2.66,11.58,2019
"5122556",8681,85,431,9197,94.39,0.92,4.69,2019
"5122623",249,13,37,299,83.28,4.35,12.37,2019
"5122807",0,0,0,0,NA,NA,NA,2019
"5122904",4,20,0,24,16.67,83.33,0,2019
"5122964",99,0,0,99,100,0,0,2019
"5122712",2564,67,392,3023,84.82,2.22,12.97,2019
"5122714",269,0,50,319,84.33,0,15.67,2019
"5122443",3184,70,609,3863,82.42,1.81,15.76,2019
"5122454",513,7,123,643,79.78,1.09,19.13,2019
"5122473",1786,63,438,2287,78.09,2.75,19.15,2019
"5122553",4535,81,402,5018,90.37,1.61,8.01,2019
"5122560",1660,161,1017,2838,58.49,5.67,35.84,2019
"5122639",211,0,40,251,84.06,0,15.94,2019
"5122663",372,0,158,530,70.19,0,29.81,2019
"5122546",5030,203,919,6152,81.76,3.3,14.94,2019
"5122567",877,17,358,1252,70.05,1.36,28.59,2019
"5122572",1624,66,838,2528,64.24,2.61,33.15,2019
"5122579",29,0,0,29,100,0,0,2019
"5122611",2649,110,562,3321,79.77,3.31,16.92,2019
"5122641",102,0,54,156,65.38,0,34.62,2019
"5122656",1028,38,181,1247,82.44,3.05,14.51,2019
"5122709",391,0,76,467,83.73,0,16.27,2019
"5122724",662,0,71,733,90.31,0,9.69,2019
"5122738",326,0,144,470,69.36,0,30.64,2019
"5122741",28,12,11,51,54.9,23.53,21.57,2019
"5122749",53,0,40,93,56.99,0,43.01,2019
"5122802",8154,591,2055,10800,75.5,5.47,19.03,2019
"5122846",628,17,129,774,81.14,2.2,16.67,2019
"5122932",2671,92,465,3228,82.74,2.85,14.41,2019
"5122935",312,14,74,400,78,3.5,18.5,2019
"5122003",17026,287,1604,18917,90,1.52,8.48,2019
"5122032",9627,50,228,9905,97.19,0.5,2.3,2019
"5122033",14551,202,322,15075,96.52,1.34,2.14,2019
"5122044",4472,202,678,5352,83.56,3.77,12.67,2019
"5425276",2179,97,884,3160,68.96,3.07,27.97,2019
"5425442",654,37,57,748,87.43,4.95,7.62,2019
"5425502",255,0,99,354,72.03,0,27.97,2019
"5425524",702,38,284,1024,68.55,3.71,27.73,2019
"5425529",272,33,60,365,74.52,9.04,16.44,2019
"4197132",9164,414,773,10351,88.53,4,7.47,2019
"4197232",6355,371,510,7236,87.82,5.13,7.05,2019
"4197033",25,3,7,35,71.43,8.57,20,2019
"4197333",8633,371,493,9497,90.9,3.91,5.19,2019
"4197377",261,0,55,316,82.59,0,17.41,2019
"4197423",2260,98,569,2927,77.21,3.35,19.44,2019
"4197837",19,5,14,38,50,13.16,36.84,2019
"4197856",146,1,59,206,70.87,0.49,28.64,2019
"4197205",3978,336,755,5069,78.48,6.63,14.89,2019
"4197301",15263,527,2768,18558,82.24,2.84,14.92,2019
"4197375",315,7,119,441,71.43,1.59,26.98,2019
"4197429",241,3,57,301,80.07,1,18.94,2019
"4197467",1780,57,380,2217,80.29,2.57,17.14,2019
"4197541",495,15,118,628,78.82,2.39,18.79,2019
"4197828",1153,52,246,1451,79.46,3.58,16.95,2019
"4197016",1860,140,539,2539,73.26,5.51,21.23,2019
"4197267",11772,286,1368,13426,87.68,2.13,10.19,2019
"4197461",248,0,21,269,92.19,0,7.81,2019
"4197884",47,4,20,71,66.2,5.63,28.17,2019
"4197449",931,16,225,1172,79.44,1.37,19.2,2019
"4197501",14986,717,2152,17855,83.93,4.02,12.05,2019
"4197531",143,34,93,270,52.96,12.59,34.44,2019
"4197627",207,26,33,266,77.82,9.77,12.41,2019
"4197758",19,2,20,41,46.34,4.88,48.78,2019
"4197063",367,8,85,460,79.78,1.74,18.48,2019
"4197009",2487,100,321,2908,85.52,3.44,11.04,2019
"4197014",501,16,68,585,85.64,2.74,11.62,2019
"4197030",12050,479,2271,14800,81.42,3.24,15.34,2019
"4197039",165,25,49,239,69.04,10.46,20.5,2019
"4197042",982,56,48,1086,90.42,5.16,4.42,2019
"4197049",637,14,21,672,94.79,2.08,3.12,2019
"4197054",499,18,63,580,86.03,3.1,10.86,2019
"4197118",268,4,63,335,80,1.19,18.81,2019
"4197141",4456,162,729,5347,83.34,3.03,13.63,2019
"4197149",285,11,49,345,82.61,3.19,14.2,2019
"4197201",7835,625,720,9180,85.35,6.81,7.84,2019
"4197216",5473,198,981,6652,82.28,2.98,14.75,2019
"4197331",0,0,0,0,NA,NA,NA,2019
"4197358",915,9,129,1053,86.89,0.85,12.25,2019
"4197034",7212,166,393,7771,92.81,2.14,5.06,2019
"4197048",2310,51,343,2704,85.43,1.89,12.68,2019
"4197056",4121,66,440,4627,89.06,1.43,9.51,2019
"4197080",13866,335,1198,15399,90.04,2.18,7.78,2019
"4197103",6138,167,1075,7380,83.17,2.26,14.57,2019
"4197110",420,37,48,505,83.17,7.33,9.5,2019
"2304735",179,8,76,263,68.06,3.04,28.9,2019
"2304740",368,32,171,571,64.45,5.6,29.95,2019
"2304746",127,9,67,203,62.56,4.43,33,2019
"2304757",984,54,172,1210,81.32,4.46,14.21,2019
"2304777",120,5,47,172,69.77,2.91,27.33,2019
"2304783",161,0,46,207,77.78,0,22.22,2019
"2304858",479,19,50,548,87.41,3.47,9.12,2019
"2304910",688,16,134,838,82.1,1.91,15.99,2019
"2304951",370,10,95,475,77.89,2.11,20,2019
"2304952",680,46,125,851,79.91,5.41,14.69,2019
"2304605",5096,278,805,6179,82.47,4.5,13.03,2019
"2304671",189,3,45,237,79.75,1.27,18.99,2019
"2304021",2150,52,118,2320,92.67,2.24,5.09,2019
"2304254",1207,54,239,1500,80.47,3.6,15.93,2019
"2501270",294,2,47,343,85.71,0.58,13.7,2019
"2501343",23,0,6,29,79.31,0,20.69,2019
"2501347",70,0,8,78,89.74,0,10.26,2019
"2501354",511,28,40,579,88.26,4.84,6.91,2019
"2501434",232,7,0,239,97.07,2.93,0,2019
"2501525",217,0,0,217,100,0,0,2019
"2501561",45,0,37,82,54.88,0,45.12,2019
"2501901",752,10,255,1017,73.94,0.98,25.07,2019
"2501937",0,0,0,0,NA,NA,NA,2019
"2501089",10382,275,1948,12605,82.36,2.18,15.45,2019
"2501259",215,7,64,286,75.17,2.45,22.38,2019
"2501507",4379,67,618,5064,86.47,1.32,12.2,2019
"2501581",6567,48,454,7069,92.9,0.68,6.42,2019
"2501960",17722,684,3135,21541,82.27,3.18,14.55,2019
"2501969",2039,21,150,2210,92.26,0.95,6.79,2019
"2501983",2004,13,189,2206,90.84,0.59,8.57,2019
"2501039",513,24,6,543,94.48,4.42,1.1,2019
"2501040",11286,415,3577,15278,73.87,2.72,23.41,2019
"2501010",1225,64,158,1447,84.66,4.42,10.92,2019
"2501036",1821,44,135,2000,91.05,2.2,6.75,2019
"2501220",3076,212,486,3774,81.51,5.62,12.88,2019
"2501824",9152,172,390,9714,94.21,1.77,4.01,2019
"2501450",3810,72,189,4071,93.59,1.77,4.64,2019
"2501612",1322,27,150,1499,88.19,1.8,10.01,2019
"2501905",7000,197,1050,8247,84.88,2.39,12.73,2019
"2501521",867,34,105,1006,86.18,3.38,10.44,2019
"2501537",780,0,161,941,82.89,0,17.11,2019
"2501542",798,0,91,889,89.76,0,10.24,2019
"2501550",5476,122,1215,6813,80.38,1.79,17.83,2019
"2501610",5722,204,1803,7729,74.03,2.64,23.33,2019
"2501718",234,0,8,242,96.69,0,3.31,2019
"2501757",9575,259,1212,11046,86.68,2.34,10.97,2019
"2501776",6186,10,190,6386,96.87,0.16,2.98,2019
"2501803",9194,211,596,10001,91.93,2.11,5.96,2019
"2501810",12162,177,462,12801,95.01,1.38,3.61,2019
"2501832",7367,369,1165,8901,82.77,4.15,13.09,2019
"2501860",2283,177,250,2710,84.24,6.53,9.23,2019
"2501862",3298,22,192,3512,93.91,0.63,5.47,2019
"2501890",7411,51,422,7884,94,0.65,5.35,2019
"2501081",688,27,41,756,91.01,3.57,5.42,2019
"2501118",4984,167,541,5692,87.56,2.93,9.5,2019
"2501469",2517,130,166,2813,89.48,4.62,5.9,2019
"2501566",2016,34,142,2192,91.97,1.55,6.48,2019
"2501022",879,11,264,1154,76.17,0.95,22.88,2019
"2501748",5911,70,323,6304,93.77,1.11,5.12,2019
"3728006",338,18,144,500,67.6,3.6,28.8,2019
"3728017",0,0,0,0,NA,NA,NA,2019
"3728021",4073,189,1312,5574,73.07,3.39,23.54,2019
"3728023",5141,62,859,6062,84.81,1.02,14.17,2019
"3728036",5647,68,398,6113,92.38,1.11,6.51,2019
"3728787",7214,403,1037,8654,83.36,4.66,11.98,2019
"3728434",287,7,165,459,62.53,1.53,35.95,2019
"3728431",1945,131,875,2951,65.91,4.44,29.65,2019
"3728438",330,10,305,645,51.16,1.55,47.29,2019
"3728439",295,61,141,497,59.36,12.27,28.37,2019
"3728451",12439,638,1619,14696,84.64,4.34,11.02,2019
"3728472",5166,252,1947,7365,70.14,3.42,26.44,2019
"3728478",1107,12,635,1754,63.11,0.68,36.2,2019
"3728518",2418,47,772,3237,74.7,1.45,23.85,2019
"1232409",3137,142,464,3743,83.81,3.79,12.4,2019
"1232459",6528,227,469,7224,90.37,3.14,6.49,2019
"1232460",1053,34,396,1483,71,2.29,26.7,2019
"1232463",68,0,20,88,77.27,0,22.73,2019
"1232531",1581,234,391,2206,71.67,10.61,17.72,2019
"1232547",11566,942,2311,14819,78.05,6.36,15.59,2019
"1232561",4001,62,140,4203,95.19,1.48,3.33,2019
"1232565",1497,109,466,2072,72.25,5.26,22.49,2019
"1232570",10561,293,1095,11949,88.38,2.45,9.16,2019
"1232606",8567,151,738,9456,90.6,1.6,7.8,2019
"1232615",4584,38,622,5244,87.41,0.72,11.86,2019
"1232617",1322,40,345,1707,77.45,2.34,20.21,2019
"1232639",34,0,63,97,35.05,0,64.95,2019
"1232653",5383,140,451,5974,90.11,2.34,7.55,2019
"1232680",2709,228,1487,4424,61.23,5.15,33.61,2019
"1232693",2667,152,1504,4323,61.69,3.52,34.79,2019
"1232127",10623,354,1837,12814,82.9,2.76,14.34,2019
"1232136",2988,308,653,3949,75.66,7.8,16.54,2019
"1232193",216,3,88,307,70.36,0.98,28.66,2019
"1232195",953,71,191,1215,78.44,5.84,15.72,2019
"1232040",1910,122,463,2495,76.55,4.89,18.56,2019
"1232044",596,21,130,747,79.79,2.81,17.4,2019
"1232112",1890,60,997,2947,64.13,2.04,33.83,2019
"1232140",535,13,12,560,95.54,2.32,2.14,2019
"1232147",156,35,23,214,72.9,16.36,10.75,2019
"1232508",535,0,10,545,98.17,0,1.83,2019
"1232535",1232,106,499,1837,67.07,5.77,27.16,2019
"1232542",727,11,0,738,98.51,1.49,0,2019
"1232583",7541,210,1092,8843,85.28,2.37,12.35,2019
"1232601",6453,541,913,7907,81.61,6.84,11.55,2019
"1232626",2399,93,1121,3613,66.4,2.57,31.03,2019
"1232643",3666,112,780,4558,80.43,2.46,17.11,2019
"1232656",4691,135,707,5533,84.78,2.44,12.78,2019
"1232664",137,0,44,181,75.69,0,24.31,2019
"1232666",2198,8,539,2745,80.07,0.29,19.64,2019
"1232697",43,6,50,99,43.43,6.06,50.51,2019
"1232725",14274,588,2087,16949,84.22,3.47,12.31,2019
"1232751",7665,175,512,8352,91.77,2.1,6.13,2019
"1232763",7258,425,1613,9296,78.08,4.57,17.35,2019
"1232766",5056,40,151,5247,96.36,0.76,2.88,2019
"1232798",1179,13,243,1435,82.16,0.91,16.93,2019
"1330663",877,51,243,1171,74.89,4.36,20.75,2019
"1330666",3015,67,357,3439,87.67,1.95,10.38,2019
"1330115",13275,73,605,13953,95.14,0.52,4.34,2019
"1330117",10553,720,2059,13332,79.16,5.4,15.44,2019
"1330127",20678,272,1679,22629,91.38,1.2,7.42,2019
"1330132",11790,785,1660,14235,82.82,5.51,11.66,2019
"1330141",7212,409,851,8472,85.13,4.83,10.04,2019
"1330161",10003,407,3023,13433,74.47,3.03,22.5,2019
"1330175",1631,31,365,2027,80.46,1.53,18.01,2019
"1330501",7446,302,2166,9914,75.11,3.05,21.85,2019
"1330513",4226,60,700,4986,84.76,1.2,14.04,2019
"1330519",13599,150,728,14477,93.94,1.04,5.03,2019
"1330545",313,17,89,419,74.7,4.06,21.24,2019
"1330549",6941,261,1333,8535,81.32,3.06,15.62,2019
"1330571",1524,15,228,1767,86.25,0.85,12.9,2019
"1330602",0,0,0,0,NA,NA,NA,2019
"1330828",746,88,883,1717,43.45,5.13,51.43,2019
"1330016",16412,443,1708,18563,88.41,2.39,9.2,2019
"1233181",5870,623,1134,7627,76.96,8.17,14.87,2019
"1233184",4977,74,1014,6065,82.06,1.22,16.72,2019
"1233308",13050,379,1765,15194,85.89,2.49,11.62,2019
"1233314",8306,43,895,9244,89.85,0.47,9.68,2019
"1233317",11018,380,1270,12668,86.98,3,10.03,2019
"1233322",12502,1438,2738,16678,74.96,8.62,16.42,2019
"1233325",8401,247,489,9137,91.94,2.7,5.35,2019
"1233430",3463,319,3716,7498,46.19,4.25,49.56,2019
"1233434",8218,483,1148,9849,83.44,4.9,11.66,2019
"1233467",17663,583,1841,20087,87.93,2.9,9.17,2019
"1233496",9088,314,584,9986,91.01,3.14,5.85,2019
"1233510",9451,300,703,10454,90.41,2.87,6.72,2019
"1233541",7304,463,1552,9319,78.38,4.97,16.65,2019
"1233572",7532,109,246,7887,95.5,1.38,3.12,2019
"1233607",8640,103,2042,10785,80.11,0.96,18.93,2019
"1233609",7525,118,668,8311,90.54,1.42,8.04,2019
"1233617",14805,638,2769,18212,81.29,3.5,15.2,2019
"1233647",23563,408,883,24854,94.81,1.64,3.55,2019
"1233702",11195,372,1885,13452,83.22,2.77,14.01,2019
"1233705",8551,561,1807,10919,78.31,5.14,16.55,2019
"1233707",10135,441,1551,12127,83.57,3.64,12.79,2019
"1233711",4999,364,1606,6969,71.73,5.22,23.04,2019
"1233073",10494,466,592,11552,90.84,4.03,5.12,2019
"1233134",13450,428,2289,16167,83.19,2.65,14.16,2019
"1233136",3627,146,2495,6268,57.87,2.33,39.81,2019
"1233145",8946,424,2270,11640,76.86,3.64,19.5,2019
"1233156",10324,411,372,11107,92.95,3.7,3.35,2019
"1233158",1956,21,20,1997,97.95,1.05,1,2019
"1233811",5875,1191,909,7975,73.67,14.93,11.4,2019
"1233841",1824,403,790,3017,60.46,13.36,26.18,2019
"1233160",13766,987,4411,19164,71.83,5.15,23.02,2019
"1233183",10076,290,1428,11794,85.43,2.46,12.11,2019
"1233306",1510,130,68,1708,88.41,7.61,3.98,2019
"1233311",15514,1648,6332,23494,66.03,7.01,26.95,2019
"1233326",10199,172,423,10794,94.49,1.59,3.92,2019
"1233330",4342,124,149,4615,94.08,2.69,3.23,2019
"1233351",9189,1472,1287,11948,76.91,12.32,10.77,2019
"1233406",7501,196,1079,8776,85.47,2.23,12.29,2019
"1233428",12475,515,846,13836,90.16,3.72,6.11,2019
"1233432",9588,338,621,10547,90.91,3.2,5.89,2019
"1233438",105,0,0,105,100,0,0,2019
"1233460",8160,215,2629,11004,74.15,1.95,23.89,2019
"1233849",176,53,71,300,58.67,17.67,23.67,2019
"1233868",2627,297,713,3637,72.23,8.17,19.6,2019
"1233870",6187,345,2164,8696,71.15,3.97,24.89,2019
"1233903",8615,471,1625,10711,80.43,4.4,15.17,2019
"1233917",10198,661,1711,12570,81.13,5.26,13.61,2019
"1233948",6036,157,812,7005,86.17,2.24,11.59,2019
"1233991",7097,192,433,7722,91.91,2.49,5.61,2019
"1233761",7442,226,1090,8758,84.97,2.58,12.45,2019
"1233765",4783,108,1263,6154,77.72,1.75,20.52,2019
"1233767",3545,115,316,3976,89.16,2.89,7.95,2019
"1233776",4613,48,303,4964,92.93,0.97,6.1,2019
"1233781",7828,181,1763,9772,80.11,1.85,18.04,2019
"1233853",2617,332,1133,4082,64.11,8.13,27.76,2019
"1233913",8577,177,205,8959,95.74,1.98,2.29,2019
"1233556",7423,123,539,8085,91.81,1.52,6.67,2019
"1233565",5136,148,874,6158,83.4,2.4,14.19,2019
"1233567",2952,175,614,3741,78.91,4.68,16.41,2019
"0136521",1629,44,489,2162,75.35,2.04,22.62,2019
"0136471",203,14,196,413,49.15,3.39,47.46,2019
"0136476",0,0,7,7,0,0,100,2019
"0136480",273,20,308,601,45.42,3.33,51.25,2019
"0136513",85,64,0,149,57.05,42.95,0,2019
"0136703",3428,158,1481,5067,67.65,3.12,29.23,2019
"0136572",1808,80,317,2205,82,3.63,14.38,2019
"0136575",6165,162,1045,7372,83.63,2.2,14.18,2019
"0136727",0,0,12,12,0,0,100,2019
"0136736",300,45,114,459,65.36,9.8,24.84,2019
"0136740",252,11,209,472,53.39,2.33,44.28,2019
"0136742",535,0,208,743,72.01,0,27.99,2019
"0136751",73,5,158,236,30.93,2.12,66.95,2019
"0136754",116,22,50,188,61.7,11.7,26.6,2019
"0136758",322,0,197,519,62.04,0,37.96,2019
"0136850",549,35,431,1015,54.09,3.45,42.46,2019
"0136003",461,6,445,912,50.55,0.66,48.79,2019
"0136022",3998,126,583,4707,84.94,2.68,12.39,2019
"0136026",339,17,121,477,71.07,3.56,25.37,2019
"0136032",559,76,344,979,57.1,7.76,35.14,2019
"0136020",284,18,111,413,68.77,4.36,26.88,2019
"0136029",218,26,100,344,63.37,7.56,29.07,2019
"0136432",376,3,269,648,58.02,0.46,41.51,2019
"0136435",42,0,89,131,32.06,0,67.94,2019
"0136106",5742,94,497,6333,90.67,1.48,7.85,2019
"0136258",479,0,115,594,80.64,0,19.36,2019
"0136345",2578,27,552,3157,81.66,0.86,17.48,2019
"0136271",1682,53,465,2200,76.45,2.41,21.14,2019
"0136276",584,33,243,860,67.91,3.84,28.26,2019
"0136316",583,14,214,811,71.89,1.73,26.39,2019
"0136352",1616,18,302,1936,83.47,0.93,15.6,2019
"0136370",206,12,139,357,57.7,3.36,38.94,2019
"0136444",129,21,151,301,42.86,6.98,50.17,2019
"0136446",53,0,102,155,34.19,0,65.81,2019
"0136477",1115,38,434,1587,70.26,2.39,27.35,2019
"0136505",417,0,76,493,84.58,0,15.42,2019
"0136509",503,7,173,683,73.65,1.02,25.33,2019
"0136544",3043,29,999,4071,74.75,0.71,24.54,2019
"0136574",288,0,64,352,81.82,0,18.18,2019
"0136576",1347,71,335,1753,76.84,4.05,19.11,2019
"0136612",897,15,706,1618,55.44,0.93,43.63,2019
"0136693",6515,227,940,7682,84.81,2.95,12.24,2019
"0136728",52,0,52,104,50,0,50,2019
"0136738",118,18,109,245,48.16,7.35,44.49,2019
"0136752",404,72,135,611,66.12,11.78,22.09,2019
"0136763",29,9,28,66,43.94,13.64,42.42,2019
"0136767",286,13,352,651,43.93,2,54.07,2019
"0136768",216,0,128,344,62.79,0,37.21,2019
"0136874",2701,110,614,3425,78.86,3.21,17.93,2019
"0136875",1131,72,435,1638,69.05,4.4,26.56,2019
"0136879",860,7,36,903,95.24,0.78,3.99,2019
"0136907",373,7,356,736,50.68,0.95,48.37,2019
"0136033",798,50,519,1367,58.38,3.66,37.97,2019
"0136277",1526,59,426,2011,75.88,2.93,21.18,2019
"0136362",1233,46,17,1296,95.14,3.55,1.31,2019
"0136541",4043,34,1009,5086,79.49,0.67,19.84,2019
"0136482",296,0,90,386,76.68,0,23.32,2019
"0136538",56,0,126,182,30.77,0,69.23,2019
"0136548",277,24,133,434,63.82,5.53,30.65,2019
"2838958",0,0,0,0,NA,NA,NA,2019
"4738544",2040,58,684,2782,73.33,2.08,24.59,2019
"4738573",571,26,254,851,67.1,3.06,29.85,2019
"4738229",871,41,364,1276,68.26,3.21,28.53,2019
"4738019",4149,338,1663,6150,67.46,5.5,27.04,2019
"4738352",152,0,92,244,62.3,0,37.7,2019
"2839040",775,5,409,1189,65.18,0.42,34.4,2019
"2839044",873,77,394,1344,64.96,5.73,29.32,2019
"2839061",0,0,0,0,NA,NA,NA,2019
"2839067",372,7,135,514,72.37,1.36,26.26,2019
"2839114",2098,260,1350,3708,56.58,7.01,36.41,2019
"2839364",712,0,269,981,72.58,0,27.42,2019
"2839459",832,17,562,1411,58.97,1.2,39.83,2019
"2839464",603,8,493,1104,54.62,0.72,44.66,2019
"2839465",5970,188,1375,7533,79.25,2.5,18.25,2019
"2839525",3461,38,268,3767,91.88,1.01,7.11,2019
"2839556",2279,126,894,3299,69.08,3.82,27.1,2019
"2839561",809,18,149,976,82.89,1.84,15.27,2019
"2839567",2992,113,968,4073,73.46,2.77,23.77,2019
"2839771",32,2,13,47,68.09,4.26,27.66,2019
"2839772",375,29,215,619,60.58,4.68,34.73,2019
"2839664",528,27,302,857,61.61,3.15,35.24,2019
"2839735",1102,35,261,1398,78.83,2.5,18.67,2019
"2839740",1761,63,210,2034,86.58,3.1,10.32,2019
"2839750",596,22,300,918,64.92,2.4,32.68,2019
"2839756",337,0,338,675,49.93,0,50.07,2019
"2839046",7972,257,2383,10612,75.12,2.42,22.46,2019
"2839047",13136,254,1050,14440,90.97,1.76,7.27,2019
"2839066",1032,46,592,1670,61.8,2.75,35.45,2019
"2839079",172,37,234,443,38.83,8.35,52.82,2019
"2839083",1392,400,1595,3387,41.1,11.81,47.09,2019
"2839156",81,0,0,81,100,0,0,2019
"2839166",120,4,85,209,57.42,1.91,40.67,2019
"2839192",265,24,193,482,54.98,4.98,40.04,2019
"2839194",4155,162,1814,6131,67.77,2.64,29.59,2019
"2839203",1211,43,644,1898,63.8,2.27,33.93,2019
"2839325",1666,35,644,2345,71.04,1.49,27.46,2019
"2839213",4987,327,2885,8199,60.82,3.99,35.19,2019
"2839320",303,0,132,435,69.66,0,30.34,2019
"2839323",429,10,232,671,63.93,1.49,34.58,2019
"2839335",794,114,196,1104,71.92,10.33,17.75,2019
"2839339",3764,148,1958,5870,64.12,2.52,33.36,2019
"2839345",1367,114,867,2348,58.22,4.86,36.93,2019
"2839363",253,9,252,514,49.22,1.75,49.03,2019
"2839739",465,48,353,866,53.7,5.54,40.76,2019
"2839751",462,10,150,622,74.28,1.61,24.12,2019
"2839057",457,38,325,820,55.73,4.63,39.63,2019
"2839063",596,120,592,1308,45.57,9.17,45.26,2019
"2839073",5624,310,1585,7519,74.8,4.12,21.08,2019
"2839086",380,20,173,573,66.32,3.49,30.19,2019
"2839092",511,58,449,1018,50.2,5.7,44.11,2019
"2839150",1162,0,710,1872,62.07,0,37.93,2019
"2839168",1304,118,1133,2555,51.04,4.62,44.34,2019
"2839209",7005,278,2251,9534,73.47,2.92,23.61,2019
"2839054",78,0,76,154,50.65,0,49.35,2019
"2839082",212,0,137,349,60.74,0,39.26,2019
"2839108",474,11,165,650,72.92,1.69,25.38,2019
"2839169",290,74,597,961,30.18,7.7,62.12,2019
"2839212",9132,335,1761,11228,81.33,2.98,15.68,2019
"4529449",2330,189,608,3127,74.51,6.04,19.44,2019
"4529458",682,20,407,1109,61.5,1.8,36.7,2019
"4529461",10414,469,2807,13690,76.07,3.43,20.5,2019
"4529464",19557,307,1829,21693,90.15,1.42,8.43,2019
"4529470",1099,139,468,1706,64.42,8.15,27.43,2019
"4529474",665,63,144,872,76.26,7.22,16.51,2019
"4529203",9534,397,5417,15348,62.12,2.59,35.29,2019
"4529209",11572,233,1682,13487,85.8,1.73,12.47,2019
"4529302",5808,57,1046,6911,84.04,0.82,15.14,2019
"4529307",5971,345,1653,7969,74.93,4.33,20.74,2019
"4529316",8625,216,1268,10109,85.32,2.14,12.54,2019
"4529321",818,14,283,1115,73.36,1.26,25.38,2019
"4529014",363,0,322,685,52.99,0,47.01,2019
"4529038",587,35,166,788,74.49,4.44,21.07,2019
"4529053",4954,267,1721,6942,71.36,3.85,24.79,2019
"4529055",890,184,570,1644,54.14,11.19,34.67,2019
"4529072",20173,375,1509,22057,91.46,1.7,6.84,2019
"4529074",50,0,45,95,52.63,0,47.37,2019
"1330101",18905,219,879,20003,94.51,1.09,4.39,2019
"1330582",1434,16,396,1846,77.68,0.87,21.45,2019
"1330665",18,0,9,27,66.67,0,33.33,2019
"1330734",830,146,363,1339,61.99,10.9,27.11,2019
"1330328",15905,231,1040,17176,92.6,1.34,6.05,2019
"1330345",9319,330,778,10427,89.37,3.16,7.46,2019
"1330411",516,29,621,1166,44.25,2.49,53.26,2019
"1330413",436,3,203,642,67.91,0.47,31.62,2019
"1330415",2366,25,331,2722,86.92,0.92,12.16,2019
"1330423",19,22,26,67,28.36,32.84,38.81,2019
"1330426",151,0,120,271,55.72,0,44.28,2019
"1330438",10,0,7,17,58.82,0,41.18,2019
"1330446",245,19,96,360,68.06,5.28,26.67,2019
"1330470",84,4,59,147,57.14,2.72,40.14,2019
"1330473",602,15,338,955,63.04,1.57,35.39,2019
"1330017",6794,50,191,7035,96.57,0.71,2.71,2019
"1330025",2862,52,501,3415,83.81,1.52,14.67,2019
"1330038",12632,544,1695,14871,84.94,3.66,11.4,2019
"1330052",20208,355,1973,22536,89.67,1.58,8.75,2019
"1330055",1007,15,170,1192,84.48,1.26,14.26,2019
"1330071",5848,76,1603,7527,77.69,1.01,21.3,2019
"1330019",13707,121,454,14282,95.97,0.85,3.18,2019
"1330005",13107,163,256,13526,96.9,1.21,1.89,2019
"1330008",9477,237,1506,11220,84.47,2.11,13.42,2019
"1330022",22867,338,667,23872,95.79,1.42,2.79,2019
"1330024",23464,278,596,24338,96.41,1.14,2.45,2019
"1330041",22152,249,856,23257,95.25,1.07,3.68,2019
"1330066",19258,306,845,20409,94.36,1.5,4.14,2019
"1330082",10764,294,517,11575,92.99,2.54,4.47,2019
"1330083",16251,493,2981,19725,82.39,2.5,15.11,2019
"1330094",9981,301,1068,11350,87.94,2.65,9.41,2019
"1330113",1719,32,549,2300,74.74,1.39,23.87,2019
"1330125",6436,316,2143,8895,72.36,3.55,24.09,2019
"1330145",2015,191,548,2754,73.17,6.94,19.9,2019
"1330148",129,11,73,213,60.56,5.16,34.27,2019
"1330152",14520,214,359,15093,96.2,1.42,2.38,2019
"1330204",3097,320,1091,4508,68.7,7.1,24.2,2019
"1330215",11520,189,693,12402,92.89,1.52,5.59,2019
"1330217",2633,48,970,3651,72.12,1.31,26.57,2019
"1330218",303,143,300,746,40.62,19.17,40.21,2019
"1330223",8857,1034,3826,13717,64.57,7.54,27.89,2019
"1330233",5796,494,1842,8132,71.27,6.07,22.65,2019
"1330248",7926,401,453,8780,90.27,4.57,5.16,2019
"1330253",17606,216,1175,18997,92.68,1.14,6.19,2019
"1330256",854,12,124,990,86.26,1.21,12.53,2019
"1330268",3089,63,621,3773,81.87,1.67,16.46,2019
"1330273",4133,101,835,5069,81.53,1.99,16.47,2019
"1330274",10091,801,1923,12815,78.74,6.25,15.01,2019
"1330288",2478,169,558,3205,77.32,5.27,17.41,2019
"1330296",7627,417,1057,9101,83.8,4.58,11.61,2019
"1330303",909,134,271,1314,69.18,10.2,20.62,2019
"1330263",18252,636,3449,22337,81.71,2.85,15.44,2019
"1330319",18214,632,1272,20118,90.54,3.14,6.32,2019
"1330429",26,0,19,45,57.78,0,42.22,2019
"1330009",6578,98,253,6929,94.93,1.41,3.65,2019
"1330028",8199,48,742,8989,91.21,0.53,8.25,2019
"1330046",10569,356,1945,12870,82.12,2.77,15.11,2019
"1330118",0,0,0,0,NA,NA,NA,2019
"1330149",39,11,9,59,66.1,18.64,15.25,2019
"1233584",8087,283,847,9217,87.74,3.07,9.19,2019
"1233604",12742,282,2196,15220,83.72,1.85,14.43,2019
"1233618",10398,320,794,11512,90.32,2.78,6.9,2019
"1233637",5986,93,350,6429,93.11,1.45,5.44,2019
"1233701",7097,509,1272,8878,79.94,5.73,14.33,2019
"1233704",6940,204,470,7614,91.15,2.68,6.17,2019
"1233070",1808,74,188,2070,87.34,3.57,9.08,2019
"1233126",12296,856,5090,18242,67.4,4.69,27.9,2019
"1233129",5804,28,713,6545,88.68,0.43,10.89,2019
"1233130",8353,1419,4235,14007,59.63,10.13,30.23,2019
"1233131",9157,923,269,10349,88.48,8.92,2.6,2019
"1233137",8360,498,1276,10134,82.49,4.91,12.59,2019
"1233155",12543,432,1496,14471,86.68,2.99,10.34,2019
"1233165",12528,579,3181,16288,76.92,3.55,19.53,2019
"1233708",7028,318,822,8168,86.04,3.89,10.06,2019
"1233760",5567,270,814,6651,83.7,4.06,12.24,2019
"1233763",7461,251,1586,9298,80.24,2.7,17.06,2019
"1233030",6655,182,2113,8950,74.36,2.03,23.61,2019
"1233035",4132,216,215,4563,90.55,4.73,4.71,2019
"1233064",17374,1091,2296,20761,83.69,5.26,11.06,2019
"1233071",12211,254,386,12851,95.02,1.98,3,2019
"1233132",5422,1111,403,6936,78.17,16.02,5.81,2019
"1233139",16671,1727,2442,20840,80,8.29,11.72,2019
"1233141",13682,1791,2096,17569,77.88,10.19,11.93,2019
"1233150",5096,321,4362,9779,52.11,3.28,44.61,2019
"1233154",5349,269,567,6185,86.48,4.35,9.17,2019
"1233166",6474,79,1370,7923,81.71,1,17.29,2019
"1233167",3555,637,1594,5786,61.44,11.01,27.55,2019
"1233176",15011,739,1478,17228,87.13,4.29,8.58,2019
"1233177",11254,1985,1588,14827,75.9,13.39,10.71,2019
"1233178",14360,317,595,15272,94.03,2.08,3.9,2019
"1233180",11216,615,2654,14485,77.43,4.25,18.32,2019
"1233919",12122,504,1307,13933,87,3.62,9.38,2019
"1233953",2675,45,209,2929,91.33,1.54,7.14,2019
"1233001",107,57,21,185,57.84,30.81,11.35,2019
"1233014",11591,419,2558,14568,79.56,2.88,17.56,2019
"1233015",18434,557,2232,21223,86.86,2.62,10.52,2019
"1233016",12291,263,2794,15348,80.08,1.71,18.2,2019
"1233026",10149,170,911,11230,90.37,1.51,8.11,2019
"1233055",8127,361,2641,11129,73.03,3.24,23.73,2019
"1233056",6673,687,2431,9791,68.15,7.02,24.83,2019
"1233716",8146,226,937,9309,87.51,2.43,10.07,2019
"1233777",5910,122,771,6803,86.87,1.79,11.33,2019
"1233778",4866,133,982,5981,81.36,2.22,16.42,2019
"1233823",7474,1415,2305,11194,66.77,12.64,20.59,2019
"1233852",6191,238,2139,8568,72.26,2.78,24.96,2019
"1233901",6416,378,1907,8701,73.74,4.34,21.92,2019
"1233904",11041,529,1825,13395,82.43,3.95,13.62,2019
"1233916",6127,396,2030,8553,71.64,4.63,23.73,2019
"1233950",10129,90,1444,11663,86.85,0.77,12.38,2019
"1233960",159,0,132,291,54.64,0,45.36,2019
"1233944",70,0,0,70,100,0,0,2019
"1233946",1074,0,9,1083,99.17,0,0.83,2019
"1233971",6281,347,768,7396,84.92,4.69,10.38,2019
"1233981",4048,126,482,4656,86.94,2.71,10.35,2019
"1233990",10169,480,768,11417,89.07,4.2,6.73,2019
"1233993",7776,316,496,8588,90.54,3.68,5.78,2019
"1233173",9655,431,901,10987,87.88,3.92,8.2,2019
"1233174",7383,181,2401,9965,74.09,1.82,24.09,2019
"0136549",1793,78,397,2268,79.06,3.44,17.5,2019
"0136550",49,0,60,109,44.95,0,55.05,2019
"0136560",721,59,483,1263,57.09,4.67,38.24,2019
"0136561",2728,320,173,3221,84.69,9.93,5.37,2019
"0136580",1442,94,364,1900,75.89,4.95,19.16,2019
"0136618",5223,270,1160,6653,78.51,4.06,17.44,2019
"0136720",213,14,115,342,62.28,4.09,33.63,2019
"0136750",612,67,303,982,62.32,6.82,30.86,2019
"0136769",495,56,363,914,54.16,6.13,39.72,2019
"0136773",122,0,63,185,65.95,0,34.05,2019
"0136775",226,21,155,402,56.22,5.22,38.56,2019
"0136786",478,18,425,921,51.9,1.95,46.15,2019
"0136041",262,18,217,497,52.72,3.62,43.66,2019
"0136053",421,62,211,694,60.66,8.93,30.4,2019
"0136066",7484,251,646,8381,89.3,2.99,7.71,2019
"0136071",108,42,57,207,52.17,20.29,27.54,2019
"0136035",387,0,185,572,67.66,0,32.34,2019
"0136048",325,33,207,565,57.52,5.84,36.64,2019
"0136049",1495,74,476,2045,73.11,3.62,23.28,2019
"0136067",7771,104,2140,10015,77.59,1.04,21.37,2019
"0136069",576,76,212,864,66.67,8.8,24.54,2019
"0136075",530,34,365,929,57.05,3.66,39.29,2019
"0136081",4014,109,1951,6074,66.08,1.79,32.12,2019
"0136088",798,126,280,1204,66.28,10.47,23.26,2019
"0136091",933,50,555,1538,60.66,3.25,36.09,2019
"0136109",8473,235,1442,10150,83.48,2.32,14.21,2019
"0136266",1664,49,441,2154,77.25,2.27,20.47,2019
"0136017",336,33,332,701,47.93,4.71,47.36,2019
"0136036",452,33,187,672,67.26,4.91,27.83,2019
"0136040",761,58,595,1414,53.82,4.1,42.08,2019
"0136051",573,46,234,853,67.17,5.39,27.43,2019
"0136064",3364,42,207,3613,93.11,1.16,5.73,2019
"0136083",2077,171,1067,3315,62.65,5.16,32.19,2019
"0136107",2212,101,771,3084,71.73,3.27,25,2019
"0136110",2803,113,1321,4237,66.16,2.67,31.18,2019
"0136205",216,9,106,331,65.26,2.72,32.02,2019
"0136272",3755,248,1333,5336,70.37,4.65,24.98,2019
"0136278",1340,39,395,1774,75.54,2.2,22.27,2019
"0136310",1865,103,653,2621,71.16,3.93,24.91,2019
"0136312",1549,17,710,2276,68.06,0.75,31.2,2019
"0136313",63,0,35,98,64.29,0,35.71,2019
"0136344",1542,39,493,2074,74.35,1.88,23.77,2019
"0136373",68,0,123,191,35.6,0,64.4,2019
"0136375",1893,90,778,2761,68.56,3.26,28.18,2019
"0136801",7469,231,2154,9854,75.8,2.34,21.86,2019
"0136804",5611,287,1029,6927,81,4.14,14.85,2019
"0136830",13398,778,1261,15437,86.79,5.04,8.17,2019
"0136852",653,19,284,956,68.31,1.99,29.71,2019
"0136860",398,36,234,668,59.58,5.39,35.03,2019
"0136870",5637,192,1455,7284,77.39,2.64,19.98,2019
"0136912",447,43,339,829,53.92,5.19,40.89,2019
"0136921",253,5,158,416,60.82,1.2,37.98,2019
"0136922",150,0,80,230,65.22,0,34.78,2019
"0136481",57,0,78,135,42.22,0,57.78,2019
"0136569",187,0,38,225,83.11,0,16.89,2019
"0136732",1818,255,945,3018,60.24,8.45,31.31,2019
"0136849",0,0,0,0,NA,NA,NA,2019
"0136919",385,21,316,722,53.32,2.91,43.77,2019
"0136006",372,5,106,483,77.02,1.04,21.95,2019
"2839338",485,144,782,1411,34.37,10.21,55.42,2019
"2839356",118,0,41,159,74.21,0,25.79,2019
"2839421",618,120,401,1139,54.26,10.54,35.21,2019
"2839429",3547,457,2166,6170,57.49,7.41,35.11,2019
"2839451",769,21,478,1268,60.65,1.66,37.7,2019
"2839530",2316,51,912,3279,70.63,1.56,27.81,2019
"2839553",4957,94,1244,6295,78.75,1.49,19.76,2019
"2839565",5517,114,1221,6852,80.52,1.66,17.82,2019
"2839573",2101,91,658,2850,73.72,3.19,23.09,2019
"2839635",17,0,113,130,13.08,0,86.92,2019
"2839705",4647,177,442,5266,88.25,3.36,8.39,2019
"2839466",7999,501,1638,10138,78.9,4.94,16.16,2019
"2839477",122,2,133,257,47.47,0.78,51.75,2019
"2839481",339,24,223,586,57.85,4.1,38.05,2019
"2839346",561,4,331,896,62.61,0.45,36.94,2019
"2839350",5934,510,2412,8856,67.01,5.76,27.24,2019
"2839360",628,43,530,1201,52.29,3.58,44.13,2019
"2839426",5238,133,1028,6399,81.86,2.08,16.07,2019
"2839560",6058,134,947,7139,84.86,1.88,13.27,2019
"2839643",151,40,202,393,38.42,10.18,51.4,2019
"2839667",2595,228,1877,4700,55.21,4.85,39.94,2019
"2839669",877,3,902,1782,49.21,0.17,50.62,2019
"2839741",466,0,212,678,68.73,0,31.27,2019
"2839744",1314,19,772,2105,62.42,0.9,36.67,2019
"2839752",718,4,391,1113,64.51,0.36,35.13,2019
"2839769",466,39,178,683,68.23,5.71,26.06,2019
"2839773",4453,145,1409,6007,74.13,2.41,23.46,2019
"2839480",844,65,325,1234,68.4,5.27,26.34,2019
"2839427",301,39,206,546,55.13,7.14,37.73,2019
"2839439",961,91,643,1695,56.7,5.37,37.94,2019
"2839440",4111,257,3467,7835,52.47,3.28,44.25,2019
"2839476",1834,123,813,2770,66.21,4.44,29.35,2019
"2839531",5772,373,1562,7707,74.89,4.84,20.27,2019
"2839562",4914,105,1110,6129,80.18,1.71,18.11,2019
"2839572",369,0,98,467,79.01,0,20.99,2019
"2839629",1531,110,1170,2811,54.46,3.91,41.62,2019
"2839630",265,10,84,359,73.82,2.79,23.4,2019
"2839189",841,90,438,1369,61.43,6.57,31.99,2019
"2839045",287,7,253,547,52.47,1.28,46.25,2019
"2839056",8076,286,864,9226,87.54,3.1,9.36,2019
"2839113",46,6,109,161,28.57,3.73,67.7,2019
"2839119",1151,65,696,1912,60.2,3.4,36.4,2019
"2839120",8182,164,2822,11168,73.26,1.47,25.27,2019
"2839191",1422,233,1000,2655,53.56,8.78,37.66,2019
"2839201",260,5,15,280,92.86,1.79,5.36,2019
"2839204",4304,193,1467,5964,72.17,3.24,24.6,2019
"2839208",9537,315,1776,11628,82.02,2.71,15.27,2019
"2839305",6953,412,1183,8548,81.34,4.82,13.84,2019
"2839307",4003,410,1865,6278,63.76,6.53,29.71,2019
"2839322",369,0,240,609,60.59,0,39.41,2019
"2839330",618,89,332,1039,59.48,8.57,31.95,2019
"2839347",263,57,303,623,42.22,9.15,48.64,2019
"2839366",214,19,218,451,47.45,4.21,48.34,2019
"2839461",115,9,152,276,41.67,3.26,55.07,2019
"2839470",3316,251,1278,4845,68.44,5.18,26.38,2019
"2839478",369,15,366,750,49.2,2,48.8,2019
"2839483",1397,80,1012,2489,56.13,3.21,40.66,2019
"2839563",3607,180,1315,5102,70.7,3.53,25.77,2019
"2839571",4170,282,814,5266,79.19,5.36,15.46,2019
"4529114",418,0,235,653,64.01,0,35.99,2019
"4529123",2228,102,649,2979,74.79,3.42,21.79,2019
"4529178",969,11,302,1282,75.59,0.86,23.56,2019
"4529223",16492,394,3768,20654,79.85,1.91,18.24,2019
"4529306",4826,167,1826,6819,70.77,2.45,26.78,2019
"4529322",2522,106,728,3356,75.15,3.16,21.69,2019
"4529376",2299,49,347,2695,85.31,1.82,12.88,2019
"4529403",6370,186,1981,8537,74.62,2.18,23.2,2019
"4529406",9196,875,2627,12698,72.42,6.89,20.69,2019
"4529414",13794,2597,1459,17850,77.28,14.55,8.17,2019
"4529471",255,0,319,574,44.43,0,55.57,2019
"4529527",7321,330,1773,9424,77.68,3.5,18.81,2019
"4529530",588,28,312,928,63.36,3.02,33.62,2019
"4529032",1092,33,707,1832,59.61,1.8,38.59,2019
"4529047",1015,70,544,1629,62.31,4.3,33.39,2019
"4529061",3835,131,1068,5034,76.18,2.6,21.22,2019
"4529384",1478,70,317,1865,79.25,3.75,17,2019
"4529407",11546,1578,2067,15191,76.01,10.39,13.61,2019
"4529418",6418,1408,2055,9881,64.95,14.25,20.8,2019
"4529432",859,46,388,1293,66.43,3.56,30.01,2019
"4529434",173,20,47,240,72.08,8.33,19.58,2019
"4529437",666,27,387,1080,61.67,2.5,35.83,2019
"4529440",7234,601,2913,10748,67.31,5.59,27.1,2019
"4529450",956,77,287,1320,72.42,5.83,21.74,2019
"4529452",158,0,13,171,92.4,0,7.6,2019
"4529456",9196,518,1396,11110,82.77,4.66,12.57,2019
"4529477",1405,83,989,2477,56.72,3.35,39.93,2019
"4529525",445,8,315,768,57.94,1.04,41.02,2019
"4529340",4807,483,2067,7357,65.34,6.57,28.1,2019
"4529353",963,59,607,1629,59.12,3.62,37.26,2019
"4529364",102,13,102,217,47,5.99,47,2019
"4529369",5009,100,491,5600,89.45,1.79,8.77,2019
"4529370",272,9,32,313,86.9,2.88,10.22,2019
"4529374",857,34,409,1300,65.92,2.62,31.46,2019
"4529385",2203,102,491,2796,78.79,3.65,17.56,2019
"4529448",374,47,402,823,45.44,5.71,48.85,2019
"4529466",13205,68,548,13821,95.54,0.49,3.96,2019
"4529472",2181,34,535,2750,79.31,1.24,19.45,2019
"4529488",6613,513,1310,8436,78.39,6.08,15.53,2019
"4529501",14821,574,3280,18675,79.36,3.07,17.56,2019
"4529510",2248,323,1298,3869,58.1,8.35,33.55,2019
"4529541",2544,78,693,3315,76.74,2.35,20.9,2019
"4529943",130,0,64,194,67.01,0,32.99,2019
"4529388",4973,105,1197,6275,79.25,1.67,19.08,2019
"4529401",3106,166,362,3634,85.47,4.57,9.96,2019
"4529405",7186,316,2827,10329,69.57,3.06,27.37,2019
"4529412",13181,2173,1019,16373,80.5,13.27,6.22,2019
"4529423",0,0,0,0,NA,NA,NA,2019
"4529426",345,76,168,589,58.57,12.9,28.52,2019
"4529003",1567,34,891,2492,62.88,1.36,35.75,2019
"4529030",510,32,200,742,68.73,4.31,26.95,2019
"4529051",129,0,65,194,66.49,0,33.51,2019
"4529054",2857,91,547,3495,81.75,2.6,15.65,2019
"4529063",13228,177,1007,14412,91.78,1.23,6.99,2019
"4529018",802,34,427,1263,63.5,2.69,33.81,2019
"4529033",4619,118,869,5606,82.39,2.1,15.5,2019
"4529052",509,44,115,668,76.2,6.59,17.22,2019
"4529069",1038,71,810,1919,54.09,3.7,42.21,2019
"4529079",9,0,5,14,64.29,0,35.71,2019
"1330164",0,0,0,0,NA,NA,NA,2019
"1330284",20,0,8,28,71.43,0,28.57,2019
"1330289",15,0,1,16,93.75,0,6.25,2019
"1330332",0,0,0,0,NA,NA,NA,2019
"1330334",0,0,0,0,NA,NA,NA,2019
"1330363",1913,161,36,2110,90.66,7.63,1.71,2019
"1330449",31,0,11,42,73.81,0,26.19,2019
"1331024",6391,336,1679,8406,76.03,4,19.97,2019
"1331028",2246,30,122,2398,93.66,1.25,5.09,2019
"1331039",0,0,0,0,NA,NA,NA,2019
"1331049",477,21,196,694,68.73,3.03,28.24,2019
"1331772",155,18,6,179,86.59,10.06,3.35,2019
"1331784",216,25,52,293,73.72,8.53,17.75,2019
"1331812",171,0,92,263,65.02,0,34.98,2019
"1331824",391,6,271,668,58.53,0.9,40.57,2019
"1331825",644,23,360,1027,62.71,2.24,35.05,2019
"1331832",105,8,26,139,75.54,5.76,18.71,2019
"1331003",14,9,14,37,37.84,24.32,37.84,2019
"1331007",236,4,190,430,54.88,0.93,44.19,2019
"1331022",423,14,187,624,67.79,2.24,29.97,2019
"1331023",3495,160,1876,5531,63.19,2.89,33.92,2019
"1331057",455,13,370,838,54.3,1.55,44.15,2019
"1331307",219,0,109,328,66.77,0,33.23,2019
"1331315",2370,58,135,2563,92.47,2.26,5.27,2019
"1331316",3559,196,414,4169,85.37,4.7,9.93,2019
"1331320",2556,79,465,3100,82.45,2.55,15,2019
"1331329",2614,217,744,3575,73.12,6.07,20.81,2019
"1331405",11299,430,2188,13917,81.19,3.09,15.72,2019
"1331406",11275,405,1770,13450,83.83,3.01,13.16,2019
"1331411",4056,139,124,4319,93.91,3.22,2.87,2019
"1331512",493,39,284,816,60.42,4.78,34.8,2019
"1331557",815,131,333,1279,63.72,10.24,26.04,2019
"1331031",1731,67,648,2446,70.77,2.74,26.49,2019
"1331002",682,35,297,1014,67.26,3.45,29.29,2019
"1331020",446,0,280,726,61.43,0,38.57,2019
"1331033",502,0,219,721,69.63,0,30.37,2019
"1331047",4471,223,424,5118,87.36,4.36,8.28,2019
"1331051",19,3,35,57,33.33,5.26,61.4,2019
"1331052",2610,103,488,3201,81.54,3.22,15.25,2019
"1331201",2242,162,964,3368,66.57,4.81,28.62,2019
"1331419",19121,382,2397,21900,87.31,1.74,10.95,2019
"1331510",2281,157,931,3369,67.71,4.66,27.63,2019
"1331520",5850,466,2754,9070,64.5,5.14,30.36,2019
"1331537",1998,186,820,3004,66.51,6.19,27.3,2019
"1331553",1090,237,500,1827,59.66,12.97,27.37,2019
"1331560",739,70,155,964,76.66,7.26,16.08,2019
"1331563",281,17,221,519,54.14,3.28,42.58,2019
"1331622",347,58,392,797,43.54,7.28,49.18,2019
"1331626",1098,28,383,1509,72.76,1.86,25.38,2019
"1331642",963,173,444,1580,60.95,10.95,28.1,2019
"1331699",0,0,0,0,NA,NA,NA,2019
"1331722",106,2,56,164,64.63,1.22,34.15,2019
"1331083",46,0,80,126,36.51,0,63.49,2019
"1331733",330,0,189,519,63.58,0,36.42,2019
"1331783",193,5,216,414,46.62,1.21,52.17,2019
"1331641",418,82,191,691,60.49,11.87,27.64,2019
"1331569",1704,67,292,2063,82.6,3.25,14.15,2019
"1331620",2705,264,913,3882,69.68,6.8,23.52,2019
"1331627",71,9,34,114,62.28,7.89,29.82,2019
"1233187",4485,254,584,5323,84.26,4.77,10.97,2019
"1233193",12755,176,1496,14427,88.41,1.22,10.37,2019
"1233031",1686,0,167,1853,90.99,0,9.01,2019
"1233032",11614,222,1358,13194,88.02,1.68,10.29,2019
"1233043",1829,89,170,2088,87.6,4.26,8.14,2019
"1233146",4041,103,188,4332,93.28,2.38,4.34,2019
"1233147",8385,1378,4548,14311,58.59,9.63,31.78,2019
"1233149",4128,120,180,4428,93.22,2.71,4.07,2019
"1233161",11453,1084,4097,16634,68.85,6.52,24.63,2019
"1233172",11116,342,2559,14017,79.3,2.44,18.26,2019
"1233175",12437,489,2717,15643,79.51,3.13,17.37,2019
"1233190",4161,142,372,4675,89.01,3.04,7.96,2019
"1233315",5346,116,606,6068,88.1,1.91,9.99,2019
"1233405",5649,221,1122,6992,80.79,3.16,16.05,2019
"1233409",9425,227,1295,10947,86.1,2.07,11.83,2019
"1233413",4566,10,462,5038,90.63,0.2,9.17,2019
"1233426",8739,355,873,9967,87.68,3.56,8.76,2019
"1233469",5796,137,660,6593,87.91,2.08,10.01,2019
"1233471",1248,64,896,2208,56.52,2.9,40.58,2019
"1233484",11298,401,2478,14177,79.69,2.83,17.48,2019
"1233004",5141,295,1152,6588,78.04,4.48,17.49,2019
"1233010",9632,469,5193,15294,62.98,3.07,33.95,2019
"1233021",15083,650,2602,18335,82.26,3.55,14.19,2019
"1233023",15934,915,3727,20576,77.44,4.45,18.11,2019
"1233025",21963,1264,2237,25464,86.25,4.96,8.78,2019
"1233857",365,15,611,991,36.83,1.51,61.65,2019
"1233947",3794,64,321,4179,90.79,1.53,7.68,2019
"1233066",6728,489,1102,8319,80.88,5.88,13.25,2019
"1233168",4619,413,1705,6737,68.56,6.13,25.31,2019
"1233313",12752,2149,5058,19959,63.89,10.77,25.34,2019
"1233437",15648,747,1917,18312,85.45,4.08,10.47,2019
"1233185",7842,82,263,8187,95.79,1,3.21,2019
"1233415",12940,427,3219,16586,78.02,2.57,19.41,2019
"1233540",2630,241,932,3803,69.16,6.34,24.51,2019
"1233619",10672,365,2171,13208,80.8,2.76,16.44,2019
"1233755",7274,421,2041,9736,74.71,4.32,20.96,2019
"1233786",689,6,47,742,92.86,0.81,6.33,2019
"1233954",3424,82,438,3944,86.82,2.08,11.11,2019
"1233182",3480,72,219,3771,92.28,1.91,5.81,2019
"1233039",100,0,0,100,100,0,0,2019
"1233051",300,20,0,320,93.75,6.25,0,2019
"1233101",0,0,0,0,NA,NA,NA,2019
"1233449",3822,66,82,3970,96.27,1.66,2.07,2019
"1233472",6945,381,641,7967,87.17,4.78,8.05,2019
"1233473",3799,142,28,3969,95.72,3.58,0.71,2019
"1233503",57,0,0,57,100,0,0,2019
"1233542",7770,314,1926,10010,77.62,3.14,19.24,2019
"1233545",5743,133,248,6124,93.78,2.17,4.05,2019
"1233548",2492,13,100,2605,95.66,0.5,3.84,2019
"1233558",8312,190,545,9047,91.88,2.1,6.02,2019
"1233559",6011,274,458,6743,89.14,4.06,6.79,2019
"1233563",7765,504,1670,9939,78.13,5.07,16.8,2019
"1233578",18397,352,1099,19848,92.69,1.77,5.54,2019
"1233579",10697,157,242,11096,96.4,1.41,2.18,2019
"1233596",9642,177,200,10019,96.24,1.77,2,2019
"1233744",0,0,0,0,NA,NA,NA,2019
"1233812",3619,465,244,4328,83.62,10.74,5.64,2019
"1233854",77,0,111,188,40.96,0,59.04,2019
"1233855",0,0,0,0,NA,NA,NA,2019
"0136374",238,25,78,341,69.79,7.33,22.87,2019
"0136507",5468,195,1644,7307,74.83,2.67,22.5,2019
"0136052",159,7,25,191,83.25,3.66,13.09,2019
"0136092",5819,240,1442,7501,77.58,3.2,19.22,2019
"0136273",781,50,449,1280,61.02,3.91,35.08,2019
"0136038",13,0,0,13,100,0,0,2019
"0136082",0,0,0,0,NA,NA,NA,2019
"0136112",0,0,0,0,NA,NA,NA,2019
"0136321",449,7,166,622,72.19,1.13,26.69,2019
"0136421",2893,90,835,3818,75.77,2.36,21.87,2019
"0136439",99,4,89,192,51.56,2.08,46.35,2019
"0136454",5,0,0,5,100,0,0,2019
"0136512",0,0,20,20,0,0,100,2019
"0136543",28,0,13,41,68.29,0,31.71,2019
"0136555",287,12,48,347,82.71,3.46,13.83,2019
"0136568",22,0,46,68,32.35,0,67.65,2019
"0136590",0,0,0,0,NA,NA,NA,2019
"0136615",0,0,0,0,NA,NA,NA,2019
"0136616",8,0,0,8,100,0,0,2019
"0136688",0,0,0,0,NA,NA,NA,2019
"0136753",0,0,8,8,0,0,100,2019
"0136766",9,0,7,16,56.25,0,43.75,2019
"0136859",0,0,8,8,0,0,100,2019
"0136865",11,0,1,12,91.67,0,8.33,2019
"0136913",8,0,9,17,47.06,0,52.94,2019
"0136108",3709,781,2753,7243,51.21,10.78,38.01,2019
"0136256",456,11,198,665,68.57,1.65,29.77,2019
"0136115",285,10,0,295,96.61,3.39,0,2019
"0136323",2067,104,836,3007,68.74,3.46,27.8,2019
"0136528",495,18,72,585,84.62,3.08,12.31,2019
"4737918",14144,703,2885,17732,79.77,3.96,16.27,2019
"4737919",11231,305,1646,13182,85.2,2.31,12.49,2019
"4737920",13401,723,3046,17170,78.05,4.21,17.74,2019
"4737059",415,2,146,563,73.71,0.36,25.93,2019
"4737062",3481,45,514,4040,86.16,1.11,12.72,2019
"4737069",6889,48,80,7017,98.18,0.68,1.14,2019
"4737072",10777,413,1343,12533,85.99,3.3,10.72,2019
"4737082",1969,89,268,2326,84.65,3.83,11.52,2019
"4737087",14055,926,2652,17633,79.71,5.25,15.04,2019
"4737118",380,0,0,380,100,0,0,2019
"4737128",18053,673,917,19643,91.91,3.43,4.67,2019
"4737138",8072,199,993,9264,87.13,2.15,10.72,2019
"4737140",12,0,15,27,44.44,0,55.56,2019
"4737150",1282,32,561,1875,68.37,1.71,29.92,2019
"4737180",1024,117,264,1405,72.88,8.33,18.79,2019
"4737181",382,14,180,576,66.32,2.43,31.25,2019
"4737207",10366,1287,3256,14909,69.53,8.63,21.84,2019
"4737208",6013,262,1699,7974,75.41,3.29,21.31,2019
"4737337",344,15,227,586,58.7,2.56,38.74,2019
"4737342",1055,78,374,1507,70.01,5.18,24.82,2019
"4737350",681,22,34,737,92.4,2.99,4.61,2019
"4737355",7442,683,2093,10218,72.83,6.68,20.48,2019
"4737362",951,11,446,1408,67.54,0.78,31.68,2019
"4737410",927,72,532,1531,60.55,4.7,34.75,2019
"4737411",5369,187,1765,7321,73.34,2.55,24.11,2019
"4737421",17270,482,3008,20760,83.19,2.32,14.49,2019
"4737332",649,62,284,995,65.23,6.23,28.54,2019
"4737339",477,19,288,784,60.84,2.42,36.73,2019
"4737343",14844,311,2125,17280,85.9,1.8,12.3,2019
"2141056",4182,67,1359,5608,74.57,1.19,24.23,2019
"2141076",6188,113,843,7144,86.62,1.58,11.8,2019
"2141092",1051,36,173,1260,83.41,2.86,13.73,2019
"2141203",259,8,35,302,85.76,2.65,11.59,2019
"2141204",119,27,83,229,51.97,11.79,36.24,2019
"2141332",286,10,104,400,71.5,2.5,26,2019
"2141514",1091,0,253,1344,81.18,0,18.82,2019
"2141531",385,30,12,427,90.16,7.03,2.81,2019
"2141538",31,0,0,31,100,0,0,2019
"2141666",216,21,89,326,66.26,6.44,27.3,2019
"2141712",149,0,8,157,94.9,0,5.1,2019
"2141719",500,0,95,595,84.03,0,15.97,2019
"2141723",486,0,222,708,68.64,0,31.36,2019
"2141776",379,37,106,522,72.61,7.09,20.31,2019
"2141810",109,43,11,163,66.87,26.38,6.75,2019
"2141812",65,0,60,125,52,0,48,2019
"2141817",66,0,27,93,70.97,0,29.03,2019
"2141232",202,23,36,261,77.39,8.81,13.79,2019
"2141043",437,20,169,626,69.81,3.19,27,2019
"2141554",218,0,210,428,50.93,0,49.07,2019
"2141804",177,8,25,210,84.29,3.81,11.9,2019
"2141311",1639,41,1059,2739,59.84,1.5,38.66,2019
"2141663",177,0,34,211,83.89,0,16.11,2019
"2141832",107,0,32,139,76.98,0,23.02,2019
"2141011",9667,341,2159,12167,79.45,2.8,17.74,2019
"2141002",701,32,270,1003,69.89,3.19,26.92,2019
"2141005",7751,108,664,8523,90.94,1.27,7.79,2019
"2141008",1876,104,877,2857,65.66,3.64,30.7,2019
"2141030",1803,62,498,2363,76.3,2.62,21.07,2019
"2141034",215,11,77,303,70.96,3.63,25.41,2019
"2141135",9,5,39,53,16.98,9.43,73.58,2019
"2141360",74,92,34,200,37,46,17,2019
"2141512",230,4,65,299,76.92,1.34,21.74,2019
"2141062",0,0,12,12,0,0,100,2019
"2141099",0,0,0,0,NA,NA,NA,2019
"2141271",66,0,0,66,100,0,0,2019
"2141352",194,4,72,270,71.85,1.48,26.67,2019
"2141366",4,0,15,19,21.05,0,78.95,2019
"2141517",63,13,0,76,82.89,17.11,0,2019
"2141526",65,0,11,76,85.53,0,14.47,2019
"2141643",26,0,6,32,81.25,0,18.75,2019
"2141713",70,0,0,70,100,0,0,2019
"2141848",0,0,0,0,NA,NA,NA,2019
"2141074",1661,71,419,2151,77.22,3.3,19.48,2019
"2141086",682,30,286,998,68.34,3.01,28.66,2019
"2141093",921,34,256,1211,76.05,2.81,21.14,2019
"2141095",875,85,399,1359,64.39,6.25,29.36,2019
"2141097",1818,82,449,2349,77.39,3.49,19.11,2019
"2141102",6284,175,1163,7622,82.45,2.3,15.26,2019
"2141129",3062,117,527,3706,82.62,3.16,14.22,2019
"2141141",547,35,158,740,73.92,4.73,21.35,2019
"2141164",2654,425,1403,4482,59.21,9.48,31.3,2019
"2141171",1145,28,499,1672,68.48,1.67,29.84,2019
"2141264",88,29,25,142,61.97,20.42,17.61,2019
"2141616",125,50,68,243,51.44,20.58,27.98,2019
"2142022",81,0,0,81,100,0,0,2019
"2142024",376,20,76,472,79.66,4.24,16.1,2019
"2142020",507,26,180,713,71.11,3.65,25.25,2019
"2142047",77,0,66,143,53.85,0,46.15,2019
"4529108",5057,265,2744,8066,62.7,3.29,34.02,2019
"4529112",1044,23,645,1712,60.98,1.34,37.68,2019
"4529127",2681,111,731,3523,76.1,3.15,20.75,2019
"4529130",1849,88,624,2561,72.2,3.44,24.37,2019
"4529138",2266,80,1272,3618,62.63,2.21,35.16,2019
"4529150",10976,653,3573,15202,72.2,4.3,23.5,2019
"4529204",5027,171,1905,7103,70.77,2.41,26.82,2019
"4529006",2645,125,1085,3855,68.61,3.24,28.15,2019
"4529010",2499,171,1691,4361,57.3,3.92,38.78,2019
"4529031",273,12,183,468,58.33,2.56,39.1,2019
"4529048",1166,108,737,2011,57.98,5.37,36.65,2019
"4529062",26,0,28,54,48.15,0,51.85,2019
"4529065",180,17,58,255,70.59,6.67,22.75,2019
"4529067",2247,265,934,3446,65.21,7.69,27.1,2019
"4529073",15029,396,2124,17549,85.64,2.26,12.1,2019
"4529107",723,0,426,1149,62.92,0,37.08,2019
"4529536",3475,362,2161,5998,57.94,6.04,36.03,2019
"4529544",1565,81,373,2019,77.51,4.01,18.47,2019
"4529565",1238,272,1106,2616,47.32,10.4,42.28,2019
"4529575",7174,452,648,8274,86.71,5.46,7.83,2019
"4529585",6101,203,667,6971,87.52,2.91,9.57,2019
"4529630",5361,442,1277,7080,75.72,6.24,18.04,2019
"4529638",881,68,232,1181,74.6,5.76,19.64,2019
"4529646",7347,393,3360,11100,66.19,3.54,30.27,2019
"4529651",14911,149,2729,17789,83.82,0.84,15.34,2019
"4529654",2446,95,1107,3648,67.05,2.6,30.35,2019
"4529662",5458,202,552,6212,87.86,3.25,8.89,2019
"4529669",3380,162,1182,4724,71.55,3.43,25.02,2019
"4529828",230,0,143,373,61.66,0,38.34,2019
"4529801",8208,256,2346,10810,75.93,2.37,21.7,2019
"4529816",228,0,162,390,58.46,0,41.54,2019
"4529826",43,3,55,101,42.57,2.97,54.46,2019
"4529850",37,0,55,92,40.22,0,59.78,2019
"4529856",903,54,171,1128,80.05,4.79,15.16,2019
"4529906",6634,786,1510,8930,74.29,8.8,16.91,2019
"4529916",555,28,86,669,82.96,4.19,12.86,2019
"4529928",7153,293,372,7818,91.49,3.75,4.76,2019
"4529929",277,16,98,391,70.84,4.09,25.06,2019
"4529160",2171,59,1026,3256,66.68,1.81,31.51,2019
"4529070",4287,151,1492,5930,72.29,2.55,25.16,2019
"4529113",356,0,163,519,68.59,0,31.41,2019
"4529133",133,0,111,244,54.51,0,45.49,2019
"4529164",1314,9,735,2058,63.85,0.44,35.71,2019
"4529205",9278,231,1341,10850,85.51,2.13,12.36,2019
"4529301",10827,521,2125,13473,80.36,3.87,15.77,2019
"4529335",1410,101,332,1843,76.51,5.48,18.01,2019
"4529360",5973,234,2029,8236,72.52,2.84,24.64,2019
"4529431",1778,176,426,2380,74.71,7.39,17.9,2019
"4529451",1677,87,104,1868,89.78,4.66,5.57,2019
"4529493",50,0,9,59,84.75,0,15.25,2019
"4529505",7626,336,1794,9756,78.17,3.44,18.39,2019
"4529543",149,35,22,206,72.33,16.99,10.68,2019
"4529563",370,68,429,867,42.68,7.84,49.48,2019
"4529564",223,12,138,373,59.79,3.22,37,2019
"4529624",3322,590,2349,6261,53.06,9.42,37.52,2019
"4529627",4871,418,1906,7195,67.7,5.81,26.49,2019
"4529650",11934,234,1248,13416,88.95,1.74,9.3,2019
"4529653",1250,57,444,1751,71.39,3.26,25.36,2019
"4529512",3583,216,2302,6101,58.73,3.54,37.73,2019
"1331649",189,71,194,454,41.63,15.64,42.73,2019
"1331705",7305,418,3136,10859,67.27,3.85,28.88,2019
"1331714",1443,12,808,2263,63.76,0.53,35.7,2019
"1331716",811,45,217,1073,75.58,4.19,20.22,2019
"1331743",85,0,16,101,84.16,0,15.84,2019
"1331744",803,33,379,1215,66.09,2.72,31.19,2019
"1331749",615,48,318,981,62.69,4.89,32.42,2019
"1331774",1399,114,887,2400,58.29,4.75,36.96,2019
"1331795",400,19,311,730,54.79,2.6,42.6,2019
"1331807",947,15,105,1067,88.75,1.41,9.84,2019
"1331815",407,32,328,767,53.06,4.17,42.76,2019
"1331821",79,0,0,79,100,0,0,2019
"1331823",297,0,46,343,86.59,0,13.41,2019
"1331904",10237,359,2148,12744,80.33,2.82,16.85,2019
"1331909",13312,552,1227,15091,88.21,3.66,8.13,2019
"1331415",3034,166,1094,4294,70.66,3.87,25.48,2019
"1331044",647,27,380,1054,61.39,2.56,36.05,2019
"1331079",549,21,333,903,60.8,2.33,36.88,2019
"1331322",8712,87,856,9655,90.23,0.9,8.87,2019
"1331639",2636,198,1163,3997,65.95,4.95,29.1,2019
"1331747",26,0,52,78,33.33,0,66.67,2019
"1331816",1410,111,560,2081,67.76,5.33,26.91,2019
"1331062",0,0,0,0,NA,NA,NA,2019
"1331084",17,8,11,36,47.22,22.22,30.56,2019
"1331207",0,0,0,0,NA,NA,NA,2019
"1331213",0,0,0,0,NA,NA,NA,2019
"1331304",35,0,0,35,100,0,0,2019
"1331409",43,0,0,43,100,0,0,2019
"1331524",0,0,0,0,NA,NA,NA,2019
"1331547",67,0,0,67,100,0,0,2019
"1331556",21,5,6,32,65.62,15.62,18.75,2019
"1331561",17,0,13,30,56.67,0,43.33,2019
"1331562",501,34,224,759,66.01,4.48,29.51,2019
"1331698",0,0,0,0,NA,NA,NA,2019
"1331719",2139,101,1145,3385,63.19,2.98,33.83,2019
"1331796",287,0,190,477,60.17,0,39.83,2019
"1331803",1050,247,833,2130,49.3,11.6,39.11,2019
"1331806",1345,50,456,1851,72.66,2.7,24.64,2019
"1331808",2437,112,110,2659,91.65,4.21,4.14,2019
"1331811",1860,28,235,2123,87.61,1.32,11.07,2019
"1331831",904,37,317,1258,71.86,2.94,25.2,2019
"1331903",3833,452,2658,6943,55.21,6.51,38.28,2019
"1331905",3378,68,92,3538,95.48,1.92,2.6,2019
"1331069",6176,175,1181,7532,82,2.32,15.68,2019
"1331081",0,16,0,16,0,100,0,2019
"1331096",1451,168,881,2500,58.04,6.72,35.24,2019
"1331097",358,47,67,472,75.85,9.96,14.19,2019
"1331211",4610,169,1573,6352,72.58,2.66,24.76,2019
"1331318",97,0,12,109,88.99,0,11.01,2019
"1331516",3525,227,1666,5418,65.06,4.19,30.75,2019
"1331519",832,75,480,1387,59.99,5.41,34.61,2019
"1331522",7064,130,428,7622,92.68,1.71,5.62,2019
"1331525",8755,376,2356,11487,76.22,3.27,20.51,2019
"1331546",2091,84,466,2641,79.17,3.18,17.64,2019
"1331548",6575,323,898,7796,84.34,4.14,11.52,2019
"1331098",948,3,49,1000,94.8,0.3,4.9,2019
"1331312",6079,105,748,6932,87.69,1.51,10.79,2019
"1331327",93,0,60,153,60.78,0,39.22,2019
"1331820",3770,113,236,4119,91.53,2.74,5.73,2019
"1233856",153,29,9,191,80.1,15.18,4.71,2019
"1233859",3270,132,930,4332,75.48,3.05,21.47,2019
"1233867",166,0,0,166,100,0,0,2019
"1233875",3844,138,719,4701,81.77,2.94,15.29,2019
"1233876",1645,40,348,2033,80.91,1.97,17.12,2019
"1233896",2688,583,339,3610,74.46,16.15,9.39,2019
"1233897",5242,1188,579,7009,74.79,16.95,8.26,2019
"1233898",4840,298,1180,6318,76.61,4.72,18.68,2019
"1233965",0,0,0,0,NA,NA,NA,2019
"1233966",4059,17,173,4249,95.53,0.4,4.07,2019
"1233967",7342,286,562,8190,89.65,3.49,6.86,2019
"1233973",3094,392,611,4097,75.52,9.57,14.91,2019
"1233974",4118,178,396,4692,87.77,3.79,8.44,2019
"1233976",3875,171,509,4555,85.07,3.75,11.17,2019
"1233076",11352,82,572,12006,94.55,0.68,4.76,2019
"1233170",3111,13,769,3893,79.91,0.33,19.75,2019
"1233316",4464,106,491,5061,88.2,2.09,9.7,2019
"1233470",7348,155,656,8159,90.06,1.9,8.04,2019
"1233034",3507,119,1118,4744,73.92,2.51,23.57,2019
"1233334",10525,425,1219,12169,86.49,3.49,10.02,2019
"1233446",11333,498,1625,13456,84.22,3.7,12.08,2019
"1233570",8277,343,1248,9868,83.88,3.48,12.65,2019
"1233634",6698,137,603,7438,90.05,1.84,8.11,2019
"1233890",827,62,594,1483,55.77,4.18,40.05,2019
"1233843",2375,235,893,3503,67.8,6.71,25.49,2019
"1233844",6921,2811,2421,12153,56.95,23.13,19.92,2019
"1233847",39,5,3,47,82.98,10.64,6.38,2019
"1233860",5651,1063,1427,8141,69.41,13.06,17.53,2019
"1233873",2781,181,1527,4489,61.95,4.03,34.02,2019
"1233884",8712,2247,1014,11973,72.76,18.77,8.47,2019
"1233921",292,0,39,331,88.22,0,11.78,2019
"1233924",30,11,4,45,66.67,24.44,8.89,2019
"1233629",10179,95,420,10694,95.18,0.89,3.93,2019
"1233703",10001,139,703,10843,92.23,1.28,6.48,2019
"1233712",7082,553,1561,9196,77.01,6.01,16.97,2019
"1233513",2578,214,868,3660,70.44,5.85,23.72,2019
"1233538",1287,131,565,1983,64.9,6.61,28.49,2019
"1233547",7248,120,627,7995,90.66,1.5,7.84,2019
"1233606",7784,162,460,8406,92.6,1.93,5.47,2019
"1233616",6109,94,594,6797,89.88,1.38,8.74,2019
"1233068",14525,698,1618,16841,86.25,4.14,9.61,2019
"1233109",193,17,0,210,91.9,8.1,0,2019
"1233142",10326,1419,7970,19715,52.38,7.2,40.43,2019
"1233144",7038,173,2051,9262,75.99,1.87,22.14,2019
"1233189",6325,93,1479,7897,80.09,1.18,18.73,2019
"1233323",6667,409,262,7338,90.86,5.57,3.57,2019
"1233332",3082,58,33,3173,97.13,1.83,1.04,2019
"1233411",22003,561,1991,24555,89.61,2.28,8.11,2019
"1233431",7088,214,672,7974,88.89,2.68,8.43,2019
"1233441",9315,246,1543,11104,83.89,2.22,13.9,2019
"1233594",11484,250,956,12690,90.5,1.97,7.53,2019
"1233549",6171,156,489,6816,90.54,2.29,7.17,2019
"1233569",9152,70,579,9801,93.38,0.71,5.91,2019
"1233573",10718,370,1828,12916,82.98,2.86,14.15,2019
"1233602",7306,318,928,8552,85.43,3.72,10.85,2019
"1233624",14311,214,665,15190,94.21,1.41,4.38,2019
"1233710",11791,356,1564,13711,86,2.6,11.41,2019
"1233759",6491,210,1232,7933,81.82,2.65,15.53,2019
"1233762",2437,74,182,2693,90.49,2.75,6.76,2019
"4737351",97,0,33,130,74.62,0,25.38,2019
"4737370",1470,70,509,2049,71.74,3.42,24.84,2019
"4737373",972,3,124,1099,88.44,0.27,11.28,2019
"4737376",64,0,75,139,46.04,0,53.96,2019
"4737387",843,19,363,1225,68.82,1.55,29.63,2019
"4737397",2765,54,964,3783,73.09,1.43,25.48,2019
"4737404",3571,128,1249,4948,72.17,2.59,25.24,2019
"4737416",4964,177,1335,6476,76.65,2.73,20.61,2019
"4737617",4636,96,815,5547,83.58,1.73,14.69,2019
"4737618",4321,223,1002,5546,77.91,4.02,18.07,2019
"4737641",2672,172,1064,3908,68.37,4.4,27.23,2019
"4737650",3428,228,1708,5364,63.91,4.25,31.84,2019
"4737656",1187,36,379,1602,74.09,2.25,23.66,2019
"4737854",3491,165,1348,5004,69.76,3.3,26.94,2019
"4737885",2130,48,465,2643,80.59,1.82,17.59,2019
"4737886",1321,14,403,1738,76.01,0.81,23.19,2019
"4737887",1483,38,469,1990,74.52,1.91,23.57,2019
"4737891",1018,4,393,1415,71.94,0.28,27.77,2019
"4737659",9363,430,1438,11231,83.37,3.83,12.8,2019
"4737665",1639,104,735,2478,66.14,4.2,29.66,2019
"4737705",1371,32,217,1620,84.63,1.98,13.4,2019
"4737708",1837,102,557,2496,73.6,4.09,22.32,2019
"4737709",1138,42,347,1527,74.53,2.75,22.72,2019
"4737716",8494,264,2031,10789,78.73,2.45,18.82,2019
"4737721",3963,216,926,5105,77.63,4.23,18.14,2019
"4737748",4743,269,1689,6701,70.78,4.01,25.21,2019
"4737809",708,41,298,1047,67.62,3.92,28.46,2019
"4737821",5709,688,2288,8685,65.73,7.92,26.34,2019
"4737825",2201,94,1409,3704,59.42,2.54,38.04,2019
"4737845",140,0,72,212,66.04,0,33.96,2019
"4737849",8852,144,1090,10086,87.77,1.43,10.81,2019
"4737866",519,14,114,647,80.22,2.16,17.62,2019
"4737869",988,161,887,2036,48.53,7.91,43.57,2019
"4737890",2088,240,543,2871,72.73,8.36,18.91,2019
"4737909",6253,265,832,7350,85.07,3.61,11.32,2019
"4737014",950,28,41,1019,93.23,2.75,4.02,2019
"4737031",1341,51,331,1723,77.83,2.96,19.21,2019
"4737032",1206,66,444,1716,70.28,3.85,25.87,2019
"4737129",18948,585,1832,21365,88.69,2.74,8.57,2019
"4737057",207,25,105,337,61.42,7.42,31.16,2019
"4737074",2041,64,742,2847,71.69,2.25,26.06,2019
"4738351",5488,100,1419,7007,78.32,1.43,20.25,2019
"4738357",818,2,230,1050,77.9,0.19,21.9,2019
"4738359",107,5,16,128,83.59,3.91,12.5,2019
"2838856",461,24,204,689,66.91,3.48,29.61,2019
"2838873",686,98,302,1086,63.17,9.02,27.81,2019
"2838947",159,5,51,215,73.95,2.33,23.72,2019
"2838950",123,0,68,191,64.4,0,35.6,2019
"4738454",260,0,104,364,71.43,0,28.57,2019
"4738461",280,40,180,500,56,8,36,2019
"4738468",1443,41,484,1968,73.32,2.08,24.59,2019
"4738469",1156,39,395,1590,72.7,2.45,24.84,2019
"4738487",264,20,95,379,69.66,5.28,25.07,2019
"4738548",258,0,69,327,78.9,0,21.1,2019
"4738563",1021,5,233,1259,81.1,0.4,18.51,2019
"4738580",594,0,67,661,89.86,0,10.14,2019
"4738587",396,0,243,639,61.97,0,38.03,2019
"2838620",711,98,488,1297,54.82,7.56,37.63,2019
"2838622",195,21,110,326,59.82,6.44,33.74,2019
"2839581",3159,112,1091,4362,72.42,2.57,25.01,2019
"2839631",788,57,515,1360,57.94,4.19,37.87,2019
"2839648",3912,442,2965,7319,53.45,6.04,40.51,2019
"2839096",444,0,119,563,78.86,0,21.14,2019
"2839110",14380,288,749,15417,93.27,1.87,4.86,2019
"2839111",1863,272,897,3032,61.44,8.97,29.58,2019
"2839115",20,0,0,20,100,0,0,2019
"2839140",494,100,359,953,51.84,10.49,37.67,2019
"2839144",144,10,36,190,75.79,5.26,18.95,2019
"2839145",1363,31,647,2041,66.78,1.52,31.7,2019
"2839157",9438,155,1114,10707,88.15,1.45,10.4,2019
"2839159",761,47,419,1227,62.02,3.83,34.15,2019
"2839180",9484,513,2580,12577,75.41,4.08,20.51,2019
"2839202",2741,49,775,3565,76.89,1.37,21.74,2019
"2839206",8084,111,1763,9958,81.18,1.11,17.7,2019
"2839039",481,4,305,790,60.89,0.51,38.61,2019
"2839041",1091,66,336,1493,73.07,4.42,22.51,2019
"2839051",3609,351,1829,5789,62.34,6.06,31.59,2019
"2839078",69,51,164,284,24.3,17.96,57.75,2019
"2839088",27,0,5,32,84.38,0,15.62,2019
"2839663",521,136,563,1220,42.7,11.15,46.15,2019
"2839348",117,0,168,285,41.05,0,58.95,2019
"2839269",0,0,0,0,NA,NA,NA,2019
"2839327",1048,98,357,1503,69.73,6.52,23.75,2019
"2839337",423,63,240,726,58.26,8.68,33.06,2019
"2839358",237,57,189,483,49.07,11.8,39.13,2019
"2839359",96,7,23,126,76.19,5.56,18.25,2019
"2839362",905,38,354,1297,69.78,2.93,27.29,2019
"2839367",3653,247,1829,5729,63.76,4.31,31.93,2019
"2839422",1021,97,746,1864,54.77,5.2,40.02,2019
"2839117",2323,168,1177,3668,63.33,4.58,32.09,2019
"2839149",414,0,147,561,73.8,0,26.2,2019
"2839211",9382,124,793,10299,91.1,1.2,7.7,2019
"2839216",1445,42,254,1741,83,2.41,14.59,2019
"2839301",6927,589,2887,10403,66.59,5.66,27.75,2019
"2839328",873,77,878,1828,47.76,4.21,48.03,2019
"2839332",469,17,74,560,83.75,3.04,13.21,2019
"2839341",1380,137,926,2443,56.49,5.61,37.9,2019
"2839355",1804,105,824,2733,66.01,3.84,30.15,2019
"2839361",382,38,201,621,61.51,6.12,32.37,2019
"2839402",13884,250,1443,15577,89.13,1.6,9.26,2019
"2141367",32,0,48,80,40,0,60,2019
"2141049",604,10,243,857,70.48,1.17,28.35,2019
"2141051",9234,258,714,10206,90.48,2.53,7,2019
"2141055",563,9,133,705,79.86,1.28,18.87,2019
"2141094",4885,238,320,5443,89.75,4.37,5.88,2019
"2141139",2689,86,488,3263,82.41,2.64,14.96,2019
"2141149",117,0,71,188,62.23,0,37.77,2019
"2141183",537,22,63,622,86.33,3.54,10.13,2019
"2141219",486,14,281,781,62.23,1.79,35.98,2019
"2141230",2741,348,1179,4268,64.22,8.15,27.62,2019
"2141250",373,12,102,487,76.59,2.46,20.94,2019
"2141254",78,6,80,164,47.56,3.66,48.78,2019
"2141257",170,8,41,219,77.63,3.65,18.72,2019
"2141314",1121,49,680,1850,60.59,2.65,36.76,2019
"2141563",118,11,17,146,80.82,7.53,11.64,2019
"2141564",156,0,151,307,50.81,0,49.19,2019
"2141566",256,0,52,308,83.12,0,16.88,2019
"2141568",287,0,158,445,64.49,0,35.51,2019
"4529550",9583,399,2534,12516,76.57,3.19,20.25,2019
"4529579",15511,328,800,16639,93.22,1.97,4.81,2019
"4529584",667,15,287,969,68.83,1.55,29.62,2019
"4529591",1058,108,722,1888,56.04,5.72,38.24,2019
"4529532",5524,268,2279,8071,68.44,3.32,28.24,2019
"4529540",1034,81,631,1746,59.22,4.64,36.14,2019
"4529545",414,14,175,603,68.66,2.32,29.02,2019
"4529546",478,45,479,1002,47.7,4.49,47.8,2019
"4529834",576,0,249,825,69.82,0,30.18,2019
"4529835",2202,80,651,2933,75.08,2.73,22.2,2019
"4529844",51,5,16,72,70.83,6.94,22.22,2019
"4529853",1692,81,756,2529,66.9,3.2,29.89,2019
"4529860",5349,131,588,6068,88.15,2.16,9.69,2019
"4529921",57,0,18,75,76,0,24,2019
"4529924",1189,33,513,1735,68.53,1.9,29.57,2019
"4529934",303,0,98,401,75.56,0,24.44,2019
"4529592",80,31,190,301,26.58,10.3,63.12,2019
"4529594",22,0,56,78,28.21,0,71.79,2019
"4529601",4341,163,1197,5701,76.14,2.86,21,2019
"4529620",3594,255,1346,5195,69.18,4.91,25.91,2019
"4529639",301,43,33,377,79.84,11.41,8.75,2019
"4529671",5010,78,1642,6730,74.44,1.16,24.4,2019
"4529678",6742,410,2184,9336,72.22,4.39,23.39,2019
"4529706",4411,462,2739,7612,57.95,6.07,35.98,2019
"4529715",11439,153,745,12337,92.72,1.24,6.04,2019
"4529718",973,36,532,1541,63.14,2.34,34.52,2019
"4529720",12174,850,4434,17458,69.73,4.87,25.4,2019
"4529554",1527,211,1823,3561,42.88,5.93,51.19,2019
"4529555",1487,45,498,2030,73.25,2.22,24.53,2019
"4529556",2631,494,1900,5025,52.36,9.83,37.81,2019
"4529566",6978,461,609,8048,86.7,5.73,7.57,2019
"4529572",3859,243,540,4642,83.13,5.23,11.63,2019
"4529576",12622,629,1326,14577,86.59,4.32,9.1,2019
"4529583",1328,0,705,2033,65.32,0,34.68,2019
"4529596",540,114,282,936,57.69,12.18,30.13,2019
"4529605",10859,355,2993,14207,76.43,2.5,21.07,2019
"4529609",9884,229,1988,12101,81.68,1.89,16.43,2019
"4529611",7789,321,3333,11443,68.07,2.81,29.13,2019
"4529628",683,47,246,976,69.98,4.82,25.2,2019
"4529645",2803,109,830,3742,74.91,2.91,22.18,2019
"4529659",35,2,10,47,74.47,4.26,21.28,2019
"1951648",81,0,24,105,77.14,0,22.86,2019
"1951632",2136,79,426,2641,80.88,2.99,16.13,2019
"1951631",110,7,27,144,76.39,4.86,18.75,2019
"1951636",161,13,31,205,78.54,6.34,15.12,2019
"1951577",430,33,86,549,78.32,6.01,15.66,2019
"1951557",338,15,72,425,79.53,3.53,16.94,2019
"1951637",66,0,32,98,67.35,0,32.65,2019
"1951579",722,77,133,932,77.47,8.26,14.27,2019
"4529655",1756,227,781,2764,63.53,8.21,28.26,2019
"4529684",1169,73,361,1603,72.93,4.55,22.52,2019
"4529702",2455,266,1176,3897,63,6.83,30.18,2019
"4529590",495,42,383,920,53.8,4.57,41.63,2019
"4529560",3344,219,1551,5114,65.39,4.28,30.33,2019
"4529567",57,3,85,145,39.31,2.07,58.62,2019
"4529574",2195,226,1546,3967,55.33,5.7,38.97,2019
"4529582",6712,433,614,7759,86.51,5.58,7.91,2019
"4529625",9232,787,2022,12041,76.67,6.54,16.79,2019
"4529635",354,42,147,543,65.19,7.73,27.07,2019
"1331826",509,72,269,850,59.88,8.47,31.65,2019
"1331827",417,47,423,887,47.01,5.3,47.69,2019
"1331906",6205,274,1996,8475,73.22,3.23,23.55,2019
"1331567",144,34,120,298,48.32,11.41,40.27,2019
"1331523",4502,45,865,5412,83.19,0.83,15.98,2019
"1331527",422,26,21,469,89.98,5.54,4.48,2019
"1331721",6938,190,714,7842,88.47,2.42,9.1,2019
"1331788",2510,42,827,3379,74.28,1.24,24.47,2019
"1331793",2455,55,766,3276,74.94,1.68,23.38,2019
"1331091",839,42,520,1401,59.89,3,37.12,2019
"1331331",2653,65,768,3486,76.1,1.86,22.03,2019
"1331554",1308,139,369,1816,72.03,7.65,20.32,2019
"1331787",406,18,189,613,66.23,2.94,30.83,2019
"1331054",293,24,212,529,55.39,4.54,40.08,2019
"1331220",4894,159,615,5668,86.34,2.81,10.85,2019
"1331025",324,23,25,372,87.1,6.18,6.72,2019
"1331060",351,12,368,731,48.02,1.64,50.34,2019
"1331032",4652,90,800,5542,83.94,1.62,14.44,2019
"1331042",305,46,150,501,60.88,9.18,29.94,2019
"1331078",749,34,332,1115,67.17,3.05,29.78,2019
"1331309",263,5,128,396,66.41,1.26,32.32,2019
"1331535",2670,184,1096,3950,67.59,4.66,27.75,2019
"1331544",238,12,105,355,67.04,3.38,29.58,2019
"1331629",252,3,39,294,85.71,1.02,13.27,2019
"1331720",72,0,55,127,56.69,0,43.31,2019
"1331804",1861,33,224,2118,87.87,1.56,10.58,2019
"1331907",15970,1010,3372,20352,78.47,4.96,16.57,2019
"1331805",652,17,441,1110,58.74,1.53,39.73,2019
"1331542",644,73,174,891,72.28,8.19,19.53,2019
"1331551",131,32,140,303,43.23,10.56,46.2,2019
"1331606",806,140,305,1251,64.43,11.19,24.38,2019
"1331645",1434,55,429,1918,74.77,2.87,22.37,2019
"1331648",139,20,214,373,37.27,5.36,57.37,2019
"1331711",124,4,151,279,44.44,1.43,54.12,2019
"1331730",2169,75,1067,3311,65.51,2.27,32.23,2019
"1331735",201,0,169,370,54.32,0,45.68,2019
"1331738",634,18,184,836,75.84,2.15,22.01,2019
"1331750",3954,593,2268,6815,58.02,8.7,33.28,2019
"1331765",817,16,276,1109,73.67,1.44,24.89,2019
"1331791",3451,78,1115,4644,74.31,1.68,24.01,2019
"1331794",6631,229,3642,10502,63.14,2.18,34.68,2019
"1331801",1020,54,275,1349,75.61,4,20.39,2019
"1331814",105,0,12,117,89.74,0,10.26,2019
"1331011",264,4,115,383,68.93,1.04,30.03,2019
"1331015",4939,367,2738,8044,61.4,4.56,34.04,2019
"1331021",6471,380,3129,9980,64.84,3.81,31.35,2019
"1331036",2843,88,1034,3965,71.7,2.22,26.08,2019
"1331038",177,0,21,198,89.39,0,10.61,2019
"1331058",441,0,317,758,58.18,0,41.82,2019
"1331065",248,0,243,491,50.51,0,49.49,2019
"1331067",69,7,28,104,66.35,6.73,26.92,2019
"1331094",251,43,164,458,54.8,9.39,35.81,2019
"1331775",737,74,331,1142,64.54,6.48,28.98,2019
"1331789",237,12,218,467,50.75,2.57,46.68,2019
"1331790",491,17,245,753,65.21,2.26,32.54,2019
"1331798",203,0,71,274,74.09,0,25.91,2019
"1331822",1658,140,385,2183,75.95,6.41,17.64,2019
"1331005",5462,90,598,6150,88.81,1.46,9.72,2019
"1331012",272,21,202,495,54.95,4.24,40.81,2019
"1233771",10480,583,2341,13404,78.19,4.35,17.46,2019
"1233773",6077,107,931,7115,85.41,1.5,13.09,2019
"1233774",6492,207,1046,7745,83.82,2.67,13.51,2019
"1233810",14550,943,2052,17545,82.93,5.37,11.7,2019
"1233813",10449,1707,899,13055,80.04,13.08,6.89,2019
"1233830",6424,1170,2093,9687,66.32,12.08,21.61,2019
"1233834",1102,61,573,1736,63.48,3.51,33.01,2019
"1233837",6689,1892,1096,9677,69.12,19.55,11.33,2019
"1233838",670,170,353,1193,56.16,14.25,29.59,2019
"1233908",14673,1014,1890,17577,83.48,5.77,10.75,2019
"1233922",1501,46,157,1704,88.09,2.7,9.21,2019
"1233931",4568,438,461,5467,83.56,8.01,8.43,2019
"1233935",4718,352,1841,6911,68.27,5.09,26.64,2019
"1233945",0,0,0,0,NA,NA,NA,2019
"1233952",10783,331,2323,13437,80.25,2.46,17.29,2019
"1233980",4620,98,1057,5775,80,1.7,18.3,2019
"1233027",17308,970,3242,21520,80.43,4.51,15.07,2019
"1233013",6498,245,2955,9698,67,2.53,30.47,2019
"1233033",13694,342,1602,15638,87.57,2.19,10.24,2019
"1233050",3473,90,552,4115,84.4,2.19,13.41,2019
"1233063",18899,789,3219,22907,82.5,3.44,14.05,2019
"1233067",8365,122,266,8753,95.57,1.39,3.04,2019
"1233069",8872,255,1367,10494,84.54,2.43,13.03,2019
"1233125",10875,1237,9237,21349,50.94,5.79,43.27,2019
"1233127",5657,609,3941,10207,55.42,5.97,38.61,2019
"1234638",8717,137,263,9117,95.61,1.5,2.88,2019
"1234688",2632,80,384,3096,85.01,2.58,12.4,2019
"1234714",6675,269,886,7830,85.25,3.44,11.32,2019
"1234715",5205,135,308,5648,92.16,2.39,5.45,2019
"1234772",8266,186,501,8953,92.33,2.08,5.6,2019
"1234653",11655,650,2524,14829,78.6,4.38,17.02,2019
"1234982",7936,379,1685,10000,79.36,3.79,16.85,2019
"1234233",6268,527,1096,7891,79.43,6.68,13.89,2019
"1234951",5859,133,1081,7073,82.84,1.88,15.28,2019
"1234956",1780,58,460,2298,77.46,2.52,20.02,2019
"1234972",3156,259,2342,5757,54.82,4.5,40.68,2019
"1234974",6484,746,2554,9784,66.27,7.62,26.1,2019
"1234744",13539,743,1881,16163,83.77,4.6,11.64,2019
"1234753",1447,59,203,1709,84.67,3.45,11.88,2019
"1234787",21287,615,1641,23543,90.42,2.61,6.97,2019
"1234236",6208,297,746,7251,85.62,4.1,10.29,2019
"0136303",9201,291,2175,11667,78.86,2.49,18.64,2019
"0136311",598,46,349,993,60.22,4.63,35.15,2019
"0136350",2096,63,487,2646,79.21,2.38,18.41,2019
"0136420",3186,98,966,4250,74.96,2.31,22.73,2019
"0136451",1020,125,575,1720,59.3,7.27,33.43,2019
"0136470",0,0,51,51,0,0,100,2019
"0136473",14,0,25,39,35.9,0,64.1,2019
"0136518",536,95,415,1046,51.24,9.08,39.67,2019
"0136526",11338,130,837,12305,92.14,1.06,6.8,2019
"0136527",5039,113,572,5724,88.03,1.97,9.99,2019
"0136551",2408,161,566,3135,76.81,5.14,18.05,2019
"0136553",566,50,210,826,68.52,6.05,25.42,2019
"0136582",6690,256,1602,8548,78.26,2.99,18.74,2019
"0136584",164,0,160,324,50.62,0,49.38,2019
"0136585",206,0,132,338,60.95,0,39.05,2019
"0136603",1425,100,1322,2847,50.05,3.51,46.43,2019
"0136605",6336,256,3783,10375,61.07,2.47,36.46,2019
"0136744",1463,134,940,2537,57.67,5.28,37.05,2019
"2838629",503,41,151,695,72.37,5.9,21.73,2019
"2838639",204,0,195,399,51.13,0,48.87,2019
"2838645",321,8,206,535,60,1.5,38.5,2019
"2838663",2892,294,1221,4407,65.62,6.67,27.71,2019
"2838666",1503,53,1179,2735,54.95,1.94,43.11,2019
"4738388",439,43,172,654,67.13,6.57,26.3,2019
"4738367",762,17,388,1167,65.3,1.46,33.25,2019
"4738463",626,4,358,988,63.36,0.4,36.23,2019
"4738464",6455,287,2083,8825,73.14,3.25,23.6,2019
"4738478",5451,87,1656,7194,75.77,1.21,23.02,2019
"4738483",1495,101,515,2111,70.82,4.78,24.4,2019
"4738577",556,0,127,683,81.41,0,18.59,2019
"4738579",237,0,134,371,63.88,0,36.12,2019
"2838606",3718,286,1526,5530,67.23,5.17,27.59,2019
"2838610",535,118,413,1066,50.19,11.07,38.74,2019
"2838641",660,8,96,764,86.39,1.05,12.57,2019
"2838644",42,0,25,67,62.69,0,37.31,2019
"2838655",13869,936,1722,16527,83.92,5.66,10.42,2019
"2838659",618,14,334,966,63.98,1.45,34.58,2019
"2838668",3741,259,860,4860,76.98,5.33,17.7,2019
"2838672",4159,171,500,4830,86.11,3.54,10.35,2019
"2838744",123,10,122,255,48.24,3.92,47.84,2019
"2838765",14,0,41,55,25.45,0,74.55,2019
"2838767",24,0,5,29,82.76,0,17.24,2019
"2838768",75,0,0,75,100,0,0,2019
"2838841",787,36,328,1151,68.38,3.13,28.5,2019
"2838847",811,64,344,1219,66.53,5.25,28.22,2019
"2838859",231,0,80,311,74.28,0,25.72,2019
"4738021",11,0,0,11,100,0,0,2019
"4738042",227,0,81,308,73.7,0,26.3,2019
"4738049",1026,44,397,1467,69.94,3,27.06,2019
"4738106",2494,417,6221,9132,27.31,4.57,68.12,2019
"4738115",14492,413,2036,16941,85.54,2.44,12.02,2019
"4738131",0,0,0,0,NA,NA,NA,2019
"2838871",485,9,194,688,70.49,1.31,28.2,2019
"2838901",4990,240,2123,7353,67.86,3.26,28.87,2019
"2838916",1246,120,652,2018,61.74,5.95,32.31,2019
"2838922",681,37,462,1180,57.71,3.14,39.15,2019
"4738133",6639,208,759,7606,87.29,2.73,9.98,2019
"4738451",1254,29,308,1591,78.82,1.82,19.36,2019
"4738452",284,0,135,419,67.78,0,32.22,2019
"4737184",1527,22,758,2307,66.19,0.95,32.86,2019
"4737187",2255,51,439,2745,82.15,1.86,15.99,2019
"4737206",9791,371,1388,11550,84.77,3.21,12.02,2019
"4737210",5028,351,1588,6967,72.17,5.04,22.79,2019
"4737765",153,13,62,228,67.11,5.7,27.19,2019
"4737766",4452,219,2800,7471,59.59,2.93,37.48,2019
"4737769",1681,66,536,2283,73.63,2.89,23.48,2019
"4737803",10565,346,1762,12673,83.37,2.73,13.9,2019
"4737807",2613,139,1160,3912,66.79,3.55,29.65,2019
"4737846",1306,42,347,1695,77.05,2.48,20.47,2019
"4737847",742,0,308,1050,70.67,0,29.33,2019
"4737215",9262,153,583,9998,92.64,1.53,5.83,2019
"4737311",7815,236,2554,10605,73.69,2.23,24.08,2019
"4737391",520,5,134,659,78.91,0.76,20.33,2019
"4737681",1714,39,650,2403,71.33,1.62,27.05,2019
"4737083",4010,427,1364,5801,69.13,7.36,23.51,2019
"4737190",2236,192,950,3378,66.19,5.68,28.12,2019
"4737010",1394,37,242,1673,83.32,2.21,14.47,2019
"2141601",142,6,156,304,46.71,1.97,51.32,2019
"2141607",88,15,67,170,51.76,8.82,39.41,2019
"2141632",115,13,55,183,62.84,7.1,30.05,2019
"2141647",476,43,140,659,72.23,6.53,21.24,2019
"2141660",191,0,40,231,82.68,0,17.32,2019
"2141828",203,26,77,306,66.34,8.5,25.16,2019
"2141836",241,7,113,361,66.76,1.94,31.3,2019
"2141843",191,24,139,354,53.95,6.78,39.27,2019
"2141845",110,0,32,142,77.46,0,22.54,2019
"2141861",47,0,19,66,71.21,0,28.79,2019
"2141041",2045,42,769,2856,71.6,1.47,26.93,2019
"2141045",285,59,125,469,60.77,12.58,26.65,2019
"2141071",6916,298,1727,8941,77.35,3.33,19.32,2019
"2141075",5807,209,693,6709,86.56,3.12,10.33,2019
"2141132",66,6,57,129,51.16,4.65,44.19,2019
"2141174",307,32,146,485,63.3,6.6,30.1,2019
"2141179",1980,131,951,3062,64.66,4.28,31.06,2019
"2141180",257,30,178,465,55.27,6.45,38.28,2019
"2141216",525,0,44,569,92.27,0,7.73,2019
"2141222",784,64,103,951,82.44,6.73,10.83,2019
"2141226",51,0,17,68,75,0,25,2019
"2141255",255,0,82,337,75.67,0,24.33,2019
"2141256",848,31,183,1062,79.85,2.92,17.23,2019
"2141260",167,7,90,264,63.26,2.65,34.09,2019
"2141262",303,0,116,419,72.32,0,27.68,2019
"2141267",181,0,119,300,60.33,0,39.67,2019
"2141408",122,15,61,198,61.62,7.58,30.81,2019
"2141472",2454,58,1049,3561,68.91,1.63,29.46,2019
"2141501",6983,234,2234,9451,73.89,2.48,23.64,2019
"2141535",149,0,71,220,67.73,0,32.27,2019
"2141539",457,21,143,621,73.59,3.38,23.03,2019
"2141540",58,0,0,58,100,0,0,2019
"2141544",237,0,60,297,79.8,0,20.2,2019
"2141547",217,0,158,375,57.87,0,42.13,2019
"2141653",3285,151,921,4357,75.4,3.47,21.14,2019
"2141655",250,0,80,330,75.76,0,24.24,2019
"2141669",188,0,58,246,76.42,0,23.58,2019
"2141777",209,15,135,359,58.22,4.18,37.6,2019
"2141821",91,0,43,134,67.91,0,32.09,2019
"2141824",279,73,230,582,47.94,12.54,39.52,2019
"2141839",473,23,76,572,82.69,4.02,13.29,2019
"1339870",490,36,337,863,56.78,4.17,39.05,2019
"1339877",120,6,67,193,62.18,3.11,34.72,2019
"1339885",24,0,10,34,70.59,0,29.41,2019
"1339886",411,21,179,611,67.27,3.44,29.3,2019
"1339897",912,35,403,1350,67.56,2.59,29.85,2019
"2839354",493,83,382,958,51.46,8.66,39.87,2019
"2839501",6069,382,2691,9142,66.39,4.18,29.44,2019
"2839730",2923,100,1388,4411,66.27,2.27,31.47,2019
"2140507",919,122,280,1321,69.57,9.24,21.2,2019
"2140701",7835,279,3329,11443,68.47,2.44,29.09,2019
"2140363",15,0,0,15,100,0,0,2019
"2140376",15,0,21,36,41.67,0,58.33,2019
"2140943",145,0,87,232,62.5,0,37.5,2019
"2140927",112,0,44,156,71.79,0,28.21,2019
"2140940",52,15,66,133,39.1,11.28,49.62,2019
"2140941",94,0,47,141,66.67,0,33.33,2019
"2140946",46,13,39,98,46.94,13.27,39.8,2019
"2140958",44,0,47,91,48.35,0,51.65,2019
"4529683",75,0,52,127,59.06,0,40.94,2019
"4529686",346,0,66,412,83.98,0,16.02,2019
"4529697",3911,388,813,5112,76.51,7.59,15.9,2019
"4529001",407,38,319,764,53.27,4.97,41.75,2019
"4529481",427,5,233,665,64.21,0.75,35.04,2019
"4529824",1615,54,943,2612,61.83,2.07,36.1,2019
"4529827",822,77,326,1225,67.1,6.29,26.61,2019
"4529845",269,42,150,461,58.35,9.11,32.54,2019
"4529922",155,0,200,355,43.66,0,56.34,2019
"4529926",9983,190,878,11051,90.34,1.72,7.94,2019
"4529932",52,0,7,59,88.14,0,11.86,2019
"4529036",7998,100,865,8963,89.23,1.12,9.65,2019
"4529037",278,0,111,389,71.47,0,28.53,2019
"4529039",1126,66,325,1517,74.23,4.35,21.42,2019
"4529040",3067,178,583,3828,80.12,4.65,15.23,2019
"4529042",983,77,570,1630,60.31,4.72,34.97,2019
"4529056",434,167,316,917,47.33,18.21,34.46,2019
"4529058",1268,51,299,1618,78.37,3.15,18.48,2019
"4529059",1116,173,891,2180,51.19,7.94,40.87,2019
"4529838",127,4,24,155,81.94,2.58,15.48,2019
"4529841",10905,152,2454,13511,80.71,1.13,18.16,2019
"4529911",453,4,82,539,84.04,0.74,15.21,2019
"4529918",984,126,439,1549,63.52,8.13,28.34,2019
"4529920",3037,268,1109,4414,68.8,6.07,25.12,2019
"4529927",2227,80,997,3304,67.4,2.42,30.18,2019
"4529708",12601,241,479,13321,94.6,1.81,3.6,2019
"4529726",444,3,245,692,64.16,0.43,35.4,2019
"4529728",2312,320,1059,3691,62.64,8.67,28.69,2019
"4529803",14080,524,1612,16216,86.83,3.23,9.94,2019
"4529805",1740,81,577,2398,72.56,3.38,24.06,2019
"4529809",812,9,310,1131,71.79,0.8,27.41,2019
"4529163",283,71,237,591,47.88,12.01,40.1,2019
"4529172",3127,71,769,3967,78.83,1.79,19.38,2019
"4529180",3561,343,1762,5666,62.85,6.05,31.1,2019
"4529207",4,0,0,4,100,0,0,2019
"4529325",3793,201,1568,5562,68.19,3.61,28.19,2019
"4529334",4515,85,616,5216,86.56,1.63,11.81,2019
"4529338",13,0,0,13,100,0,0,2019
"4529009",444,19,369,832,53.37,2.28,44.35,2019
"4529015",293,21,298,612,47.88,3.43,48.69,2019
"4529016",6667,123,637,7427,89.77,1.66,8.58,2019
"4529078",4935,230,1095,6260,78.83,3.67,17.49,2019
"4529102",5278,226,1463,6967,75.76,3.24,21,2019
"4529105",291,0,154,445,65.39,0,34.61,2019
"4529115",7762,283,2432,10477,74.09,2.7,23.21,2019
"4529125",671,42,355,1068,62.83,3.93,33.24,2019
"4529135",2305,96,862,3263,70.64,2.94,26.42,2019
"4529145",146,15,95,256,57.03,5.86,37.11,2019
"4529154",9856,331,1792,11979,82.28,2.76,14.96,2019
"4529175",111,14,63,188,59.04,7.45,33.51,2019
"4529201",6801,643,688,8132,83.63,7.91,8.46,2019
"4529210",14110,293,1959,16362,86.24,1.79,11.97,2019
"4529332",716,48,265,1029,69.58,4.66,25.75,2019
"4529349",9640,349,2126,12115,79.57,2.88,17.55,2019
"4529375",22,0,3,25,88,0,12,2019
"4529377",170,59,219,448,37.95,13.17,48.88,2019
"4529420",5934,1514,901,8349,71.07,18.13,10.79,2019
"4529429",1022,142,268,1432,71.37,9.92,18.72,2019
"4529436",1014,86,633,1733,58.51,4.96,36.53,2019
"1331014",3038,151,1127,4316,70.39,3.5,26.11,2019
"1331017",408,31,257,696,58.62,4.45,36.93,2019
"1331027",1675,80,1609,3364,49.79,2.38,47.83,2019
"1331035",211,41,156,408,51.72,10.05,38.24,2019
"1331046",1065,52,238,1355,78.6,3.84,17.56,2019
"1331050",271,0,55,326,83.13,0,16.87,2019
"1331061",11821,608,3329,15758,75.02,3.86,21.13,2019
"1331087",1426,157,1428,3011,47.36,5.21,47.43,2019
"1331068",880,60,567,1507,58.39,3.98,37.62,2019
"1331550",178,25,104,307,57.98,8.14,33.88,2019
"1331602",9130,1910,2422,13462,67.82,14.19,17.99,2019
"1331624",317,25,134,476,66.6,5.25,28.15,2019
"1331630",63,46,48,157,40.13,29.3,30.57,2019
"1331635",1266,240,854,2360,53.64,10.17,36.19,2019
"1331066",232,34,148,414,56.04,8.21,35.75,2019
"1331075",597,68,361,1026,58.19,6.63,35.19,2019
"1331076",789,37,476,1302,60.6,2.84,36.56,2019
"1331082",2545,331,1014,3890,65.42,8.51,26.07,2019
"1331089",1149,68,584,1801,63.8,3.78,32.43,2019
"1331093",8177,383,2579,11139,73.41,3.44,23.15,2019
"1331901",1779,191,886,2856,62.29,6.69,31.02,2019
"1331555",669,15,291,975,68.62,1.54,29.85,2019
"1331558",7004,358,758,8120,86.26,4.41,9.33,2019
"1331565",678,47,173,898,75.5,5.23,19.27,2019
"1331566",949,106,502,1557,60.95,6.81,32.24,2019
"1331601",6108,1192,4217,11517,53.03,10.35,36.62,2019
"1331605",6372,905,936,8213,77.58,11.02,11.4,2019
"1331623",21,5,9,35,60,14.29,25.71,2019
"1331631",102,14,66,182,56.04,7.69,36.26,2019
"1331636",2418,332,1338,4088,59.15,8.12,32.73,2019
"1331701",4995,305,2049,7349,67.97,4.15,27.88,2019
"1331712",239,6,208,453,52.76,1.32,45.92,2019
"1331773",1031,5,435,1471,70.09,0.34,29.57,2019
"1331778",641,66,242,949,67.54,6.95,25.5,2019
"1331779",2232,73,866,3171,70.39,2.3,27.31,2019
"1331009",273,6,204,483,56.52,1.24,42.24,2019
"1331016",428,24,155,607,70.51,3.95,25.54,2019
"1331029",4187,85,1341,5613,74.59,1.51,23.89,2019
"1331030",4312,221,1789,6322,68.21,3.5,28.3,2019
"1331037",320,4,750,1074,29.8,0.37,69.83,2019
"1331041",139,7,127,273,50.92,2.56,46.52,2019
"1233301",7269,129,370,7768,93.58,1.66,4.76,2019
"1233304",8162,497,890,9549,85.47,5.2,9.32,2019
"1233401",8844,722,1840,11406,77.54,6.33,16.13,2019
"1233407",7817,375,2541,10733,72.83,3.49,23.67,2019
"1233410",13221,234,928,14383,91.92,1.63,6.45,2019
"1233442",11382,402,2018,13802,82.47,2.91,14.62,2019
"1233461",11805,440,2835,15080,78.28,2.92,18.8,2019
"1233019",5853,312,395,6560,89.22,4.76,6.02,2019
"1233029",12414,376,334,13124,94.59,2.86,2.54,2019
"1233042",2715,141,214,3070,88.44,4.59,6.97,2019
"1233065",16155,356,1346,17857,90.47,1.99,7.54,2019
"1233458",19378,755,1513,21646,89.52,3.49,6.99,2019
"1233486",8278,277,506,9061,91.36,3.06,5.58,2019
"1233498",5066,125,59,5250,96.5,2.38,1.12,2019
"1233511",20163,509,1429,22101,91.23,2.3,6.47,2019
"1233534",4357,63,697,5117,85.15,1.23,13.62,2019
"1233815",2857,696,2137,5690,50.21,12.23,37.56,2019
"1233839",544,332,243,1119,48.61,29.67,21.72,2019
"0136761",103,49,222,374,27.54,13.1,59.36,2019
"0136765",157,0,411,568,27.64,0,72.36,2019
"0136783",198,35,129,362,54.7,9.67,35.64,2019
"0136785",231,0,297,528,43.75,0,56.25,2019
"0136792",320,0,172,492,65.04,0,34.96,2019
"0136854",4799,37,975,5811,82.58,0.64,16.78,2019
"0136861",1037,15,299,1351,76.76,1.11,22.13,2019
"0136915",145,21,75,241,60.17,8.71,31.12,2019
"0136604",3080,215,774,4069,75.69,5.28,19.02,2019
"0136322",2805,157,430,3392,82.69,4.63,12.68,2019
"0136340",1366,207,708,2281,59.89,9.07,31.04,2019
"0136343",289,6,206,501,57.68,1.2,41.12,2019
"0136360",5670,341,1781,7792,72.77,4.38,22.86,2019
"0136376",512,19,256,787,65.06,2.41,32.53,2019
"0136425",129,52,232,413,31.23,12.59,56.17,2019
"0136426",3558,103,2223,5884,60.47,1.75,37.78,2019
"0136436",71,4,47,122,58.2,3.28,38.52,2019
"0136535",10029,1135,2057,13221,75.86,8.58,15.56,2019
"0136545",1961,237,1215,3413,57.46,6.94,35.6,2019
"0136556",176,43,10,229,76.86,18.78,4.37,2019
"0136578",432,0,101,533,81.05,0,18.95,2019
"0136581",97,9,0,106,91.51,8.49,0,2019
"0136607",1787,106,846,2739,65.24,3.87,30.89,2019
"0136608",12401,415,2143,14959,82.9,2.77,14.33,2019
"0136613",3028,150,995,4173,72.56,3.59,23.84,2019
"0136619",4493,295,1043,5831,77.05,5.06,17.89,2019
"0136722",76,0,96,172,44.19,0,55.81,2019
"0136759",498,5,170,673,74,0.74,25.26,2019
"0136784",1723,123,1017,2863,60.18,4.3,35.52,2019
"0136855",447,53,149,649,68.88,8.17,22.96,2019
"0136856",2276,100,255,2631,86.51,3.8,9.69,2019
"0136867",7138,494,1796,9428,75.71,5.24,19.05,2019
"0136871",331,74,91,496,66.73,14.92,18.35,2019
"0136910",0,0,31,31,0,0,100,2019
"0136916",170,15,149,334,50.9,4.49,44.61,2019
"0136441",919,23,529,1471,62.47,1.56,35.96,2019
"0136442",796,21,435,1252,63.58,1.68,34.74,2019
"0136445",687,191,990,1868,36.78,10.22,53,2019
"0136456",289,29,227,545,53.03,5.32,41.65,2019
"0136474",685,66,363,1114,61.49,5.92,32.59,2019
"0136475",435,42,401,878,49.54,4.78,45.67,2019
"1234683",11388,1057,913,13358,85.25,7.91,6.83,2019
"1234690",3427,398,1562,5387,63.62,7.39,29,2019
"1234758",8772,311,1597,10680,82.13,2.91,14.95,2019
"1234946",1724,112,561,2397,71.92,4.67,23.4,2019
"1234957",9314,457,1242,11013,84.57,4.15,11.28,2019
"1234990",10809,286,711,11806,91.56,2.42,6.02,2019
"1234613",7324,257,930,8511,86.05,3.02,10.93,2019
"1234614",2284,33,311,2628,86.91,1.26,11.83,2019
"1234639",9356,191,483,10030,93.28,1.9,4.82,2019
"1234654",7297,337,1246,8880,82.17,3.8,14.03,2019
"1234746",11067,263,1807,13137,84.24,2,13.76,2019
"1234786",14235,437,106,14778,96.33,2.96,0.72,2019
"1234947",2980,65,1249,4294,69.4,1.51,29.09,2019
"1234949",3665,128,461,4254,86.15,3.01,10.84,2019
"1234105",7264,304,333,7901,91.94,3.85,4.21,2019
"1234135",16960,728,1478,19166,88.49,3.8,7.71,2019
"1234137",143,16,0,159,89.94,10.06,0,2019
"1234145",7169,422,788,8379,85.56,5.04,9.4,2019
"4737015",5209,149,1315,6673,78.06,2.23,19.71,2019
"4737029",2174,38,307,2519,86.3,1.51,12.19,2019
"4737042",24688,1001,2893,28582,86.38,3.5,10.12,2019
"4737060",803,55,119,977,82.19,5.63,12.18,2019
"4737025",1432,125,502,2059,69.55,6.07,24.38,2019
"4737220",2119,8,189,2316,91.49,0.35,8.16,2019
"4737306",537,59,289,885,60.68,6.67,32.66,2019
"4737310",1261,10,313,1584,79.61,0.63,19.76,2019
"4737312",11255,294,1854,13403,83.97,2.19,13.83,2019
"4737317",902,20,304,1226,73.57,1.63,24.8,2019
"4737326",125,0,38,163,76.69,0,23.31,2019
"4737328",353,0,329,682,51.76,0,48.24,2019
"4737363",12958,302,1638,14898,86.98,2.03,10.99,2019
"4737366",334,0,61,395,84.56,0,15.44,2019
"4737369",216,0,59,275,78.55,0,21.45,2019
"4737687",1185,127,610,1922,61.65,6.61,31.74,2019
"4737688",309,9,151,469,65.88,1.92,32.2,2019
"4737710",237,16,115,368,64.4,4.35,31.25,2019
"4737713",295,49,202,546,54.03,8.97,37,2019
"4737722",1416,129,860,2405,58.88,5.36,35.76,2019
"4737723",272,17,119,408,66.67,4.17,29.17,2019
"4737730",0,0,0,0,NA,NA,NA,2019
"4737742",1902,131,367,2400,79.25,5.46,15.29,2019
"4737755",862,32,305,1199,71.89,2.67,25.44,2019
"4737756",668,39,408,1115,59.91,3.5,36.59,2019
"4737757",2988,182,664,3834,77.93,4.75,17.32,2019
"4737040",15872,658,2095,18625,85.22,3.53,11.25,2019
"4737743",7133,324,2514,9971,71.54,3.25,25.21,2019
"4737731",66,0,100,166,39.76,0,60.24,2019
"4737221",16335,364,1260,17959,90.96,2.03,7.02,2019
"4737333",149,0,116,265,56.23,0,43.77,2019
"4737692",1567,44,391,2002,78.27,2.2,19.53,2019
"4737090",4728,173,846,5747,82.27,3.01,14.72,2019
"4737146",2317,27,286,2630,88.1,1.03,10.87,2019
"4737763",4861,168,1081,6110,79.56,2.75,17.69,2019
"4737175",244,5,123,372,65.59,1.34,33.06,2019
"4737185",2360,66,896,3322,71.04,1.99,26.97,2019
"4737191",1382,15,201,1598,86.48,0.94,12.58,2019
"4737209",13296,788,1800,15884,83.71,4.96,11.33,2019
"4737217",11134,399,937,12470,89.29,3.2,7.51,2019
"4737219",810,19,0,829,97.71,2.29,0,2019
"4737301",275,0,120,395,69.62,0,30.38,2019
"4737305",190,24,111,325,58.46,7.38,34.15,2019
"4737308",890,25,180,1095,81.28,2.28,16.44,2019
"4737810",455,8,211,674,67.51,1.19,31.31,2019
"4737811",1226,22,288,1536,79.82,1.43,18.75,2019
"4737814",9852,480,2691,13023,75.65,3.69,20.66,2019
"4737828",378,14,139,531,71.19,2.64,26.18,2019
"4737857",5172,291,2326,7789,66.4,3.74,29.86,2019
"4737870",1209,162,623,1994,60.63,8.12,31.24,2019
"4737902",1267,53,240,1560,81.22,3.4,15.38,2019
"4737915",1285,234,1073,2592,49.58,9.03,41.4,2019
"4737719",65,0,10,75,86.67,0,13.33,2019
"4737724",879,82,258,1219,72.11,6.73,21.16,2019
"4737725",5011,397,1180,6588,76.06,6.03,17.91,2019
"4737777",4163,50,826,5039,82.62,0.99,16.39,2019
"4737820",2237,198,681,3116,71.79,6.35,21.85,2019
"4737829",449,76,163,688,65.26,11.05,23.69,2019
"4737843",1164,89,400,1653,70.42,5.38,24.2,2019
"2140962",4458,106,1875,6439,69.23,1.65,29.12,2019
"2140982",69,9,58,136,50.74,6.62,42.65,2019
"2140004",10323,334,1288,11945,86.42,2.8,10.78,2019
"2140008",808,83,341,1232,65.58,6.74,27.68,2019
"2140037",705,40,271,1016,69.39,3.94,26.67,2019
"2140046",546,9,136,691,79.02,1.3,19.68,2019
"2140050",310,51,178,539,57.51,9.46,33.02,2019
"2140108",3991,56,497,4544,87.83,1.23,10.94,2019
"2140117",863,3,86,952,90.65,0.32,9.03,2019
"2140144",388,8,148,544,71.32,1.47,27.21,2019
"2140150",1263,33,240,1536,82.23,2.15,15.62,2019
"2140152",258,14,136,408,63.24,3.43,33.33,2019
"2140020",26,0,26,52,50,0,50,2019
"2140026",1870,11,41,1922,97.29,0.57,2.13,2019
"2140060",362,13,85,460,78.7,2.83,18.48,2019
"2140258",8773,207,1323,10303,85.15,2.01,12.84,2019
"2140312",1481,33,730,2244,66,1.47,32.53,2019
"2140328",232,4,147,383,60.57,1.04,38.38,2019
"2140330",6089,134,1711,7934,76.75,1.69,21.57,2019
"2140339",0,0,0,0,NA,NA,NA,2019
"2140347",964,14,173,1151,83.75,1.22,15.03,2019
"2140351",6284,79,1277,7640,82.25,1.03,16.71,2019
"2140353",6503,183,1747,8433,77.11,2.17,20.72,2019
"2140360",1983,99,543,2625,75.54,3.77,20.69,2019
"2140383",7786,234,1191,9211,84.53,2.54,12.93,2019
"2140437",1404,36,645,2085,67.34,1.73,30.94,2019
"2140444",4365,202,1038,5605,77.88,3.6,18.52,2019
"2140472",455,15,173,643,70.76,2.33,26.91,2019
"2140486",661,79,315,1055,62.65,7.49,29.86,2019
"2140514",5837,84,217,6138,95.1,1.37,3.54,2019
"2140734",676,106,603,1385,48.81,7.65,43.54,2019
"2140170",124,0,24,148,83.78,0,16.22,2019
"2140215",5596,424,1928,7948,70.41,5.33,24.26,2019
"2140816",9,0,0,9,100,0,0,2019
"2140844",0,0,46,46,0,0,100,2019
"2140849",100,6,19,125,80,4.8,15.2,2019
"2140935",506,53,472,1031,49.08,5.14,45.78,2019
"2140995",12,14,14,40,30,35,35,2019
"2140729",1424,59,528,2011,70.81,2.93,26.26,2019
"2140059",6846,279,170,7295,93.85,3.82,2.33,2019
"2140165",11214,509,1935,13658,82.11,3.73,14.17,2019
"2140219",12954,495,2226,15675,82.64,3.16,14.2,2019
"2140162",1825,132,335,2292,79.62,5.76,14.62,2019
"2140923",128,25,37,190,67.37,13.16,19.47,2019
"2140965",3179,194,1533,4906,64.8,3.95,31.25,2019
"2140988",109,0,99,208,52.4,0,47.6,2019
"2140744",5487,110,1275,6872,79.85,1.6,18.55,2019
"2140759",555,12,314,881,63,1.36,35.64,2019
"2140823",1000,127,473,1600,62.5,7.94,29.56,2019
"2140863",106,14,139,259,40.93,5.41,53.67,2019
"2140902",322,0,174,496,64.92,0,35.08,2019
"2140071",4746,122,767,5635,84.22,2.17,13.61,2019
"2140104",381,0,48,429,88.81,0,11.19,2019
"2140121",2261,53,159,2473,91.43,2.14,6.43,2019
"2140142",741,0,153,894,82.89,0,17.11,2019
"2140145",140,0,65,205,68.29,0,31.71,2019
"2140204",6261,249,819,7329,85.43,3.4,11.17,2019
"2140209",96,0,34,130,73.85,0,26.15,2019
"2140210",3664,356,1404,5424,67.55,6.56,25.88,2019
"4529438",944,31,122,1097,86.05,2.83,11.12,2019
"4529445",17700,544,2158,20402,86.76,2.67,10.58,2019
"4529446",236,9,107,352,67.05,2.56,30.4,2019
"4529455",7290,998,1237,9525,76.54,10.48,12.99,2019
"4529468",571,90,269,930,61.4,9.68,28.92,2019
"4529475",495,35,297,827,59.85,4.23,35.91,2019
"4529729",471,58,260,789,59.7,7.35,32.95,2019
"4529732",20988,566,1946,23500,89.31,2.41,8.28,2019
"4529742",657,60,307,1024,64.16,5.86,29.98,2019
"4529819",473,30,194,697,67.86,4.3,27.83,2019
"4529821",414,22,200,636,65.09,3.46,31.45,2019
"4529832",1171,36,797,2004,58.43,1.8,39.77,2019
"4529836",107,17,61,185,57.84,9.19,32.97,2019
"4529082",172,5,39,216,79.63,2.31,18.06,2019
"4529104",327,30,150,507,64.5,5.92,29.59,2019
"4529128",1210,51,673,1934,62.56,2.64,34.8,2019
"4529129",882,46,369,1297,68,3.55,28.45,2019
"4529482",787,0,34,821,95.86,0,4.14,2019
"4529485",17960,1082,1706,20748,86.56,5.21,8.22,2019
"4529518",260,48,180,488,53.28,9.84,36.89,2019
"4529547",599,63,411,1073,55.82,5.87,38.3,2019
"4529568",5539,94,798,6431,86.13,1.46,12.41,2019
"4529615",15336,363,1509,17208,89.12,2.11,8.77,2019
"4529640",9377,119,2772,12268,76.43,0.97,22.6,2019
"4529643",743,78,172,993,74.82,7.85,17.32,2019
"4529649",8558,129,1799,10486,81.61,1.23,17.16,2019
"4529661",1341,96,593,2030,66.06,4.73,29.21,2019
"4529664",630,8,167,805,78.26,0.99,20.75,2019
"4529666",2033,62,462,2557,79.51,2.42,18.07,2019
"4529673",8748,194,1404,10346,84.55,1.88,13.57,2019
"4529676",2072,82,324,2478,83.62,3.31,13.08,2019
"4529682",1130,47,336,1513,74.69,3.11,22.21,2019
"4529687",13769,195,2004,15968,86.23,1.22,12.55,2019
"4529693",3916,155,1785,5856,66.87,2.65,30.48,2019
"4529710",12200,266,1351,13817,88.3,1.93,9.78,2019
"4529714",736,123,333,1192,61.74,10.32,27.94,2019
"4529717",411,4,128,543,75.69,0.74,23.57,2019
"4529439",718,415,98,1231,58.33,33.71,7.96,2019
"4529373",86,16,58,160,53.75,10,36.25,2019
"4529404",496,0,7,503,98.61,0,1.39,2019
"4529435",1542,9,175,1726,89.34,0.52,10.14,2019
"1330178",809,104,227,1140,70.96,9.12,19.91,2019
"1330216",668,17,158,843,79.24,2.02,18.74,2019
"1330660",112,13,249,374,29.95,3.48,66.58,2019
"1330701",10743,738,2897,14378,74.72,5.13,20.15,2019
"1330708",74,21,0,95,77.89,22.11,0,2019
"1330808",1003,19,451,1473,68.09,1.29,30.62,2019
"1330810",535,20,191,746,71.72,2.68,25.6,2019
"1330817",1782,176,1426,3384,52.66,5.2,42.14,2019
"1330292",1513,73,188,1774,85.29,4.11,10.6,2019
"1330293",588,17,506,1111,52.93,1.53,45.54,2019
"1330316",11139,485,1775,13399,83.13,3.62,13.25,2019
"1330329",9579,583,1422,11584,82.69,5.03,12.28,2019
"1330354",4612,497,1281,6390,72.18,7.78,20.05,2019
"1330421",996,61,200,1257,79.24,4.85,15.91,2019
"1330434",1023,16,804,1843,55.51,0.87,43.62,2019
"1330436",3004,160,1253,4417,68.01,3.62,28.37,2019
"1330441",458,13,224,695,65.9,1.87,32.23,2019
"1330448",17,0,7,24,70.83,0,29.17,2019
"1233848",144,25,0,169,85.21,14.79,0,2019
"1233851",208,91,51,350,59.43,26,14.57,2019
"1233865",122,0,102,224,54.46,0,45.54,2019
"1233880",8176,2250,3260,13686,59.74,16.44,23.82,2019
"1233881",9588,653,2818,13059,73.42,5,21.58,2019
"1233905",9126,466,2186,11778,77.48,3.96,18.56,2019
"1233909",8864,306,1045,10215,86.77,3,10.23,2019
"1233914",13647,527,742,14916,91.49,3.53,4.97,2019
"1233930",316,0,41,357,88.52,0,11.48,2019
"1233955",3939,96,409,4444,88.64,2.16,9.2,2019
"1233956",1380,65,235,1680,82.14,3.87,13.99,2019
"1233972",3870,128,508,4506,85.89,2.84,11.27,2019
"1233983",5167,191,539,5897,87.62,3.24,9.14,2019
"1233169",9002,383,2778,12163,74.01,3.15,22.84,2019
"1233309",12210,318,874,13402,91.11,2.37,6.52,2019
"1233319",14187,1513,2615,18315,77.46,8.26,14.28,2019
"1233321",16093,585,2848,19526,82.42,3,14.59,2019
"1233403",3650,47,511,4208,86.74,1.12,12.14,2019
"1233404",7351,377,2253,9981,73.65,3.78,22.57,2019
"1233418",16029,323,611,16963,94.49,1.9,3.6,2019
"1233435",10843,556,2297,13696,79.17,4.06,16.77,2019
"1233440",4061,187,2248,6496,62.52,2.88,34.61,2019
"1233455",8066,297,1250,9613,83.91,3.09,13,2019
"1233476",1184,124,1357,2665,44.43,4.65,50.92,2019
"1233477",6194,269,527,6990,88.61,3.85,7.54,2019
"1233478",4481,26,116,4623,96.93,0.56,2.51,2019
"1233527",3928,127,683,4738,82.9,2.68,14.42,2019
"1233585",405,14,52,471,85.99,2.97,11.04,2019
"1233597",1856,131,646,2633,70.49,4.98,24.53,2019
"1233603",7299,163,1082,8544,85.43,1.91,12.66,2019
"1233613",11162,1199,2193,14554,76.69,8.24,15.07,2019
"1233621",555,15,0,570,97.37,2.63,0,2019
"1233626",11046,167,306,11519,95.89,1.45,2.66,2019
"1233782",7697,329,1288,9314,82.64,3.53,13.83,2019
"1233803",8176,1477,2069,11722,69.75,12.6,17.65,2019
"1233805",5631,653,2757,9041,62.28,7.22,30.49,2019
"1233907",8011,350,1175,9536,84.01,3.67,12.32,2019
"1233912",7387,199,393,7979,92.58,2.49,4.93,2019
"1233920",1866,65,167,2098,88.94,3.1,7.96,2019
"1233928",10287,252,551,11090,92.76,2.27,4.97,2019
"1233936",6365,341,1548,8254,77.11,4.13,18.75,2019
"1232805",4477,261,2606,7344,60.96,3.55,35.48,2019
"1232817",10322,500,771,11593,89.04,4.31,6.65,2019
"1232839",13941,351,3191,17483,79.74,2.01,18.25,2019
"1232948",1274,0,575,1849,68.9,0,31.1,2019
"1232952",7534,99,633,8266,91.14,1.2,7.66,2019
"1232953",8659,311,687,9657,89.67,3.22,7.11,2019
"1232955",14167,197,953,15317,92.49,1.29,6.22,2019
"1232967",6093,217,1576,7886,77.26,2.75,19.98,2019
"1232456",2812,40,487,3339,84.22,1.2,14.59,2019
"1232504",7783,314,853,8950,86.96,3.51,9.53,2019
"1232505",7488,687,2852,11027,67.91,6.23,25.86,2019
"1232506",12065,354,1791,14210,84.9,2.49,12.6,2019
"1232507",11040,381,1493,12914,85.49,2.95,11.56,2019
"1232541",7209,595,370,8174,88.19,7.28,4.53,2019
"1232564",801,71,140,1012,79.15,7.02,13.83,2019
"1232568",792,89,234,1115,71.03,7.98,20.99,2019
"1232579",3512,284,553,4349,80.75,6.53,12.72,2019
"1232609",5577,265,1311,7153,77.97,3.7,18.33,2019
"1234207",11410,613,2585,14608,78.11,4.2,17.7,2019
"1234741",11659,733,3337,15729,74.12,4.66,21.22,2019
"1234748",14700,480,2710,17890,82.17,2.68,15.15,2019
"1234759",9585,549,1848,11982,79.99,4.58,15.42,2019
"1234771",5550,107,514,6171,89.94,1.73,8.33,2019
"1234984",5178,41,344,5563,93.08,0.74,6.18,2019
"1234134",6810,286,526,7622,89.35,3.75,6.9,2019
"1234237",5600,304,1012,6916,80.97,4.4,14.63,2019
"1234103",5545,188,382,6115,90.68,3.07,6.25,2019
"1234110",9561,333,1124,11018,86.78,3.02,10.2,2019
"1234120",9853,292,557,10702,92.07,2.73,5.2,2019
"1234201",1838,0,8,1846,99.57,0,0.43,2019
"1234203",11739,675,1864,14278,82.22,4.73,13.06,2019
"1234205",9430,851,2032,12313,76.59,6.91,16.5,2019
"1234221",11589,1198,2482,15269,75.9,7.85,16.26,2019
"1234449",890,83,443,1416,62.85,5.86,31.29,2019
"1234601",7692,264,2061,10017,76.79,2.64,20.58,2019
"1234747",6856,739,429,8024,85.44,9.21,5.35,2019
"1234788",7011,185,1128,8324,84.23,2.22,13.55,2019
"1234997",15333,497,2045,17875,85.78,2.78,11.44,2019
"1234429",3205,92,538,3835,83.57,2.4,14.03,2019
"1234607",3236,181,393,3810,84.93,4.75,10.31,2019
"1234209",12415,633,1620,14668,84.64,4.32,11.04,2019
"1234241",5580,74,309,5963,93.58,1.24,5.18,2019
"1234661",23,0,29,52,44.23,0,55.77,2019
"1234945",1271,11,150,1432,88.76,0.77,10.47,2019
"1234101",0,0,0,0,NA,NA,NA,2019
"1234140",98,0,0,98,100,0,0,2019
"1234211",3367,246,117,3730,90.27,6.6,3.14,2019
"1234212",6864,355,330,7549,90.93,4.7,4.37,2019
"1234269",1524,137,351,2012,75.75,6.81,17.45,2019
"1234288",3920,145,174,4239,92.47,3.42,4.1,2019
"1234289",1134,165,38,1337,84.82,12.34,2.84,2019
"1234291",1773,75,45,1893,93.66,3.96,2.38,2019
"1234445",0,0,0,0,NA,NA,NA,2019
"1234604",3492,54,558,4104,85.09,1.32,13.6,2019
"1234637",1902,66,206,2174,87.49,3.04,9.48,2019
"0135951",3223,107,936,4266,75.55,2.51,21.94,2019
"0135957",4414,204,1037,5655,78.05,3.61,18.34,2019
"0135963",287,14,213,514,55.84,2.72,41.44,2019
"0135972",285,22,130,437,65.22,5.03,29.75,2019
"0135973",796,28,303,1127,70.63,2.48,26.89,2019
"0135022",7319,148,1113,8580,85.3,1.72,12.97,2019
"0135036",53,18,17,88,60.23,20.45,19.32,2019
"0135043",3756,57,189,4002,93.85,1.42,4.72,2019
"0135058",2334,174,938,3446,67.73,5.05,27.22,2019
"0135061",323,16,78,417,77.46,3.84,18.71,2019
"0135062",2360,113,576,3049,77.4,3.71,18.89,2019
"0135074",53,0,0,53,100,0,0,2019
"0135077",3820,127,1315,5262,72.6,2.41,24.99,2019
"0135080",5750,89,535,6374,90.21,1.4,8.39,2019
"0135089",444,11,348,803,55.29,1.37,43.34,2019
"0135091",969,14,91,1074,90.22,1.3,8.47,2019
"0135096",2549,76,486,3111,81.94,2.44,15.62,2019
"0135112",76,0,48,124,61.29,0,38.71,2019
"0135126",6333,204,1025,7562,83.75,2.7,13.55,2019
"0135130",755,48,488,1291,58.48,3.72,37.8,2019
"0135133",844,0,377,1221,69.12,0,30.88,2019
"0135151",2284,43,629,2956,77.27,1.45,21.28,2019
"4737860",1197,92,205,1494,80.12,6.16,13.72,2019
"4737862",6411,597,1532,8540,75.07,6.99,17.94,2019
"4737872",423,40,170,633,66.82,6.32,26.86,2019
"4737877",2510,189,708,3407,73.67,5.55,20.78,2019
"4737882",856,27,296,1179,72.6,2.29,25.11,2019
"4737914",6168,309,2073,8550,72.14,3.61,24.25,2019
"4737027",19104,355,491,19950,95.76,1.78,2.46,2019
"4737035",982,42,229,1253,78.37,3.35,18.28,2019
"4737046",1761,0,195,1956,90.03,0,9.97,2019
"4737050",394,33,169,596,66.11,5.54,28.36,2019
"4737055",7750,156,2352,10258,75.55,1.52,22.93,2019
"4737058",2010,26,858,2894,69.45,0.9,29.65,2019
"4737066",16236,533,2894,19663,82.57,2.71,14.72,2019
"4737078",143,0,20,163,87.73,0,12.27,2019
"4737130",17603,1562,2788,21953,80.18,7.12,12.7,2019
"4737166",3811,177,1307,5295,71.97,3.34,24.68,2019
"4737178",570,5,227,802,71.07,0.62,28.3,2019
"4737186",2722,103,725,3550,76.68,2.9,20.42,2019
"4737188",5185,146,350,5681,91.27,2.57,6.16,2019
"4737189",1360,31,118,1509,90.13,2.05,7.82,2019
"4737228",555,133,363,1051,52.81,12.65,34.54,2019
"4737329",1555,102,616,2273,68.41,4.49,27.1,2019
"4737338",920,31,314,1265,72.73,2.45,24.82,2019
"4737345",568,47,331,946,60.04,4.97,34.99,2019
"4737347",2483,42,786,3311,74.99,1.27,23.74,2019
"4737352",974,101,271,1346,72.36,7.5,20.13,2019
"4737354",5120,238,1563,6921,73.98,3.44,22.58,2019
"4737356",629,23,243,895,70.28,2.57,27.15,2019
"4737360",469,40,148,657,71.39,6.09,22.53,2019
"4737361",488,0,229,717,68.06,0,31.94,2019
"4737377",5422,113,277,5812,93.29,1.94,4.77,2019
"4737380",1761,61,738,2560,68.79,2.38,28.83,2019
"4737381",2584,208,921,3713,69.59,5.6,24.8,2019
"4737388",7667,761,2041,10469,73.24,7.27,19.5,2019
"4737398",4407,275,1286,5968,73.84,4.61,21.55,2019
"4737403",1343,53,135,1531,87.72,3.46,8.82,2019
"4737412",6622,282,2117,9021,73.41,3.13,23.47,2019
"4737604",13839,716,1951,16506,83.84,4.34,11.82,2019
"4737643",9231,856,4012,14099,65.47,6.07,28.46,2019
"4737663",5297,120,545,5962,88.85,2.01,9.14,2019
"4737729",283,11,314,608,46.55,1.81,51.64,2019
"4737737",1850,108,400,2358,78.46,4.58,16.96,2019
"4737771",4821,81,1239,6141,78.51,1.32,20.18,2019
"4737826",1435,50,506,1991,72.07,2.51,25.41,2019
"4737830",10397,261,1551,12209,85.16,2.14,12.7,2019
"4737840",2995,93,847,3935,76.11,2.36,21.52,2019
"4737841",2740,130,1114,3984,68.78,3.26,27.96,2019
"4737848",29,0,45,74,39.19,0,60.81,2019
"4737853",947,33,575,1555,60.9,2.12,36.98,2019
"4737888",687,163,266,1116,61.56,14.61,23.84,2019
"4737892",504,69,247,820,61.46,8.41,30.12,2019
"4737922",12620,304,534,13458,93.77,2.26,3.97,2019
"4737923",12006,355,1064,13425,89.43,2.64,7.93,2019
"4737061",1113,25,448,1586,70.18,1.58,28.25,2019
"4737075",21646,529,2100,24275,89.17,2.18,8.65,2019
"4737095",727,1,238,966,75.26,0.1,24.64,2019
"4737917",8239,350,2799,11388,72.35,3.07,24.58,2019
"4737016",287,20,88,395,72.66,5.06,22.28,2019
"4737037",2240,233,287,2760,81.16,8.44,10.4,2019
"2140311",1837,84,882,2803,65.54,3,31.47,2019
"2140324",15572,493,1981,18046,86.29,2.73,10.98,2019
"2140379",1149,27,264,1440,79.79,1.88,18.33,2019
"2140380",1597,132,703,2432,65.67,5.43,28.91,2019
"2140391",11220,228,2876,14324,78.33,1.59,20.08,2019
"2140448",26,0,0,26,100,0,0,2019
"2140461",1144,56,183,1383,82.72,4.05,13.23,2019
"2140475",18807,810,3603,23220,80.99,3.49,15.52,2019
"2140481",17,0,12,29,58.62,0,41.38,2019
"2140484",3236,106,1182,4524,71.53,2.34,26.13,2019
"2140509",15603,303,968,16874,92.47,1.8,5.74,2019
"2140831",1299,68,703,2070,62.75,3.29,33.96,2019
"2140056",1215,18,92,1325,91.7,1.36,6.94,2019
"2140206",8555,289,780,9624,88.89,3,8.1,2019
"2140513",4116,55,84,4255,96.73,1.29,1.97,2019
"2140801",91,12,56,159,57.23,7.55,35.22,2019
"2140025",32,0,0,32,100,0,0,2019
"2140041",122,116,66,304,40.13,38.16,21.71,2019
"2140048",0,0,0,0,NA,NA,NA,2019
"2140049",0,0,0,0,NA,NA,NA,2019
"2140063",0,0,0,0,NA,NA,NA,2019
"2140075",293,22,73,388,75.52,5.67,18.81,2019
"2140110",11,0,27,38,28.95,0,71.05,2019
"2140161",68,0,0,68,100,0,0,2019
"2140231",0,0,0,0,NA,NA,NA,2019
"2140280",108,7,0,115,93.91,6.09,0,2019
"2140404",0,0,0,0,NA,NA,NA,2019
"2140434",0,0,0,0,NA,NA,NA,2019
"2140506",0,0,0,0,NA,NA,NA,2019
"2140604",0,0,0,0,NA,NA,NA,2019
"2140743",66,0,0,66,100,0,0,2019
"2140829",50,0,28,78,64.1,0,35.9,2019
"2140939",79,0,41,120,65.83,0,34.17,2019
"2140964",35,0,0,35,100,0,0,2019
"2140346",125,14,120,259,48.26,5.41,46.33,2019
"2140402",707,0,394,1101,64.21,0,35.79,2019
"2140371",861,41,290,1192,72.23,3.44,24.33,2019
"2140489",1212,0,563,1775,68.28,0,31.72,2019
"2140077",136,0,20,156,87.18,0,12.82,2019
"2140175",4383,203,590,5176,84.68,3.92,11.4,2019
"2140010",195,0,0,195,100,0,0,2019
"2140014",6351,178,411,6940,91.51,2.56,5.92,2019
"2140022",318,5,18,341,93.26,1.47,5.28,2019
"2140115",128,3,47,178,71.91,1.69,26.4,2019
"2140119",535,61,190,786,68.07,7.76,24.17,2019
"2140155",278,33,116,427,65.11,7.73,27.17,2019
"2140160",7168,577,1678,9423,76.07,6.12,17.81,2019
"2140171",44,0,46,90,48.89,0,51.11,2019
"2140178",127,15,13,155,81.94,9.68,8.39,2019
"2140203",5254,710,2707,8671,60.59,8.19,31.22,2019
"2140205",9232,167,1028,10427,88.54,1.6,9.86,2019
"2140245",11783,246,271,12300,95.8,2,2.2,2019
"2140313",890,43,151,1084,82.1,3.97,13.93,2019
"2140011",809,11,245,1065,75.96,1.03,23,2019
"2140013",1704,31,292,2027,84.07,1.53,14.41,2019
"2140031",6617,223,775,7615,86.89,2.93,10.18,2019
"2140040",81,12,28,121,66.94,9.92,23.14,2019
"2140062",60,0,43,103,58.25,0,41.75,2019
"2140065",9121,505,1656,11282,80.85,4.48,14.68,2019
"1330456",531,13,260,804,66.04,1.62,32.34,2019
"1330461",4341,146,980,5467,79.4,2.67,17.93,2019
"1330471",1102,76,530,1708,64.52,4.45,31.03,2019
"1330512",6962,376,1617,8955,77.74,4.2,18.06,2019
"1330522",317,19,113,449,70.6,4.23,25.17,2019
"1330530",1884,48,555,2487,75.75,1.93,22.32,2019
"1330535",1975,20,906,2901,68.08,0.69,31.23,2019
"1330548",6352,113,412,6877,92.37,1.64,5.99,2019
"1330552",550,20,110,680,80.88,2.94,16.18,2019
"1330294",12042,705,1274,14021,85.89,5.03,9.09,2019
"1330297",6746,251,2282,9279,72.7,2.71,24.59,2019
"1330309",14095,1121,349,15565,90.56,7.2,2.24,2019
"1330313",1884,139,226,2249,83.77,6.18,10.05,2019
"1330318",17964,847,3359,22170,81.03,3.82,15.15,2019
"1330326",3730,122,204,4056,91.96,3.01,5.03,2019
"1330327",8823,188,459,9470,93.17,1.99,4.85,2019
"1330344",10388,658,2159,13205,78.67,4.98,16.35,2019
"1330427",2988,99,1128,4215,70.89,2.35,26.76,2019
"1330428",243,28,472,743,32.71,3.77,63.53,2019
"1330477",544,46,449,1039,52.36,4.43,43.21,2019
"1330228",12437,428,1002,13867,89.69,3.09,7.23,2019
"1330147",1392,35,377,1804,77.16,1.94,20.9,2019
"1330251",488,8,384,880,55.45,0.91,43.64,2019
"1330733",463,20,269,752,61.57,2.66,35.77,2019
"1330805",597,29,270,896,66.63,3.24,30.13,2019
"1330807",27,1,10,38,71.05,2.63,26.32,2019
"1330820",220,7,188,415,53.01,1.69,45.3,2019
"1330824",4311,220,2111,6642,64.91,3.31,31.78,2019
"1330901",3624,221,2375,6220,58.26,3.55,38.18,2019
"1330904",6951,732,2358,10041,69.23,7.29,23.48,2019
"1330907",15543,376,2221,18140,85.68,2.07,12.24,2019
"1330012",7155,519,2258,9932,72.04,5.23,22.73,2019
"1330013",8191,435,958,9584,85.47,4.54,10,2019
"1330092",13341,407,1045,14793,90.18,2.75,7.06,2019
"1330047",18615,283,1841,20739,89.76,1.36,8.88,2019
"1330080",23627,404,1583,25614,92.24,1.58,6.18,2019
"1330087",12773,191,1198,14162,90.19,1.35,8.46,2019
"1330103",4844,217,743,5804,83.46,3.74,12.8,2019
"1330107",4116,24,719,4859,84.71,0.49,14.8,2019
"1330114",17435,436,1702,19573,89.08,2.23,8.7,2019
"1330662",2162,199,989,3350,64.54,5.94,29.52,2019
"4529665",49,0,52,101,48.51,0,51.49,2019
"4529672",4492,104,804,5400,83.19,1.93,14.89,2019
"4529685",693,8,112,813,85.24,0.98,13.78,2019
"4529691",3482,123,885,4490,77.55,2.74,19.71,2019
"4529704",1160,27,242,1429,81.18,1.89,16.93,2019
"4529743",222,10,141,373,59.52,2.68,37.8,2019
"4529829",3613,130,740,4483,80.59,2.9,16.51,2019
"4529847",1201,30,587,1818,66.06,1.65,32.29,2019
"4529849",63,22,56,141,44.68,15.6,39.72,2019
"4529851",2306,15,503,2824,81.66,0.53,17.81,2019
"4529910",13949,796,719,15464,90.2,5.15,4.65,2019
"4529923",67,0,83,150,44.67,0,55.33,2019
"4529941",105,23,84,212,49.53,10.85,39.62,2019
"4529935",1452,170,226,1848,78.57,9.2,12.23,2019
"4529936",3283,96,1551,4930,66.59,1.95,31.46,2019
"4529075",740,61,170,971,76.21,6.28,17.51,2019
"4529081",307,18,154,479,64.09,3.76,32.15,2019
"4529111",343,10,187,540,63.52,1.85,34.63,2019
"1232628",836,23,678,1537,54.39,1.5,44.11,2019
"1232669",4380,173,414,4967,88.18,3.48,8.34,2019
"1232692",42,0,26,68,61.76,0,38.24,2019
"1232701",8618,335,957,9910,86.96,3.38,9.66,2019
"1232709",601,0,126,727,82.67,0,17.33,2019
"1232052",1690,76,701,2467,68.5,3.08,28.42,2019
"1232058",813,30,375,1218,66.75,2.46,30.79,2019
"1232038",3244,139,561,3944,82.25,3.52,14.22,2019
"1232059",603,38,362,1003,60.12,3.79,36.09,2019
"1232102",774,39,249,1062,72.88,3.67,23.45,2019
"1232114",8738,342,4386,13466,64.89,2.54,32.57,2019
"1232117",7435,399,2840,10674,69.66,3.74,26.61,2019
"1232118",6669,356,2027,9052,73.67,3.93,22.39,2019
"1232132",2670,83,612,3365,79.35,2.47,18.19,2019
"1232137",13694,1818,1686,17198,79.63,10.57,9.8,2019
"1232174",18885,438,3158,22481,84,1.95,14.05,2019
"1232204",2915,122,778,3815,76.41,3.2,20.39,2019
"1232205",10609,483,1928,13020,81.48,3.71,14.81,2019
"1232211",10296,432,2584,13312,77.34,3.25,19.41,2019
"1232216",13196,577,1850,15623,84.47,3.69,11.84,2019
"1232224",14714,293,1082,16089,91.45,1.82,6.73,2019
"1232226",5122,30,425,5577,91.84,0.54,7.62,2019
"1232323",67,0,24,91,73.63,0,26.37,2019
"1232347",2367,82,501,2950,80.24,2.78,16.98,2019
"1232408",7181,203,586,7970,90.1,2.55,7.35,2019
"1232713",7091,258,975,8324,85.19,3.1,11.71,2019
"1232714",14213,127,1110,15450,91.99,0.82,7.18,2019
"1232784",3438,81,801,4320,79.58,1.88,18.54,2019
"1232789",9821,217,1157,11195,87.73,1.94,10.33,2019
"1232796",6953,278,812,8043,86.45,3.46,10.1,2019
"1232806",9679,248,1058,10985,88.11,2.26,9.63,2019
"1232825",18144,415,1625,20184,89.89,2.06,8.05,2019
"1232826",6655,421,568,7644,87.06,5.51,7.43,2019
"1232421",1208,105,292,1605,75.26,6.54,18.19,2019
"1232433",4951,220,1224,6395,77.42,3.44,19.14,2019
"1232437",206,13,111,330,62.42,3.94,33.64,2019
"1232438",1124,48,345,1517,74.09,3.16,22.74,2019
"1232444",7430,71,532,8033,92.49,0.88,6.62,2019
"1232446",3227,85,704,4016,80.35,2.12,17.53,2019
"1232449",126,0,35,161,78.26,0,21.74,2019
"1232062",561,15,49,625,89.76,2.4,7.84,2019
"1232072",85,0,24,109,77.98,0,22.02,2019
"1232073",13796,329,1259,15384,89.68,2.14,8.18,2019
"1232084",10400,689,1926,13015,79.91,5.29,14.8,2019
"1232086",9600,539,1468,11607,82.71,4.64,12.65,2019
"1232095",3288,261,550,4099,80.21,6.37,13.42,2019
"1232096",604,47,411,1062,56.87,4.43,38.7,2019
"1232097",6079,175,583,6837,88.91,2.56,8.53,2019
"1232141",6338,297,970,7605,83.34,3.91,12.75,2019
"1232157",158,0,0,158,100,0,0,2019
"1232164",13106,1877,1981,16964,77.26,11.06,11.68,2019
"1232168",9663,394,1632,11689,82.67,3.37,13.96,2019
"1232189",1881,81,669,2631,71.49,3.08,25.43,2019
"1232202",1490,107,389,1986,75.03,5.39,19.59,2019
"1232212",213,0,18,231,92.21,0,7.79,2019
"1232333",3316,84,1428,4828,68.68,1.74,29.58,2019
"1232340",2322,139,1424,3885,59.77,3.58,36.65,2019
"1232344",3717,137,1193,5047,73.65,2.71,23.64,2019
"1232358",561,40,250,851,65.92,4.7,29.38,2019
"0135172",859,53,328,1240,69.27,4.27,26.45,2019
"0135178",983,69,196,1248,78.77,5.53,15.71,2019
"0135183",194,37,73,304,63.82,12.17,24.01,2019
"0135210",4862,156,1083,6101,79.69,2.56,17.75,2019
"0135211",7765,608,3068,11441,67.87,5.31,26.82,2019
"0135214",5648,293,1367,7308,77.29,4.01,18.71,2019
"0135242",20821,374,961,22156,93.97,1.69,4.34,2019
"0135470",1307,27,516,1850,70.65,1.46,27.89,2019
"0135481",953,2,495,1450,65.72,0.14,34.14,2019
"0135504",3854,135,960,4949,77.87,2.73,19.4,2019
"0135555",2911,43,993,3947,73.75,1.09,25.16,2019
"0135581",1126,118,735,1979,56.9,5.96,37.14,2019
"0135582",1050,68,652,1770,59.32,3.84,36.84,2019
"0135611",7355,422,2062,9839,74.75,4.29,20.96,2019
"0135620",2723,153,469,3345,81.41,4.57,14.02,2019
"0135621",801,56,267,1124,71.26,4.98,23.75,2019
"0135755",139,3,76,218,63.76,1.38,34.86,2019
"0135773",3662,189,855,4706,77.82,4.02,18.17,2019
"0135802",9054,339,899,10292,87.97,3.29,8.73,2019
"0135805",6965,475,1706,9146,76.15,5.19,18.65,2019
"0135904",3814,147,1372,5333,71.52,2.76,25.73,2019
"0135980",1316,84,400,1800,73.11,4.67,22.22,2019
"0135031",1907,76,823,2806,67.96,2.71,29.33,2019
"0135956",2510,186,574,3270,76.76,5.69,17.55,2019
"0135966",1136,74,432,1642,69.18,4.51,26.31,2019
"0135981",472,0,181,653,72.28,0,27.72,2019
"0135010",6193,174,1620,7987,77.54,2.18,20.28,2019
"0135064",2902,270,1409,4581,63.35,5.89,30.76,2019
"0135046",1487,50,523,2060,72.18,2.43,25.39,2019
"0135053",756,9,127,892,84.75,1.01,14.24,2019
"0135063",908,71,285,1264,71.84,5.62,22.55,2019
"0135072",1103,30,567,1700,64.88,1.76,33.35,2019
"0135078",532,22,179,733,72.58,3,24.42,2019
"0135087",672,48,260,980,68.57,4.9,26.53,2019
"0135097",511,3,117,631,80.98,0.48,18.54,2019
"0135114",2741,89,152,2982,91.92,2.98,5.1,2019
"0135117",1888,55,214,2157,87.53,2.55,9.92,2019
"0135119",28,0,61,89,31.46,0,68.54,2019
"0135127",3153,12,445,3610,87.34,0.33,12.33,2019
"0135136",635,2,147,784,80.99,0.26,18.75,2019
"0135149",79,0,53,132,59.85,0,40.15,2019
"0135180",4207,162,1299,5668,74.22,2.86,22.92,2019
"0135188",707,11,176,894,79.08,1.23,19.69,2019
"0135228",2565,113,1103,3781,67.84,2.99,29.17,2019
"0135401",7648,607,3116,11371,67.26,5.34,27.4,2019
"0135447",563,57,544,1164,48.37,4.9,46.74,2019
"0135453",3003,68,601,3672,81.78,1.85,16.37,2019
"0135457",0,0,0,0,NA,NA,NA,2019
"0135462",892,2,883,1777,50.2,0.11,49.69,2019
"0135466",1407,37,678,2122,66.31,1.74,31.95,2019
"0135476",2056,29,647,2732,75.26,1.06,23.68,2019
"0135543",229,21,161,411,55.72,5.11,39.17,2019
"0135550",1699,77,528,2304,73.74,3.34,22.92,2019
"0135585",463,0,95,558,82.97,0,17.03,2019
"0135587",149,6,126,281,53.02,2.14,44.84,2019
"0135622",1877,132,526,2535,74.04,5.21,20.75,2019
"0135633",6456,239,1654,8349,77.33,2.86,19.81,2019
"0135643",816,220,469,1505,54.22,14.62,31.16,2019
"0135648",868,22,408,1298,66.87,1.69,31.43,2019
"4737049",990,51,302,1343,73.72,3.8,22.49,2019
"4737052",637,13,220,870,73.22,1.49,25.29,2019
"4737079",725,23,275,1023,70.87,2.25,26.88,2019
"4737085",1578,94,316,1988,79.38,4.73,15.9,2019
"4737122",19301,529,1082,20912,92.3,2.53,5.17,2019
"4737143",1350,20,182,1552,86.98,1.29,11.73,2019
"4737144",744,62,258,1064,69.92,5.83,24.25,2019
"4737148",7117,153,1355,8625,82.52,1.77,15.71,2019
"4737211",25701,662,3087,29450,87.27,2.25,10.48,2019
"4737212",6320,175,462,6957,90.84,2.52,6.64,2019
"4737216",6682,179,1062,7923,84.34,2.26,13.4,2019
"4737218",4324,290,1240,5854,73.86,4.95,21.18,2019
"4737303",7267,412,2022,9701,74.91,4.25,20.84,2019
"4737321",5424,231,1371,7026,77.2,3.29,19.51,2019
"4737327",3175,205,1019,4399,72.18,4.66,23.16,2019
"4737813",4919,493,1409,6821,72.12,7.23,20.66,2019
"4737818",1426,60,507,1993,71.55,3.01,25.44,2019
"4737852",587,77,283,947,61.99,8.13,29.88,2019
"4737098",1534,36,601,2171,70.66,1.66,27.68,2019
"4737134",798,39,203,1040,76.73,3.75,19.52,2019
"4737149",815,73,166,1054,77.32,6.93,15.75,2019
"4737151",171,0,71,242,70.66,0,29.34,2019
"4737160",8906,706,2458,12070,73.79,5.85,20.36,2019
"4737174",11841,50,577,12468,94.97,0.4,4.63,2019
"4737762",633,124,503,1260,50.24,9.84,39.92,2019
"4737770",812,28,319,1159,70.06,2.42,27.52,2019
"4737774",6088,327,1675,8090,75.25,4.04,20.7,2019
"4737806",893,23,219,1135,78.68,2.03,19.3,2019
"4737309",639,42,200,881,72.53,4.77,22.7,2019
"4737322",2141,140,1139,3420,62.6,4.09,33.3,2019
"4737340",145,12,77,234,61.97,5.13,32.91,2019
"4737341",3749,155,574,4478,83.72,3.46,12.82,2019
"4737348",143,80,175,398,35.93,20.1,43.97,2019
"4737357",1297,108,454,1859,69.77,5.81,24.42,2019
"4737394",19,0,17,36,52.78,0,47.22,2019
"4737402",1311,56,944,2311,56.73,2.42,40.85,2019
"4737615",7953,171,1084,9208,86.37,1.86,11.77,2019
"4737616",1316,80,565,1961,67.11,4.08,28.81,2019
"4737694",509,53,225,787,64.68,6.73,28.59,2019
"4737204",5331,202,429,5962,89.42,3.39,7.2,2019
"4737738",2000,106,274,2380,84.03,4.45,11.51,2019
"4737861",2464,236,687,3387,72.75,6.97,20.28,2019
"4737938",5586,182,760,6528,85.57,2.79,11.64,2019
"4737658",1085,80,588,1753,61.89,4.56,33.54,2019
"4737878",69,0,96,165,41.82,0,58.18,2019
"4737132",0,0,0,0,NA,NA,NA,2019
"4737165",11,0,11,22,50,0,50,2019
"4737240",0,0,0,0,NA,NA,NA,2019
"4737243",0,0,0,0,NA,NA,NA,2019
"4737246",0,0,0,0,NA,NA,NA,2019
"4737315",0,0,0,0,NA,NA,NA,2019
"4737682",70,0,40,110,63.64,0,36.36,2019
"4737733",20,0,8,28,71.43,0,28.57,2019
"4737851",0,0,12,12,0,0,100,2019
"4737934",9322,208,704,10234,91.09,2.03,6.88,2019
"4737330",2141,209,476,2826,75.76,7.4,16.84,2019
"4737379",9310,261,1597,11168,83.36,2.34,14.3,2019
"4737415",9395,195,1708,11298,83.16,1.73,15.12,2019
"4738030",161,0,8,169,95.27,0,4.73,2019
"2140067",1779,38,205,2022,87.98,1.88,10.14,2019
"2140068",631,27,164,822,76.76,3.28,19.95,2019
"2140143",1695,64,561,2320,73.06,2.76,24.18,2019
"2140176",276,0,106,382,72.25,0,27.75,2019
"2140207",12432,245,1186,13863,89.68,1.77,8.56,2019
"2140212",4331,343,1663,6337,68.34,5.41,26.24,2019
"2140217",4767,271,1021,6059,78.68,4.47,16.85,2019
"2140218",10843,454,2105,13402,80.91,3.39,15.71,2019
"2140222",8878,341,950,10169,87.3,3.35,9.34,2019
"2140223",8968,138,365,9471,94.69,1.46,3.85,2019
"2140241",11500,397,892,12789,89.92,3.1,6.97,2019
"2140242",4109,113,351,4573,89.85,2.47,7.68,2019
"2140291",13514,441,1023,14978,90.23,2.94,6.83,2019
"2140334",0,0,11,11,0,0,100,2019
"2140337",1597,45,421,2063,77.41,2.18,20.41,2019
"2140359",1537,225,770,2532,60.7,8.89,30.41,2019
"2140361",5664,165,1611,7440,76.13,2.22,21.65,2019
"2140813",141,0,43,184,76.63,0,23.37,2019
"2140826",91,15,181,287,31.71,5.23,63.07,2019
"2140830",25,7,35,67,37.31,10.45,52.24,2019
"2140840",33,0,60,93,35.48,0,64.52,2019
"2140870",93,10,37,140,66.43,7.14,26.43,2019
"2140873",567,9,366,942,60.19,0.96,38.85,2019
"2140316",77,7,114,198,38.89,3.54,57.58,2019
"2140336",3277,178,1439,4894,66.96,3.64,29.4,2019
"2140006",1369,195,352,1916,71.45,10.18,18.37,2019
"2140019",1155,73,291,1519,76.04,4.81,19.16,2019
"2140036",39,0,65,104,37.5,0,62.5,2019
"2140078",617,34,272,923,66.85,3.68,29.47,2019
"2140109",576,48,143,767,75.1,6.26,18.64,2019
"2140118",2748,94,590,3432,80.07,2.74,17.19,2019
"2140211",6031,654,2150,8835,68.26,7.4,24.34,2019
"2140214",14179,545,2979,17703,80.09,3.08,16.83,2019
"2140220",12890,285,1401,14576,88.43,1.96,9.61,2019
"2140229",12262,536,1408,14206,86.32,3.77,9.91,2019
"2140243",3988,123,571,4682,85.18,2.63,12.2,2019
"2140348",119,51,85,255,46.67,20,33.33,2019
"2140356",13730,365,2081,16176,84.88,2.26,12.86,2019
"2140409",980,44,342,1366,71.74,3.22,25.04,2019
"2140440",745,41,139,925,80.54,4.43,15.03,2019
"2140445",155,33,112,300,51.67,11,37.33,2019
"2140510",301,31,13,345,87.25,8.99,3.77,2019
"2140515",13535,413,690,14638,92.46,2.82,4.71,2019
"2140824",122,0,12,134,91.04,0,8.96,2019
"2140843",100,0,38,138,72.46,0,27.54,2019
"2140847",136,0,0,136,100,0,0,2019
"2140903",151,40,72,263,57.41,15.21,27.38,2019
"2140972",287,16,233,536,53.54,2.99,43.47,2019
"2140979",12,0,0,12,100,0,0,2019
"2140983",155,8,5,168,92.26,4.76,2.98,2019
"2140057",977,98,343,1418,68.9,6.91,24.19,2019
"2140012",145,0,106,251,57.77,0,42.23,2019
"2140047",6603,213,885,7701,85.74,2.77,11.49,2019
"2140052",172,0,36,208,82.69,0,17.31,2019
"2140069",2482,70,667,3219,77.1,2.17,20.72,2019
"2140107",745,51,67,863,86.33,5.91,7.76,2019
"2140111",494,20,130,644,76.71,3.11,20.19,2019
"2140140",134,16,99,249,53.82,6.43,39.76,2019
"2140146",1013,51,416,1480,68.45,3.45,28.11,2019
"4529122",17,0,4,21,80.95,0,19.05,2019
"4529142",1060,159,759,1978,53.59,8.04,38.37,2019
"4529152",669,0,11,680,98.38,0,1.62,2019
"4529161",2733,202,1338,4273,63.96,4.73,31.31,2019
"4529166",187,1,104,292,64.04,0.34,35.62,2019
"4529170",7299,150,1111,8560,85.27,1.75,12.98,2019
"4529206",7244,167,825,8236,87.96,2.03,10.02,2019
"4529229",16076,232,1532,17840,90.11,1.3,8.59,2019
"4529323",3809,217,1306,5332,71.44,4.07,24.49,2019
"4529330",2563,189,567,3319,77.22,5.69,17.08,2019
"4529341",5249,333,1917,7499,70,4.44,25.56,2019
"4529351",371,0,113,484,76.65,0,23.35,2019
"4529355",174,7,147,328,53.05,2.13,44.82,2019
"4529356",2752,142,647,3541,77.72,4.01,18.27,2019
"4529379",5102,225,2209,7536,67.7,2.99,29.31,2019
"4529670",3021,107,665,3793,79.65,2.82,17.53,2019
"4529680",11070,316,596,11982,92.39,2.64,4.97,2019
"4529681",19363,306,1034,20703,93.53,1.48,4.99,2019
"4529709",1840,150,634,2624,70.12,5.72,24.16,2019
"4529724",7,0,0,7,100,0,0,2019
"4529730",19083,683,2658,22424,85.1,3.05,11.85,2019
"4529745",9548,476,1796,11820,80.78,4.03,15.19,2019
"4529812",2900,260,1257,4417,65.66,5.89,28.46,2019
"4529831",1407,61,311,1779,79.09,3.43,17.48,2019
"4529842",2119,121,692,2932,72.27,4.13,23.6,2019
"4529843",238,10,190,438,54.34,2.28,43.38,2019
"4529212",11139,170,893,12202,91.29,1.39,7.32,2019
"4529303",6053,521,2168,8742,69.24,5.96,24.8,2019
"4529365",3725,73,362,4160,89.54,1.75,8.7,2019
"4529137",520,26,213,759,68.51,3.43,28.06,2019
"4529153",4320,304,1438,6062,71.26,5.01,23.72,2019
"4529162",763,13,319,1095,69.68,1.19,29.13,2019
"4529169",8743,318,2117,11178,78.22,2.84,18.94,2019
"4529202",167,10,6,183,91.26,5.46,3.28,2019
"4529148",1911,156,816,2883,66.29,5.41,28.3,2019
"4529320",243,0,0,243,100,0,0,2019
"4529453",241,10,171,422,57.11,2.37,40.52,2019
"4529581",973,155,613,1741,55.89,8.9,35.21,2019
"4529657",4290,175,1488,5953,72.06,2.94,25,2019
"4529569",4572,190,1710,6472,70.64,2.94,26.42,2019
"4529607",15076,544,2031,17651,85.41,3.08,11.51,2019
"4529741",619,10,333,962,64.35,1.04,34.62,2019
"4529902",4929,207,774,5910,83.4,3.5,13.1,2019
"4529944",1256,25,385,1666,75.39,1.5,23.11,2019
"4529945",1248,182,868,2298,54.31,7.92,37.77,2019
"4529712",614,75,224,913,67.25,8.21,24.53,2019
"4529469",370,14,70,454,81.5,3.08,15.42,2019
"4529479",1721,253,630,2604,66.09,9.72,24.19,2019
"4529483",26588,739,4080,31407,84.66,2.35,12.99,2019
"4529487",701,173,211,1085,64.61,15.94,19.45,2019
"4529506",4579,285,2170,7034,65.1,4.05,30.85,2019
"4529511",1440,29,520,1989,72.4,1.46,26.14,2019
"4529516",174,18,144,336,51.79,5.36,42.86,2019
"4529519",63,26,77,166,37.95,15.66,46.39,2019
"4529526",13898,684,2006,16588,83.78,4.12,12.09,2019
"4529570",818,17,551,1386,59.02,1.23,39.75,2019
"4529571",2643,650,2280,5573,47.43,11.66,40.91,2019
"4529577",10791,541,2062,13394,80.57,4.04,15.39,2019
"4529580",282,4,249,535,52.71,0.75,46.54,2019
"1232008",1314,199,436,1949,67.42,10.21,22.37,2019
"1232053",806,50,379,1235,65.26,4.05,30.69,2019
"1232359",344,61,299,704,48.86,8.66,42.47,2019
"1232401",7194,101,2038,9333,77.08,1.08,21.84,2019
"1232413",5932,187,435,6554,90.51,2.85,6.64,2019
"1232423",262,0,168,430,60.93,0,39.07,2019
"1232426",202,1,116,319,63.32,0.31,36.36,2019
"1232448",2619,100,1152,3871,67.66,2.58,29.76,2019
"1232503",10081,339,1666,12086,83.41,2.8,13.78,2019
"1232544",223,81,0,304,73.36,26.64,0,2019
"1232571",11295,313,1145,12753,88.57,2.45,8.98,2019
"1232608",17090,1120,908,19118,89.39,5.86,4.75,2019
"1232621",1272,57,647,1976,64.37,2.88,32.74,2019
"1232640",3074,123,1196,4393,69.97,2.8,27.23,2019
"1232683",35,0,30,65,53.85,0,46.15,2019
"1232686",1340,43,628,2011,66.63,2.14,31.23,2019
"1232618",2270,85,477,2832,80.16,3,16.84,2019
"1232804",7132,92,551,7775,91.73,1.18,7.09,2019
"1232931",6316,105,795,7216,87.53,1.46,11.02,2019
"1232707",13176,257,1424,14857,88.69,1.73,9.58,2019
"1232712",13506,301,1983,15790,85.54,1.91,12.56,2019
"1232720",9578,325,2590,12493,76.67,2.6,20.73,2019
"1232732",1658,18,81,1757,94.37,1.02,4.61,2019
"1232738",12651,298,1832,14781,85.59,2.02,12.39,2019
"1232771",17579,438,2433,20450,85.96,2.14,11.9,2019
"1232773",9691,339,1544,11574,83.73,2.93,13.34,2019
"1232776",3553,63,385,4001,88.8,1.57,9.62,2019
"1232808",14495,434,3615,18544,78.17,2.34,19.49,2019
"1232809",7319,155,1903,9377,78.05,1.65,20.29,2019
"1232819",9516,198,417,10131,93.93,1.95,4.12,2019
"1232831",27,0,0,27,100,0,0,2019
"1232835",16279,294,918,17491,93.07,1.68,5.25,2019
"1232836",6535,141,432,7108,91.94,1.98,6.08,2019
"1232905",7378,206,1848,9432,78.22,2.18,19.59,2019
"1232322",859,23,260,1142,75.22,2.01,22.77,2019
"1232440",1510,56,536,2102,71.84,2.66,25.5,2019
"1232566",13613,338,681,14632,93.04,2.31,4.65,2019
"1232625",442,51,136,629,70.27,8.11,21.62,2019
"1232746",16484,340,541,17365,94.93,1.96,3.12,2019
"1232908",3614,59,282,3955,91.38,1.49,7.13,2019
"1232832",9069,144,193,9406,96.42,1.53,2.05,2019
"1232833",3090,112,155,3357,92.05,3.34,4.62,2019
"1232837",14488,392,911,15791,91.75,2.48,5.77,2019
"1232935",14095,428,2241,16764,84.08,2.55,13.37,2019
"1232976",3647,84,1141,4872,74.86,1.72,23.42,2019
"1232694",541,0,197,738,73.31,0,26.69,2019
"1232754",3394,142,625,4161,81.57,3.41,15.02,2019
"1232801",6267,235,1022,7524,83.29,3.12,13.58,2019
"1232803",8918,128,554,9600,92.9,1.33,5.77,2019
"1232811",12568,394,1992,14954,84.04,2.63,13.32,2019
"1232812",12305,195,1509,14009,87.84,1.39,10.77,2019
"1232821",6768,65,398,7231,93.6,0.9,5.5,2019
"1232043",8164,135,1006,9305,87.74,1.45,10.81,2019
"1232130",1535,27,428,1990,77.14,1.36,21.51,2019
"1232009",979,62,197,1238,79.08,5.01,15.91,2019
"1232011",4636,200,538,5374,86.27,3.72,10.01,2019
"1232024",5649,235,1112,6996,80.75,3.36,15.89,2019
"1232063",3420,132,852,4404,77.66,3,19.35,2019
"1232082",11789,325,517,12631,93.33,2.57,4.09,2019
"0135651",223,52,186,461,48.37,11.28,40.35,2019
"0135661",5359,228,1037,6624,80.9,3.44,15.66,2019
"0135739",1583,9,383,1975,80.15,0.46,19.39,2019
"0135746",164,0,49,213,77,0,23,2019
"0135756",4142,97,261,4500,92.04,2.16,5.8,2019
"0135758",17264,692,610,18566,92.99,3.73,3.29,2019
"0135760",1494,84,253,1831,81.59,4.59,13.82,2019
"0135764",154,12,82,248,62.1,4.84,33.06,2019
"0135772",1179,21,678,1878,62.78,1.12,36.1,2019
"0135020",6501,359,3228,10088,64.44,3.56,32,2019
"0135034",780,30,387,1197,65.16,2.51,32.33,2019
"0135035",252,19,63,334,75.45,5.69,18.86,2019
"0135042",1646,50,634,2330,70.64,2.15,27.21,2019
"0135082",0,0,0,0,NA,NA,NA,2019
"0135121",4269,158,1587,6014,70.98,2.63,26.39,2019
"0135139",40,0,68,108,37.04,0,62.96,2019
"0135147",1990,17,191,2198,90.54,0.77,8.69,2019
"0135148",632,31,244,907,69.68,3.42,26.9,2019
"0135176",249,0,92,341,73.02,0,26.98,2019
"0135216",13522,278,1019,14819,91.25,1.88,6.88,2019
"0135221",1199,66,506,1771,67.7,3.73,28.57,2019
"0135223",3963,105,129,4197,94.42,2.5,3.07,2019
"0135224",1331,70,632,2033,65.47,3.44,31.09,2019
"0135233",762,134,25,921,82.74,14.55,2.71,2019
"0135243",7185,127,390,7702,93.29,1.65,5.06,2019
"0135441",225,26,141,392,57.4,6.63,35.97,2019
"0135446",541,7,173,721,75.03,0.97,23.99,2019
"0135452",922,18,249,1189,77.54,1.51,20.94,2019
"0135458",111,0,50,161,68.94,0,31.06,2019
"0135475",4802,109,646,5557,86.41,1.96,11.62,2019
"0135477",23,9,30,62,37.1,14.52,48.39,2019
"0135549",964,51,501,1516,63.59,3.36,33.05,2019
"0135554",340,0,115,455,74.73,0,25.27,2019
"0135579",940,36,391,1367,68.76,2.63,28.6,2019
"0135640",7618,236,1601,9455,80.57,2.5,16.93,2019
"0135653",2277,249,1085,3611,63.06,6.9,30.05,2019
"0135660",2556,175,1315,4046,63.17,4.33,32.5,2019
"0135677",383,27,257,667,57.42,4.05,38.53,2019
"0135749",7480,111,695,8286,90.27,1.34,8.39,2019
"0135179",2678,63,555,3296,81.25,1.91,16.84,2019
"0135950",5787,142,1374,7303,79.24,1.94,18.81,2019
"0135953",2126,72,545,2743,77.51,2.62,19.87,2019
"0135967",4594,110,1313,6017,76.35,1.83,21.82,2019
"0135979",384,0,206,590,65.08,0,34.92,2019
"0135987",663,64,185,912,72.7,7.02,20.29,2019
"0135988",626,15,148,789,79.34,1.9,18.76,2019
"0135049",1171,10,195,1376,85.1,0.73,14.17,2019
"0135051",2466,237,749,3452,71.44,6.87,21.7,2019
"0135060",80,0,52,132,60.61,0,39.39,2019
"0135115",4041,125,1293,5459,74.02,2.29,23.69,2019
"0135116",1469,32,188,1689,86.97,1.89,11.13,2019
"0135120",3937,162,725,4824,81.61,3.36,15.03,2019
"0135160",7138,234,2576,9948,71.75,2.35,25.89,2019
"0135171",782,30,430,1242,62.96,2.42,34.62,2019
"0135175",1646,95,262,2003,82.18,4.74,13.08,2019
"0135968",1267,65,323,1655,76.56,3.93,19.52,2019
"0135989",954,24,394,1372,69.53,1.75,28.72,2019
"0135083",782,61,430,1273,61.43,4.79,33.78,2019
"0135094",4556,305,785,5646,80.69,5.4,13.9,2019
"4738036",81,4,120,205,39.51,1.95,58.54,2019
"4738046",14,0,11,25,56,0,44,2019
"4738050",152,19,42,213,71.36,8.92,19.72,2019
"4738069",410,55,471,936,43.8,5.88,50.32,2019
"4738108",2942,430,3006,6378,46.13,6.74,47.13,2019
"4738118",9759,295,2855,12909,75.6,2.29,22.12,2019
"4738231",483,29,190,702,68.8,4.13,27.07,2019
"4738235",130,11,37,178,73.03,6.18,20.79,2019
"4738241",225,25,137,387,58.14,6.46,35.4,2019
"4738251",866,26,255,1147,75.5,2.27,22.23,2019
"4738347",116,17,12,145,80,11.72,8.28,2019
"4738255",716,22,277,1015,70.54,2.17,27.29,2019
"4738318",113,0,51,164,68.9,0,31.1,2019
"4738329",933,35,277,1245,74.94,2.81,22.25,2019
"4738371",281,5,106,392,71.68,1.28,27.04,2019
"4738382",2290,129,1049,3468,66.03,3.72,30.25,2019
"4738387",66,0,48,114,57.89,0,42.11,2019
"4738044",190,5,96,291,65.29,1.72,32.99,2019
"4738058",3059,148,507,3714,82.36,3.98,13.65,2019
"4738063",4864,163,1598,6625,73.42,2.46,24.12,2019
"4738068",2847,76,1228,4151,68.59,1.83,29.58,2019
"4738107",3731,316,2553,6600,56.53,4.79,38.68,2019
"4738330",1289,59,440,1788,72.09,3.3,24.61,2019
"4738334",586,21,219,826,70.94,2.54,26.51,2019
"4738342",404,12,151,567,71.25,2.12,26.63,2019
"4738344",2230,53,777,3060,72.88,1.73,25.39,2019
"4738345",397,87,190,674,58.9,12.91,28.19,2019
"4738366",544,6,162,712,76.4,0.84,22.75,2019
"4738368",410,32,350,792,51.77,4.04,44.19,2019
"4738376",53,0,0,53,100,0,0,2019
"4738381",320,16,296,632,50.63,2.53,46.84,2019
"4738391",277,48,99,424,65.33,11.32,23.35,2019
"4738460",344,6,153,503,68.39,1.19,30.42,2019
"4738471",111,0,23,134,82.84,0,17.16,2019
"4738002",12086,32,1019,13137,92,0.24,7.76,2019
"4738015",630,44,191,865,72.83,5.09,22.08,2019
"4738017",17761,311,939,19011,93.42,1.64,4.94,2019
"4738079",791,96,419,1306,60.57,7.35,32.08,2019
"4738117",9572,201,1308,11081,86.38,1.81,11.8,2019
"4738127",8029,864,5072,13965,57.49,6.19,36.32,2019
"4738132",0,0,0,0,NA,NA,NA,2019
"4738139",5164,184,128,5476,94.3,3.36,2.34,2019
"4738233",797,47,278,1122,71.03,4.19,24.78,2019
"4738236",154,0,18,172,89.53,0,10.47,2019
"4738261",5183,143,1285,6611,78.4,2.16,19.44,2019
"4738301",9212,661,3392,13265,69.45,4.98,25.57,2019
"4738305",16630,929,2524,20083,82.81,4.63,12.57,2019
"4738328",172,10,78,260,66.15,3.85,30,2019
"2838962",19,0,23,42,45.24,0,54.76,2019
"2838964",31,0,0,31,100,0,0,2019
"4738112",4023,301,2178,6502,61.87,4.63,33.5,2019
"4738116",8890,526,5324,14740,60.31,3.57,36.12,2019
"4738120",5620,105,619,6344,88.59,1.66,9.76,2019
"4738126",604,24,1470,2098,28.79,1.14,70.07,2019
"4738138",8899,330,670,9899,89.9,3.33,6.77,2019
"4738316",781,23,259,1063,73.47,2.16,24.37,2019
"4738333",53,0,28,81,65.43,0,34.57,2019
"4738356",751,43,206,1000,75.1,4.3,20.6,2019
"4738363",1466,11,573,2050,71.51,0.54,27.95,2019
"2140157",309,0,37,346,89.31,0,10.69,2019
"2140177",507,24,108,639,79.34,3.76,16.9,2019
"2140202",1941,245,517,2703,71.81,9.06,19.13,2019
"2140208",4512,510,802,5824,77.47,8.76,13.77,2019
"2140055",411,71,233,715,57.48,9.93,32.59,2019
"2140033",3714,268,1087,5069,73.27,5.29,21.44,2019
"2140045",1000,115,351,1466,68.21,7.84,23.94,2019
"2140051",1300,91,450,1841,70.61,4.94,24.44,2019
"2140058",27,0,5,32,84.38,0,15.62,2019
"2140070",242,9,0,251,96.41,3.59,0,2019
"2140076",692,18,192,902,76.72,2,21.29,2019
"2140502",11204,208,911,12323,90.92,1.69,7.39,2019
"2140503",10822,438,982,12242,88.4,3.58,8.02,2019
"2140505",8603,265,2048,10916,78.81,2.43,18.76,2019
"2140508",6864,991,1593,9448,72.65,10.49,16.86,2019
"2140511",10555,409,1545,12509,84.38,3.27,12.35,2019
"2140737",265,0,18,283,93.64,0,6.36,2019
"2140213",5490,246,1201,6937,79.14,3.55,17.31,2019
"2140272",12106,265,1934,14305,84.63,1.85,13.52,2019
"2140299",14497,237,1393,16127,89.89,1.47,8.64,2019
"2140310",78,13,43,134,58.21,9.7,32.09,2019
"2140358",343,22,77,442,77.6,4.98,17.42,2019
"2140370",825,1,241,1067,77.32,0.09,22.59,2019
"2140385",753,0,256,1009,74.63,0,25.37,2019
"2140422",7344,244,1626,9214,79.7,2.65,17.65,2019
"2140442",277,18,68,363,76.31,4.96,18.73,2019
"2140003",541,73,119,733,73.81,9.96,16.23,2019
"2140023",1855,45,57,1957,94.79,2.3,2.91,2019
"2140828",1012,69,334,1415,71.52,4.88,23.6,2019
"2140815",346,0,153,499,69.34,0,30.66,2019
"2140818",15,0,0,15,100,0,0,2019
"2140854",320,17,121,458,69.87,3.71,26.42,2019
"2140855",232,6,82,320,72.5,1.88,25.62,2019
"2140856",178,16,89,283,62.9,5.65,31.45,2019
"2140862",115,0,26,141,81.56,0,18.44,2019
"2140865",124,0,49,173,71.68,0,28.32,2019
"2140874",92,0,80,172,53.49,0,46.51,2019
"2140007",11,0,27,38,28.95,0,71.05,2019
"2140009",264,1,114,379,69.66,0.26,30.08,2019
"2140387",633,0,228,861,73.52,0,26.48,2019
"2140390",1996,68,351,2415,82.65,2.82,14.53,2019
"2140403",7411,170,1500,9081,81.61,1.87,16.52,2019
"2140460",345,7,99,451,76.5,1.55,21.95,2019
"2140771",334,0,148,482,69.29,0,30.71,2019
"2140806",808,0,289,1097,73.66,0,26.34,2019
"2140807",132,9,21,162,81.48,5.56,12.96,2019
"2140820",183,15,37,235,77.87,6.38,15.74,2019
"2140953",186,9,78,273,68.13,3.3,28.57,2019
"2140216",13096,488,3761,17345,75.5,2.81,21.68,2019
"2140228",5769,37,592,6398,90.17,0.58,9.25,2019
"2140322",962,26,350,1338,71.9,1.94,26.16,2019
"2140374",497,20,172,689,72.13,2.9,24.96,2019
"2140447",2350,76,885,3311,70.98,2.3,26.73,2019
"2140456",2705,115,1131,3951,68.46,2.91,28.63,2019
"2140468",515,18,146,679,75.85,2.65,21.5,2019
"2140504",9514,647,1395,11556,82.33,5.6,12.07,2019
"2140601",17312,1173,2925,21410,80.86,5.48,13.66,2019
"2140740",786,24,298,1108,70.94,2.17,26.9,2019
"2140741",6689,486,1831,9006,74.27,5.4,20.33,2019
"4529593",426,47,267,740,57.57,6.35,36.08,2019
"4529617",8322,224,2489,11035,75.41,2.03,22.56,2019
"4529621",13333,555,2270,16158,82.52,3.43,14.05,2019
"4529626",3804,194,971,4969,76.55,3.9,19.54,2019
"4529631",5547,232,388,6167,89.95,3.76,6.29,2019
"4529644",6514,139,1039,7692,84.69,1.81,13.51,2019
"4529658",125,38,26,189,66.14,20.11,13.76,2019
"4529690",5906,243,1704,7853,75.21,3.09,21.7,2019
"4529692",1225,86,553,1864,65.72,4.61,29.67,2019
"4529696",1595,83,309,1987,80.27,4.18,15.55,2019
"4529727",403,131,142,676,59.62,19.38,21.01,2019
"4529810",890,201,732,1823,48.82,11.03,40.15,2019
"4529840",23,0,92,115,20,0,80,2019
"4529848",206,45,64,315,65.4,14.29,20.32,2019
"4529939",128,8,31,167,76.65,4.79,18.56,2019
"4529046",37,0,39,76,48.68,0,51.32,2019
"4529101",764,77,239,1080,70.74,7.13,22.13,2019
"4529168",1086,121,241,1448,75,8.36,16.64,2019
"4529940",1145,142,168,1455,78.69,9.76,11.55,2019
"4529020",6218,286,2125,8629,72.06,3.31,24.63,2019
"4529044",1168,99,853,2120,55.09,4.67,40.24,2019
"4529126",542,22,228,792,68.43,2.78,28.79,2019
"4529117",0,0,0,0,NA,NA,NA,2019
"4529147",0,0,0,0,NA,NA,NA,2019
"4529208",0,0,0,0,NA,NA,NA,2019
"4529225",0,0,0,0,NA,NA,NA,2019
"4529324",68,0,46,114,59.65,0,40.35,2019
"4529329",76,9,8,93,81.72,9.68,8.6,2019
"4529331",38,0,0,38,100,0,0,2019
"4529333",168,0,56,224,75,0,25,2019
"4529346",119,7,5,131,90.84,5.34,3.82,2019
"4529368",55,0,0,55,100,0,0,2019
"4529378",22,0,18,40,55,0,45,2019
"4529409",10,0,0,10,100,0,0,2019
"4529410",7377,301,1213,8891,82.97,3.39,13.64,2019
"4529424",0,0,0,0,NA,NA,NA,2019
"4529588",15432,535,1531,17498,88.19,3.06,8.75,2019
"4529613",0,0,0,0,NA,NA,NA,2019
"4529614",79,12,0,91,86.81,13.19,0,2019
"4529634",14,0,12,26,53.85,0,46.15,2019
"4529707",11868,169,442,12479,95.1,1.35,3.54,2019
"4529733",0,0,0,0,NA,NA,NA,2019
"4529899",0,0,0,0,NA,NA,NA,2019
"4529904",0,0,0,0,NA,NA,NA,2019
"4529905",16,0,0,16,100,0,0,2019
"4529907",4407,188,473,5068,86.96,3.71,9.33,2019
"4529909",8269,389,498,9156,90.31,4.25,5.44,2019
"4529912",0,0,0,0,NA,NA,NA,2019
"4529915",196,0,5,201,97.51,0,2.49,2019
"4529817",1019,80,544,1643,62.02,4.87,33.11,2019
"4529520",3742,411,1384,5537,67.58,7.42,25,2019
"4529642",11119,204,1219,12542,88.65,1.63,9.72,2019
"4529667",71,3,34,108,65.74,2.78,31.48,2019
"4529689",1246,111,297,1654,75.33,6.71,17.96,2019
"4529080",576,54,450,1080,53.33,5,41.67,2019
"4529146",373,30,193,596,62.58,5.03,32.38,2019
"4529045",8358,189,1158,9705,86.12,1.95,11.93,2019
"4529118",5373,153,934,6460,83.17,2.37,14.46,2019
"4529372",1224,21,368,1613,75.88,1.3,22.81,2019
"1232083",366,0,174,540,67.78,0,32.22,2019
"1232087",1338,110,176,1624,82.39,6.77,10.84,2019
"1232091",3946,81,1618,5645,69.9,1.43,28.66,2019
"1232092",10910,716,851,12477,87.44,5.74,6.82,2019
"1232134",2371,53,693,3117,76.07,1.7,22.23,2019
"1232206",4021,223,2306,6550,61.39,3.4,35.21,2019
"1232218",18583,759,2857,22199,83.71,3.42,12.87,2019
"1232744",1161,20,313,1494,77.71,1.34,20.95,2019
"1232767",960,19,130,1109,86.56,1.71,11.72,2019
"1232810",11574,243,1637,13454,86.03,1.81,12.17,2019
"1232818",14059,422,2940,17421,80.7,2.42,16.88,2019
"1232820",2603,48,332,2983,87.26,1.61,11.13,2019
"1232827",3253,66,95,3414,95.28,1.93,2.78,2019
"1232922",4512,414,1367,6293,71.7,6.58,21.72,2019
"1232927",9105,65,862,10032,90.76,0.65,8.59,2019
"1232949",789,8,47,844,93.48,0.95,5.57,2019
"1232407",4251,98,411,4760,89.31,2.06,8.63,2019
"1232410",448,23,28,499,89.78,4.61,5.61,2019
"1232425",3400,184,1108,4692,72.46,3.92,23.61,2019
"1232427",248,41,175,464,53.45,8.84,37.72,2019
"1232431",1154,24,555,1733,66.59,1.38,32.03,2019
"1232445",320,13,168,501,63.87,2.59,33.53,2019
"1232501",2818,93,1413,4324,65.17,2.15,32.68,2019
"1232526",12898,400,1340,14638,88.11,2.73,9.15,2019
"1232533",9364,375,1016,10755,87.07,3.49,9.45,2019
"1232539",7958,531,1006,9495,83.81,5.59,10.6,2019
"1232222",3564,36,345,3945,90.34,0.91,8.75,2019
"1232223",9215,118,452,9785,94.17,1.21,4.62,2019
"1232227",386,0,27,413,93.46,0,6.54,2019
"1232256",19867,417,1159,21443,92.65,1.94,5.41,2019
"1232304",15146,1003,1486,17635,85.89,5.69,8.43,2019
"1232308",9341,290,690,10321,90.5,2.81,6.69,2019
"1232901",8369,464,1675,10508,79.64,4.42,15.94,2019
"1232926",7348,219,712,8279,88.75,2.65,8.6,2019
"1232940",15865,226,922,17013,93.25,1.33,5.42,2019
"1232950",1611,10,145,1766,91.22,0.57,8.21,2019
"1232968",4028,35,320,4383,91.9,0.8,7.3,2019
"1232780",13360,523,1343,15226,87.74,3.43,8.82,2019
"1232934",6480,109,680,7269,89.15,1.5,9.35,2019
"1232033",1401,186,216,1803,77.7,10.32,11.98,2019
"1232003",9713,171,544,10428,93.14,1.64,5.22,2019
"1232026",0,0,0,0,NA,NA,NA,2019
"1232064",1592,39,810,2441,65.22,1.6,33.18,2019
"1232080",8344,664,728,9736,85.7,6.82,7.48,2019
"1232081",4901,24,0,4925,99.51,0.49,0,2019
"1232128",7786,243,392,8421,92.46,2.89,4.66,2019
"1232129",7904,349,1576,9829,80.42,3.55,16.03,2019
"1232133",8,0,0,8,100,0,0,2019
"1232162",28221,397,1537,30155,93.59,1.32,5.1,2019
"1232228",0,0,0,0,NA,NA,NA,2019
"1232305",5717,206,1800,7723,74.03,2.67,23.31,2019
"1232309",11592,283,563,12438,93.2,2.28,4.53,2019
"1232317",4955,48,471,5474,90.52,0.88,8.6,2019
"1232348",2427,281,1047,3755,64.63,7.48,27.88,2019
"1232352",1602,37,741,2380,67.31,1.55,31.13,2019
"1232435",2379,78,514,2971,80.07,2.63,17.3,2019
"1232461",25,0,0,25,100,0,0,2019
"1232502",1271,43,221,1535,82.8,2.8,14.4,2019
"1232509",0,0,0,0,NA,NA,NA,2019
"0135125",2829,215,1051,4095,69.08,5.25,25.67,2019
"0135128",3464,224,606,4294,80.67,5.22,14.11,2019
"0135135",790,8,96,894,88.37,0.89,10.74,2019
"0135173",8315,310,695,9320,89.22,3.33,7.46,2019
"0135459",196,5,196,397,49.37,1.26,49.37,2019
"0135460",284,5,112,401,70.82,1.25,27.93,2019
"0135480",242,0,87,329,73.56,0,26.44,2019
"0135552",194,43,118,355,54.65,12.11,33.24,2019
"0135559",6,0,0,6,100,0,0,2019
"0135563",1281,122,493,1896,67.56,6.43,26,2019
"0135570",3131,132,1266,4529,69.13,2.91,27.95,2019
"0135571",191,2,131,324,58.95,0.62,40.43,2019
"0135576",841,38,455,1334,63.04,2.85,34.11,2019
"0135594",1938,73,674,2685,72.18,2.72,25.1,2019
"0135613",6959,273,705,7937,87.68,3.44,8.88,2019
"0135614",1866,191,554,2611,71.47,7.32,21.22,2019
"0135650",3324,171,1658,5153,64.51,3.32,32.18,2019
"0135671",524,156,192,872,60.09,17.89,22.02,2019
"0135673",1951,94,575,2620,74.47,3.59,21.95,2019
"0135740",987,74,358,1419,69.56,5.21,25.23,2019
"0135750",4316,157,793,5266,81.96,2.98,15.06,2019
"0135903",4930,248,1496,6674,73.87,3.72,22.42,2019
"0135754",1549,42,389,1980,78.23,2.12,19.65,2019
"0135811",8970,297,1680,10947,81.94,2.71,15.35,2019
"0135901",5694,165,1694,7553,75.39,2.18,22.43,2019
"0135954",3564,152,761,4477,79.61,3.4,17,2019
"0135958",1014,0,436,1450,69.93,0,30.07,2019
"0135961",1631,127,739,2497,65.32,5.09,29.6,2019
"0135971",1369,45,539,1953,70.1,2.3,27.6,2019
"0135751",81,5,0,86,94.19,5.81,0,2019
"0135771",1098,59,265,1422,77.22,4.15,18.64,2019
"0135806",10149,72,835,11056,91.8,0.65,7.55,2019
"0135808",343,0,8,351,97.72,0,2.28,2019
"0135775",211,0,169,380,55.53,0,44.47,2019
"0135803",10227,132,940,11299,90.51,1.17,8.32,2019
"0135044",2060,185,846,3091,66.65,5.99,27.37,2019
"0135055",5973,286,1579,7838,76.21,3.65,20.15,2019
"0135071",5362,151,815,6328,84.73,2.39,12.88,2019
"0135986",2199,81,775,3055,71.98,2.65,25.37,2019
"0135004",3719,156,749,4624,80.43,3.37,16.2,2019
"0135005",2020,58,619,2697,74.9,2.15,22.95,2019
"0135045",3993,259,1663,5915,67.51,4.38,28.11,2019
"0135052",0,0,23,23,0,0,100,2019
"0135186",1454,97,457,2008,72.41,4.83,22.76,2019
"0135213",5220,188,285,5693,91.69,3.3,5.01,2019
"0135215",14308,868,2997,18173,78.73,4.78,16.49,2019
"0135442",1484,50,473,2007,73.94,2.49,23.57,2019
"0135456",960,109,231,1300,73.85,8.38,17.77,2019
"0135118",954,21,217,1192,80.03,1.76,18.2,2019
"0135073",597,14,215,826,72.28,1.69,26.03,2019
"0135085",2341,125,725,3191,73.36,3.92,22.72,2019
"0135111",5022,106,637,5765,87.11,1.84,11.05,2019
"0135124",8669,189,724,9582,90.47,1.97,7.56,2019
"0135150",5187,226,1540,6953,74.6,3.25,22.15,2019
"0135203",951,232,505,1688,56.34,13.74,29.92,2019
"0135206",4775,259,1826,6860,69.61,3.78,26.62,2019
"0135209",10777,304,911,11992,89.87,2.54,7.6,2019
"0135218",1937,158,747,2842,68.16,5.56,26.28,2019
"0135226",12272,308,537,13117,93.56,2.35,4.09,2019
"4738390",275,16,105,396,69.44,4.04,26.52,2019
"4738462",2391,133,1456,3980,60.08,3.34,36.58,2019
"4738562",1682,120,650,2452,68.6,4.89,26.51,2019
"4738222",776,87,128,991,78.3,8.78,12.92,2019
"4738230",1063,19,551,1633,65.09,1.16,33.74,2019
"4738242",5955,442,1993,8390,70.98,5.27,23.75,2019
"4738258",388,84,181,653,59.42,12.86,27.72,2019
"4738260",1087,59,355,1501,72.42,3.93,23.65,2019
"4738321",568,56,301,925,61.41,6.05,32.54,2019
"4738326",866,4,363,1233,70.24,0.32,29.44,2019
"4738332",341,0,152,493,69.17,0,30.83,2019
"4738339",147,2,146,295,49.83,0.68,49.49,2019
"4738340",3508,29,960,4497,78.01,0.64,21.35,2019
"4738370",248,5,48,301,82.39,1.66,15.95,2019
"4738372",4840,230,1553,6623,73.08,3.47,23.45,2019
"4738379",355,5,159,519,68.4,0.96,30.64,2019
"4738425",457,65,209,731,62.52,8.89,28.59,2019
"4738449",840,21,232,1093,76.85,1.92,21.23,2019
"4738313",1019,0,154,1173,86.87,0,13.13,2019
"4738320",3063,167,1237,4467,68.57,3.74,27.69,2019
"4738341",514,58,329,901,57.05,6.44,36.51,2019
"4738348",277,0,123,400,69.25,0,30.75,2019
"4738355",1963,93,234,2290,85.72,4.06,10.22,2019
"4738358",3695,139,821,4655,79.38,2.99,17.64,2019
"4738374",545,12,257,814,66.95,1.47,31.57,2019
"4738401",19255,778,3292,23325,82.55,3.34,14.11,2019
"4738459",94,0,14,108,87.04,0,12.96,2019
"4738472",906,30,253,1189,76.2,2.52,21.28,2019
"4738485",1819,25,679,2523,72.1,0.99,26.91,2019
"4738506",9281,261,2152,11694,79.37,2.23,18.4,2019
"4738542",0,0,9,9,0,0,100,2019
"4738570",2492,153,1357,4002,62.27,3.82,33.91,2019
"4738575",292,15,175,482,60.58,3.11,36.31,2019
"2838625",359,80,83,522,68.77,15.33,15.9,2019
"2838627",200,0,153,353,56.66,0,43.34,2019
"2838647",132,8,144,284,46.48,2.82,50.7,2019
"2838658",544,0,186,730,74.52,0,25.48,2019
"2838661",421,67,254,742,56.74,9.03,34.23,2019
"2838664",1200,10,169,1379,87.02,0.73,12.26,2019
"2838676",1386,49,706,2141,64.74,2.29,32.98,2019
"2838730",584,23,265,872,66.97,2.64,30.39,2019
"2838753",351,2,170,523,67.11,0.38,32.5,2019
"2838754",341,19,218,578,59,3.29,37.72,2019
"2838761",402,49,288,739,54.4,6.63,38.97,2019
"2838778",347,3,200,550,63.09,0.55,36.36,2019
"2838804",4991,99,1576,6666,74.87,1.49,23.64,2019
"2838824",1945,76,747,2768,70.27,2.75,26.99,2019
"2838849",1688,111,475,2274,74.23,4.88,20.89,2019
"4738011",2574,213,503,3290,78.24,6.47,15.29,2019
"2838961",51,0,286,337,15.13,0,84.87,2019
"2838967",2250,92,581,2923,76.98,3.15,19.88,2019
"2838670",218,4,174,396,55.05,1.01,43.94,2019
"2838674",285,37,31,353,80.74,10.48,8.78,2019
"2838680",1776,74,295,2145,82.8,3.45,13.75,2019
"2838703",3022,199,1340,4561,66.26,4.36,29.38,2019
"2838725",164,1,111,276,59.42,0.36,40.22,2019
"2838726",133,5,57,195,68.21,2.56,29.23,2019
"2838732",4170,61,2029,6260,66.61,0.97,32.41,2019
"2838760",153,3,157,313,48.88,0.96,50.16,2019
"2140808",19,0,0,19,100,0,0,2019
"2140810",324,30,157,511,63.41,5.87,30.72,2019
"2140819",189,0,42,231,81.82,0,18.18,2019
"2140827",220,38,77,335,65.67,11.34,22.99,2019
"2140845",142,8,76,226,62.83,3.54,33.63,2019
"2140858",164,0,13,177,92.66,0,7.34,2019
"2140868",260,42,149,451,57.65,9.31,33.04,2019
"2140906",2393,423,1528,4344,55.09,9.74,35.17,2019
"2140913",80,0,55,135,59.26,0,40.74,2019
"2140914",147,0,18,165,89.09,0,10.91,2019
"2140769",3793,303,1998,6094,62.24,4.97,32.79,2019
"2140516",1064,23,174,1261,84.38,1.82,13.8,2019
"2140517",14232,567,1682,16481,86.35,3.44,10.21,2019
"2140763",78,24,110,212,36.79,11.32,51.89,2019
"2140915",254,28,31,313,81.15,8.95,9.9,2019
"2140921",22,21,35,78,28.21,26.92,44.87,2019
"2140949",259,0,48,307,84.36,0,15.64,2019
"2140977",2508,173,1368,4049,61.94,4.27,33.79,2019
"2140997",55,39,45,139,39.57,28.06,32.37,2019
"2140419",913,49,644,1606,56.85,3.05,40.1,2019
"2140342",6679,510,1377,8566,77.97,5.95,16.08,2019
"2140350",21,0,44,65,32.31,0,67.69,2019
"2140372",607,14,177,798,76.07,1.75,22.18,2019
"2140464",281,41,190,512,54.88,8.01,37.11,2019
"2141175",1495,92,407,1994,74.97,4.61,20.41,2019
"2141224",1523,39,441,2003,76.04,1.95,22.02,2019
"2141234",209,8,79,296,70.61,2.7,26.69,2019
"2141268",170,0,95,265,64.15,0,35.85,2019
"2141317",49,0,35,84,58.33,0,41.67,2019
"2141348",201,15,241,457,43.98,3.28,52.74,2019
"2141465",3231,71,1280,4582,70.52,1.55,27.94,2019
"2141527",294,0,31,325,90.46,0,9.54,2019
"2141528",206,17,128,351,58.69,4.84,36.47,2019
"2141603",421,39,158,618,68.12,6.31,25.57,2019
"2141615",193,0,25,218,88.53,0,11.47,2019
"2141621",53,0,0,53,100,0,0,2019
"2141630",393,27,192,612,64.22,4.41,31.37,2019
"2141649",688,15,358,1061,64.84,1.41,33.74,2019
"2141006",1128,88,368,1584,71.21,5.56,23.23,2019
"2141007",1380,67,174,1621,85.13,4.13,10.73,2019
"2141018",9287,118,1245,10650,87.2,1.11,11.69,2019
"2141039",975,13,171,1159,84.12,1.12,14.75,2019
"2141052",47,0,0,47,100,0,0,2019
"2141059",919,14,166,1099,83.62,1.27,15.1,2019
"2141425",344,11,89,444,77.48,2.48,20.05,2019
"2141513",166,0,59,225,73.78,0,26.22,2019
"2141524",50,0,15,65,76.92,0,23.08,2019
"2141558",226,9,99,334,67.66,2.69,29.64,2019
"2141559",70,0,10,80,87.5,0,12.5,2019
"2141560",103,0,8,111,92.79,0,7.21,2019
"2141567",29,0,22,51,56.86,0,43.14,2019
"2141572",1290,22,246,1558,82.8,1.41,15.79,2019
"2141606",335,0,119,454,73.79,0,26.21,2019
"2141612",24,0,22,46,52.17,0,47.83,2019
"2141619",41,8,43,92,44.57,8.7,46.74,2019
"2141631",321,0,153,474,67.72,0,32.28,2019
"2141636",209,8,173,390,53.59,2.05,44.36,2019
"2141650",99,23,22,144,68.75,15.97,15.28,2019
"2141667",213,0,7,220,96.82,0,3.18,2019
"4529492",4887,129,407,5423,90.12,2.38,7.51,2019
"1330451",18,0,0,18,100,0,0,2019
"1330460",0,0,0,0,NA,NA,NA,2019
"1330475",0,0,0,0,NA,NA,NA,2019
"1330536",3053,34,379,3466,88.08,0.98,10.93,2019
"1330573",23,0,1,24,95.83,0,4.17,2019
"1330609",0,0,0,0,NA,NA,NA,2019
"1330623",20,0,9,29,68.97,0,31.03,2019
"1330751",20,0,0,20,100,0,0,2019
"1330756",8,0,63,71,11.27,0,88.73,2019
"1330812",0,0,0,0,NA,NA,NA,2019
"1330903",302,0,0,302,100,0,0,2019
"1330912",0,0,0,0,NA,NA,NA,2019
"1330078",10410,134,669,11213,92.84,1.2,5.97,2019
"1330110",4149,85,885,5119,81.05,1.66,17.29,2019
"1330134",11259,1466,2072,14797,76.09,9.91,14,2019
"1330755",2871,95,535,3501,82.01,2.71,15.28,2019
"1330905",859,19,57,935,91.87,2.03,6.1,2019
"1330634",426,34,311,771,55.25,4.41,40.34,2019
"1330060",11365,310,2155,13830,82.18,2.24,15.58,2019
"1330565",1369,23,313,1705,80.29,1.35,18.36,2019
"1330619",424,23,86,533,79.55,4.32,16.14,2019
"1330710",2057,28,321,2406,85.49,1.16,13.34,2019
"1330823",344,2,133,479,71.82,0.42,27.77,2019
"1330068",11504,88,603,12195,94.33,0.72,4.94,2019
"1330188",22955,296,1022,24273,94.57,1.22,4.21,2019
"1330295",1038,79,411,1528,67.93,5.17,26.9,2019
"1330341",10763,591,1695,13049,82.48,4.53,12.99,2019
"1330062",22137,164,1260,23561,93.96,0.7,5.35,2019
"1330124",990,13,194,1197,82.71,1.09,16.21,2019
"1330205",942,25,145,1112,84.71,2.25,13.04,2019
"1330833",887,0,578,1465,60.55,0,39.45,2019
"1330236",13349,886,2067,16302,81.89,5.43,12.68,2019
"1330252",13925,380,627,14932,93.26,2.54,4.2,2019
"1330257",1367,4,379,1750,78.11,0.23,21.66,2019
"1330258",729,19,284,1032,70.64,1.84,27.52,2019
"1330285",156,46,66,268,58.21,17.16,24.63,2019
"1330312",10152,1051,1199,12402,81.86,8.47,9.67,2019
"1330317",4625,214,745,5584,82.83,3.83,13.34,2019
"1330559",1607,45,333,1985,80.96,2.27,16.78,2019
"1330568",393,59,142,594,66.16,9.93,23.91,2019
"1330572",245,31,173,449,54.57,6.9,38.53,2019
"1330575",354,21,181,556,63.67,3.78,32.55,2019
"1330576",706,38,171,915,77.16,4.15,18.69,2019
"1330577",5168,390,2081,7639,67.65,5.11,27.24,2019
"1330625",610,22,297,929,65.66,2.37,31.97,2019
"1330629",1289,108,423,1820,70.82,5.93,23.24,2019
"1330646",2023,41,713,2777,72.85,1.48,25.68,2019
"1330667",205,25,88,318,64.47,7.86,27.67,2019
"1330677",6073,94,616,6783,89.53,1.39,9.08,2019
"1330506",13717,196,1460,15373,89.23,1.27,9.5,2019
"1330507",6493,216,1248,7957,81.6,2.71,15.68,2019
"1330511",845,20,414,1279,66.07,1.56,32.37,2019
"1330171",899,51,244,1194,75.29,4.27,20.44,2019
"1330234",416,108,205,729,57.06,14.81,28.12,2019
"1330240",8260,325,2128,10713,77.1,3.03,19.86,2019
"1330265",11822,322,666,12810,92.29,2.51,5.2,2019
"1330276",4811,111,627,5549,86.7,2,11.3,2019
"1330307",8219,326,482,9027,91.05,3.61,5.34,2019
"1232511",0,0,0,0,NA,NA,NA,2019
"1232530",7,0,0,7,100,0,0,2019
"1232550",3129,286,213,3628,86.25,7.88,5.87,2019
"1232563",9341,241,626,10208,91.51,2.36,6.13,2019
"1232612",0,5,0,5,0,100,0,2019
"1232631",102,0,0,102,100,0,0,2019
"1232814",3485,34,23,3542,98.39,0.96,0.65,2019
"1232830",6,0,0,6,100,0,0,2019
"1232405",10765,271,1810,12846,83.8,2.11,14.09,2019
"1232131",1089,31,533,1653,65.88,1.88,32.24,2019
"1232822",18307,572,3444,22323,82.01,2.56,15.43,2019
"1232909",9413,177,1027,10617,88.66,1.67,9.67,2019
"1232616",313,7,58,378,82.8,1.85,15.34,2019
"1232750",8438,154,670,9262,91.1,1.66,7.23,2019
"1232828",20884,321,955,22160,94.24,1.45,4.31,2019
"1232641",3221,140,1388,4749,67.82,2.95,29.23,2019
"1232464",1361,104,392,1857,73.29,5.6,21.11,2019
"1232667",1356,25,430,1811,74.88,1.38,23.74,2019
"1232765",20173,390,1258,21821,92.45,1.79,5.77,2019
"1232824",11853,166,875,12894,91.93,1.29,6.79,2019
"1232962",7207,259,1555,9021,79.89,2.87,17.24,2019
"1232356",0,0,0,0,NA,NA,NA,2019
"1232266",2782,41,225,3048,91.27,1.35,7.38,2019
"1232065",12023,129,433,12585,95.53,1.03,3.44,2019
"1232580",1295,99,139,1533,84.47,6.46,9.07,2019
"1232668",1592,34,405,2031,78.39,1.67,19.94,2019
"1232703",14480,703,3076,18259,79.3,3.85,16.85,2019
"1232060",6359,252,1245,7856,80.94,3.21,15.85,2019
"1232094",682,21,255,958,71.19,2.19,26.62,2019
"1232139",294,24,112,430,68.37,5.58,26.05,2019
"1232145",1265,226,460,1951,64.84,11.58,23.58,2019
"1232148",3182,182,848,4212,75.55,4.32,20.13,2019
"1232169",4660,224,531,5415,86.06,4.14,9.81,2019
"1232180",1090,15,310,1415,77.03,1.06,21.91,2019
"1232187",532,0,192,724,73.48,0,26.52,2019
"1232190",254,7,161,422,60.19,1.66,38.15,2019
"1232217",7392,184,1095,8671,85.25,2.12,12.63,2019
"1232219",3182,445,708,4335,73.4,10.27,16.33,2019
"1232257",13288,636,1617,15541,85.5,4.09,10.4,2019
"1232258",12066,244,492,12802,94.25,1.91,3.84,2019
"1232259",16027,119,373,16519,97.02,0.72,2.26,2019
"1232310",4281,283,1057,5621,76.16,5.03,18.8,2019
"1232311",7922,97,382,8401,94.3,1.15,4.55,2019
"1232331",896,78,619,1593,56.25,4.9,38.86,2019
"1232336",333,33,96,462,72.08,7.14,20.78,2019
"1232355",87,0,37,124,70.16,0,29.84,2019
"1232403",623,9,9,641,97.19,1.4,1.4,2019
"1232113",1137,20,648,1805,62.99,1.11,35.9,2019
"1232034",14035,498,1174,15707,89.36,3.17,7.47,2019
"1232055",4519,178,1263,5960,75.82,2.99,21.19,2019
"1232061",107,0,15,122,87.7,0,12.3,2019
"1232066",1365,8,397,1770,77.12,0.45,22.43,2019
"1232071",1233,0,126,1359,90.73,0,9.27,2019
"1232079",207,6,20,233,88.84,2.58,8.58,2019
"1232110",1763,413,837,3013,58.51,13.71,27.78,2019
"1232119",7957,275,1809,10041,79.25,2.74,18.02,2019
"1232124",1638,38,105,1781,91.97,2.13,5.9,2019
"1232159",12719,622,1977,15318,83.03,4.06,12.91,2019
"1232208",8567,834,2933,12334,69.46,6.76,23.78,2019
"0135235",6940,216,983,8139,85.27,2.65,12.08,2019
"0135444",1105,37,286,1428,77.38,2.59,20.03,2019
"0135461",640,7,248,895,71.51,0.78,27.71,2019
"0135473",5524,160,536,6220,88.81,2.57,8.62,2019
"0135490",1051,62,159,1272,82.63,4.87,12.5,2019
"0135501",2884,118,778,3780,76.3,3.12,20.58,2019
"0135540",873,72,178,1123,77.74,6.41,15.85,2019
"0135541",1057,34,423,1514,69.82,2.25,27.94,2019
"0135542",307,6,104,417,73.62,1.44,24.94,2019
"0135544",153,0,99,252,60.71,0,39.29,2019
"0135564",536,41,317,894,59.96,4.59,35.46,2019
"0135601",8623,796,2871,12290,70.16,6.48,23.36,2019
"0135610",513,13,277,803,63.89,1.62,34.5,2019
"0135619",1238,59,550,1847,67.03,3.19,29.78,2019
"0135646",984,186,658,1828,53.83,10.18,36,2019
"0135654",1770,91,917,2778,63.71,3.28,33.01,2019
"0135672",1474,172,565,2211,66.67,7.78,25.55,2019
"0135744",302,30,405,737,40.98,4.07,54.95,2019
"0135761",4109,115,610,4834,85,2.38,12.62,2019
"0135763",6415,155,297,6867,93.42,2.26,4.33,2019
"0135765",1016,96,294,1406,72.26,6.83,20.91,2019
"0135768",3453,102,928,4483,77.02,2.28,20.7,2019
"0135769",3011,114,916,4041,74.51,2.82,22.67,2019
"0135776",1135,27,288,1450,78.28,1.86,19.86,2019
"0135905",1853,107,389,2349,78.88,4.56,16.56,2019
"0135907",2903,61,281,3245,89.46,1.88,8.66,2019
"0135960",2953,91,1232,4276,69.06,2.13,28.81,2019
"0135131",1123,7,373,1503,74.72,0.47,24.82,2019
"0135463",632,14,115,761,83.05,1.84,15.11,2019
"0135469",73,0,15,88,82.95,0,17.05,2019
"0135503",2732,88,679,3499,78.08,2.52,19.41,2019
"0135553",1040,90,594,1724,60.32,5.22,34.45,2019
"0135565",3300,250,1564,5114,64.53,4.89,30.58,2019
"0135574",435,15,231,681,63.88,2.2,33.92,2019
"0135578",1382,25,886,2293,60.27,1.09,38.64,2019
"0135584",68,14,55,137,49.64,10.22,40.15,2019
"0135618",410,91,351,852,48.12,10.68,41.2,2019
"0135647",261,0,107,368,70.92,0,29.08,2019
"0135649",29,0,1,30,96.67,0,3.33,2019
"0135652",2311,169,999,3479,66.43,4.86,28.72,2019
"0135670",1765,139,623,2527,69.85,5.5,24.65,2019
"0135741",1265,0,85,1350,93.7,0,6.3,2019
"0135752",706,20,293,1019,69.28,1.96,28.75,2019
"0135759",2822,14,253,3089,91.36,0.45,8.19,2019
"0135766",67,0,0,67,100,0,0,2019
"0135801",8834,245,941,10020,88.16,2.45,9.39,2019
"0135810",8793,373,2331,11497,76.48,3.24,20.27,2019
"0135816",4887,499,1236,6622,73.8,7.54,18.67,2019
"0135952",1900,61,915,2876,66.06,2.12,31.82,2019
"0135962",2241,64,778,3083,72.69,2.08,25.24,2019
"0135974",499,1,208,708,70.48,0.14,29.38,2019
"0135976",5481,158,1243,6882,79.64,2.3,18.06,2019
"0135990",10,7,6,23,43.48,30.43,26.09,2019
"0135068",2915,16,448,3379,86.27,0.47,13.26,2019
"0135645",4117,184,922,5223,78.82,3.52,17.65,2019
"0135745",52,6,23,81,64.2,7.41,28.4,2019
"0135774",55,0,12,67,82.09,0,17.91,2019
"0135984",558,40,158,756,73.81,5.29,20.9,2019
"0135978",1390,116,381,1887,73.66,6.15,20.19,2019
"2838764",66,0,74,140,47.14,0,52.86,2019
"2838772",0,0,21,21,0,0,100,2019
"2838773",678,49,623,1350,50.22,3.63,46.15,2019
"2838828",836,57,594,1487,56.22,3.83,39.95,2019
"2838838",266,0,220,486,54.73,0,45.27,2019
"2838846",674,24,201,899,74.97,2.67,22.36,2019
"2838851",1948,120,1068,3136,62.12,3.83,34.06,2019
"2838860",1325,93,814,2232,59.36,4.17,36.47,2019
"2838862",674,48,324,1046,64.44,4.59,30.98,2019
"2838913",120,0,54,174,68.97,0,31.03,2019
"4738006",1379,76,434,1889,73,4.02,22.98,2019
"4738012",3588,166,1794,5548,64.67,2.99,32.34,2019
"4738034",719,51,321,1091,65.9,4.67,29.42,2019
"4738037",376,29,185,590,63.73,4.92,31.36,2019
"4738040",1450,42,473,1965,73.79,2.14,24.07,2019
"4738047",15,0,11,26,57.69,0,42.31,2019
"4738052",1245,16,445,1706,72.98,0.94,26.08,2019
"4738066",852,56,222,1130,75.4,4.96,19.65,2019
"4738080",794,31,252,1077,73.72,2.88,23.4,2019
"4738103",5968,210,1457,7635,78.17,2.75,19.08,2019
"4738105",1438,343,1351,3132,45.91,10.95,43.14,2019
"4738569",21,0,16,37,56.76,0,43.24,2019
"4738582",502,5,124,631,79.56,0.79,19.65,2019
"2838614",4252,104,2261,6617,64.26,1.57,34.17,2019
"2838617",145,9,108,262,55.34,3.44,41.22,2019
"2838626",226,80,207,513,44.05,15.59,40.35,2019
"2838671",11780,356,1923,14059,83.79,2.53,13.68,2019
"2838683",1303,179,459,1941,67.13,9.22,23.65,2019
"2838740",61,0,37,98,62.24,0,37.76,2019
"2838685",133,31,232,396,33.59,7.83,58.59,2019
"2838721",247,19,151,417,59.23,4.56,36.21,2019
"2838736",96,0,60,156,61.54,0,38.46,2019
"2838751",2257,138,1408,3803,59.35,3.63,37.02,2019
"2838759",236,5,128,369,63.96,1.36,34.69,2019
"2838771",685,0,411,1096,62.5,0,37.5,2019
"2838843",3125,193,926,4244,73.63,4.55,21.82,2019
"2838852",2457,216,988,3661,67.11,5.9,26.99,2019
"2838863",4441,528,1993,6962,63.79,7.58,28.63,2019
"2838864",503,6,153,662,75.98,0.91,23.11,2019
"2838879",172,31,114,317,54.26,9.78,35.96,2019
"2838917",650,64,355,1069,60.8,5.99,33.21,2019
"2838921",973,58,529,1560,62.37,3.72,33.91,2019
"2838946",16,0,62,78,20.51,0,79.49,2019
"2838954",123,10,213,346,35.55,2.89,61.56,2019
"2838774",382,18,300,700,54.57,2.57,42.86,2019
"2838801",8560,603,2299,11462,74.68,5.26,20.06,2019
"2838834",8104,444,3036,11584,69.96,3.83,26.21,2019
"2838855",1274,53,374,1701,74.9,3.12,21.99,2019
"2838865",1229,45,371,1645,74.71,2.74,22.55,2019
"2838869",95,14,75,184,51.63,7.61,40.76,2019
"2838878",749,60,333,1142,65.59,5.25,29.16,2019
"4738001",1241,63,497,1801,68.91,3.5,27.6,2019
"4738004",3062,165,299,3526,86.84,4.68,8.48,2019
"4738008",2335,82,1174,3591,65.02,2.28,32.69,2019
"4738018",12675,243,755,13673,92.7,1.78,5.52,2019
"4738028",2246,39,293,2578,87.12,1.51,11.37,2019
"4738039",367,0,238,605,60.66,0,39.34,2019
"4738041",697,10,317,1024,68.07,0.98,30.96,2019
"4738053",7237,647,1877,9761,74.14,6.63,19.23,2019
"2141739",42,0,7,49,85.71,0,14.29,2019
"2141754",103,0,0,103,100,0,0,2019
"2141764",215,23,53,291,73.88,7.9,18.21,2019
"2141766",66,0,23,89,74.16,0,25.84,2019
"2141819",139,12,14,165,84.24,7.27,8.48,2019
"2141849",31,0,12,43,72.09,0,27.91,2019
"2141855",248,0,63,311,79.74,0,20.26,2019
"2141537",1565,44,365,1974,79.28,2.23,18.49,2019
"2141553",596,15,153,764,78.01,1.96,20.03,2019
"2141555",131,7,134,272,48.16,2.57,49.26,2019
"2141557",551,0,214,765,72.03,0,27.97,2019
"2141571",201,0,85,286,70.28,0,29.72,2019
"2141605",155,0,26,181,85.64,0,14.36,2019
"2141635",813,0,414,1227,66.26,0,33.74,2019
"2141640",287,40,140,467,61.46,8.57,29.98,2019
"2141735",38,0,33,71,53.52,0,46.48,2019
"2141749",823,90,231,1144,71.94,7.87,20.19,2019
"2141825",181,0,69,250,72.4,0,27.6,2019
"2141831",269,13,115,397,67.76,3.27,28.97,2019
"2141847",160,0,87,247,64.78,0,35.22,2019
"2141859",104,25,38,167,62.28,14.97,22.75,2019
"2141080",645,12,55,712,90.59,1.69,7.72,2019
"2141098",454,41,205,700,64.86,5.86,29.29,2019
"2141101",5915,193,1215,7323,80.77,2.64,16.59,2019
"2141121",462,64,124,650,71.08,9.85,19.08,2019
"2141001",5363,152,706,6221,86.21,2.44,11.35,2019
"2141016",1933,135,321,2389,80.91,5.65,13.44,2019
"2141042",18129,644,1905,20678,87.67,3.11,9.21,2019
"2141044",290,5,89,384,75.52,1.3,23.18,2019
"2141046",339,17,96,452,75,3.76,21.24,2019
"2141064",358,23,350,731,48.97,3.15,47.88,2019
"2141124",199,19,150,368,54.08,5.16,40.76,2019
"2141144",2860,103,758,3721,76.86,2.77,20.37,2019
"2141159",96,20,130,246,39.02,8.13,52.85,2019
"2141231",280,4,131,415,67.47,0.96,31.57,2019
"2141301",1485,31,992,2508,59.21,1.24,39.55,2019
"2141339",2895,161,1256,4312,67.14,3.73,29.13,2019
"2141385",108,0,63,171,63.16,0,36.84,2019
"2141390",0,0,12,12,0,0,100,2019
"2141421",121,0,90,211,57.35,0,42.65,2019
"2141464",167,25,63,255,65.49,9.8,24.71,2019
"2141503",194,0,85,279,69.53,0,30.47,2019
"2141519",338,37,143,518,65.25,7.14,27.61,2019
"2141534",75,10,27,112,66.96,8.93,24.11,2019
"2141543",94,0,0,94,100,0,0,2019
"2141562",704,73,356,1133,62.14,6.44,31.42,2019
"2141604",192,0,43,235,81.7,0,18.3,2019
"2141645",293,36,103,432,67.82,8.33,23.84,2019
"2141166",347,11,113,471,73.67,2.34,23.99,2019
"2141201",39,0,11,50,78,0,22,2019
"2141214",81,0,111,192,42.19,0,57.81,2019
"2141238",191,11,44,246,77.64,4.47,17.89,2019
"2141240",1969,50,411,2430,81.03,2.06,16.91,2019
"2141263",133,0,31,164,81.1,0,18.9,2019
"2141265",339,15,178,532,63.72,2.82,33.46,2019
"2141397",4,0,0,4,100,0,0,2019
"2141701",4904,121,1507,6532,75.08,1.85,23.07,2019
"2141714",90,11,56,157,57.32,7.01,35.67,2019
"2141751",115,0,0,115,100,0,0,2019
"1330310",7954,817,2585,11356,70.04,7.19,22.76,2019
"1330336",57,74,0,131,43.51,56.49,0,2019
"1330337",3806,508,1167,5481,69.44,9.27,21.29,2019
"1330339",12256,133,372,12761,96.04,1.04,2.92,2019
"1330401",3605,116,1408,5129,70.29,2.26,27.45,2019
"1330452",508,0,117,625,81.28,0,18.72,2019
"1330455",184,8,33,225,81.78,3.56,14.67,2019
"1330457",1344,52,773,2169,61.96,2.4,35.64,2019
"1330467",3160,112,1198,4470,70.69,2.51,26.8,2019
"1330504",7492,76,941,8509,88.05,0.89,11.06,2019
"1330510",1624,72,571,2267,71.64,3.18,25.19,2019
"1330516",552,2,320,874,63.16,0.23,36.61,2019
"1330525",2362,62,788,3212,73.54,1.93,24.53,2019
"1330541",500,25,73,598,83.61,4.18,12.21,2019
"1330547",765,109,277,1151,66.46,9.47,24.07,2019
"1330555",705,30,229,964,73.13,3.11,23.76,2019
"1330746",267,32,166,465,57.42,6.88,35.7,2019
"1330683",2132,47,534,2713,78.58,1.73,19.68,2019
"1330725",1329,62,166,1557,85.36,3.98,10.66,2019
"1330728",5641,216,1725,7582,74.4,2.85,22.75,2019
"1330747",3894,131,1720,5745,67.78,2.28,29.94,2019
"1330752",2582,148,787,3517,73.41,4.21,22.38,2019
"1330906",15397,911,3280,19588,78.6,4.65,16.74,2019
"1330030",10281,491,1392,12164,84.52,4.04,11.44,2019
"1330034",13955,522,2584,17061,81.79,3.06,15.15,2019
"1330039",13711,257,1015,14983,91.51,1.72,6.77,2019
"1330044",24024,420,2544,26988,89.02,1.56,9.43,2019
"1330412",15,0,14,29,51.72,0,48.28,2019
"1330417",2890,182,999,4071,70.99,4.47,24.54,2019
"1330425",436,18,145,599,72.79,3.01,24.21,2019
"1330241",6162,294,2313,8769,70.27,3.35,26.38,2019
"1330250",0,0,0,0,NA,NA,NA,2019
"1330259",989,81,121,1191,83.04,6.8,10.16,2019
"1330260",6310,406,1275,7991,78.96,5.08,15.96,2019
"1330315",7893,1043,3628,12564,62.82,8.3,28.88,2019
"1330360",4443,225,618,5286,84.05,4.26,11.69,2019
"1330439",2559,141,1303,4003,63.93,3.52,32.55,2019
"1330458",12056,972,2845,15873,75.95,6.12,17.92,2019
"1330464",19,0,9,28,67.86,0,32.14,2019
"1330517",4808,85,320,5213,92.23,1.63,6.14,2019
"1330533",7856,189,1589,9634,81.54,1.96,16.49,2019
"1330542",11645,115,689,12449,93.54,0.92,5.53,2019
"1330553",2558,68,700,3326,76.91,2.04,21.05,2019
"1330557",1544,93,363,2000,77.2,4.65,18.15,2019
"1330564",1278,26,161,1465,87.24,1.77,10.99,2019
"1330566",2328,23,304,2655,87.68,0.87,11.45,2019
"1330607",3145,53,459,3657,86,1.45,12.55,2019
"1330601",7168,277,2192,9637,74.38,2.87,22.75,2019
"1330605",14524,780,1345,16649,87.24,4.68,8.08,2019
"1330631",303,31,250,584,51.88,5.31,42.81,2019
"1330075",18393,403,759,19555,94.06,2.06,3.88,2019
"1330116",7596,118,1097,8811,86.21,1.34,12.45,2019
"1330143",7814,211,924,8949,87.32,2.36,10.33,2019
"1330144",18877,279,1412,20568,91.78,1.36,6.87,2019
"1330170",874,29,251,1154,75.74,2.51,21.75,2019
"1330224",7290,696,1791,9777,74.56,7.12,18.32,2019
"1330230",2336,41,1043,3420,68.3,1.2,30.5,2019
"1330275",21,0,0,21,100,0,0,2019
"1330277",7340,226,544,8110,90.51,2.79,6.71,2019
"1232209",8032,1282,3853,13167,61,9.74,29.26,2019
"1232176",5845,251,988,7084,82.51,3.54,13.95,2019
"1232177",7491,438,2460,10389,72.11,4.22,23.68,2019
"1232210",18889,574,4180,23643,79.89,2.43,17.68,2019
"1232250",11247,213,920,12380,90.85,1.72,7.43,2019
"1232277",10447,182,1455,12084,86.45,1.51,12.04,2019
"1232320",1220,62,237,1519,80.32,4.08,15.6,2019
"1232346",708,16,200,924,76.62,1.73,21.65,2019
"1232351",3258,232,2755,6245,52.17,3.71,44.12,2019
"1232025",6085,383,1288,7756,78.46,4.94,16.61,2019
"1232046",2727,56,627,3410,79.97,1.64,18.39,2019
"1232054",2422,118,964,3504,69.12,3.37,27.51,2019
"1232068",17985,377,1308,19670,91.43,1.92,6.65,2019
"1232179",2534,109,611,3254,77.87,3.35,18.78,2019
"1232181",701,64,232,997,70.31,6.42,23.27,2019
"1232207",11254,506,2839,14599,77.09,3.47,19.45,2019
"1232220",3920,145,638,4703,83.35,3.08,13.57,2019
"1232233",8405,313,937,9655,87.05,3.24,9.7,2019
"1232246",18203,419,1696,20318,89.59,2.06,8.35,2019
"1232301",11421,329,1063,12813,89.14,2.57,8.3,2019
"1232321",1063,64,503,1630,65.21,3.93,30.86,2019
"1232324",887,78,792,1757,50.48,4.44,45.08,2019
"1232328",1125,42,256,1423,79.06,2.95,17.99,2019
"1232330",90,3,136,229,39.3,1.31,59.39,2019
"1232332",224,12,237,473,47.36,2.54,50.11,2019
"1232334",598,33,198,829,72.14,3.98,23.88,2019
"1232428",4527,130,1215,5872,77.09,2.21,20.69,2019
"1232430",320,12,108,440,72.73,2.73,24.55,2019
"1232432",0,0,0,0,NA,NA,NA,2019
"1232439",3430,63,502,3995,85.86,1.58,12.57,2019
"1232442",956,5,525,1486,64.33,0.34,35.33,2019
"1232443",1004,8,217,1229,81.69,0.65,17.66,2019
"1232447",0,0,0,0,NA,NA,NA,2019
"1232465",1704,22,873,2599,65.56,0.85,33.59,2019
"1232536",7348,273,845,8466,86.79,3.22,9.98,2019
"1232548",7848,622,1173,9643,81.39,6.45,12.16,2019
"1232569",4310,232,331,4873,88.45,4.76,6.79,2019
"1232312",11890,185,469,12544,94.79,1.47,3.74,2019
"1232577",1382,76,304,1762,78.43,4.31,17.25,2019
"1232578",11219,415,750,12384,90.59,3.35,6.06,2019
"1232603",1407,272,53,1732,81.24,15.7,3.06,2019
"1232619",1338,57,584,1979,67.61,2.88,29.51,2019
"1232648",144,4,21,169,85.21,2.37,12.43,2019
"1232681",16,0,0,16,100,0,0,2019
"1232708",16024,267,1406,17697,90.55,1.51,7.94,2019
"1232724",12085,411,2215,14711,82.15,2.79,15.06,2019
"1232735",1866,43,197,2106,88.6,2.04,9.35,2019
"1232764",960,18,173,1151,83.41,1.56,15.03,2019
"1232778",7780,380,1401,9561,81.37,3.97,14.65,2019
"1232963",6820,95,361,7276,93.73,1.31,4.96,2019
"1232970",16,0,94,110,14.55,0,85.45,2019
"1232350",451,25,153,629,71.7,3.97,24.32,2019
"1232404",11972,359,1932,14263,83.94,2.52,13.55,2019
"1232420",621,18,257,896,69.31,2.01,28.68,2019
"1232424",1336,64,777,2177,61.37,2.94,35.69,2019
"1232455",1137,35,469,1641,69.29,2.13,28.58,2019
"1232534",5612,134,691,6437,87.18,2.08,10.73,2019
"1232462",1101,43,279,1423,77.37,3.02,19.61,2019
"1232466",1658,101,181,1940,85.46,5.21,9.33,2019
"0135634",3169,83,682,3934,80.55,2.11,17.34,2019
"0135906",3324,216,377,3917,84.86,5.51,9.62,2019
"0135983",1154,54,218,1426,80.93,3.79,15.29,2019
"0135013",0,0,17,17,0,0,100,2019
"0135032",11,0,4,15,73.33,0,26.67,2019
"0135187",3,0,0,3,100,0,0,2019
"0135229",0,0,0,0,NA,NA,NA,2019
"0135254",65,0,90,155,41.94,0,58.06,2019
"0135577",13,0,0,13,100,0,0,2019
"0135615",0,0,17,17,0,0,100,2019
"0135896",0,0,0,0,NA,NA,NA,2019
"0135033",898,32,200,1130,79.47,2.83,17.7,2019
"0135244",11639,143,479,12261,94.93,1.17,3.91,2019
"0135548",431,23,240,694,62.1,3.31,34.58,2019
"0135747",1701,29,346,2076,81.94,1.4,16.67,2019
"0135959",1378,147,403,1928,71.47,7.62,20.9,2019
"0135184",1087,120,434,1641,66.24,7.31,26.45,2019
"0135205",7410,697,1690,9797,75.64,7.11,17.25,2019
"0135208",3875,228,1336,5439,71.24,4.19,24.56,2019
"0135212",3069,227,1470,4766,64.39,4.76,30.84,2019
"0135222",3366,179,602,4147,81.17,4.32,14.52,2019
"0135234",987,103,815,1905,51.81,5.41,42.78,2019
"0135007",8206,247,839,9292,88.31,2.66,9.03,2019
"0135016",5089,267,1140,6496,78.34,4.11,17.55,2019
"0135006",689,21,308,1018,67.68,2.06,30.26,2019
"0135014",1180,129,346,1655,71.3,7.79,20.91,2019
"0135019",590,19,298,907,65.05,2.09,32.86,2019
"0135023",6788,149,1420,8357,81.23,1.78,16.99,2019
"0135040",5347,91,747,6185,86.45,1.47,12.08,2019
"0135054",1277,59,595,1931,66.13,3.06,30.81,2019
"0135057",3823,55,1099,4977,76.81,1.11,22.08,2019
"0135070",80,0,23,103,77.67,0,22.33,2019
"0135079",2402,78,578,3058,78.55,2.55,18.9,2019
"0135098",273,9,146,428,63.79,2.1,34.11,2019
"0135143",1030,30,139,1199,85.9,2.5,11.59,2019
"0135146",2843,147,350,3340,85.12,4.4,10.48,2019
"0135204",2423,223,1675,4321,56.07,5.16,38.76,2019
"0135207",1942,236,1366,3544,54.8,6.66,38.54,2019
"0135217",3224,221,1487,4932,65.37,4.48,30.15,2019
"0135404",5895,547,1315,7757,76,7.05,16.95,2019
"0135405",14041,525,2396,16962,82.78,3.1,14.13,2019
"0135406",6450,72,383,6905,93.41,1.04,5.55,2019
"0135443",274,0,260,534,51.31,0,48.69,2019
"0135464",181,12,113,306,59.15,3.92,36.93,2019
"0135474",1731,80,465,2276,76.05,3.51,20.43,2019
"0135545",15,0,35,50,30,0,70,2019
"0135546",1023,39,403,1465,69.83,2.66,27.51,2019
"0135572",317,0,191,508,62.4,0,37.6,2019
"0135575",313,5,113,431,72.62,1.16,26.22,2019
"0135580",878,51,414,1343,65.38,3.8,30.83,2019
"0135586",1033,58,615,1706,60.55,3.4,36.05,2019
"0135592",1303,35,572,1910,68.22,1.83,29.95,2019
"0135593",348,15,229,592,58.78,2.53,38.68,2019
"0135603",10652,583,2038,13273,80.25,4.39,15.35,2019
"0135616",1027,46,562,1635,62.81,2.81,34.37,2019
"0135630",10325,1204,3417,14946,69.08,8.06,22.86,2019
"0135674",5179,242,1884,7305,70.9,3.31,25.79,2019
"0135748",2211,111,416,2738,80.75,4.05,15.19,2019
"0135757",5631,119,271,6021,93.52,1.98,4.5,2019
"4738061",216,8,48,272,79.41,2.94,17.65,2019
"4738067",339,2,204,545,62.2,0.37,37.43,2019
"4738125",12945,139,792,13876,93.29,1,5.71,2019
"4738134",13093,351,2036,15480,84.58,2.27,13.15,2019
"4738135",9413,205,972,10590,88.89,1.94,9.18,2019
"4738220",479,30,254,763,62.78,3.93,33.29,2019
"4738221",843,56,487,1386,60.82,4.04,35.14,2019
"4738224",194,6,99,299,64.88,2.01,33.11,2019
"4738240",754,24,205,983,76.7,2.44,20.85,2019
"4738253",343,5,61,409,83.86,1.22,14.91,2019
"4738256",1134,6,382,1522,74.51,0.39,25.1,2019
"4738257",1399,47,444,1890,74.02,2.49,23.49,2019
"4738259",188,2,74,264,71.21,0.76,28.03,2019
"4738315",1022,28,295,1345,75.99,2.08,21.93,2019
"4738317",560,45,309,914,61.27,4.92,33.81,2019
"4738327",140,10,53,203,68.97,4.93,26.11,2019
"4738343",4584,184,1657,6425,71.35,2.86,25.79,2019
"4738361",272,27,92,391,69.57,6.91,23.53,2019
"4738369",464,3,188,655,70.84,0.46,28.7,2019
"4738375",2544,24,897,3465,73.42,0.69,25.89,2019
"4738380",151,19,67,237,63.71,8.02,28.27,2019
"4738111",11540,726,4976,17242,66.93,4.21,28.86,2019
"4738119",9014,176,997,10187,88.49,1.73,9.79,2019
"4738122",6020,351,2449,8820,68.25,3.98,27.77,2019
"4738201",2874,51,1127,4052,70.93,1.26,27.81,2019
"4738225",1547,50,701,2298,67.32,2.18,30.5,2019
"4738475",156,17,33,206,75.73,8.25,16.02,2019
"4738453",84,0,28,112,75,0,25,2019
"4738457",155,14,63,232,66.81,6.03,27.16,2019
"4738474",2187,198,684,3069,71.26,6.45,22.29,2019
"4738023",1475,177,276,1928,76.5,9.18,14.32,2019
"2838920",135,0,180,315,42.86,0,57.14,2019
"2838925",728,42,462,1232,59.09,3.41,37.5,2019
"2838951",242,1,183,426,56.81,0.23,42.96,2019
"2838953",107,27,106,240,44.58,11.25,44.17,2019
"2838930",3847,727,3696,8270,46.52,8.79,44.69,2019
"2838943",91,0,14,105,86.67,0,13.33,2019
"2838944",70,0,67,137,51.09,0,48.91,2019
"2838965",2264,59,1222,3545,63.86,1.66,34.47,2019
"2838966",167,0,147,314,53.18,0,46.82,2019
"2839425",532,32,349,913,58.27,3.5,38.23,2019
"2839428",1871,88,1432,3391,55.18,2.6,42.23,2019
"2839437",2451,291,1731,4473,54.8,6.51,38.7,2019
"2839455",2185,133,1112,3430,63.7,3.88,32.42,2019
"2839456",237,0,69,306,77.45,0,22.55,2019
"2839462",277,22,129,428,64.72,5.14,30.14,2019
"2839474",1191,111,939,2241,53.15,4.95,41.9,2019
"2839479",1094,5,1109,2208,49.55,0.23,50.23,2019
"2839482",2867,76,759,3702,77.44,2.05,20.5,2019
"2839503",16474,307,2956,19737,83.47,1.56,14.98,2019
"2839507",5759,128,1333,7220,79.76,1.77,18.46,2019
"2839564",12723,372,1847,14942,85.15,2.49,12.36,2019
"2839574",4221,57,674,4952,85.24,1.15,13.61,2019
"2839645",1336,30,844,2210,60.45,1.36,38.19,2019
"2839576",1826,66,502,2394,76.27,2.76,20.97,2019
"2839601",5520,639,2186,8345,66.15,7.66,26.2,2019
"2839647",216,23,80,319,67.71,7.21,25.08,2019
"4738059",2377,61,560,2998,79.29,2.03,18.68,2019
"2839652",1666,120,1124,2910,57.25,4.12,38.63,2019
"2141760",0,0,5,5,0,0,100,2019
"2141815",248,0,161,409,60.64,0,39.36,2019
"2141822",690,7,261,958,72.03,0.73,27.24,2019
"2141826",202,0,87,289,69.9,0,30.1,2019
"2141840",217,21,78,316,68.67,6.65,24.68,2019
"2141844",329,23,175,527,62.43,4.36,33.21,2019
"2141659",162,0,9,171,94.74,0,5.26,2019
"2141722",320,36,148,504,63.49,7.14,29.37,2019
"2141727",239,0,86,325,73.54,0,26.46,2019
"2141729",0,0,0,0,NA,NA,NA,2019
"2141740",358,0,47,405,88.4,0,11.6,2019
"2141745",115,0,44,159,72.33,0,27.67,2019
"2141759",78,0,23,101,77.23,0,22.77,2019
"2141762",0,0,0,0,NA,NA,NA,2019
"2141772",95,0,19,114,83.33,0,16.67,2019
"2141774",759,16,235,1010,75.15,1.58,23.27,2019
"2141775",0,22,0,22,0,100,0,2019
"2141834",90,0,54,144,62.5,0,37.5,2019
"2141837",251,64,118,433,57.97,14.78,27.25,2019
"2141858",2568,161,664,3393,75.69,4.75,19.57,2019
"2141721",103,7,138,248,41.53,2.82,55.65,2019
"2141725",45,0,0,45,100,0,0,2019
"2141731",322,10,117,449,71.71,2.23,26.06,2019
"2141746",105,10,100,215,48.84,4.65,46.51,2019
"2141773",334,8,250,592,56.42,1.35,42.23,2019
"2141835",246,40,75,361,68.14,11.08,20.78,2019
"2141838",140,0,106,246,56.91,0,43.09,2019
"2141862",214,44,144,402,53.23,10.95,35.82,2019
"2141035",2699,371,1125,4195,64.34,8.84,26.82,2019
"2141040",1897,78,799,2774,68.39,2.81,28.8,2019
"2141048",4574,32,304,4910,93.16,0.65,6.19,2019
"2141073",2154,81,283,2518,85.54,3.22,11.24,2019
"2141083",318,7,172,497,63.98,1.41,34.61,2019
"2141085",234,4,94,332,70.48,1.2,28.31,2019
"2141091",6519,106,267,6892,94.59,1.54,3.87,2019
"2141143",3216,296,1504,5016,64.11,5.9,29.98,2019
"2141146",79,0,72,151,52.32,0,47.68,2019
"2141168",688,56,190,934,73.66,6,20.34,2019
"2141169",1894,22,291,2207,85.82,1,13.19,2019
"2141189",606,9,180,795,76.23,1.13,22.64,2019
"2141365",91,13,65,169,53.85,7.69,38.46,2019
"2142129",2037,76,668,2781,73.25,2.73,24.02,2019
"2142134",5161,136,1483,6780,76.12,2.01,21.87,2019
"2142157",100,0,96,196,51.02,0,48.98,2019
"2142207",535,12,43,590,90.68,2.03,7.29,2019
"2142214",243,0,35,278,87.41,0,12.59,2019
"2142215",251,19,170,440,57.05,4.32,38.64,2019
"2142217",872,48,397,1317,66.21,3.64,30.14,2019
"2142275",170,10,101,281,60.5,3.56,35.94,2019
"2142463",29,0,7,36,80.56,0,19.44,2019
"2142724",1257,224,372,1853,67.84,12.09,20.08,2019
"3943160",6894,442,1719,9055,76.13,4.88,18.98,2019
"3943201",11094,420,1119,12633,87.82,3.32,8.86,2019
"3943213",10764,378,2685,13827,77.85,2.73,19.42,2019
"3943220",11038,220,513,11771,93.77,1.87,4.36,2019
"3943321",105,0,12,117,89.74,0,10.26,2019
"3943338",3045,73,629,3747,81.27,1.95,16.79,2019
"3943351",3337,157,762,4256,78.41,3.69,17.9,2019
"3943357",1355,26,216,1597,84.85,1.63,13.53,2019
"1330281",20111,1735,2687,24533,81.98,7.07,10.95,2019
"1330290",2730,39,284,3053,89.42,1.28,9.3,2019
"1330045",11169,311,954,12434,89.83,2.5,7.67,2019
"1330054",3359,96,630,4085,82.23,2.35,15.42,2019
"1330058",17335,660,2790,20785,83.4,3.18,13.42,2019
"1330064",16691,225,1362,18278,91.32,1.23,7.45,2019
"1330067",17919,262,1860,20041,89.41,1.31,9.28,2019
"1330096",22192,563,3070,25825,85.93,2.18,11.89,2019
"1330102",12967,108,1597,14672,88.38,0.74,10.88,2019
"1330108",2272,104,739,3115,72.94,3.34,23.72,2019
"1330135",18706,2131,1575,22412,83.46,9.51,7.03,2019
"1330177",472,9,13,494,95.55,1.82,2.63,2019
"1330213",9903,924,593,11420,86.72,8.09,5.19,2019
"1330222",849,15,703,1567,54.18,0.96,44.86,2019
"1330269",12245,440,1014,13699,89.39,3.21,7.4,2019
"1330286",6017,330,2322,8669,69.41,3.81,26.79,2019
"1330291",5933,839,1454,8226,72.12,10.2,17.68,2019
"1330305",11248,693,765,12706,88.53,5.45,6.02,2019
"1330308",10138,884,595,11617,87.27,7.61,5.12,2019
"1330324",13115,1141,688,14944,87.76,7.64,4.6,2019
"1330331",19329,936,4198,24463,79.01,3.83,17.16,2019
"1330338",14018,102,520,14640,95.75,0.7,3.55,2019
"1330342",11564,645,768,12977,89.11,4.97,5.92,2019
"1330014",11163,525,1701,13389,83.37,3.92,12.7,2019
"1330035",6675,362,1361,8398,79.48,4.31,16.21,2019
"1330056",616,18,166,800,77,2.25,20.75,2019
"1330076",15406,298,1111,16815,91.62,1.77,6.61,2019
"1330084",12234,391,1494,14119,86.65,2.77,10.58,2019
"1330088",8773,336,1209,10318,85.03,3.26,11.72,2019
"1330097",15600,229,540,16369,95.3,1.4,3.3,2019
"1330105",588,48,133,769,76.46,6.24,17.3,2019
"1330120",11917,833,1794,14544,81.94,5.73,12.33,2019
"1330139",1028,171,283,1482,69.37,11.54,19.1,2019
"1330816",622,22,150,794,78.34,2.77,18.89,2019
"1330818",205,17,19,241,85.06,7.05,7.88,2019
"1330830",3679,67,1157,4903,75.04,1.37,23.6,2019
"1330909",12895,424,3468,16787,76.82,2.53,20.66,2019
"1330093",13322,607,4272,18201,73.19,3.33,23.47,2019
"1330021",5428,502,1100,7030,77.21,7.14,15.65,2019
"1330070",99,13,72,184,53.8,7.07,39.13,2019
"1330072",333,3,41,377,88.33,0.8,10.88,2019
"1330126",14012,429,1103,15544,90.14,2.76,7.1,2019
"1330137",523,55,114,692,75.58,7.95,16.47,2019
"1330554",2155,84,633,2872,75.03,2.92,22.04,2019
"1330558",977,82,770,1829,53.42,4.48,42.1,2019
"1330560",1688,13,290,1991,84.78,0.65,14.57,2019
"1330606",15380,723,2286,18389,83.64,3.93,12.43,2019
"1330624",562,15,505,1082,51.94,1.39,46.67,2019
"1330628",1903,87,409,2399,79.32,3.63,17.05,2019
"1330633",2357,137,651,3145,74.94,4.36,20.7,2019
"1330650",3495,147,900,4542,76.95,3.24,19.82,2019
"1330656",4517,99,812,5428,83.22,1.82,14.96,2019
"1330176",2116,39,682,2837,74.59,1.37,24.04,2019
"1330180",10959,825,1223,13007,84.25,6.34,9.4,2019
"1330206",925,6,223,1154,80.16,0.52,19.32,2019
"1330214",9774,220,945,10939,89.35,2.01,8.64,2019
"1330635",3803,238,2013,6054,62.82,3.93,33.25,2019
"1330567",982,2,257,1241,79.13,0.16,20.71,2019
"1330630",502,15,436,953,52.68,1.57,45.75,2019
"1232514",14303,450,1817,16570,86.32,2.72,10.97,2019
"1232567",876,128,285,1289,67.96,9.93,22.11,2019
"1232605",9462,174,612,10248,92.33,1.7,5.97,2019
"1232607",10620,381,801,11802,89.98,3.23,6.79,2019
"1232622",365,5,52,422,86.49,1.18,12.32,2019
"1232658",72,0,26,98,73.47,0,26.53,2019
"1232696",3274,159,1187,4620,70.87,3.44,25.69,2019
"1232702",870,23,267,1160,75,1.98,23.02,2019
"1232726",7111,271,1107,8489,83.77,3.19,13.04,2019
"1232730",2269,60,310,2639,85.98,2.27,11.75,2019
"1232736",3320,76,253,3649,90.98,2.08,6.93,2019
"1232757",9499,541,1329,11369,83.55,4.76,11.69,2019
"1232759",963,62,193,1218,79.06,5.09,15.85,2019
"1232779",10277,161,524,10962,93.75,1.47,4.78,2019
"1232792",18811,358,1632,20801,90.43,1.72,7.85,2019
"1232829",5903,84,126,6113,96.56,1.37,2.06,2019
"1232903",5505,49,461,6015,91.52,0.81,7.66,2019
"1232904",10433,245,1260,11938,87.39,2.05,10.55,2019
"1232907",13548,231,1055,14834,91.33,1.56,7.11,2019
"1232966",6286,194,1475,7955,79.02,2.44,18.54,2019
"1232958",9889,333,1271,11493,86.04,2.9,11.06,2019
"1232960",6789,206,1662,8657,78.42,2.38,19.2,2019
"1232221",8816,313,1145,10274,85.81,3.05,11.14,2019
"1232225",18588,317,1305,20210,91.97,1.57,6.46,2019
"1232234",1739,71,443,2253,77.19,3.15,19.66,2019
"1232244",18988,833,1683,21504,88.3,3.87,7.83,2019
"1232254",3250,328,1185,4763,68.23,6.89,24.88,2019
"1232937",10188,203,697,11088,91.88,1.83,6.29,2019
"1232807",9272,293,2155,11720,79.11,2.5,18.39,2019
"1232920",4577,156,639,5372,85.2,2.9,11.9,2019
"1232925",441,19,0,460,95.87,4.13,0,2019
"1232951",4824,154,391,5369,89.85,2.87,7.28,2019
"1232303",18007,630,2043,20680,87.07,3.05,9.88,2019
"1232327",7747,553,1278,9578,80.88,5.77,13.34,2019
"1232343",1041,8,188,1237,84.16,0.65,15.2,2019
"1233009",14570,817,3080,18467,78.9,4.42,16.68,2019
"1233012",17156,461,6779,24396,70.32,1.89,27.79,2019
"1233018",13036,264,1337,14637,89.06,1.8,9.13,2019
"1233312",14924,574,2445,17943,83.17,3.2,13.63,2019
"1233331",7162,124,131,7417,96.56,1.67,1.77,2019
"1233324",17289,566,1182,19037,90.82,2.97,6.21,2019
"1233327",6258,63,180,6501,96.26,0.97,2.77,2019
"1233328",9437,214,500,10151,92.97,2.11,4.93,2019
"1233408",8207,149,762,9118,90.01,1.63,8.36,2019
"1233412",5248,46,96,5390,97.37,0.85,1.78,2019
"1233414",18654,264,831,19749,94.46,1.34,4.21,2019
"1233417",10733,586,3028,14347,74.81,4.08,21.11,2019
"1233433",16331,622,1345,18298,89.25,3.4,7.35,2019
"1233436",14647,543,2143,17333,84.5,3.13,12.36,2019
"1233444",7086,264,1355,8705,81.4,3.03,15.57,2019
"1233445",11953,663,1461,14077,84.91,4.71,10.38,2019
"1233462",9982,289,2139,12410,80.44,2.33,17.24,2019
"1233463",15779,358,2374,18511,85.24,1.93,12.82,2019
"1233483",5676,156,403,6235,91.03,2.5,6.46,2019
"1233487",8455,305,572,9332,90.6,3.27,6.13,2019
"1233493",222,27,234,483,45.96,5.59,48.45,2019
"1233521",137,4,77,218,62.84,1.83,35.32,2019
"1233525",5925,154,1124,7203,82.26,2.14,15.6,2019
"1233544",9124,265,193,9582,95.22,2.77,2.01,2019
"0135824",3752,29,47,3828,98.01,0.76,1.23,2019
"0135975",156,15,53,224,69.64,6.7,23.66,2019
"0136262",309,8,141,458,67.47,1.75,30.79,2019
"0136279",789,9,230,1028,76.75,0.88,22.37,2019
"0136319",626,26,253,905,69.17,2.87,27.96,2019
"0136320",835,52,479,1366,61.13,3.81,35.07,2019
"0136330",12349,234,1578,14161,87.2,1.65,11.14,2019
"0136401",1579,121,1219,2919,54.09,4.15,41.76,2019
"0136013",200,0,10,210,95.24,0,4.76,2019
"0136037",2880,121,1264,4265,67.53,2.84,29.64,2019
"0136039",46,13,28,87,52.87,14.94,32.18,2019
"0136093",3625,52,228,3905,92.83,1.33,5.84,2019
"0136111",4028,8,873,4909,82.05,0.16,17.78,2019
"0136203",5606,214,1160,6980,80.32,3.07,16.62,2019
"0136250",1691,0,143,1834,92.2,0,7.8,2019
"0136317",100,1,126,227,44.05,0.44,55.51,2019
"0136318",398,8,111,517,76.98,1.55,21.47,2019
"0136866",1125,42,449,1616,69.62,2.6,27.78,2019
"0136877",3957,70,824,4851,81.57,1.44,16.99,2019
"0136901",54,0,127,181,29.83,0,70.17,2019
"0136005",360,10,128,498,72.29,2.01,25.7,2019
"0136010",933,45,646,1624,57.45,2.77,39.78,2019
"0136027",4088,310,1713,6111,66.9,5.07,28.03,2019
"0136028",359,7,221,587,61.16,1.19,37.65,2019
"0136030",85,10,82,177,48.02,5.65,46.33,2019
"0136034",249,7,102,358,69.55,1.96,28.49,2019
"0136042",407,6,219,632,64.4,0.95,34.65,2019
"0136046",381,0,166,547,69.65,0,30.35,2019
"0136054",4983,101,780,5864,84.98,1.72,13.3,2019
"0136089",1569,214,879,2662,58.94,8.04,33.02,2019
"0136104",1816,232,884,2932,61.94,7.91,30.15,2019
"0136105",2205,221,1414,3840,57.42,5.76,36.82,2019
"0136116",14295,426,2328,17049,83.85,2.5,13.65,2019
"0136207",6575,210,1332,8117,81,2.59,16.41,2019
"0136260",979,97,528,1604,61.03,6.05,32.92,2019
"0136263",74,0,108,182,40.66,0,59.34,2019
"0136265",6113,414,1004,7531,81.17,5.5,13.33,2019
"0136267",0,0,7,7,0,0,100,2019
"0136305",5320,97,659,6076,87.56,1.6,10.85,2019
"0136268",1630,67,519,2216,73.56,3.02,23.42,2019
"0136269",351,25,137,513,68.42,4.87,26.71,2019
"4737096",1318,29,839,2186,60.29,1.33,38.38,2019
"4737135",4349,57,70,4476,97.16,1.27,1.56,2019
"4737137",667,13,425,1105,60.36,1.18,38.46,2019
"4737142",420,12,247,679,61.86,1.77,36.38,2019
"4737167",18630,832,1926,21388,87.1,3.89,9.01,2019
"4737171",226,0,45,271,83.39,0,16.61,2019
"4737201",339,158,29,526,64.45,30.04,5.51,2019
"4737213",22,0,0,22,100,0,0,2019
"4737302",1434,38,243,1715,83.62,2.22,14.17,2019
"4737334",6191,536,2546,9273,66.76,5.78,27.46,2019
"4737335",687,64,215,966,71.12,6.63,22.26,2019
"4737601",12246,617,2627,15490,79.06,3.98,16.96,2019
"4737642",4548,187,1449,6184,73.54,3.02,23.43,2019
"4737680",159,0,59,218,72.94,0,27.06,2019
"4737686",2647,214,359,3220,82.2,6.65,11.15,2019
"4737701",2410,60,633,3103,77.67,1.93,20.4,2019
"4737727",416,15,446,877,47.43,1.71,50.86,2019
"4737764",2940,43,694,3677,79.96,1.17,18.87,2019
"2839702",6377,420,1555,8352,76.35,5.03,18.62,2019
"2839736",66,2,30,98,67.35,2.04,30.61,2019
"2839745",134,28,146,308,43.51,9.09,47.4,2019
"2839633",333,23,131,487,68.38,4.72,26.9,2019
"2839641",742,90,598,1430,51.89,6.29,41.82,2019
"2839654",959,208,852,2019,47.5,10.3,42.2,2019
"2839657",462,7,333,802,57.61,0.87,41.52,2019
"2839665",236,64,277,577,40.9,11.09,48.01,2019
"2839668",156,0,170,326,47.85,0,52.15,2019
"2839160",612,51,370,1033,59.24,4.94,35.82,2019
"2839116",515,48,313,876,58.79,5.48,35.73,2019
"2839154",2727,13,550,3290,82.89,0.4,16.72,2019
"2839174",115,0,0,115,100,0,0,2019
"2839176",473,0,494,967,48.91,0,51.09,2019
"2839183",4112,248,1217,5577,73.73,4.45,21.82,2019
"2839218",2192,46,380,2618,83.73,1.76,14.51,2019
"2839326",99,25,50,174,56.9,14.37,28.74,2019
"2839336",224,0,261,485,46.19,0,53.81,2019
"2839365",1853,74,915,2842,65.2,2.6,32.2,2019
"2839401",11575,853,3962,16390,70.62,5.2,24.17,2019
"2839423",783,40,279,1102,71.05,3.63,25.32,2019
"2839452",5994,244,2800,9038,66.32,2.7,30.98,2019
"2839175",1133,30,578,1741,65.08,1.72,33.2,2019
"2839177",50,0,0,50,100,0,0,2019
"2839179",305,43,49,397,76.83,10.83,12.34,2019
"2839443",4968,187,2963,8118,61.2,2.3,36.5,2019
"2839520",6113,243,1786,8142,75.08,2.98,21.94,2019
"2839532",11634,445,1954,14033,82.9,3.17,13.92,2019
"2839577",2408,74,1083,3565,67.55,2.08,30.38,2019
"2839638",758,49,450,1257,60.3,3.9,35.8,2019
"2839653",622,23,266,911,68.28,2.52,29.2,2019
"2839656",93,51,84,228,40.79,22.37,36.84,2019
"2839661",740,34,287,1061,69.75,3.2,27.05,2019
"2839743",434,24,242,700,62,3.43,34.57,2019
"2839746",842,46,316,1204,69.93,3.82,26.25,2019
"2839747",380,14,350,744,51.08,1.88,47.04,2019
"2839762",21,0,0,21,100,0,0,2019
"2839766",933,0,246,1179,79.13,0,20.87,2019
"2839767",326,0,95,421,77.43,0,22.57,2019
"2839776",420,0,195,615,68.29,0,31.71,2019
"2839759",12903,1211,2469,16583,77.81,7.3,14.89,2019
"2839666",2425,32,1389,3846,63.05,0.83,36.12,2019
"2839701",3360,145,1635,5140,65.37,2.82,31.81,2019
"2839662",345,40,121,506,68.18,7.91,23.91,2019
"2839095",1100,193,1181,2474,44.46,7.8,47.74,2019
"2839755",210,7,123,340,61.76,2.06,36.18,2019
"2839038",1270,161,688,2119,59.93,7.6,32.47,2019
"2839074",3364,269,1910,5543,60.69,4.85,34.46,2019
"2839152",199,9,208,416,47.84,2.16,50,2019
"2839090",3416,240,1265,4921,69.42,4.88,25.71,2019
"2839170",2776,120,863,3759,73.85,3.19,22.96,2019
"2839352",278,0,30,308,90.26,0,9.74,2019
"2839475",3927,284,787,4998,78.57,5.68,15.75,2019
"2839059",2142,387,1301,3830,55.93,10.1,33.97,2019
"2839042",11545,292,2176,14013,82.39,2.08,15.53,2019
"2839062",113,29,63,205,55.12,14.15,30.73,2019
"2839069",1218,22,467,1707,71.35,1.29,27.36,2019
"2839071",1523,69,458,2050,74.29,3.37,22.34,2019
"2839094",932,31,475,1438,64.81,2.16,33.03,2019
"3943360",525,45,73,643,81.65,7,11.35,2019
"3943046",1263,49,179,1491,84.71,3.29,12.01,2019
"3943010",79,3,12,94,84.04,3.19,12.77,2019
"3943028",2687,23,329,3039,88.42,0.76,10.83,2019
"3943033",102,4,14,120,85,3.33,11.67,2019
"3943054",10025,65,318,10408,96.32,0.62,3.06,2019
"3943060",847,23,126,996,85.04,2.31,12.65,2019
"3943074",4205,58,498,4761,88.32,1.22,10.46,2019
"3943082",11409,91,448,11948,95.49,0.76,3.75,2019
"3943084",224,15,7,246,91.06,6.1,2.85,2019
"3943103",3547,61,360,3968,89.39,1.54,9.07,2019
"3943106",501,15,106,622,80.55,2.41,17.04,2019
"3943116",493,4,65,562,87.72,0.71,11.57,2019
"3943119",9277,190,648,10115,91.72,1.88,6.41,2019
"3943123",22599,595,1965,25159,89.82,2.36,7.81,2019
"3943140",6426,123,1059,7608,84.46,1.62,13.92,2019
"3943143",1767,52,331,2150,82.19,2.42,15.4,2019
"3943146",2650,51,481,3182,83.28,1.6,15.12,2019
"3943209",10110,229,1404,11743,86.09,1.95,11.96,2019
"3943222",929,127,355,1411,65.84,9,25.16,2019
"3943331",1741,73,361,2175,80.05,3.36,16.6,2019
"3943332",511,3,112,626,81.63,0.48,17.89,2019
"3943006",112,5,77,194,57.73,2.58,39.69,2019
"3943462",324,10,71,405,80,2.47,17.53,2019
"3943465",2076,10,390,2476,83.84,0.4,15.75,2019
"3943004",9583,233,399,10215,93.81,2.28,3.91,2019
"3943009",797,24,47,868,91.82,2.76,5.41,2019
"3943466",703,19,129,851,82.61,2.23,15.16,2019
"3943333",244,30,50,324,75.31,9.26,15.43,2019
"3943334",1759,44,495,2298,76.54,1.91,21.54,2019
"3943336",0,0,0,0,NA,NA,NA,2019
"3943341",336,6,45,387,86.82,1.55,11.63,2019
"3943406",568,17,83,668,85.03,2.54,12.43,2019
"3943410",3232,90,739,4061,79.59,2.22,18.2,2019
"3943420",9638,492,2010,12140,79.39,4.05,16.56,2019
"3943435",372,11,71,454,81.94,2.42,15.64,2019
"3943440",2029,143,348,2520,80.52,5.67,13.81,2019
"3943443",620,10,95,725,85.52,1.38,13.1,2019
"3943445",507,15,17,539,94.06,2.78,3.15,2019
"3943452",5137,354,846,6337,81.06,5.59,13.35,2019
"3943468",105,0,30,135,77.78,0,22.22,2019
"3943515",2692,68,418,3178,84.71,2.14,13.15,2019
"3943518",901,17,110,1028,87.65,1.65,10.7,2019
"3943525",357,6,37,400,89.25,1.5,9.25,2019
"3943532",1294,25,209,1528,84.69,1.64,13.68,2019
"3943565",150,0,12,162,92.59,0,7.41,2019
"3943567",4151,93,756,5000,83.02,1.86,15.12,2019
"3943610",1339,113,353,1805,74.18,6.26,19.56,2019
"3943727",301,29,159,489,61.55,5.93,32.52,2019
"3943725",6393,263,1757,8413,75.99,3.13,20.88,2019
"3943738",52,0,4,56,92.86,0,7.14,2019
"3943747",219,35,103,357,61.34,9.8,28.85,2019
"3943771",555,9,150,714,77.73,1.26,21.01,2019
"3943777",1362,110,380,1852,73.54,5.94,20.52,2019
"3943782",148,2,51,201,73.63,1,25.37,2019
"3943783",1663,35,263,1961,84.8,1.78,13.41,2019
"3943787",912,32,341,1285,70.97,2.49,26.54,2019
"3943802",232,0,96,328,70.73,0,29.27,2019
"3943804",413,16,528,957,43.16,1.67,55.17,2019
"1330642",3935,188,1105,5228,75.27,3.6,21.14,2019
"1330643",4158,222,1430,5810,71.57,3.82,24.61,2019
"1330669",837,75,372,1284,65.19,5.84,28.97,2019
"1330678",396,7,128,531,74.58,1.32,24.11,2019
"1330680",12173,311,2344,14828,82.09,2.1,15.81,2019
"1330705",9562,200,2319,12081,79.15,1.66,19.2,2019
"1330720",7576,117,1593,9286,81.59,1.26,17.15,2019
"1330736",13618,252,1627,15497,87.88,1.63,10.5,2019
"1330813",11226,507,1791,13524,83.01,3.75,13.24,2019
"1330815",11368,594,2201,14163,80.27,4.19,15.54,2019
"1330668",411,11,344,766,53.66,1.44,44.91,2019
"1330673",1435,196,1358,2989,48.01,6.56,45.43,2019
"1330707",4951,170,1202,6323,78.3,2.69,19.01,2019
"1330721",14107,237,3738,18082,78.02,1.31,20.67,2019
"1330726",0,0,0,0,NA,NA,NA,2019
"1330731",762,11,218,991,76.89,1.11,22,2019
"1330518",13820,343,2811,16974,81.42,2.02,16.56,2019
"1330520",1294,50,491,1835,70.52,2.72,26.76,2019
"1330537",517,13,87,617,83.79,2.11,14.1,2019
"1330153",5229,254,993,6476,80.74,3.92,15.33,2019
"1330157",13967,868,1608,16443,84.94,5.28,9.78,2019
"1330165",11968,369,2666,15003,79.77,2.46,17.77,2019
"1330168",7844,252,1086,9182,85.43,2.74,11.83,2019
"1330173",1756,50,244,2050,85.66,2.44,11.9,2019
"1330179",5375,136,770,6281,85.58,2.17,12.26,2019
"1330185",1279,42,188,1509,84.76,2.78,12.46,2019
"1330220",1420,70,406,1896,74.89,3.69,21.41,2019
"1330238",9656,541,1923,12120,79.67,4.46,15.87,2019
"1330453",1985,51,711,2747,72.26,1.86,25.88,2019
"1330454",158,0,98,256,61.72,0,38.28,2019
"1330474",4860,142,1288,6290,77.27,2.26,20.48,2019
"1330521",1150,145,486,1781,64.57,8.14,27.29,2019
"1330523",3731,160,1126,5017,74.37,3.19,22.44,2019
"1330730",500,26,175,701,71.33,3.71,24.96,2019
"1330735",1816,90,483,2389,76.02,3.77,20.22,2019
"1330738",1178,19,392,1589,74.13,1.2,24.67,2019
"1330739",2044,53,207,2304,88.72,2.3,8.98,2019
"1330742",2228,91,668,2987,74.59,3.05,22.36,2019
"1330757",707,11,173,891,79.35,1.23,19.42,2019
"1330802",1309,13,492,1814,72.16,0.72,27.12,2019
"1330809",12879,175,1632,14686,87.7,1.19,11.11,2019
"1330822",185,0,102,287,64.46,0,35.54,2019
"1330821",217,24,135,376,57.71,6.38,35.9,2019
"1330004",21817,588,600,23005,94.84,2.56,2.61,2019
"1330032",12747,654,4030,17431,73.13,3.75,23.12,2019
"1330306",10311,293,282,10886,94.72,2.69,2.59,2019
"1330311",10272,616,3597,14485,70.91,4.25,24.83,2019
"1330314",4870,567,2153,7590,64.16,7.47,28.37,2019
"1330322",0,0,0,0,NA,NA,NA,2019
"1330340",7455,532,1537,9524,78.28,5.59,16.14,2019
"1330346",2786,61,256,3103,89.78,1.97,8.25,2019
"1330349",22601,1123,3286,27010,83.68,4.16,12.17,2019
"1330350",15939,366,801,17106,93.18,2.14,4.68,2019
"1330410",551,14,149,714,77.17,1.96,20.87,2019
"1330420",309,1,165,475,65.05,0.21,34.74,2019
"1330442",1722,104,1182,3008,57.25,3.46,39.3,2019
"1330445",865,36,248,1149,75.28,3.13,21.58,2019
"1330450",516,7,324,847,60.92,0.83,38.25,2019
"1330543",1114,0,243,1357,82.09,0,17.91,2019
"1233514",554,11,152,717,77.27,1.53,21.2,2019
"1233523",4940,225,1447,6612,74.71,3.4,21.88,2019
"1233543",8767,123,497,9387,93.4,1.31,5.29,2019
"1233566",6476,179,714,7369,87.88,2.43,9.69,2019
"1233592",3148,163,669,3980,79.1,4.1,16.81,2019
"1233605",5132,143,1817,7092,72.36,2.02,25.62,2019
"1233610",12595,767,2878,16240,77.56,4.72,17.72,2019
"1233611",13132,416,1302,14850,88.43,2.8,8.77,2019
"1233625",9660,111,603,10374,93.12,1.07,5.81,2019
"1233635",6243,351,517,7111,87.79,4.94,7.27,2019
"1233706",7658,356,522,8536,89.71,4.17,6.12,2019
"1233713",10881,336,1782,12999,83.71,2.58,13.71,2019
"1233715",3285,200,205,3690,89.02,5.42,5.56,2019
"1233756",10608,560,2416,13584,78.09,4.12,17.79,2019
"1233764",10012,319,1456,11787,84.94,2.71,12.35,2019
"1233785",2640,58,180,2878,91.73,2.02,6.25,2019
"1233801",7268,847,3673,11788,61.66,7.19,31.16,2019
"1233809",9101,487,1559,11147,81.65,4.37,13.99,2019
"1233825",7051,193,1866,9110,77.4,2.12,20.48,2019
"1233194",1428,0,0,1428,100,0,0,2019
"1233305",5517,255,541,6313,87.39,4.04,8.57,2019
"1233827",816,21,116,953,85.62,2.2,12.17,2019
"1233850",2397,151,629,3177,75.45,4.75,19.8,2019
"1233872",5891,186,1134,7211,81.69,2.58,15.73,2019
"1233877",36,0,70,106,33.96,0,66.04,2019
"1233133",11286,192,2435,13913,81.12,1.38,17.5,2019
"1233135",10005,363,4255,14623,68.42,2.48,29.1,2019
"1233138",9374,268,2945,12587,74.47,2.13,23.4,2019
"1233140",7262,783,629,8674,83.72,9.03,7.25,2019
"1233157",16006,521,3170,19697,81.26,2.65,16.09,2019
"1233020",16057,556,1965,18578,86.43,2.99,10.58,2019
"1233024",21388,287,1930,23605,90.61,1.22,8.18,2019
"1233036",1348,36,145,1529,88.16,2.35,9.48,2019
"1233040",11429,885,1654,13968,81.82,6.34,11.84,2019
"1233122",94,0,0,94,100,0,0,2019
"1233128",1416,292,1505,3213,44.07,9.09,46.84,2019
"1233143",10799,483,1132,12414,86.99,3.89,9.12,2019
"1233162",9071,543,3479,13093,69.28,4.15,26.57,2019
"1233179",12834,633,2714,16181,79.32,3.91,16.77,2019
"1233186",19345,1094,1000,21439,90.23,5.1,4.66,2019
"1233196",12359,1316,829,14504,85.21,9.07,5.72,2019
"1234292",6403,471,915,7789,82.21,6.05,11.75,2019
"1234420",5477,66,1212,6755,81.08,0.98,17.94,2019
"1234452",4141,105,606,4852,85.35,2.16,12.49,2019
"1234470",6080,123,1518,7721,78.75,1.59,19.66,2019
"1234474",5583,40,1419,7042,79.28,0.57,20.15,2019
"1234482",5982,167,1183,7332,81.59,2.28,16.13,2019
"1234602",2296,94,345,2735,83.95,3.44,12.61,2019
"1234606",10192,268,1289,11749,86.75,2.28,10.97,2019
"1234102",4621,100,877,5598,82.55,1.79,15.67,2019
"1234113",7088,392,1066,8546,82.94,4.59,12.47,2019
"1234119",11983,296,824,13103,91.45,2.26,6.29,2019
"1234208",10201,664,1882,12747,80.03,5.21,14.76,2019
"1234234",7032,137,1615,8784,80.05,1.56,18.39,2019
"1234471",8315,243,1480,10038,82.84,2.42,14.74,2019
"1234475",2946,124,1376,4446,66.26,2.79,30.95,2019
"1234479",4424,29,615,5068,87.29,0.57,12.13,2019
"1234480",5375,275,1176,6826,78.74,4.03,17.23,2019
"1234655",14958,727,1429,17114,87.4,4.25,8.35,2019
"4737772",4431,136,568,5135,86.29,2.65,11.06,2019
"4737801",8263,159,2345,10767,76.74,1.48,21.78,2019
"4737804",7616,194,1561,9371,81.27,2.07,16.66,2019
"4737819",167,13,124,304,54.93,4.28,40.79,2019
"4737871",2763,45,589,3397,81.34,1.32,17.34,2019
"4737873",1307,72,593,1972,66.28,3.65,30.07,2019
"4737874",4280,166,1099,5545,77.19,2.99,19.82,2019
"4737876",9843,598,2291,12732,77.31,4.7,17.99,2019
"4737879",2739,230,1508,4477,61.18,5.14,33.68,2019
"4737880",1001,22,369,1392,71.91,1.58,26.51,2019
"4737881",518,67,266,851,60.87,7.87,31.26,2019
"4737924",4022,95,1002,5119,78.57,1.86,19.57,2019
"4737931",10251,205,765,11221,91.36,1.83,6.82,2019
"4737932",6695,139,593,7427,90.14,1.87,7.98,2019
"4737019",187,0,40,227,82.38,0,17.62,2019
"4737020",1681,75,297,2053,81.88,3.65,14.47,2019
"4737353",1485,29,466,1980,75,1.46,23.54,2019
"4737365",269,5,151,425,63.29,1.18,35.53,2019
"4737374",581,25,125,731,79.48,3.42,17.1,2019
"4737375",803,115,178,1096,73.27,10.49,16.24,2019
"4737385",2270,91,811,3172,71.56,2.87,25.57,2019
"4737396",53,0,26,79,67.09,0,32.91,2019
"4737406",4152,221,1722,6095,68.12,3.63,28.25,2019
"4737408",665,14,200,879,75.65,1.59,22.75,2019
"4737419",2301,158,330,2789,82.5,5.67,11.83,2019
"4737018",565,63,270,898,62.92,7.02,30.07,2019
"4737022",1750,37,322,2109,82.98,1.75,15.27,2019
"4737023",348,9,202,559,62.25,1.61,36.14,2019
"4737030",2103,78,672,2853,73.71,2.73,23.55,2019
"4737064",19554,429,1657,21640,90.36,1.98,7.66,2019
"4737067",10959,197,487,11643,94.13,1.69,4.18,2019
"4737620",12893,449,2979,16321,79,2.75,18.25,2019
"4737640",1048,28,393,1469,71.34,1.91,26.75,2019
"4737660",13000,520,3943,17463,74.44,2.98,22.58,2019
"4737664",9619,334,1701,11654,82.54,2.87,14.6,2019
"4737690",1317,50,342,1709,77.06,2.93,20.01,2019
"4737714",1143,58,528,1729,66.11,3.35,30.54,2019
"4737073",4701,87,637,5425,86.65,1.6,11.74,2019
"4737013",31679,1407,2511,35597,88.99,3.95,7.05,2019
"4737076",15780,299,1310,17389,90.75,1.72,7.53,2019
"4737086",9219,499,827,10545,87.43,4.73,7.84,2019
"4737097",556,27,285,868,64.06,3.11,32.83,2019
"4737101",1609,64,666,2339,68.79,2.74,28.47,2019
"4737172",9087,209,1847,11143,81.55,1.88,16.58,2019
"4737203",7465,324,937,8726,85.55,3.71,10.74,2019
"4737205",9582,374,822,10778,88.9,3.47,7.63,2019
"4737214",12114,317,1463,13894,87.19,2.28,10.53,2019
"4737313",384,4,222,610,62.95,0.66,36.39,2019
"4737324",1509,119,654,2282,66.13,5.21,28.66,2019
"4737012",681,24,236,941,72.37,2.55,25.08,2019
"4737026",706,13,136,855,82.57,1.52,15.91,2019
"4737028",151,14,123,288,52.43,4.86,42.71,2019
"4737033",1802,72,1072,2946,61.17,2.44,36.39,2019
"4737036",1314,71,751,2136,61.52,3.32,35.16,2019
"4737043",16604,462,1477,18543,89.54,2.49,7.97,2019
"4737048",1964,40,335,2339,83.97,1.71,14.32,2019
"4737051",969,22,468,1459,66.42,1.51,32.08,2019
"4737307",1567,13,493,2073,75.59,0.63,23.78,2019
"4737318",407,46,251,704,57.81,6.53,35.65,2019
"2839097",145,42,60,247,58.7,17,24.29,2019
"2839146",451,13,372,836,53.95,1.56,44.5,2019
"2839153",486,27,680,1193,40.74,2.26,57,2019
"2839162",4,0,18,22,18.18,0,81.82,2019
"2839167",0,0,0,0,NA,NA,NA,2019
"2839193",0,0,0,0,NA,NA,NA,2019
"2839217",0,0,0,0,NA,NA,NA,2019
"2839232",2843,177,165,3185,89.26,5.56,5.18,2019
"2839272",4104,311,507,4922,83.38,6.32,10.3,2019
"2839309",0,0,0,0,NA,NA,NA,2019
"2839342",462,24,97,583,79.25,4.12,16.64,2019
"2839406",0,0,0,0,NA,NA,NA,2019
"2839534",0,0,0,0,NA,NA,NA,2019
"2839540",2907,16,503,3426,84.85,0.47,14.68,2019
"2839737",52,0,47,99,52.53,0,47.47,2019
"2839760",12,0,0,12,100,0,0,2019
"1339813",439,50,298,787,55.78,6.35,37.87,2019
"1339815",310,14,340,664,46.69,2.11,51.2,2019
"1339817",2172,134,1535,3841,56.55,3.49,39.96,2019
"1339819",2372,292,1368,4032,58.83,7.24,33.93,2019
"1339823",1570,70,1323,2963,52.99,2.36,44.65,2019
"1339824",142,12,91,245,57.96,4.9,37.14,2019
"1339825",271,62,197,530,51.13,11.7,37.17,2019
"1339826",120,12,71,203,59.11,5.91,34.98,2019
"1339827",1129,33,327,1489,75.82,2.22,21.96,2019
"1339828",3673,47,1581,5301,69.29,0.89,29.82,2019
"1339834",458,20,394,872,52.52,2.29,45.18,2019
"1339836",74,0,14,88,84.09,0,15.91,2019
"1339837",1177,123,1291,2591,45.43,4.75,49.83,2019
"1339840",1377,109,432,1918,71.79,5.68,22.52,2019
"1339841",121,2,216,339,35.69,0.59,63.72,2019
"1339842",2159,100,692,2951,73.16,3.39,23.45,2019
"1339845",1934,66,1016,3016,64.12,2.19,33.69,2019
"1339846",480,24,286,790,60.76,3.04,36.2,2019
"1339851",600,42,228,870,68.97,4.83,26.21,2019
"1339854",474,48,347,869,54.55,5.52,39.93,2019
"1339859",263,29,122,414,63.53,7,29.47,2019
"1339861",220,25,269,514,42.8,4.86,52.33,2019
"1339862",288,9,199,496,58.06,1.81,40.12,2019
"1339866",85,11,42,138,61.59,7.97,30.43,2019
"1339867",162,6,14,182,89.01,3.3,7.69,2019
"4738456",852,95,528,1475,57.76,6.44,35.8,2019
"4738473",338,40,59,437,77.35,9.15,13.5,2019
"4738477",850,18,306,1174,72.4,1.53,26.06,2019
"4738481",294,8,113,415,70.84,1.93,27.23,2019
"4738549",1078,73,378,1529,70.5,4.77,24.72,2019
"4738551",1000,84,545,1629,61.39,5.16,33.46,2019
"4738555",6595,306,1541,8442,78.12,3.62,18.25,2019
"4738559",340,5,200,545,62.39,0.92,36.7,2019
"4738560",432,0,94,526,82.13,0,17.87,2019
"4738564",122,5,106,233,52.36,2.15,45.49,2019
"4738565",264,26,101,391,67.52,6.65,25.83,2019
"4738568",417,52,303,772,54.02,6.74,39.25,2019
"4738583",6460,515,2012,8987,71.88,5.73,22.39,2019
"4738588",182,14,114,310,58.71,4.52,36.77,2019
"4738589",55,0,29,84,65.48,0,34.52,2019
"2838601",449,56,241,746,60.19,7.51,32.31,2019
"2838603",846,42,403,1291,65.53,3.25,31.22,2019
"2838619",1097,142,745,1984,55.29,7.16,37.55,2019
"3943555",55,0,8,63,87.3,0,12.7,2019
"3943557",840,8,145,993,84.59,0.81,14.6,2019
"3943611",6378,312,1204,7894,80.8,3.95,15.25,2019
"3943619",2511,44,344,2899,86.62,1.52,11.87,2019
"3943227",6903,205,2513,9621,71.75,2.13,26.12,2019
"3943326",4182,154,1153,5489,76.19,2.81,21.01,2019
"3943340",440,16,233,689,63.86,2.32,33.82,2019
"3943016",14672,160,508,15340,95.65,1.04,3.31,2019
"3943023",3879,26,386,4291,90.4,0.61,9,2019
"3943025",1763,46,278,2087,84.48,2.2,13.32,2019
"3943029",99,15,25,139,71.22,10.79,17.99,2019
"3943068",18551,542,1913,21006,88.31,2.58,9.11,2019
"3943109",25,0,4,29,86.21,0,13.79,2019
"3943126",162,5,24,191,84.82,2.62,12.57,2019
"3943128",792,37,188,1017,77.88,3.64,18.49,2019
"3943142",35,5,17,57,61.4,8.77,29.82,2019
"3943149",693,78,165,936,74.04,8.33,17.63,2019
"3943153",271,0,66,337,80.42,0,19.58,2019
"3943203",2439,144,830,3413,71.46,4.22,24.32,2019
"3943211",5731,265,2381,8377,68.41,3.16,28.42,2019
"3943230",22146,293,1307,23746,93.26,1.23,5.5,2019
"3943314",996,27,210,1233,80.78,2.19,17.03,2019
"3943320",449,4,88,541,82.99,0.74,16.27,2019
"3943323",219,0,105,324,67.59,0,32.41,2019
"3943407",176,4,29,209,84.21,1.91,13.88,2019
"3943447",1123,44,93,1260,89.13,3.49,7.38,2019
"3943449",2849,127,497,3473,82.03,3.66,14.31,2019
"3943467",28,0,8,36,77.78,0,22.22,2019
"3943504",369,10,58,437,84.44,2.29,13.27,2019
"3943517",1310,46,191,1547,84.68,2.97,12.35,2019
"3943542",1276,0,66,1342,95.08,0,4.92,2019
"3943553",76,4,11,91,83.52,4.4,12.09,2019
"3943927",59,0,28,87,67.82,0,32.18,2019
"3943944",743,7,248,998,74.45,0.7,24.85,2019
"3943948",141,0,49,190,74.21,0,25.79,2019
"3943964",2840,82,844,3766,75.41,2.18,22.41,2019
"3943973",590,27,341,958,61.59,2.82,35.59,2019
"3943976",485,19,109,613,79.12,3.1,17.78,2019
"3943112",1597,34,140,1771,90.18,1.92,7.91,2019
"3943113",7408,192,1753,9353,79.2,2.05,18.74,2019
"2141003",578,30,292,900,64.22,3.33,32.44,2019
"2141004",1105,43,485,1633,67.67,2.63,29.7,2019
"2141014",2027,146,613,2786,72.76,5.24,22,2019
"2141015",6715,146,1146,8007,83.86,1.82,14.31,2019
"2141031",4237,177,1813,6227,68.04,2.84,29.12,2019
"2141033",484,0,112,596,81.21,0,18.79,2019
"2141142",26,0,0,26,100,0,0,2019
"2141274",112,43,42,197,56.85,21.83,21.32,2019
"2141522",1671,52,583,2306,72.46,2.25,25.28,2019
"2141622",48,0,11,59,81.36,0,18.64,2019
"2141017",14154,182,956,15292,92.56,1.19,6.25,2019
"2141548",341,0,124,465,73.33,0,26.67,2019
"2141602",328,37,39,404,81.19,9.16,9.65,2019
"2141642",171,0,95,266,64.29,0,35.71,2019
"2141763",141,0,95,236,59.75,0,40.25,2019
"2141833",103,0,74,177,58.19,0,41.81,2019
"3943903",669,17,165,851,78.61,2,19.39,2019
"2141010",991,24,332,1347,73.57,1.78,24.65,2019
"2141063",908,17,231,1156,78.55,1.47,19.98,2019
"1330546",2528,96,667,3291,76.82,2.92,20.27,2019
"1330581",24,0,9,33,72.73,0,27.27,2019
"1330622",4052,59,609,4720,85.85,1.25,12.9,2019
"1330641",672,30,110,812,82.76,3.69,13.55,2019
"1330648",645,44,462,1151,56.04,3.82,40.14,2019
"1330655",7160,310,1785,9255,77.36,3.35,19.29,2019
"1330664",4,0,11,15,26.67,0,73.33,2019
"1330711",1000,46,335,1381,72.41,3.33,24.26,2019
"1330803",229,0,69,298,76.85,0,23.15,2019
"1330627",560,23,390,973,57.55,2.36,40.08,2019
"1330740",2762,80,433,3275,84.34,2.44,13.22,2019
"1330741",8829,259,2457,11545,76.47,2.24,21.28,2019
"1330750",1144,24,100,1268,90.22,1.89,7.89,2019
"1330753",1848,52,596,2496,74.04,2.08,23.88,2019
"1330814",1826,138,728,2692,67.83,5.13,27.04,2019
"1330002",2416,75,326,2817,85.76,2.66,11.57,2019
"1330011",4374,59,510,4943,88.49,1.19,10.32,2019
"1330033",12028,263,837,13128,91.62,2,6.38,2019
"1330040",23265,220,1406,24891,93.47,0.88,5.65,2019
"1330043",26316,516,1693,28525,92.26,1.81,5.94,2019
"1330079",1273,25,206,1504,84.64,1.66,13.7,2019
"1330104",1208,70,374,1652,73.12,4.24,22.64,2019
"1330106",7370,186,623,8179,90.11,2.27,7.62,2019
"1330121",7056,260,1481,8797,80.21,2.96,16.84,2019
"1330122",7366,891,1082,9339,78.87,9.54,11.59,2019
"1330182",747,0,333,1080,69.17,0,30.83,2019
"1330184",1866,177,418,2461,75.82,7.19,16.98,2019
"1330187",2524,196,154,2874,87.82,6.82,5.36,2019
"1330189",13472,152,492,14116,95.44,1.08,3.49,2019
"1330527",1192,36,334,1562,76.31,2.3,21.38,2019
"1330528",7036,427,2135,9598,73.31,4.45,22.24,2019
"1330529",2854,132,1222,4208,67.82,3.14,29.04,2019
"1330531",2478,281,943,3702,66.94,7.59,25.47,2019
"1330534",9107,442,1128,10677,85.3,4.14,10.56,2019
"1330538",815,15,361,1191,68.43,1.26,30.31,2019
"1330540",5649,194,1789,7632,74.02,2.54,23.44,2019
"1330562",273,37,181,491,55.6,7.54,36.86,2019
"1330563",1523,54,372,1949,78.14,2.77,19.09,2019
"1330620",4229,109,429,4767,88.71,2.29,9,2019
"1330621",1623,48,145,1816,89.37,2.64,7.98,2019
"1330183",2011,37,78,2126,94.59,1.74,3.67,2019
"1331045",13,0,0,13,100,0,0,2019
"1331063",1263,85,571,1919,65.82,4.43,29.76,2019
"1331071",281,7,202,490,57.35,1.43,41.22,2019
"1331077",314,8,254,576,54.51,1.39,44.1,2019
"1331085",273,22,89,384,71.09,5.73,23.18,2019
"1331204",8445,369,2952,11766,71.77,3.14,25.09,2019
"1331217",3867,158,1917,5942,65.08,2.66,32.26,2019
"1331308",2218,35,566,2819,78.68,1.24,20.08,2019
"1331313",14267,247,1517,16031,89,1.54,9.46,2019
"1331314",0,0,0,0,NA,NA,NA,2019
"1331321",2055,43,548,2646,77.66,1.63,20.71,2019
"1331328",1387,8,64,1459,95.07,0.55,4.39,2019
"1331407",4548,201,403,5152,88.28,3.9,7.82,2019
"1331503",5274,456,1939,7669,68.77,5.95,25.28,2019
"1331513",3607,317,1895,5819,61.99,5.45,32.57,2019
"1331533",4104,233,1869,6206,66.13,3.75,30.12,2019
"1331539",3154,400,1554,5108,61.75,7.83,30.42,2019
"1331552",208,41,131,380,54.74,10.79,34.47,2019
"1234677",7872,260,597,8729,90.18,2.98,6.84,2019
"1234711",20521,411,951,21883,93.78,1.88,4.35,2019
"1234756",1064,16,128,1208,88.08,1.32,10.6,2019
"1234762",194,0,55,249,77.91,0,22.09,2019
"1234769",6721,144,1227,8092,83.06,1.78,15.16,2019
"1234773",916,74,33,1023,89.54,7.23,3.23,2019
"1234785",13489,265,1516,15270,88.34,1.74,9.93,2019
"1234987",3492,187,46,3725,93.74,5.02,1.23,2019
"1234996",4733,90,645,5468,86.56,1.65,11.8,2019
"1234491",10332,349,1555,12236,84.44,2.85,12.71,2019
"1234695",6719,61,594,7374,91.12,0.83,8.06,2019
"1234737",959,37,137,1133,84.64,3.27,12.09,2019
"1234242",3454,196,202,3852,89.67,5.09,5.24,2019
"1234266",5487,385,4100,9972,55.02,3.86,41.12,2019
"1234287",8789,540,1949,11278,77.93,4.79,17.28,2019
"1234431",2887,65,609,3561,81.07,1.83,17.1,2019
"1234433",2223,101,505,2829,78.58,3.57,17.85,2019
"1234434",2677,86,348,3111,86.05,2.76,11.19,2019
"1234446",6975,105,895,7975,87.46,1.32,11.22,2019
"1234465",6602,352,994,7948,83.06,4.43,12.51,2019
"1234481",8818,462,1193,10473,84.2,4.41,11.39,2019
"1234484",1114,68,322,1504,74.07,4.52,21.41,2019
"1234652",7682,698,2341,10721,71.65,6.51,21.84,2019
"1234669",4413,144,629,5186,85.09,2.78,12.13,2019
"1234681",334,0,0,334,100,0,0,2019
"1234684",10907,648,1403,12958,84.17,5,10.83,2019
"1234691",6086,646,1993,8725,69.75,7.4,22.84,2019
"1234114",6468,298,1116,7882,82.06,3.78,14.16,2019
"1234141",18,0,0,18,100,0,0,2019
"1234698",14460,849,2827,18136,79.73,4.68,15.59,2019
"1234734",1333,15,66,1414,94.27,1.06,4.67,2019
"1234235",5897,259,505,6661,88.53,3.89,7.58,2019
"1234448",3753,137,833,4723,79.46,2.9,17.64,2019
"1234202",8793,346,390,9529,92.28,3.63,4.09,2019
"1234432",4352,139,1051,5542,78.53,2.51,18.96,2019
"1234450",3922,157,980,5059,77.53,3.1,19.37,2019
"1234461",3746,174,549,4469,83.82,3.89,12.28,2019
"1234472",8824,325,1354,10503,84.01,3.09,12.89,2019
"1234476",8755,408,884,10047,87.14,4.06,8.8,2019
"1234609",13667,558,1659,15884,86.04,3.51,10.44,2019
"1234667",12288,636,2605,15529,79.13,4.1,16.78,2019
"1234679",22,0,11,33,66.67,0,33.33,2019
"1234689",8697,433,1684,10814,80.42,4,15.57,2019
"1234705",691,70,203,964,71.68,7.26,21.06,2019
"1234739",74,0,76,150,49.33,0,50.67,2019
"1234104",8755,380,1359,10494,83.43,3.62,12.95,2019
"1234112",9957,431,1477,11865,83.92,3.63,12.45,2019
"1234116",8221,442,977,9640,85.28,4.59,10.13,2019
"1234142",4260,326,2502,7088,60.1,4.6,35.3,2019
"1234210",6186,340,558,7084,87.32,4.8,7.88,2019
"1234215",271,0,0,271,100,0,0,2019
"1234216",323,6,55,384,84.11,1.56,14.32,2019
"1234223",7498,568,1143,9209,81.42,6.17,12.41,2019
"1234239",5921,156,792,6869,86.2,2.27,11.53,2019
"1234240",3739,63,144,3946,94.75,1.6,3.65,2019
"1234743",9693,703,1703,12099,80.11,5.81,14.08,2019
"1234760",244,0,55,299,81.61,0,18.39,2019
"1234761",13228,232,1185,14645,90.32,1.58,8.09,2019
"1234950",3955,138,1774,5867,67.41,2.35,30.24,2019
"4737323",9781,132,2181,12094,80.87,1.09,18.03,2019
"4737325",535,3,219,757,70.67,0.4,28.93,2019
"4737331",2247,116,644,3007,74.73,3.86,21.42,2019
"4737336",1216,91,486,1793,67.82,5.08,27.11,2019
"4737359",231,28,135,394,58.63,7.11,34.26,2019
"4737367",2739,165,1028,3932,69.66,4.2,26.14,2019
"4737405",6715,204,992,7911,84.88,2.58,12.54,2019
"4737407",2278,100,1181,3559,64.01,2.81,33.18,2019
"4737409",974,39,171,1184,82.26,3.29,14.44,2019
"4737614",0,0,0,0,NA,NA,NA,2019
"4737645",1736,70,290,2096,82.82,3.34,13.84,2019
"4737657",255,0,129,384,66.41,0,33.59,2019
"4737683",2891,325,1713,4929,58.65,6.59,34.75,2019
"4737691",170,0,63,233,72.96,0,27.04,2019
"4737711",1264,169,566,1999,63.23,8.45,28.31,2019
"4737715",185,8,113,306,60.46,2.61,36.93,2019
"4737726",525,11,269,805,65.22,1.37,33.42,2019
"4737732",44,0,55,99,44.44,0,55.56,2019
"4737745",5508,296,1539,7343,75.01,4.03,20.96,2019
"4737752",1744,10,762,2516,69.32,0.4,30.29,2019
"4737753",151,36,179,366,41.26,9.84,48.91,2019
"4737754",1435,61,421,1917,74.86,3.18,21.96,2019
"4737760",3641,253,863,4757,76.54,5.32,18.14,2019
"4737779",893,50,441,1384,64.52,3.61,31.86,2019
"4737863",1900,143,521,2564,74.1,5.58,20.32,2019
"4737865",6943,141,1340,8424,82.42,1.67,15.91,2019
"4737912",7886,333,2161,10380,75.97,3.21,20.82,2019
"4737916",2286,448,121,2855,80.07,15.69,4.24,2019
"4737921",8868,335,1574,10777,82.29,3.11,14.61,2019
"4737034",2358,52,385,2795,84.36,1.86,13.77,2019
"4737047",622,29,216,867,71.74,3.34,24.91,2019
"4737080",2344,66,602,3012,77.82,2.19,19.99,2019
"4737091",6401,302,1739,8442,75.82,3.58,20.6,2019
"4737110",9293,477,3378,13148,70.68,3.63,25.69,2019
"4737115",12242,585,3683,16510,74.15,3.54,22.31,2019
"4737127",5985,239,466,6690,89.46,3.57,6.97,2019
"4737141",375,15,41,431,87.01,3.48,9.51,2019
"4737145",663,14,163,840,78.93,1.67,19.4,2019
"4737153",1902,46,256,2204,86.3,2.09,11.62,2019
"4737179",4427,81,303,4811,92.02,1.68,6.3,2019
"4737183",885,47,235,1167,75.84,4.03,20.14,2019
"0136483",117,0,59,176,66.48,0,33.52,2019
"0136502",3639,32,2166,5837,62.34,0.55,37.11,2019
"0136522",1966,81,562,2609,75.35,3.1,21.54,2019
"0136530",2113,109,405,2627,80.43,4.15,15.42,2019
"0136539",171,47,44,262,65.27,17.94,16.79,2019
"0136558",984,16,485,1485,66.26,1.08,32.66,2019
"0136562",292,15,157,464,62.93,3.23,33.84,2019
"0136579",394,10,118,522,75.48,1.92,22.61,2019
"0136587",2823,5,424,3252,86.81,0.15,13.04,2019
"0136602",350,47,241,638,54.86,7.37,37.77,2019
"0136606",5165,300,2472,7937,65.07,3.78,31.15,2019
"0136609",8759,358,2194,11311,77.44,3.17,19.4,2019
"0136610",1669,119,2213,4001,41.71,2.97,55.31,2019
"0136611",1410,88,636,2134,66.07,4.12,29.8,2019
"0136695",17087,606,1288,18981,90.02,3.19,6.79,2019
"0136701",6474,166,1886,8526,75.93,1.95,22.12,2019
"0136726",944,104,659,1707,55.3,6.09,38.61,2019
"0136756",1101,20,745,1866,59,1.07,39.92,2019
"2838621",332,2,229,563,58.97,0.36,40.67,2019
"2838623",66,0,51,117,56.41,0,43.59,2019
"2838630",12,0,56,68,17.65,0,82.35,2019
"2838631",320,6,218,544,58.82,1.1,40.07,2019
"2838633",523,20,241,784,66.71,2.55,30.74,2019
"2838651",2564,53,280,2897,88.51,1.83,9.67,2019
"2838665",585,96,139,820,71.34,11.71,16.95,2019
"2838677",0,0,0,0,NA,NA,NA,2019
"2838701",5655,417,3011,9083,62.26,4.59,33.15,2019
"2838737",669,39,390,1098,60.93,3.55,35.52,2019
"2838745",0,0,59,59,0,0,100,2019
"2838746",102,1,95,198,51.52,0.51,47.98,2019
"4738392",172,0,50,222,77.48,0,22.52,2019
"2838876",363,12,160,535,67.85,2.24,29.91,2019
"2838914",163,14,77,254,64.17,5.51,30.31,2019
"2838924",52,13,155,220,23.64,5.91,70.45,2019
"2838928",12,0,125,137,8.76,0,91.24,2019
"2838940",419,31,135,585,71.62,5.3,23.08,2019
"2838941",528,115,717,1360,38.82,8.46,52.72,2019
"2838646",695,26,472,1193,58.26,2.18,39.56,2019
"2838632",8240,145,1148,9533,86.44,1.52,12.04,2019
"2838637",8378,190,1097,9665,86.68,1.97,11.35,2019
"2838642",601,50,179,830,72.41,6.02,21.57,2019
"2838650",731,118,519,1368,53.44,8.63,37.94,2019
"2838720",132,0,161,293,45.05,0,54.95,2019
"2838723",30,0,0,30,100,0,0,2019
"2838762",544,15,377,936,58.12,1.6,40.28,2019
"2838850",542,30,378,950,57.05,3.16,39.79,2019
"2838858",1834,158,593,2585,70.95,6.11,22.94,2019
"2838868",1553,71,563,2187,71.01,3.25,25.74,2019
"4738476",262,15,131,408,64.22,3.68,32.11,2019
"4738482",392,14,214,620,63.23,2.26,34.52,2019
"4738486",244,8,87,339,71.98,2.36,25.66,2019
"4738488",591,34,292,917,64.45,3.71,31.84,2019
"4738504",177,0,152,329,53.8,0,46.2,2019
"4738543",163,7,64,234,69.66,2.99,27.35,2019
"4738547",599,0,194,793,75.54,0,24.46,2019
"4738553",765,12,256,1033,74.06,1.16,24.78,2019
"4738556",3567,180,1375,5122,69.64,3.51,26.84,2019
"4738574",2243,135,908,3286,68.26,4.11,27.63,2019
"2838618",3014,193,1553,4760,63.32,4.05,32.63,2019
"2838635",3592,139,1755,5486,65.48,2.53,31.99,2019
"2838652",4220,387,1415,6022,70.08,6.43,23.5,2019
"2838654",16222,376,1588,18186,89.2,2.07,8.73,2019
"2838722",62,8,50,120,51.67,6.67,41.67,2019
"2838748",731,25,435,1191,61.38,2.1,36.52,2019
"2838756",1545,102,854,2501,61.78,4.08,34.15,2019
"2838821",3815,63,1192,5070,75.25,1.24,23.51,2019
"2838826",1441,106,317,1864,77.31,5.69,17.01,2019
"2838827",966,67,189,1222,79.05,5.48,15.47,2019
"2838833",628,88,298,1014,61.93,8.68,29.39,2019
"2838848",167,0,85,252,66.27,0,33.73,2019
"2838866",3486,182,596,4264,81.75,4.27,13.98,2019
"2838870",794,24,230,1048,75.76,2.29,21.95,2019
"2838963",252,24,211,487,51.75,4.93,43.33,2019
"4738024",8572,355,2280,11207,76.49,3.17,20.34,2019
"4738060",3403,99,564,4066,83.69,2.43,13.87,2019
"4738076",325,16,64,405,80.25,3.95,15.8,2019
"4738104",9012,497,3062,12571,71.69,3.95,24.36,2019
"1331568",216,0,90,306,70.59,0,29.41,2019
"1331625",280,0,118,398,70.35,0,29.65,2019
"1331634",1094,125,881,2100,52.1,5.95,41.95,2019
"1331638",226,19,219,464,48.71,4.09,47.2,2019
"1331647",711,109,502,1322,53.78,8.25,37.97,2019
"1331650",923,33,407,1363,67.72,2.42,29.86,2019
"1331709",4347,187,1565,6099,71.27,3.07,25.66,2019
"1331756",295,0,60,355,83.1,0,16.9,2019
"1331763",7065,86,1252,8403,84.08,1.02,14.9,2019
"1331768",5689,111,2043,7843,72.54,1.42,26.05,2019
"1331757",3398,135,567,4100,82.88,3.29,13.83,2019
"1331780",491,13,290,794,61.84,1.64,36.52,2019
"1331810",38,10,56,104,36.54,9.62,53.85,2019
"1331637",620,75,402,1097,56.52,6.84,36.65,2019
"1331643",2160,282,908,3350,64.48,8.42,27.1,2019
"1331707",7814,514,2103,10431,74.91,4.93,20.16,2019
"1331764",376,17,84,477,78.83,3.56,17.61,2019
"1331771",1394,156,465,2015,69.18,7.74,23.08,2019
"1331781",500,2,258,760,65.79,0.26,33.95,2019
"1331792",7621,236,1577,9434,80.78,2.5,16.72,2019
"1331829",268,16,30,314,85.35,5.1,9.55,2019
"1331830",640,2,138,780,82.05,0.26,17.69,2019
"1331833",2064,31,660,2755,74.92,1.13,23.96,2019
"1331836",270,42,162,474,56.96,8.86,34.18,2019
"1331055",781,221,1202,2204,35.44,10.03,54.54,2019
"1331064",2563,129,921,3613,70.94,3.57,25.49,2019
"1331070",317,8,113,438,72.37,1.83,25.8,2019
"1331072",265,48,201,514,51.56,9.34,39.11,2019
"1331090",148,31,197,376,39.36,8.24,52.39,2019
"1331092",1549,112,1025,2686,57.67,4.17,38.16,2019
"1331210",12311,328,1155,13794,89.25,2.38,8.37,2019
"1331302",2611,178,435,3224,80.99,5.52,13.49,2019
"1331323",411,16,160,587,70.02,2.73,27.26,2019
"1331326",6503,212,1055,7770,83.69,2.73,13.58,2019
"1331404",9505,246,1914,11665,81.48,2.11,16.41,2019
"1331501",4370,333,1579,6282,69.56,5.3,25.14,2019
"1331532",112,20,100,232,48.28,8.62,43.1,2019
"1331545",4203,310,1245,5758,72.99,5.38,21.62,2019
"1331549",188,4,552,744,25.27,0.54,74.19,2019
"1331001",488,23,389,900,54.22,2.56,43.22,2019
"1331006",1194,72,686,1952,61.17,3.69,35.14,2019
"1331008",5888,152,1079,7119,82.71,2.14,15.16,2019
"1331088",18275,606,2483,21364,85.54,2.84,11.62,2019
"1331206",5906,387,2958,9251,63.84,4.18,31.97,2019
"1331216",4723,241,1012,5976,79.03,4.03,16.93,2019
"1331301",1202,76,392,1670,71.98,4.55,23.47,2019
"1331303",549,88,255,892,61.55,9.87,28.59,2019
"1331305",1560,304,479,2343,66.58,12.97,20.44,2019
"1331324",8469,86,657,9212,91.93,0.93,7.13,2019
"1331401",6513,257,1108,7878,82.67,3.26,14.06,2019
"1331408",2549,100,455,3104,82.12,3.22,14.66,2019
"1331410",9352,204,486,10042,93.13,2.03,4.84,2019
"1331518",189,0,136,325,58.15,0,41.85,2019
"1331543",1093,194,347,1634,66.89,11.87,21.24,2019
"1331632",3778,385,462,4625,81.69,8.32,9.99,2019
"1331018",327,16,120,463,70.63,3.46,25.92,2019
"1331019",542,10,267,819,66.18,1.22,32.6,2019
"1232361",123,38,0,161,76.4,23.6,0,2019
"1232399",0,0,0,0,NA,NA,NA,2019
"1234983",12499,275,1134,13908,89.87,1.98,8.15,2019
"1234994",5972,375,1091,7438,80.29,5.04,14.67,2019
"1234736",5393,170,761,6324,85.28,2.69,12.03,2019
"1234108",7162,331,435,7928,90.34,4.18,5.49,2019
"1234117",4349,47,373,4769,91.19,0.99,7.82,2019
"1234138",106,0,49,155,68.39,0,31.61,2019
"1234139",95,3,17,115,82.61,2.61,14.78,2019
"1234217",2482,112,149,2743,90.48,4.08,5.43,2019
"1234219",7613,628,376,8617,88.35,7.29,4.36,2019
"1234228",3445,215,178,3838,89.76,5.6,4.64,2019
"1234232",11934,433,1400,13767,86.69,3.15,10.17,2019
"1234243",11882,340,1070,13292,89.39,2.56,8.05,2019
"1234285",7559,592,1749,9900,76.35,5.98,17.67,2019
"1234293",15987,503,1606,18096,88.35,2.78,8.87,2019
"1234436",2699,143,730,3572,75.56,4,20.44,2019
"1234488",3018,75,1069,4162,72.51,1.8,25.68,2019
"1234498",214,15,43,272,78.68,5.51,15.81,2019
"1234610",4214,68,735,5017,83.99,1.36,14.65,2019
"1234685",6116,410,499,7025,87.06,5.84,7.1,2019
"1234731",5549,197,706,6452,86,3.05,10.94,2019
"1234797",404,0,14,418,96.65,0,3.35,2019
"1234952",14337,526,2163,17026,84.21,3.09,12.7,2019
"1234981",1173,97,484,1754,66.88,5.53,27.59,2019
"1234986",10376,529,933,11838,87.65,4.47,7.88,2019
"1234251",1539,136,353,2028,75.89,6.71,17.41,2019
"1234275",8063,295,981,9339,86.34,3.16,10.5,2019
"1234453",3323,122,892,4337,76.62,2.81,20.57,2019
"1234608",11606,355,1518,13479,86.1,2.63,11.26,2019
"1234109",9342,480,1242,11064,84.44,4.34,11.23,2019
"1234953",20172,485,1182,21839,92.37,2.22,5.41,2019
"1234222",4102,333,801,5236,78.34,6.36,15.3,2019
"1234224",6198,144,1099,7441,83.3,1.94,14.77,2019
"1234229",3001,56,320,3377,88.87,1.66,9.48,2019
"1234231",12328,492,1685,14505,84.99,3.39,11.62,2019
"1234238",9002,186,903,10091,89.21,1.84,8.95,2019
"1234268",0,0,88,88,0,0,100,2019
"1234286",6137,37,320,6494,94.5,0.57,4.93,2019
"1234428",3395,84,514,3993,85.02,2.1,12.87,2019
"1234442",5992,138,701,6831,87.72,2.02,10.26,2019
"1234473",5905,83,741,6729,87.75,1.23,11.01,2019
"1234668",16115,670,2924,19709,81.76,3.4,14.84,2019
"1233957",3422,143,119,3684,92.89,3.88,3.23,2019
"1233982",3415,145,507,4067,83.97,3.57,12.47,2019
"1233598",5361,51,726,6138,87.34,0.83,11.83,2019
"1233480",5157,221,323,5701,90.46,3.88,5.67,2019
"1233576",1887,80,165,2132,88.51,3.75,7.74,2019
"1233612",14287,696,3883,18866,75.73,3.69,20.58,2019
"1233614",16340,239,1818,18397,88.82,1.3,9.88,2019
"1233615",15157,357,1941,17455,86.83,2.05,11.12,2019
"1233620",0,0,11,11,0,0,100,2019
"1233709",8613,308,1694,10615,81.14,2.9,15.96,2019
"1233714",6264,164,1511,7939,78.9,2.07,19.03,2019
"1233770",9015,403,2203,11621,77.58,3.47,18.96,2019
"1233772",8287,296,1265,9848,84.15,3.01,12.85,2019
"1233028",7571,256,306,8133,93.09,3.15,3.76,2019
"1233037",3825,166,717,4708,81.24,3.53,15.23,2019
"1233054",5917,414,3238,9569,61.84,4.33,33.84,2019
"1233060",9955,351,2989,13295,74.88,2.64,22.48,2019
"1233062",10263,489,1406,12158,84.41,4.02,11.56,2019
"0136793",87,0,3,90,96.67,0,3.33,2019
"0136853",2472,82,760,3314,74.59,2.47,22.93,2019
"0136863",3354,114,1431,4899,68.46,2.33,29.21,2019
"0136869",5598,372,2192,8162,68.59,4.56,26.86,2019
"0136908",631,60,148,839,75.21,7.15,17.64,2019
"0136009",554,31,375,960,57.71,3.23,39.06,2019
"0136025",1129,5,184,1318,85.66,0.38,13.96,2019
"0136047",263,20,164,447,58.84,4.47,36.69,2019
"0136078",3582,237,1093,4912,72.92,4.82,22.25,2019
"0136079",2467,164,728,3359,73.44,4.88,21.67,2019
"0136080",659,22,174,855,77.08,2.57,20.35,2019
"0136113",253,3,7,263,96.2,1.14,2.66,2019
"0136201",4197,298,2609,7104,59.08,4.19,36.73,2019
"0136206",3265,121,1047,4433,73.65,2.73,23.62,2019
"0136251",1137,132,549,1818,62.54,7.26,30.2,2019
"0136274",3262,125,974,4361,74.8,2.87,22.33,2019
"0136314",142,1,54,197,72.08,0.51,27.41,2019
"0136346",337,14,194,545,61.83,2.57,35.6,2019
"0136351",1048,37,381,1466,71.49,2.52,25.99,2019
"0136523",724,33,200,957,75.65,3.45,20.9,2019
"0136532",11470,209,1250,12929,88.72,1.62,9.67,2019
"0136540",109,11,126,246,44.31,4.47,51.22,2019
"0136542",5473,343,895,6711,81.55,5.11,13.34,2019
"0136559",107,0,0,107,100,0,0,2019
"0136564",42,19,0,61,68.85,31.15,0,2019
"0136567",3810,134,1032,4976,76.57,2.69,20.74,2019
"0136571",4383,100,1075,5558,78.86,1.8,19.34,2019
"0136862",1335,60,931,2326,57.39,2.58,40.03,2019
"0136904",1014,110,388,1512,67.06,7.28,25.66,2019
"0136925",830,36,380,1246,66.61,2.89,30.5,2019
"0136016",673,193,629,1495,45.02,12.91,42.07,2019
"0136024",1700,43,432,2175,78.16,1.98,19.86,2019
"0136031",40,0,52,92,43.48,0,56.52,2019
"0136043",889,44,385,1318,67.45,3.34,29.21,2019
"0136117",20071,583,1898,22552,89,2.59,8.42,2019
"0136255",298,0,84,382,78.01,0,21.99,2019
"0136264",2119,82,1045,3246,65.28,2.53,32.19,2019
"0136280",1021,19,584,1624,62.87,1.17,35.96,2019
"0136301",10140,291,3713,14144,71.69,2.06,26.25,2019
"0136455",68,0,49,117,58.12,0,41.88,2019
"0136460",1644,265,1867,3776,43.54,7.02,49.44,2019
"0136511",117,0,83,200,58.5,0,41.5,2019
"0136524",228,11,249,488,46.72,2.25,51.02,2019
"0136525",481,25,122,628,76.59,3.98,19.43,2019
"0136529",51,0,26,77,66.23,0,33.77,2019
"0136583",225,35,37,297,75.76,11.78,12.46,2019
"0136749",256,28,115,399,64.16,7.02,28.82,2019
"0136617",2576,169,2196,4941,52.14,3.42,44.44,2019
"0136723",43,0,84,127,33.86,0,66.14,2019
"0136748",656,3,334,993,66.06,0.3,33.64,2019
"0136776",441,0,135,576,76.56,0,23.44,2019
"0136782",518,18,412,948,54.64,1.9,43.46,2019
"0136353",527,23,151,701,75.18,3.28,21.54,2019
"0136371",210,2,108,320,65.62,0.62,33.75,2019
"0136453",662,27,252,941,70.35,2.87,26.78,2019
"0136467",2799,61,1135,3995,70.06,1.53,28.41,2019
"0136790",38,0,21,59,64.41,0,35.59,2019
"0136832",8385,974,875,10234,81.93,9.52,8.55,2019
"0136858",93,0,59,152,61.18,0,38.82,2019
"4738109",8468,721,7196,16385,51.68,4.4,43.92,2019
"4738114",4382,416,4981,9779,44.81,4.25,50.94,2019
"4738128",10778,865,4162,15805,68.19,5.47,26.33,2019
"4738141",6900,105,645,7650,90.2,1.37,8.43,2019
"4738232",573,28,213,814,70.39,3.44,26.17,2019
"4738310",1600,39,717,2356,67.91,1.66,30.43,2019
"2838915",1090,15,458,1563,69.74,0.96,29.3,2019
"2838929",297,0,277,574,51.74,0,48.26,2019
"2838952",76,2,96,174,43.68,1.15,55.17,2019
"2838957",154,5,106,265,58.11,1.89,40,2019
"4738501",12911,735,3344,16990,75.99,4.33,19.68,2019
"4738541",471,18,239,728,64.7,2.47,32.83,2019
"2838611",4236,288,1308,5832,72.63,4.94,22.43,2019
"2838673",295,18,34,347,85.01,5.19,9.8,2019
"2838769",386,10,324,720,53.61,1.39,45,2019
"2838643",482,0,377,859,56.11,0,43.89,2019
"4738545",535,0,145,680,78.68,0,21.32,2019
"4738552",62,0,8,70,88.57,0,11.43,2019
"4738554",339,21,71,431,78.65,4.87,16.47,2019
"4738558",4154,138,351,4643,89.47,2.97,7.56,2019
"4738567",202,8,51,261,77.39,3.07,19.54,2019
"4738581",1063,21,426,1510,70.4,1.39,28.21,2019
"2838829",4853,237,1730,6820,71.16,3.48,25.37,2019
"2838927",249,8,240,497,50.1,1.61,48.29,2019
"2838857",1106,81,302,1489,74.28,5.44,20.28,2019
"4738075",752,30,458,1240,60.65,2.42,36.94,2019
"4738226",98,0,32,130,75.38,0,24.62,2019
"4738337",412,7,161,580,71.03,1.21,27.76,2019
"4738585",953,2,485,1440,66.18,0.14,33.68,2019
"2838738",14,7,24,45,31.11,15.56,53.33,2019
"4738311",331,15,69,415,79.76,3.61,16.63,2019
"4738362",375,13,94,482,77.8,2.7,19.5,2019
"4738057",908,9,418,1335,68.01,0.67,31.31,2019
"4738450",720,56,363,1139,63.21,4.92,31.87,2019
"4738237",4658,206,1310,6174,75.45,3.34,21.22,2019
"2838923",296,18,120,434,68.2,4.15,27.65,2019
"2838948",596,3,453,1052,56.65,0.29,43.06,2019
"2838844",50,0,32,82,60.98,0,39.02,2019
"2838949",132,0,11,143,92.31,0,7.69,2019
"4738007",29,7,0,36,80.56,19.44,0,2019
"4738016",17191,449,1037,18677,92.04,2.4,5.55,2019
"4738029",12,0,0,12,100,0,0,2019
"4738054",33,0,0,33,100,0,0,2019
"4738070",56,0,9,65,86.15,0,13.85,2019
"4738077",23,0,16,39,58.97,0,41.03,2019
"4738152",0,0,0,0,NA,NA,NA,2019
"4738254",22,0,3,25,88,0,12,2019
"4738365",0,0,0,0,NA,NA,NA,2019
"4738455",58,0,9,67,86.57,0,13.43,2019
"4738505",0,0,0,0,NA,NA,NA,2019
"4738571",4342,108,1336,5786,75.04,1.87,23.09,2019
"4738572",3861,68,886,4815,80.19,1.41,18.4,2019
"4738578",55,0,6,61,90.16,0,9.84,2019
"2838702",13,0,0,13,100,0,0,2019
"2838704",2,0,0,2,100,0,0,2019
"2838731",8,0,46,54,14.81,0,85.19,2019
"2838749",5,0,29,34,14.71,0,85.29,2019
"2838781",22,0,85,107,20.56,0,79.44,2019
"2838945",12,0,0,12,100,0,0,2019
